t_id,SourcePort,Destination Port,NATSourcePort,NATDestinationPort,Action,Bytes,BytesSent,BytesReceived,Packets,ElapsedTime,pkts_sent,pkts_received
53685,58060,445,0,0,drop,70,70,0,1,0,1,0
53686,53097,443,17057,443,allow,7013,1718,5295,18,326,9,9
53687,53092,443,57966,443,allow,8071,1789,6282,20,326,10,10
53688,53101,443,37557,443,allow,8071,1789,6282,20,326,10,10
53689,47080,80,47080,80,allow,276453,7832,268621,287,165,92,195
53690,56192,53,2949,53,allow,170,87,83,2,30,1,1
53691,55056,53,8605,53,allow,170,87,83,2,30,1,1
53692,58283,443,44449,443,allow,42792,12402,30390,98,370,45,53
53693,51799,58416,38209,58416,allow,316,136,180,6,6,3,3
53694,41328,53,51462,53,allow,198,93,105,2,30,1,1
53695,53100,443,46629,443,allow,8571,1789,6782,20,326,10,10
53696,53130,443,27794,443,allow,7169,1715,5454,18,325,9,9
53697,56630,443,6016,443,allow,7941,1952,5989,20,15,11,9
53698,57205,53,27220,53,allow,711,87,624,2,30,1,1
53699,41520,53,0,0,allow,82,82,0,1,30,1,0
53700,27005,27015,31409,27015,allow,891,126,765,2,31,1,1
53701,53166,80,34843,80,allow,1487,838,649,10,323,6,4
53702,53126,443,9290,443,allow,5604,2738,2866,20,325,10,10
53703,53102,443,30366,443,allow,7149,1719,5430,18,326,9,9
53704,53140,443,26358,443,allow,6401,1225,5176,18,324,9,9
53705,53168,80,46007,80,allow,1501,958,543,10,323,6,4
53706,58974,443,58974,443,allow,6792,1521,5271,18,28,11,7
53707,55618,45341,55864,45341,allow,70,70,0,2,8,2,0
53708,37961,443,21395,443,allow,153,93,60,2,5,1,1
53709,28316,3389,28316,3389,allow,4695,2520,2175,22,19,13,9
53710,37805,443,65176,443,allow,5577,1977,3600,29,56,16,13
53711,45540,443,45540,443,allow,4702,1795,2907,19,28,11,8
53712,64380,53,44055,53,allow,98,98,0,1,30,1,0
53713,58970,80,38149,80,allow,1521,967,554,10,75,6,4
53714,54823,53,13813,53,allow,198,93,105,2,30,1,1
53715,57162,53,0,0,allow,198,91,107,2,30,1,1
53716,29805,53,29805,53,allow,226,89,137,2,30,1,1
53717,52728,80,55587,80,allow,13372,7598,5774,29,555,18,11
53718,35601,80,28025,80,allow,1151,711,440,10,15,5,5
53719,53138,443,15464,443,allow,6760,1346,5414,18,325,9,9
53720,52652,443,14258,443,allow,14511,4628,9883,29,559,15,14
53721,53158,443,6890,443,allow,7427,1517,5910,22,323,11,11
53722,53095,443,22543,443,allow,7014,1719,5295,18,326,9,9
53723,56803,52421,20663,52421,allow,164,70,94,2,5,1,1
53724,39328,80,62636,80,allow,234,234,0,4,12,4,0
53725,41518,443,53815,443,allow,25342,17809,7533,56,80,28,28
53726,51775,57887,37993,57887,allow,66,66,0,1,5,1,0
53727,56628,443,49515,443,allow,7941,1952,5989,20,15,11,9
53728,3669,53,3669,53,allow,825,99,726,2,30,1,1
53729,53085,53,0,0,allow,82,82,0,1,30,1,0
53730,56629,443,57154,443,allow,7889,1900,5989,20,15,11,9
53731,37233,53,50033,53,allow,198,93,105,2,30,1,1
53732,60405,64722,47645,64722,allow,70,70,0,2,8,2,0
53733,20892,53,20892,53,allow,825,99,726,2,30,1,1
53734,53597,53,0,0,allow,233,85,148,2,30,1,1
53735,56750,53,56750,53,allow,217,87,130,2,30,1,1
53736,41772,80,18406,80,allow,738,70,668,12,394,2,10
53737,52335,443,49316,443,allow,5670,2739,2931,18,129,9,9
53738,8933,56205,0,0,deny,62,62,0,1,0,1,0
53739,53105,445,0,0,drop,70,70,0,1,0,1,0
53740,53104,445,0,0,drop,70,70,0,1,0,1,0
53741,60294,30188,0,0,deny,66,66,0,1,0,1,0
53742,53103,445,0,0,drop,70,70,0,1,0,1,0
53743,27010,64147,0,0,deny,62,62,0,1,0,1,0
53744,53097,445,0,0,drop,70,70,0,1,0,1,0
53745,53100,445,0,0,drop,70,70,0,1,0,1,0
53746,9605,57470,0,0,deny,62,62,0,1,0,1,0
53747,11133,51505,0,0,deny,66,66,0,1,0,1,0
53748,13441,57470,0,0,deny,62,62,0,1,0,1,0
53749,12895,37965,0,0,deny,62,62,0,1,0,1,0
53750,58074,11392,0,0,deny,66,66,0,1,0,1,0
53751,48706,23393,0,0,deny,60,60,0,1,0,1,0
53752,53650,64147,0,0,deny,66,66,0,1,0,1,0
53753,43671,37965,0,0,deny,62,62,0,1,0,1,0
53754,52356,55442,0,0,deny,66,66,0,1,0,1,0
53755,3564,57470,0,0,deny,62,62,0,1,0,1,0
53756,42783,53,31772,53,allow,199,94,105,2,30,1,1
53757,39834,53,46672,53,allow,199,94,105,2,30,1,1
53758,51270,48061,59473,48061,allow,70,70,0,2,8,2,0
53759,41295,443,9928,443,allow,1482,988,494,12,26,7,5
53760,3578,51505,0,0,deny,66,66,0,1,0,1,0
53761,53085,445,0,0,drop,70,70,0,1,0,1,0
53762,53083,445,0,0,drop,70,70,0,1,0,1,0
53763,53080,445,0,0,drop,70,70,0,1,0,1,0
53764,53075,445,0,0,drop,70,70,0,1,0,1,0
53765,53074,445,0,0,drop,70,70,0,1,0,1,0
53766,50143,35253,0,0,deny,62,62,0,1,0,1,0
53767,58054,445,0,0,drop,70,70,0,1,0,1,0
53768,58053,445,0,0,drop,70,70,0,1,0,1,0
53769,58049,445,0,0,drop,70,70,0,1,0,1,0
53770,64051,36829,0,0,deny,62,62,0,1,0,1,0
53771,28221,37965,0,0,deny,62,62,0,1,0,1,0
53772,62386,37965,0,0,deny,66,66,0,1,0,1,0
53773,47173,35440,0,0,deny,146,146,0,1,0,1,0
53774,16322,57470,0,0,deny,62,62,0,1,0,1,0
53775,53063,445,0,0,drop,70,70,0,1,0,1,0
53776,58468,37965,0,0,deny,66,66,0,1,0,1,0
53777,53454,445,0,0,drop,66,66,0,1,0,1,0
53778,37646,53,37646,53,allow,832,106,726,2,30,1,1
53779,37066,443,21003,443,allow,2386,1423,963,18,169,10,8
53780,58780,443,38855,443,allow,8661,1687,6974,30,244,16,14
53781,65471,443,32170,443,allow,92569,4939,87630,111,15,45,66
53782,65118,53,14399,53,allow,539,91,448,4,43,2,2
53783,55613,56511,52356,56511,allow,504,318,186,8,15,5,3
53784,63971,53,59567,53,allow,358,94,264,4,45,2,2
53785,55889,53,31264,53,allow,177,94,83,2,29,1,1
53786,56448,53,60650,53,allow,177,94,83,2,29,1,1
53787,52957,80,46330,80,allow,156378,5406,150972,165,383,60,105
53788,64540,53,44077,53,allow,352,107,245,4,37,2,2
53789,60404,37869,39714,37869,allow,258,70,188,4,8,2,2
53790,56799,1,48991,1,allow,316,136,180,6,6,3,3
53791,64407,53,18646,53,allow,232,110,122,2,29,1,1
53792,53115,40693,57479,40693,allow,70,70,0,1,5,1,0
53793,51513,443,33339,443,allow,75323,6054,69269,110,38,52,58
53794,35515,53,6694,53,allow,199,94,105,2,29,1,1
53795,65111,53,60409,53,allow,198,94,104,2,29,1,1
53796,26900,27017,25827,27017,allow,172,86,86,2,29,1,1
53797,49360,53,44969,53,allow,263,102,161,2,29,1,1
53798,49818,53,22415,53,allow,211,102,109,2,29,1,1
53799,52922,443,7305,443,allow,5583,1390,4193,19,15,9,10
53800,19872,53,19872,53,allow,235,90,145,2,32,1,1
53801,51773,23728,8041,23728,allow,70,70,0,1,5,1,0
53802,5588,5588,0,0,allow,3354,1792,1562,46,193,23,23
53803,65064,53,64961,53,allow,197,94,103,2,30,1,1
53804,29606,53,29606,53,allow,216,90,126,2,30,1,1
53805,27005,27015,58465,27015,allow,881,126,755,2,30,1,1
53806,57867,27019,34880,27019,allow,468,390,78,5,30,4,1
53807,64365,53,32131,53,allow,234,94,140,2,30,1,1
53808,53160,80,36074,80,allow,1213,725,488,10,323,6,4
53809,51776,14645,62934,14645,allow,70,70,0,1,5,1,0
53810,60753,40010,14923,40010,allow,316,136,180,6,6,3,3
53811,46263,7700,25323,7700,allow,1440,956,484,15,35,8,7
53812,51793,12210,40752,12210,allow,70,70,0,2,8,2,0
53813,50648,80,8370,80,allow,62,62,0,1,5,1,0
53814,59975,443,17092,443,allow,7875,3100,4775,42,24,22,20
53815,49913,443,1275,443,allow,4275,2222,2053,24,15,14,10
53816,53577,8999,47694,8999,allow,372,186,186,6,15,3,3
53817,56792,42155,2470,42155,allow,70,70,0,2,8,2,0
53818,49662,443,39223,443,allow,2690,1342,1348,23,19,12,11
53819,55056,53,24229,53,allow,177,94,83,2,30,1,1
53820,44498,53,11053,53,allow,168,78,90,2,30,1,1
53821,63966,53,6914,53,allow,214,102,112,2,30,1,1
53822,48165,53,17622,53,allow,199,94,105,2,30,1,1
53823,50838,53,8440,53,allow,70,70,0,1,30,1,0
53824,27005,27015,14961,27015,allow,884,126,758,2,30,1,1
53825,56266,53,6584,53,allow,245,102,143,2,30,1,1
53826,51505,443,46771,443,allow,645662,22326,623336,743,41,299,444
53827,49202,80,38617,80,allow,3223,605,2618,13,15,7,6
53828,33254,443,31595,443,allow,4838,2974,1864,21,17,13,8
53829,27005,27016,2493,27016,allow,895,126,769,2,30,1,1
53830,52932,80,19505,80,allow,4214,1921,2293,18,383,10,8
53831,13514,53,13514,53,allow,244,98,146,2,32,1,1
53832,7447,53,7447,53,allow,244,98,146,2,32,1,1
53833,51791,56116,1472,56116,allow,70,70,0,2,8,2,0
53834,60406,64337,47861,64337,allow,70,70,0,2,8,2,0
53835,42165,443,38543,443,allow,7583,607,6976,18,119,7,11
53836,57790,443,14547,443,allow,6321,3341,2980,19,135,9,10
53837,46762,443,18994,443,allow,565251,13665,551586,542,30,173,369
53838,56405,443,34557,443,allow,6202,1212,4990,27,1197,8,19
53839,27005,27025,44976,27025,allow,893,126,767,2,30,1,1
53840,53490,80,9100,80,allow,2577,1278,1299,14,267,8,6
53841,52732,80,5693,80,allow,23509,14666,8843,70,553,38,32
53842,56791,11500,39420,11500,allow,70,70,0,2,8,2,0
53843,55611,58049,54667,58049,allow,504,318,186,8,15,5,3
53844,28004,443,21121,443,allow,5517,1390,4127,18,15,9,9
53845,26900,27017,23576,27017,allow,340,82,258,5,29,2,3
53846,59756,53,24009,53,allow,211,78,133,2,29,1,1
53847,56970,80,14502,80,allow,1783,841,942,10,20,6,4
53848,27005,27015,4886,27015,allow,876,126,750,2,30,1,1
53849,64481,53,22915,53,allow,386,106,280,4,51,2,2
53850,26900,27017,12614,27017,allow,422,164,258,6,29,3,3
53851,42956,443,56970,443,allow,11435,2668,8767,38,233,14,24
53852,55889,53,19175,53,allow,177,94,83,2,29,1,1
53853,57788,443,31761,443,allow,6400,1327,5073,21,21,13,8
53854,44389,53,44389,53,allow,235,90,145,2,32,1,1
53855,56745,53,50042,53,allow,900,110,790,2,30,1,1
53856,34988,53,12799,53,allow,199,94,105,2,30,1,1
53857,60469,53,22418,53,allow,78,78,0,1,30,1,0
53858,51217,443,21771,443,allow,126,60,66,3,5,2,1
53859,51774,16930,9118,16930,allow,70,70,0,1,5,1,0
53860,49686,443,60868,443,allow,8475,1661,6814,32,76,14,18
53861,46262,123,34977,123,allow,184,94,90,2,30,1,1
53862,49986,53,35150,53,allow,209,94,115,2,30,1,1
53863,60752,28080,38222,28080,allow,70,70,0,2,8,2,0
53864,51268,47662,19145,47662,allow,70,70,0,1,5,1,0
53865,49798,53,59765,53,allow,365,97,268,4,40,2,2
53866,42917,53,23421,53,allow,168,78,90,2,30,1,1
53867,52318,443,6808,443,allow,9453,2797,6656,46,32,25,21
53868,27005,27015,56758,27015,allow,869,126,743,2,30,1,1
53869,27005,27015,46152,27015,allow,875,126,749,2,30,1,1
53870,60281,443,39585,443,allow,63696,4774,58922,83,125,32,51
53871,41476,53,41476,53,allow,235,90,145,2,33,1,1
53872,51794,53911,31763,53911,allow,70,70,0,2,8,2,0
53873,51795,60258,12488,60258,allow,70,70,0,2,8,2,0
53874,56617,80,63909,80,allow,234,234,0,4,12,4,0
53875,49556,443,13898,443,allow,6440,1844,4596,22,141,11,11
53876,8180,53,8180,53,allow,220,90,130,2,30,1,1
53877,64415,53,14789,53,allow,228,102,126,2,30,1,1
53878,56192,53,54480,53,allow,177,94,83,2,30,1,1
53879,64678,53,21797,53,allow,229,110,119,2,30,1,1
53880,27005,27015,19285,27015,allow,892,126,766,2,30,1,1
53881,58805,443,39224,443,allow,9030,2311,6719,24,362,13,11
53882,60408,55557,44331,55557,allow,70,70,0,2,8,2,0
53883,57470,24874,7043,24874,allow,132,132,0,3,1199,3,0
53884,50265,55243,25034,55243,allow,481,150,331,2,1200,1,1
53885,50186,443,39007,443,allow,6440,1603,4837,23,361,11,12
53886,17750,1024,34469,1024,allow,323,150,173,2,1200,1,1
53887,49657,443,29231,443,allow,9039,2175,6864,32,20,17,15
53888,56192,53,12282,53,allow,282,87,195,4,45,2,2
53889,59974,443,48312,443,allow,200862,57949,142913,361,24,172,189
53890,56140,53,23511,53,allow,195,86,109,2,30,1,1
53891,63787,18318,40020,18318,allow,66,66,0,2,8,2,0
53892,53601,30160,44927,30160,allow,70,70,0,2,8,2,0
53893,59980,443,52666,443,allow,345468,18536,326932,432,22,200,232
53894,52763,443,13803,443,allow,256711,14141,242570,367,96,152,215
53895,36025,443,36025,443,allow,4585,1678,2907,19,29,11,8
53896,64973,53,36407,53,allow,257,102,155,2,30,1,1
53897,57096,53,51826,53,allow,177,94,83,2,30,1,1
53898,52921,443,13055,443,allow,5581,1388,4193,19,15,9,10
53899,28003,443,64020,443,allow,5515,1388,4127,18,15,9,9
53900,52412,443,22141,443,allow,11565,5557,6008,52,16,27,25
53901,49743,53,12081,53,allow,636,202,434,6,47,3,3
53902,65511,53,22579,53,allow,545,136,409,4,56,2,2
53903,56363,53,52930,53,allow,212,102,110,2,30,1,1
53904,65209,57866,0,0,deny,62,62,0,1,0,1,0
53905,58043,445,0,0,drop,70,70,0,1,0,1,0
53906,53419,28189,0,0,deny,60,60,0,1,0,1,0
53907,2323,23117,0,0,deny,62,62,0,1,0,1,0
53908,18091,23,0,0,deny,60,60,0,1,0,1,0
53909,6889,40740,0,0,deny,143,143,0,1,0,1,0
53910,58787,23,0,0,deny,60,60,0,1,0,1,0
53911,64940,36237,0,0,deny,62,62,0,1,0,1,0
53912,53059,445,0,0,drop,70,70,0,1,0,1,0
53913,1024,57470,0,0,deny,62,62,0,1,0,1,0
53914,53449,445,0,0,drop,66,66,0,1,0,1,0
53915,53448,445,0,0,drop,66,66,0,1,0,1,0
53916,52064,22114,0,0,deny,66,66,0,1,0,1,0
53917,58036,445,0,0,drop,70,70,0,1,0,1,0
53918,53049,445,0,0,drop,70,70,0,1,0,1,0
53919,53050,445,0,0,drop,70,70,0,1,0,1,0
53920,2923,57470,0,0,deny,66,66,0,1,0,1,0
53921,4127,26467,0,0,deny,66,66,0,1,0,1,0
53922,53044,445,0,0,drop,70,70,0,1,0,1,0
53923,53045,445,0,0,drop,70,70,0,1,0,1,0
53924,58030,445,0,0,drop,70,70,0,1,0,1,0
53925,58027,445,0,0,drop,70,70,0,1,0,1,0
53926,58023,445,0,0,drop,70,70,0,1,0,1,0
53927,53043,445,0,0,drop,70,70,0,1,0,1,0
53928,53447,445,0,0,drop,66,66,0,1,0,1,0
53929,80,37649,0,0,deny,60,60,0,1,0,1,0
53930,59781,56205,0,0,deny,66,66,0,1,0,1,0
53931,6881,59353,0,0,deny,146,146,0,1,0,1,0
53932,6881,29517,0,0,deny,146,146,0,1,0,1,0
53933,58020,445,0,0,drop,70,70,0,1,0,1,0
53934,58017,445,0,0,drop,70,70,0,1,0,1,0
53935,58015,445,0,0,drop,70,70,0,1,0,1,0
53936,58013,445,0,0,drop,70,70,0,1,0,1,0
53937,53439,445,0,0,drop,66,66,0,1,0,1,0
53938,53037,445,0,0,drop,70,70,0,1,0,1,0
53939,53242,37965,0,0,deny,66,66,0,1,0,1,0
53940,53433,445,0,0,drop,66,66,0,1,0,1,0
53941,53432,445,0,0,drop,66,66,0,1,0,1,0
53942,53431,445,0,0,drop,66,66,0,1,0,1,0
53943,80,53945,0,0,deny,60,60,0,1,0,1,0
53944,19747,37965,0,0,deny,62,62,0,1,0,1,0
53945,53427,445,0,0,drop,66,66,0,1,0,1,0
53946,53428,445,0,0,drop,66,66,0,1,0,1,0
53947,53429,445,0,0,drop,66,66,0,1,0,1,0
53948,50067,64147,0,0,deny,66,66,0,1,0,1,0
53949,29203,26467,0,0,deny,62,62,0,1,0,1,0
53950,6416,22114,0,0,deny,66,66,0,1,0,1,0
53951,53029,445,0,0,drop,70,70,0,1,0,1,0
53952,36930,22,36930,22,deny,293,126,167,4,0,2,2
53953,5222,48709,0,0,deny,66,66,0,1,0,1,0
53954,53027,445,0,0,drop,70,70,0,1,0,1,0
53955,58011,445,0,0,drop,70,70,0,1,0,1,0
53956,58010,445,0,0,drop,70,70,0,1,0,1,0
53957,58008,445,0,0,drop,70,70,0,1,0,1,0
53958,53425,445,0,0,drop,66,66,0,1,0,1,0
53959,58004,445,0,0,drop,70,70,0,1,0,1,0
53960,49842,7302,0,0,deny,66,66,0,1,0,1,0
53961,53421,445,0,0,drop,66,66,0,1,0,1,0
53962,57478,7302,0,0,deny,66,66,0,1,0,1,0
53963,50820,57470,0,0,deny,66,66,0,1,0,1,0
53964,17837,62609,0,0,deny,148,148,0,1,0,1,0
53965,53418,445,0,0,drop,66,66,0,1,0,1,0
53966,53419,445,0,0,drop,66,66,0,1,0,1,0
53967,53023,445,0,0,drop,70,70,0,1,0,1,0
53968,63305,62413,0,0,deny,62,62,0,1,0,1,0
53969,53415,445,0,0,drop,66,66,0,1,0,1,0
53970,53021,445,0,0,drop,70,70,0,1,0,1,0
53971,443,64347,0,0,deny,131,131,0,1,0,1,0
53972,3541,22114,0,0,deny,62,62,0,1,0,1,0
53973,53017,445,0,0,drop,70,70,0,1,0,1,0
53974,57996,445,0,0,drop,70,70,0,1,0,1,0
53975,26722,11446,0,0,deny,62,62,0,1,0,1,0
53976,57995,445,0,0,drop,70,70,0,1,0,1,0
53977,57990,445,0,0,drop,70,70,0,1,0,1,0
53978,26084,36237,0,0,deny,66,66,0,1,0,1,0
53979,58468,57587,0,0,deny,66,66,0,1,0,1,0
53980,53016,445,0,0,drop,70,70,0,1,0,1,0
53981,57789,30188,0,0,deny,62,62,0,1,0,1,0
53982,19534,26467,0,0,deny,66,66,0,1,0,1,0
53983,53405,445,0,0,drop,66,66,0,1,0,1,0
53984,50878,53733,0,0,deny,66,66,0,1,0,1,0
53985,27064,51221,0,0,deny,72,72,0,1,0,1,0
53986,61701,44847,0,0,deny,66,66,0,1,0,1,0
53987,49628,35440,0,0,deny,66,66,0,1,0,1,0
53988,19610,9571,0,0,deny,62,62,0,1,0,1,0
53989,443,9986,0,0,deny,66,66,0,1,0,1,0
53990,443,9986,0,0,deny,152,152,0,1,0,1,0
53991,57060,50584,0,0,deny,62,62,0,1,0,1,0
53992,53011,445,0,0,drop,70,70,0,1,0,1,0
53993,53397,445,0,0,drop,66,66,0,1,0,1,0
53994,51725,56205,0,0,deny,62,62,0,1,0,1,0
53995,0,0,0,0,deny,98,98,0,1,0,1,0
53996,0,0,0,0,deny,98,98,0,1,0,1,0
53997,53395,445,0,0,drop,66,66,0,1,0,1,0
53998,1888,51505,0,0,deny,62,62,0,1,0,1,0
53999,52431,50265,0,0,deny,62,62,0,1,0,1,0
54000,25565,30367,0,0,deny,60,60,0,1,0,1,0
54001,65512,44847,0,0,deny,62,62,0,1,0,1,0
54002,53388,445,0,0,drop,66,66,0,1,0,1,0
54003,52998,445,0,0,drop,70,70,0,1,0,1,0
54004,51760,50584,0,0,deny,62,62,0,1,0,1,0
54005,53377,445,0,0,drop,66,66,0,1,0,1,0
54006,51674,51505,0,0,deny,66,66,0,1,0,1,0
54007,23274,50584,0,0,deny,62,62,0,1,0,1,0
54008,59055,11392,0,0,deny,62,62,0,1,0,1,0
54009,54062,49813,0,0,deny,62,62,0,1,0,1,0
54010,52447,43890,0,0,deny,66,66,0,1,0,1,0
54011,52995,445,0,0,drop,70,70,0,1,0,1,0
54012,80,9918,0,0,deny,60,60,0,1,0,1,0
54013,49976,22114,0,0,deny,62,62,0,1,0,1,0
54014,443,52365,0,0,deny,97,97,0,1,0,1,0
54015,36908,26467,0,0,deny,62,62,0,1,0,1,0
54016,57965,445,0,0,drop,70,70,0,1,0,1,0
54017,57967,445,0,0,drop,70,70,0,1,0,1,0
54018,57964,445,0,0,drop,70,70,0,1,0,1,0
54019,53371,445,0,0,drop,66,66,0,1,0,1,0
54020,53372,445,0,0,drop,66,66,0,1,0,1,0
54021,53370,445,0,0,drop,66,66,0,1,0,1,0
54022,53369,445,0,0,drop,66,66,0,1,0,1,0
54023,53368,445,0,0,drop,66,66,0,1,0,1,0
54024,53367,445,0,0,drop,66,66,0,1,0,1,0
54025,53366,445,0,0,drop,66,66,0,1,0,1,0
54026,53365,445,0,0,drop,66,66,0,1,0,1,0
54027,23776,57354,0,0,deny,145,145,0,1,0,1,0
54028,45079,31573,0,0,deny,62,62,0,1,0,1,0
54029,52990,445,0,0,drop,70,70,0,1,0,1,0
54030,57654,35440,0,0,deny,66,66,0,1,0,1,0
54031,52989,445,0,0,drop,70,70,0,1,0,1,0
54032,61520,23718,0,0,deny,66,66,0,1,0,1,0
54033,27147,22114,0,0,deny,62,62,0,1,0,1,0
54034,26528,51221,0,0,deny,78,78,0,1,0,1,0
54035,62776,62413,0,0,deny,62,62,0,1,0,1,0
54036,52987,445,0,0,drop,70,70,0,1,0,1,0
54037,54600,6881,0,0,deny,66,66,0,1,0,1,0
54038,65454,61600,0,0,deny,66,66,0,1,0,1,0
54039,46478,64147,0,0,deny,62,62,0,1,0,1,0
54040,62737,64147,0,0,deny,66,66,0,1,0,1,0
54041,53460,443,38830,443,allow,25079,5739,19340,39,337,18,21
54042,11592,80,11592,80,allow,6967,765,6202,15,16,7,8
54043,55021,443,3999,443,allow,5987,1556,4431,19,47,12,7
54044,57194,53,31354,53,allow,2198,193,2005,6,90,3,3
54045,53009,80,53009,80,allow,378,180,198,7,17,4,3
54046,41625,15000,38798,15000,allow,130,70,60,2,5,1,1
54047,59420,443,62141,443,allow,2854,1732,1122,16,15,8,8
54048,54135,443,36564,443,allow,11065,1394,9671,23,75,13,10
54049,57140,53,16030,53,allow,170,87,83,2,30,1,1
54050,51772,59814,9968,59814,allow,66,66,0,1,5,1,0
54051,52107,443,6381,443,allow,12091,3135,8956,30,49,16,14
54052,58885,15000,9072,15000,allow,138,78,60,2,5,1,1
54053,55584,53,31260,53,allow,184,80,104,2,30,1,1
54054,37444,53,37444,53,allow,213,79,134,2,32,1,1
54055,60017,443,51690,443,allow,134,60,74,3,10,2,1
54056,61467,443,56685,443,allow,130792,4916,125876,161,89,69,92
54057,39336,443,55309,443,allow,7759,4000,3759,23,96,11,12
54058,58259,53,21594,53,allow,578,286,292,9,15,5,4
54059,55540,443,32830,443,allow,10458,5272,5186,24,76,13,11
54060,55786,53,21732,53,allow,170,87,83,2,30,1,1
54061,39611,443,2531,443,allow,78,78,0,1,5,1,0
54062,61469,443,16667,443,allow,6204,1125,5079,23,89,13,10
54063,54137,443,45668,443,allow,10046,1394,8652,22,75,13,9
54064,61493,443,44435,443,allow,5325,1242,4083,23,27,13,10
54065,54134,443,5561,443,allow,10425,1383,9042,23,75,13,10
54066,61494,443,60069,443,allow,14558,2653,11905,33,27,18,15
54067,59419,443,5544,443,allow,2854,1732,1122,16,15,8,8
54068,61462,443,27750,443,allow,6271,1191,5080,24,94,14,10
54069,56360,53,64885,53,allow,711,87,624,2,30,1,1
54070,55800,53,53999,53,allow,711,87,624,2,30,1,1
54071,49685,443,41646,443,allow,8435,1687,6748,30,76,14,16
54072,50564,443,64623,443,allow,1894028,31411,1862617,1579,122,209,1370
54073,54136,443,41489,443,allow,10109,1394,8715,22,75,13,9
54074,2084,7000,2084,7000,allow,3566,1999,1567,16,15,8,8
54075,56626,443,26601,443,allow,7941,1952,5989,20,15,11,9
54076,61465,80,64777,80,allow,17320,9430,7890,67,93,35,32
54077,35053,80,19912,80,allow,71843,2833,69010,83,15,36,47
54078,61468,443,50536,443,allow,6265,1185,5080,24,89,14,10
54079,61464,80,54948,80,allow,366,180,186,7,93,4,3
54080,56627,443,11832,443,allow,7889,1900,5989,20,15,11,9
54081,61461,443,31107,443,allow,9073,2899,6174,36,94,19,17
54082,61466,443,43127,443,allow,6205,1125,5080,23,89,13,10
54083,63793,53,63793,53,allow,237,91,146,2,33,1,1
54084,58994,443,24369,443,allow,204,70,134,4,25,2,2
54085,56625,443,59240,443,allow,7888,1899,5989,20,15,11,9
54086,59418,443,6727,443,allow,2946,1812,1134,16,15,8,8
54087,56624,443,34630,443,allow,7940,1951,5989,20,16,11,9
54088,41335,53,41335,53,allow,825,99,726,2,30,1,1
54089,48720,53,0,0,allow,82,82,0,1,30,1,0
54090,56472,53,0,0,allow,371,77,294,2,30,1,1
54091,65386,443,29589,443,allow,5405,4034,1371,25,43,10,15
54092,48533,443,47218,443,allow,160,69,91,2,121,1,1
54093,13262,53,13262,53,allow,208,94,114,2,31,1,1
54094,36986,53,36986,53,allow,234,93,141,2,31,1,1
54095,5431,53,5431,53,allow,224,88,136,2,31,1,1
54096,7176,53,7176,53,allow,233,91,142,2,31,1,1
54097,5938,47512,0,0,allow,60,60,0,1,90,1,0
54098,55542,53,5269,53,allow,711,87,624,2,31,1,1
54099,52151,53,52151,53,allow,198,89,109,2,31,1,1
54100,11835,53,11835,53,allow,216,88,128,2,31,1,1
54101,27386,53,27386,53,allow,194,87,107,2,31,1,1
54102,52677,53,52677,53,allow,233,91,142,2,31,1,1
54103,56282,53,56282,53,allow,194,87,107,2,31,1,1
54104,55128,53,34503,53,allow,711,87,624,2,31,1,1
54105,50038,53,0,0,allow,275,85,190,2,31,1,1
54106,50038,53,0,0,allow,275,85,190,2,31,1,1
54107,57470,32177,25835,32177,allow,480,149,331,2,1200,1,1
54108,30960,45692,4911,45692,allow,330,330,0,6,3609,6,0
54109,61896,34021,0,0,allow,66,66,0,1,91,1,0
54110,32618,53,32618,53,allow,231,90,141,2,31,1,1
54111,47063,53,47063,53,allow,221,89,132,2,31,1,1
54112,58178,53,58178,53,allow,237,93,144,2,31,1,1
54113,8762,53,8762,53,allow,233,91,142,2,31,1,1
54114,63755,53,63755,53,allow,223,92,131,2,31,1,1
54115,41199,443,15931,443,allow,30604,3050,27554,45,122,18,27
54116,59267,53,59267,53,allow,222,87,135,2,31,1,1
54117,55072,53,31850,53,allow,168,86,82,2,31,1,1
54118,49432,5228,59843,5228,allow,10635,3087,7548,41,3661,22,19
54119,54693,30188,0,0,deny,66,66,0,1,0,1,0
54120,57963,445,0,0,drop,70,70,0,1,0,1,0
54121,57961,445,0,0,drop,70,70,0,1,0,1,0
54122,57956,445,0,0,drop,70,70,0,1,0,1,0
54123,8239,37965,0,0,deny,146,146,0,1,0,1,0
54124,53352,445,0,0,drop,66,66,0,1,0,1,0
54125,53351,445,0,0,drop,66,66,0,1,0,1,0
54126,53349,445,0,0,drop,66,66,0,1,0,1,0
54127,52980,445,0,0,drop,70,70,0,1,0,1,0
54128,4447,35440,0,0,deny,66,66,0,1,0,1,0
54129,57946,445,0,0,drop,70,70,0,1,0,1,0
54130,51192,15503,0,0,deny,66,66,0,1,0,1,0
54131,60751,20010,54269,20010,allow,70,70,0,2,8,2,0
54132,55786,53,23026,53,allow,177,94,83,2,30,1,1
54133,59984,443,19518,443,allow,1527,940,587,14,21,8,6
54134,59982,443,1995,443,allow,1467,880,587,13,21,7,6
54135,53603,53796,63183,53796,allow,70,70,0,2,7,2,0
54136,52978,445,0,0,drop,70,70,0,1,0,1,0
54137,21892,15503,0,0,deny,62,62,0,1,0,1,0
54138,4961,62741,0,0,deny,66,66,0,1,0,1,0
54139,39895,26467,0,0,deny,62,62,0,1,0,1,0
54140,52977,445,0,0,drop,70,70,0,1,0,1,0
54141,57944,445,0,0,drop,70,70,0,1,0,1,0
54142,26800,22,0,0,deny,60,60,0,1,0,1,0
54143,52976,445,0,0,drop,70,70,0,1,0,1,0
54144,52975,445,0,0,drop,70,70,0,1,0,1,0
54145,57943,445,0,0,drop,70,70,0,1,0,1,0
54146,57934,445,0,0,drop,70,70,0,1,0,1,0
54147,57936,445,0,0,drop,70,70,0,1,0,1,0
54148,52971,445,0,0,drop,70,70,0,1,0,1,0
54149,52970,445,0,0,drop,70,70,0,1,0,1,0
54150,61426,64910,0,0,deny,66,66,0,1,0,1,0
54151,50717,9571,0,0,deny,62,62,0,1,0,1,0
54152,21420,44847,0,0,deny,66,66,0,1,0,1,0
54153,42252,33303,0,0,deny,60,60,0,1,0,1,0
54154,52957,445,0,0,drop,70,70,0,1,0,1,0
54155,52956,445,0,0,drop,70,70,0,1,0,1,0
54156,52953,445,0,0,drop,70,70,0,1,0,1,0
54157,443,64347,0,0,deny,60,60,0,1,0,1,0
54158,52945,445,0,0,drop,70,70,0,1,0,1,0
54159,52946,445,0,0,drop,70,70,0,1,0,1,0
54160,55056,53,38233,53,allow,177,94,83,2,29,1,1
54161,49940,53,29743,53,allow,197,94,103,2,29,1,1
54162,56646,53,30377,53,allow,177,94,83,2,30,1,1
54163,51103,80,39889,80,allow,2792,2073,719,15,30,9,6
54164,63786,50091,30767,50091,allow,66,66,0,2,7,2,0
54165,59608,443,1997,443,allow,2149,1277,872,18,829,10,8
54166,53602,12395,26422,12395,allow,70,70,0,2,7,2,0
54167,59981,443,57380,443,allow,180817,9921,170896,241,21,116,125
54168,55462,53,41879,53,allow,194,102,92,2,33,1,1
54169,55417,53,62498,53,allow,198,102,96,2,32,1,1
54170,51975,443,14807,443,allow,29510,15378,14132,76,216,35,41
54171,123,123,55557,123,allow,184,94,90,2,29,1,1
54172,56646,53,16936,53,allow,177,94,83,2,29,1,1
54173,54427,443,64059,443,allow,2878,1252,1626,16,361,9,7
54174,51100,80,29611,80,allow,12300,4454,7846,26,30,13,13
54175,55615,13826,16730,13826,allow,70,70,0,1,5,1,0
54176,27490,53,27490,53,allow,214,82,132,2,33,1,1
54177,49176,443,60169,443,allow,533295,14310,518985,552,18,201,351
54178,61472,443,58092,443,allow,6211,1132,5079,23,88,13,10
54179,58557,443,4317,443,allow,114852,43911,70941,248,69,132,116
54180,42106,443,29417,443,allow,5361,973,4388,18,15,10,8
54181,49752,53,64105,53,allow,193,102,91,2,30,1,1
54182,52407,443,29892,443,allow,1043,556,487,10,16,6,4
54183,60455,443,23230,443,allow,25055,5440,19615,65,84,35,30
54184,2083,7000,2083,7000,allow,3374,1535,1839,16,15,8,8
54185,61833,443,61833,443,allow,80743,4724,76019,101,89,37,64
54186,55041,53,58764,53,allow,234,94,140,2,30,1,1
54187,43677,443,54935,443,allow,30090,19982,10108,77,543,41,36
54188,55614,29731,26252,29731,allow,70,70,0,1,5,1,0
54189,57140,53,49557,53,allow,177,94,83,2,30,1,1
54190,37697,443,26341,443,allow,2071929,56793,2015136,2088,179,685,1403
54191,51771,19103,1964,19103,allow,70,70,0,1,5,1,0
54192,55254,443,12972,443,allow,3257,782,2475,17,140,8,9
54193,50151,53,24855,53,allow,177,94,83,2,30,1,1
54194,61470,443,10942,443,allow,12420,4900,7520,47,88,24,23
54195,52408,443,37575,443,allow,1043,556,487,10,16,6,4
54196,56798,40759,43301,40759,allow,70,70,0,1,5,1,0
54197,61463,443,9374,443,allow,11355,3474,7881,45,93,22,23
54198,42599,443,19054,443,allow,215284,28807,186477,346,129,151,195
54199,55607,17820,29778,17820,allow,504,318,186,8,16,5,3
54200,56569,53,52915,53,allow,94,94,0,1,30,1,0
54201,64537,53,63183,53,allow,718,94,624,2,30,1,1
54202,55610,23383,13424,23383,allow,70,70,0,1,5,1,0
54203,43205,22,43205,22,allow,6957,2330,4627,35,27,17,18
54204,55429,443,25959,443,allow,6292,4834,1458,18,129,11,7
54205,46695,443,28304,443,allow,12787534,288179,12499355,12299,64,4036,8263
54206,44836,443,51394,443,allow,34881,6721,28160,62,46,30,32
54207,2085,7010,2085,7010,allow,3342,1983,1359,16,15,8,8
54208,49724,443,21055,443,allow,4139,511,3628,12,15,6,6
54209,37310,443,2394,443,allow,3950,2949,1001,26,69,15,11
54210,51102,80,31602,80,allow,2794,2075,719,15,30,9,6
54211,50638,443,62460,443,allow,14401,2712,11689,52,19,23,29
54212,55836,53,41454,53,allow,181,94,87,2,33,1,1
54213,49374,53,26610,53,allow,307,102,205,4,35,2,2
54214,49658,443,50327,443,allow,14121,2299,11822,37,19,19,18
54215,56783,21279,24337,21279,allow,70,70,0,1,5,1,0
54216,59983,443,57676,443,allow,158230,9208,149022,214,21,105,109
54217,1462,41599,48660,41599,allow,70,70,0,2,8,2,0
54218,50202,443,56858,443,allow,8415,3119,5296,26,73,9,17
54219,64779,53,46294,53,allow,497,102,395,4,40,2,2
54220,39570,443,58125,443,allow,127970,4968,123002,144,30,53,91
54221,61471,443,26685,443,allow,18168,2973,15195,46,88,21,25
54222,42963,443,15595,443,allow,7681,4711,2970,36,28,17,19
54223,52112,443,29903,443,allow,59796,4486,55310,92,48,45,47
54224,58302,443,37691,443,allow,4611,3176,1435,26,30,15,11
54225,26865,443,47610,443,allow,20959,15902,5057,38,20,21,17
54226,64636,53,42647,53,allow,727,223,504,6,70,3,3
54227,27005,23010,35544,23010,allow,881,126,755,2,29,1,1
54228,49284,53,32626,53,allow,245,102,143,2,29,1,1
54229,49163,36069,48102,36069,allow,5990,5698,292,17,51,14,3
54230,57096,53,50734,53,allow,177,94,83,2,29,1,1
54231,49844,53,30878,53,allow,755,102,653,2,30,1,1
54232,55777,53,11730,53,allow,200,94,106,2,30,1,1
54233,55699,53,21219,53,allow,211,102,109,2,29,1,1
54234,35546,443,6886,443,allow,5198,973,4225,16,17,10,6
54235,49203,53,26385,53,allow,240,94,146,2,29,1,1
54236,55669,53,15322,53,allow,94,94,0,1,29,1,0
54237,55786,53,33325,53,allow,177,94,83,2,30,1,1
54238,57397,53,56026,53,allow,177,94,83,2,31,1,1
54239,65269,53,55640,53,allow,273,134,139,2,30,1,1
54240,65291,53,62097,53,allow,247,118,129,2,30,1,1
54241,49234,53,59585,53,allow,177,94,83,2,30,1,1
54242,23514,53,23514,53,allow,245,98,147,2,30,1,1
54243,49792,443,37527,443,allow,9841,3185,6656,25,186,14,11
54244,40985,443,29028,443,allow,3166,2097,1069,24,46,12,12
54245,60401,30046,40405,30046,allow,70,70,0,1,5,1,0
54246,55609,39869,60499,39869,allow,70,70,0,1,5,1,0
54247,39571,443,44587,443,allow,580560,15724,564836,583,30,187,396
54248,39573,443,27028,443,allow,29226,2150,27076,44,30,19,25
54249,39569,443,5001,443,allow,1784075,46752,1737323,1812,47,606,1206
54250,57004,53,12740,53,allow,195,78,117,2,30,1,1
54251,56551,53,25599,53,allow,225,102,123,2,30,1,1
54252,45816,443,14384,443,allow,21950,3632,18318,46,140,20,26
54253,49160,14387,38901,14387,allow,854,150,704,4,1200,2,2
54254,1609,53,1609,53,allow,197,90,107,2,30,1,1
54255,63526,3389,63526,3389,allow,4365,2581,1784,20,33,11,9
54256,32811,443,18226,443,allow,16652,13777,2875,48,44,27,21
54257,39572,443,50194,443,allow,64247,3857,60390,94,30,43,51
54258,58056,443,35080,443,allow,10493,2658,7835,50,1469,26,24
54259,60400,56243,17811,56243,allow,70,70,0,1,5,1,0
54260,60822,443,12029,443,allow,7839,2697,5142,21,137,10,11
54261,63967,53,22995,53,allow,195,102,93,2,33,1,1
54262,51790,46839,55080,46839,allow,70,70,0,2,8,2,0
54263,57140,53,49322,53,allow,177,94,83,2,30,1,1
54264,63972,53,28656,53,allow,325,94,231,2,30,1,1
54265,50151,53,38506,53,allow,177,94,83,2,30,1,1
54266,57397,53,60967,53,allow,177,94,83,2,30,1,1
54267,55539,53,25818,53,allow,249,94,155,2,31,1,1
54268,37965,14259,39595,14259,allow,150,150,0,1,1199,1,0
54269,52048,443,14008,443,allow,3182,1568,1614,8,120,4,4
54270,49919,53,2531,53,allow,225,102,123,2,30,1,1
54271,27005,1102,9620,1102,allow,867,126,741,2,30,1,1
54272,49672,53,36807,53,allow,718,94,624,2,30,1,1
54273,49509,53,2190,53,allow,339,110,229,2,30,1,1
54274,49757,53,31813,53,allow,177,94,83,2,31,1,1
54275,53521,443,20457,443,allow,280,140,140,5,129,3,2
54276,6881,37957,48141,37957,allow,509,150,359,2,1199,1,1
54277,51221,9869,40891,9869,allow,870,330,540,12,1298,6,6
54278,37272,443,58616,443,allow,10809,2465,8344,45,121,21,24
54279,37989,49152,16381,49152,allow,156,156,0,3,8,3,0
54280,58969,80,39801,80,allow,1431,783,648,10,75,6,4
54281,51247,443,62660,443,allow,5747,1892,3855,19,16,11,8
54282,57117,443,28755,443,allow,8997,1155,7842,19,76,11,8
54283,50905,80,47395,80,allow,11749346,149441,11599905,10089,147,2116,7973
54284,41210,443,59857,443,allow,78,78,0,1,5,1,0
54285,58796,443,14867,443,allow,7402,2429,4973,40,139,22,18
54286,58802,443,37884,443,allow,8591,2275,6316,37,137,21,16
54287,51237,443,50232,443,allow,9668,4698,4970,42,16,25,17
54288,55113,53,62810,53,allow,198,102,96,2,33,1,1
54289,49665,53,6360,53,allow,779,298,481,8,67,4,4
54290,27005,1108,19358,1108,allow,873,126,747,2,30,1,1
54291,49628,443,14591,443,allow,12843,3808,9035,26,81,13,13
54292,63783,1375,0,0,deny,109,109,0,1,0,1,0
54293,19698,502,0,0,deny,60,60,0,1,0,1,0
54294,18415,37965,0,0,deny,62,62,0,1,0,1,0
54295,53419,28189,0,0,deny,60,60,0,1,0,1,0
54296,21145,11392,0,0,deny,62,62,0,1,0,1,0
54297,57925,445,0,0,drop,70,70,0,1,0,1,0
54298,57927,445,0,0,drop,70,70,0,1,0,1,0
54299,57921,445,0,0,drop,70,70,0,1,0,1,0
54300,16393,22114,0,0,deny,62,62,0,1,0,1,0
54301,30922,22,0,0,deny,60,60,0,1,0,1,0
54302,41482,23,0,0,deny,60,60,0,1,0,1,0
54303,52934,445,0,0,drop,70,70,0,1,0,1,0
54304,80,56289,0,0,deny,1090,1090,0,1,0,1,0
54305,53469,44847,0,0,deny,66,66,0,1,0,1,0
54306,16660,55783,0,0,deny,62,62,0,1,0,1,0
54307,16361,60888,0,0,deny,146,146,0,1,0,1,0
54308,54062,31573,0,0,deny,66,66,0,1,0,1,0
54309,53328,445,0,0,drop,66,66,0,1,0,1,0
54310,57918,445,0,0,drop,70,70,0,1,0,1,0
54311,57915,445,0,0,drop,70,70,0,1,0,1,0
54312,62827,1,0,0,deny,66,66,0,1,0,1,0
54313,50804,1,0,0,deny,62,62,0,1,0,1,0
54314,3270,35440,0,0,deny,62,62,0,1,0,1,0
54315,52930,445,0,0,drop,70,70,0,1,0,1,0
54316,59592,37965,0,0,deny,62,62,0,1,0,1,0
54317,53321,445,0,0,drop,66,66,0,1,0,1,0
54318,52921,445,0,0,drop,70,70,0,1,0,1,0
54319,52919,445,0,0,drop,70,70,0,1,0,1,0
54320,37903,23,0,0,deny,60,60,0,1,0,1,0
54321,52918,445,0,0,drop,70,70,0,1,0,1,0
54322,52917,445,0,0,drop,70,70,0,1,0,1,0
54323,36903,56205,0,0,deny,146,146,0,1,0,1,0
54324,53320,445,0,0,drop,66,66,0,1,0,1,0
54325,8999,32480,0,0,deny,146,146,0,1,0,1,0
54326,57904,445,0,0,drop,70,70,0,1,0,1,0
54327,52914,445,0,0,drop,70,70,0,1,0,1,0
54328,57901,445,0,0,drop,70,70,0,1,0,1,0
54329,57897,445,0,0,drop,70,70,0,1,0,1,0
54330,12608,21247,0,0,deny,66,66,0,1,0,1,0
54331,53317,445,0,0,drop,66,66,0,1,0,1,0
54332,17008,35440,0,0,deny,62,62,0,1,0,1,0
54333,43688,22114,0,0,deny,66,66,0,1,0,1,0
54334,54214,443,38557,443,allow,499,425,74,4,0,3,1
54335,54215,443,45620,443,allow,499,425,74,4,0,3,1
54336,53817,443,41947,443,allow,499,425,74,4,0,3,1
54337,53816,443,52923,443,allow,499,425,74,4,0,3,1
54338,26053,33720,0,0,deny,160,160,0,1,0,1,0
54339,26053,33720,0,0,deny,160,160,0,1,0,1,0
54340,9095,22114,0,0,deny,146,146,0,1,0,1,0
54341,24480,35440,0,0,deny,62,62,0,1,0,1,0
54342,1024,64147,0,0,deny,62,62,0,1,0,1,0
54343,29424,37807,0,0,deny,66,66,0,1,0,1,0
54344,60196,53,0,0,deny,88,88,0,1,0,1,0
54345,57892,445,0,0,drop,70,70,0,1,0,1,0
54346,10006,64147,0,0,deny,62,62,0,1,0,1,0
54347,52907,445,0,0,drop,70,70,0,1,0,1,0
54348,10265,64147,0,0,deny,66,66,0,1,0,1,0
54349,52726,56205,0,0,deny,66,66,0,1,0,1,0
54350,57889,445,0,0,drop,70,70,0,1,0,1,0
54351,57888,445,0,0,drop,70,70,0,1,0,1,0
54352,57885,445,0,0,drop,70,70,0,1,0,1,0
54353,53309,445,0,0,drop,66,66,0,1,0,1,0
54354,34176,51505,0,0,deny,62,62,0,1,0,1,0
54355,53308,445,0,0,drop,66,66,0,1,0,1,0
54356,53304,445,0,0,drop,66,66,0,1,0,1,0
54357,53302,445,0,0,drop,66,66,0,1,0,1,0
54358,10006,64147,0,0,deny,145,145,0,1,0,1,0
54359,55225,11392,0,0,deny,66,66,0,1,0,1,0
54360,53300,445,0,0,drop,66,66,0,1,0,1,0
54361,53301,445,0,0,drop,66,66,0,1,0,1,0
54362,53298,445,0,0,drop,66,66,0,1,0,1,0
54363,21833,22114,0,0,deny,62,62,0,1,0,1,0
54364,30046,15503,0,0,deny,62,62,0,1,0,1,0
54365,1176,64147,0,0,deny,62,62,0,1,0,1,0
54366,52900,445,0,0,drop,70,70,0,1,0,1,0
54367,52898,445,0,0,drop,70,70,0,1,0,1,0
54368,1024,9319,0,0,deny,62,62,0,1,0,1,0
54369,59377,9319,0,0,deny,62,62,0,1,0,1,0
54370,443,51160,0,0,deny,102,102,0,1,0,1,0
54371,63205,9571,0,0,deny,66,66,0,1,0,1,0
54372,58751,9571,0,0,deny,62,62,0,1,0,1,0
54373,54339,23117,0,0,deny,66,66,0,1,0,1,0
54374,57884,445,0,0,drop,70,70,0,1,0,1,0
54375,57882,445,0,0,drop,70,70,0,1,0,1,0
54376,57878,445,0,0,drop,70,70,0,1,0,1,0
54377,6828,64322,0,0,deny,60,60,0,1,0,1,0
54378,443,64347,0,0,deny,60,60,0,1,0,1,0
54379,443,64347,0,0,deny,85,85,0,1,0,1,0
54380,443,64347,0,0,deny,100,100,0,1,0,1,0
54381,53294,445,0,0,drop,66,66,0,1,0,1,0
54382,36966,10387,0,0,deny,159,159,0,1,0,1,0
54383,52893,445,0,0,drop,70,70,0,1,0,1,0
54384,53293,445,0,0,drop,66,66,0,1,0,1,0
54385,52892,445,0,0,drop,70,70,0,1,0,1,0
54386,42241,11392,0,0,deny,66,66,0,1,0,1,0
54387,53290,445,0,0,drop,66,66,0,1,0,1,0
54388,53289,445,0,0,drop,66,66,0,1,0,1,0
54389,53287,445,0,0,drop,66,66,0,1,0,1,0
54390,26053,33720,0,0,deny,160,160,0,1,0,1,0
54391,26053,33720,0,0,deny,160,160,0,1,0,1,0
54392,52888,445,0,0,drop,70,70,0,1,0,1,0
54393,6881,21162,0,0,deny,146,146,0,1,0,1,0
54394,56474,18375,0,0,deny,62,62,0,1,0,1,0
54395,26053,33720,0,0,deny,160,160,0,1,0,1,0
54396,26053,33720,0,0,deny,160,160,0,1,0,1,0
54397,57870,445,0,0,drop,70,70,0,1,0,1,0
54398,26053,33720,0,0,deny,160,160,0,1,0,1,0
54399,52887,445,0,0,drop,70,70,0,1,0,1,0
54400,63852,35440,0,0,deny,62,62,0,1,0,1,0
54401,57864,445,0,0,drop,70,70,0,1,0,1,0
54402,57862,445,0,0,drop,70,70,0,1,0,1,0
54403,22927,48817,0,0,deny,143,143,0,1,0,1,0
54404,0,0,0,0,allow,320,320,0,5,0,5,0
54405,0,0,0,0,allow,274,274,0,2,0,2,0
54406,17640,55442,0,0,deny,66,66,0,1,0,1,0
54407,59168,39004,0,0,deny,62,62,0,1,0,1,0
54408,53278,445,0,0,drop,66,66,0,1,0,1,0
54409,37008,42707,0,0,deny,62,62,0,1,0,1,0
54410,58022,5601,0,0,deny,60,60,0,1,0,1,0
54411,38320,51505,0,0,deny,66,66,0,1,0,1,0
54412,16059,22114,0,0,deny,62,62,0,1,0,1,0
54413,52882,445,0,0,drop,70,70,0,1,0,1,0
54414,50439,64147,0,0,deny,62,62,0,1,0,1,0
54415,53105,42707,0,0,deny,66,66,0,1,0,1,0
54416,53269,445,0,0,drop,66,66,0,1,0,1,0
54417,15959,56205,0,0,deny,66,66,0,1,0,1,0
54418,57850,445,0,0,drop,70,70,0,1,0,1,0
54419,53267,445,0,0,drop,66,66,0,1,0,1,0
54420,64087,50265,0,0,deny,145,145,0,1,0,1,0
54421,22583,9822,0,0,deny,62,62,0,1,0,1,0
54422,38723,15503,0,0,deny,146,146,0,1,0,1,0
54423,52869,445,0,0,drop,70,70,0,1,0,1,0
54424,31021,35440,0,0,deny,62,62,0,1,0,1,0
54425,5357,32468,0,0,deny,66,66,0,1,0,1,0
54426,53258,445,0,0,drop,66,66,0,1,0,1,0
54427,53252,445,0,0,drop,66,66,0,1,0,1,0
54428,443,37338,0,0,deny,118,118,0,1,0,1,0
54429,52866,445,0,0,drop,70,70,0,1,0,1,0
54430,8976,44847,0,0,deny,62,62,0,1,0,1,0
54431,50710,50584,0,0,deny,146,146,0,1,0,1,0
54432,57504,44847,0,0,deny,66,66,0,1,0,1,0
54433,25010,30188,0,0,deny,62,62,0,1,0,1,0
54434,61420,64097,0,0,deny,66,66,0,1,0,1,0
54435,9095,22114,0,0,deny,62,62,0,1,0,1,0
54436,54575,11392,0,0,deny,66,66,0,1,0,1,0
54437,11983,57470,0,0,deny,62,62,0,1,0,1,0
54438,49805,6881,0,0,deny,66,66,0,1,0,1,0
54439,44594,64147,0,0,deny,66,66,0,1,0,1,0
54440,49906,443,16050,443,allow,6754,2219,4535,21,77,11,10
54441,49873,80,19431,80,allow,9540,2954,6586,18,88,8,10
54442,49860,80,9156,80,allow,6892,2154,4738,22,89,12,10
54443,49857,80,39166,80,allow,7800,1743,6057,20,89,11,9
54444,56620,443,7502,443,allow,8033,2013,6020,20,16,11,9
54445,49884,443,34007,443,allow,5265,1647,3618,16,88,9,7
54446,49880,80,21728,80,allow,2087,1215,872,8,88,5,3
54447,38643,443,16669,443,allow,2540,1317,1223,17,28,9,8
54448,56622,443,13170,443,allow,8034,2014,6020,20,15,11,9
54449,56887,53,15975,53,allow,170,87,83,3,56,2,1
54450,49876,80,23793,80,allow,24764,4454,20310,30,88,12,18
54451,49887,443,18602,443,allow,977,590,387,10,87,6,4
54452,38645,443,41278,443,allow,2535,1177,1358,16,28,7,9
54453,38647,443,59827,443,allow,2634,1411,1223,18,28,10,8
54454,50693,443,1637,443,allow,306,120,186,6,23,3,3
54455,62423,443,31493,443,allow,28031,7016,21015,51,45,23,28
54456,36445,443,44215,443,allow,234,234,0,4,12,4,0
54457,49905,443,56801,443,allow,4712,908,3804,18,77,9,9
54458,49874,80,9513,80,allow,9921,2945,6976,19,88,8,11
54459,36500,3142,36500,3142,allow,138,78,60,2,6,1,1
54460,2081,7000,2081,7000,allow,5914,4395,1519,19,15,10,9
54461,30188,53,30188,53,allow,238,95,143,2,30,1,1
54462,49895,80,46026,80,allow,2781,1400,1381,11,87,6,5
54463,38644,443,1255,443,allow,2622,1399,1223,18,28,10,8
54464,2080,7000,2080,7000,allow,754151,15395,738756,762,16,239,523
54465,49858,80,51229,80,allow,1539,674,865,11,89,6,5
54466,49854,80,32743,80,allow,14603,5117,9486,24,89,12,12
54467,49845,80,64041,80,allow,31466,852,30614,32,89,9,23
54468,49913,443,65032,443,allow,976,589,387,10,76,6,4
54469,38646,443,44799,443,allow,2335,1247,1088,15,28,8,7
54470,49861,80,57112,80,allow,4892,1157,3735,16,89,8,8
54471,56623,443,54121,443,allow,7982,1962,6020,20,15,11,9
54472,26843,53,26843,53,allow,209,77,132,2,33,1,1
54473,49852,80,47954,80,allow,8868,3774,5094,20,89,10,10
54474,49850,443,7132,443,allow,7371,1564,5807,18,89,9,9
54475,49879,80,2147,80,allow,2087,1215,872,8,88,5,3
54476,55521,53,35090,53,allow,701,88,613,2,30,1,1
54477,49853,80,30133,80,allow,15055,6439,8616,26,89,14,12
54478,58793,443,33855,443,allow,40456,12307,28149,114,140,58,56
54479,49855,80,46269,80,allow,41720,6568,35152,47,89,17,30
54480,49234,53,38404,53,allow,170,87,83,2,30,1,1
54481,36661,53,36661,53,allow,237,93,144,2,30,1,1
54482,56785,28902,1768,28902,allow,70,70,0,2,8,2,0
54483,53063,443,53063,443,allow,6793,3206,3587,25,52,15,10
54484,56997,53,44658,53,allow,168,86,82,2,30,1,1
54485,40030,80,62413,80,allow,1286,403,883,16,393,4,12
54486,6881,35766,64668,35766,allow,221,111,110,2,1200,1,1
54487,64539,53,5433,53,allow,170,87,83,2,31,1,1
54488,49875,80,61335,80,allow,35824,4558,31266,39,88,13,26
54489,51174,443,5740,443,allow,12037,3531,8506,35,271,18,17
54490,49872,80,54932,80,allow,31938,3363,28575,38,88,15,23
54491,49859,80,31286,80,allow,1529,677,852,11,89,6,5
54492,54269,443,49860,443,allow,5768,3426,2342,22,135,11,11
54493,49856,80,12008,80,allow,13992,1645,12347,23,89,10,13
54494,2082,7000,2082,7000,allow,3022,1567,1455,16,15,8,8
54495,49877,80,36716,80,allow,28450,4547,23903,34,88,13,21
54496,55594,42459,54770,42459,allow,1253,716,537,12,23,7,5
54497,57118,80,7804,80,allow,2404,568,1836,10,75,6,4
54498,37090,443,37090,443,allow,4637,1730,2907,19,30,11,8
54499,60398,443,6115,443,allow,8060,1868,6192,28,16,15,13
54500,44558,443,44558,443,allow,5480,2503,2977,20,15,11,9
54501,49878,80,42487,80,allow,2086,1214,872,8,88,5,3
54502,56621,443,45506,443,allow,7981,1961,6020,20,15,11,9
54503,49863,443,52855,443,allow,7280,1441,5839,17,89,9,8
54504,49844,80,65486,80,allow,18950,788,18162,23,89,8,15
54505,44546,53,44546,53,allow,204,92,112,2,30,1,1
54506,63513,53,63513,53,allow,236,94,142,2,30,1,1
54507,51202,53,51202,53,allow,221,89,132,2,30,1,1
54508,34517,80,7727,80,allow,1056,682,374,10,16,6,4
54509,39119,53,39119,53,allow,221,89,132,2,30,1,1
54510,50107,53,50107,53,allow,216,89,127,2,30,1,1
54511,6881,6881,55325,6881,allow,853,355,498,4,1200,2,2
54512,56876,53,55574,53,allow,711,87,624,2,31,1,1
54513,3382,53,3382,53,allow,220,100,120,2,31,1,1
54514,52795,443,61686,443,allow,7203,2188,5015,23,186,11,12
54515,30960,45691,5004,45691,allow,330,330,0,6,3609,6,0
54516,52862,445,0,0,drop,70,70,0,1,0,1,0
54517,57839,445,0,0,drop,70,70,0,1,0,1,0
54518,57837,445,0,0,drop,70,70,0,1,0,1,0
54519,57836,445,0,0,drop,70,70,0,1,0,1,0
54520,52860,445,0,0,drop,70,70,0,1,0,1,0
54521,53239,445,0,0,drop,66,66,0,1,0,1,0
54522,53241,445,0,0,drop,66,66,0,1,0,1,0
54523,53240,445,0,0,drop,66,66,0,1,0,1,0
54524,53244,445,0,0,drop,66,66,0,1,0,1,0
54525,53243,445,0,0,drop,66,66,0,1,0,1,0
54526,53238,445,0,0,drop,66,66,0,1,0,1,0
54527,53237,445,0,0,drop,66,66,0,1,0,1,0
54528,53236,445,0,0,drop,66,66,0,1,0,1,0
54529,52858,445,0,0,drop,70,70,0,1,0,1,0
54530,43333,50584,0,0,deny,146,146,0,1,0,1,0
54531,24144,57470,0,0,deny,62,62,0,1,0,1,0
54532,30114,65151,0,0,deny,60,60,0,1,0,1,0
54533,53987,57470,0,0,deny,66,66,0,1,0,1,0
54534,12614,22,0,0,deny,60,60,0,1,0,1,0
54535,28498,36237,0,0,deny,62,62,0,1,0,1,0
54536,52913,2767,0,0,deny,66,66,0,1,0,1,0
54537,57828,445,0,0,drop,70,70,0,1,0,1,0
54538,57827,445,0,0,drop,70,70,0,1,0,1,0
54539,57825,445,0,0,drop,70,70,0,1,0,1,0
54540,57500,23,0,0,deny,60,60,0,1,0,1,0
54541,52851,445,0,0,drop,70,70,0,1,0,1,0
54542,59879,55783,0,0,deny,62,62,0,1,0,1,0
54543,52849,445,0,0,drop,70,70,0,1,0,1,0
54544,53223,445,0,0,drop,66,66,0,1,0,1,0
54545,53224,445,0,0,drop,66,66,0,1,0,1,0
54546,53221,445,0,0,drop,66,66,0,1,0,1,0
54547,52848,445,0,0,drop,70,70,0,1,0,1,0
54548,20726,2767,0,0,deny,62,62,0,1,0,1,0
54549,52847,445,0,0,drop,70,70,0,1,0,1,0
54550,52846,445,0,0,drop,70,70,0,1,0,1,0
54551,52843,445,0,0,drop,70,70,0,1,0,1,0
54552,52842,445,0,0,drop,70,70,0,1,0,1,0
54553,53419,28189,0,0,deny,60,60,0,1,0,1,0
54554,57816,445,0,0,drop,70,70,0,1,0,1,0
54555,22724,9822,0,0,deny,66,66,0,1,0,1,0
54556,57810,445,0,0,drop,70,70,0,1,0,1,0
54557,57808,445,0,0,drop,70,70,0,1,0,1,0
54558,57804,445,0,0,drop,70,70,0,1,0,1,0
54559,25360,51505,0,0,deny,62,62,0,1,0,1,0
54560,55157,7302,0,0,deny,66,66,0,1,0,1,0
54561,54617,64147,0,0,deny,62,62,0,1,0,1,0
54562,54276,39004,0,0,deny,62,62,0,1,0,1,0
54563,45941,23388,0,0,deny,60,60,0,1,0,1,0
54564,52828,445,0,0,drop,70,70,0,1,0,1,0
54565,52827,445,0,0,drop,70,70,0,1,0,1,0
54566,32215,22114,0,0,deny,62,62,0,1,0,1,0
54567,52817,445,0,0,drop,70,70,0,1,0,1,0
54568,52818,445,0,0,drop,70,70,0,1,0,1,0
54569,62767,57470,0,0,deny,74,74,0,1,0,1,0
54570,59201,51221,0,0,deny,66,66,0,1,0,1,0
54571,52743,15503,0,0,deny,66,66,0,1,0,1,0
54572,1067,51221,0,0,deny,62,62,0,1,0,1,0
54573,16387,26193,0,0,deny,60,60,0,1,0,1,0
54574,1067,51221,0,0,deny,145,145,0,1,0,1,0
54575,16387,35308,0,0,deny,60,60,0,1,0,1,0
54576,60217,80,16783,80,allow,4050,2838,1212,14,16,7,7
54577,50628,80,65125,80,allow,4349,647,3702,16,22,7,9
54578,59754,53,11671,53,allow,260,86,174,2,30,1,1
54579,40180,443,53378,443,allow,1310,649,661,13,184,7,6
54580,53201,28513,16417,28513,allow,862,562,300,13,145,8,5
54581,46332,443,57498,443,allow,3132,1697,1435,17,15,10,7
54582,56813,53,9920,53,allow,516,136,380,4,40,2,2
54583,50692,443,32817,443,allow,180,60,120,4,15,2,2
54584,65080,53,49569,53,allow,193,102,91,2,29,1,1
54585,27005,1305,58083,1305,allow,855,126,729,2,29,1,1
54586,27005,1308,10914,1308,allow,855,126,729,2,29,1,1
54587,49281,53,58920,53,allow,345,110,235,2,29,1,1
54588,50689,443,64099,443,allow,180,60,120,4,15,2,2
54589,27005,1202,29779,1202,allow,865,126,739,2,29,1,1
54590,27005,1103,52058,1103,allow,822,126,696,2,29,1,1
54591,45935,25,35960,25,allow,511,191,320,9,60,4,5
54592,35377,443,51737,443,allow,15771,2037,13734,39,187,20,19
54593,57140,53,58402,53,allow,177,94,83,2,29,1,1
54594,53113,8372,13040,8372,allow,758,320,438,11,17,6,5
54595,58794,443,45135,443,allow,20298,11977,8321,85,139,45,40
54596,34737,443,45602,443,allow,5586,1338,4248,17,109,9,8
54597,49632,53,31125,53,allow,288,94,194,2,30,1,1
54598,27005,1105,65392,1105,allow,855,126,729,2,29,1,1
54599,56795,35465,29402,35465,allow,70,70,0,1,5,1,0
54600,55653,53,52726,53,allow,94,94,0,1,29,1,0
54601,15111,53,15111,53,allow,210,98,112,2,29,1,1
54602,64212,53,41326,53,allow,215,102,113,2,30,1,1
54603,49234,53,14008,53,allow,177,94,83,2,30,1,1
54604,59755,53,7532,53,allow,211,78,133,2,30,1,1
54605,27005,1106,25259,1106,allow,903,126,777,2,29,1,1
54606,49752,53,10768,53,allow,193,102,91,2,29,1,1
54607,38194,53,38194,53,allow,210,98,112,2,29,1,1
54608,51802,443,19479,443,allow,4426,1518,2908,12,120,6,6
54609,49868,443,36753,443,allow,6251,1706,4545,16,88,9,7
54610,49893,80,42792,80,allow,1376,946,430,8,86,5,3
54611,65384,53,46519,53,allow,197,102,95,2,33,1,1
54612,53666,80,3658,80,allow,3741,3008,733,16,15,10,6
54613,65378,53,49018,53,allow,212,102,110,2,30,1,1
54614,56972,53,28054,53,allow,177,94,83,2,30,1,1
54615,51004,53,15547,53,allow,194,94,100,2,30,1,1
54616,65135,53,23354,53,allow,312,102,210,2,30,1,1
54617,49900,443,38776,443,allow,8417,1173,7244,18,86,9,9
54618,57371,443,2707,443,allow,5619,927,4692,17,15,10,7
54619,36225,443,18751,443,allow,638,350,288,10,26,6,4
54620,56616,80,15252,80,allow,234,234,0,4,12,4,0
54621,36327,80,6199,80,allow,1348,844,504,13,255,8,5
54622,49886,443,58788,443,allow,77867,2411,75456,82,87,27,55
54623,55022,443,12848,443,allow,14634,1801,12833,28,46,14,14
54624,49888,443,29885,443,allow,117085,3435,113650,123,87,43,80
54625,60196,80,43098,80,allow,70,70,0,2,8,2,0
54626,50823,443,51509,443,allow,6601,1120,5481,17,115,9,8
54627,49898,80,5457,80,allow,1550,1157,393,8,86,5,3
54628,51503,443,42971,443,allow,9239,4472,4767,37,39,21,16
54629,65452,53,31972,53,allow,365,102,263,2,30,1,1
54630,43817,443,47281,443,allow,5911,1666,4245,27,18,15,12
54631,51788,35787,52462,35787,allow,70,70,0,2,8,2,0
54632,56972,53,24503,53,allow,177,94,83,2,30,1,1
54633,21859,53,21859,53,allow,242,98,144,2,30,1,1
54634,57272,53,3406,53,allow,373,107,266,4,45,2,2
54635,34670,53,34670,53,allow,257,106,151,2,30,1,1
54636,56997,53,62280,53,allow,86,86,0,1,30,1,0
54637,50568,443,63503,443,allow,15702,3473,12229,50,70,23,27
54638,54167,53,54167,53,allow,242,98,144,2,30,1,1
54639,49891,53,6545,53,allow,375,126,249,2,30,1,1
54640,44242,5228,42163,5228,allow,10823,1636,9187,32,591,11,21
54641,49882,443,5946,443,allow,5019,1424,3595,15,87,9,6
54642,51769,19165,52583,19165,allow,70,70,0,1,5,1,0
54643,56613,443,6770,443,allow,6016,1284,4732,18,984,8,10
54644,53665,80,59537,80,allow,4417,3685,732,16,15,10,6
54645,55072,53,38583,53,allow,86,86,0,1,30,1,0
54646,49757,53,9163,53,allow,177,94,83,2,30,1,1
54647,49234,53,56023,53,allow,177,94,83,2,30,1,1
54648,49647,53,18676,53,allow,361,102,259,2,30,1,1
54649,48817,14888,48817,14888,allow,481,150,331,2,1200,1,1
54650,56796,41431,54757,41431,allow,70,70,0,1,5,1,0
54651,62424,443,60409,443,allow,4650,3116,1534,19,44,10,9
54652,49349,80,23734,80,allow,185645,6753,178892,213,81,89,124
54653,53437,6057,38097,6057,allow,245,245,0,2,30,2,0
54654,56227,53,50602,53,allow,278,102,176,2,30,1,1
54655,40182,443,24953,443,allow,1312,651,661,13,184,7,6
54656,58724,443,33462,443,allow,10179,4285,5894,60,272,31,29
54657,56887,53,8046,53,allow,250,87,163,4,57,2,2
54658,49211,53,35833,53,allow,484,100,384,4,56,2,2
54659,39980,443,30240,443,allow,2674,1386,1288,17,120,8,9
54660,57425,443,33540,443,allow,130,70,60,2,15,1,1
54661,53598,40326,41639,40326,allow,70,70,0,2,7,2,0
54662,55601,44049,44869,44049,allow,504,318,186,8,15,5,3
54663,64448,53,46885,53,allow,353,92,261,4,38,2,2
54664,41193,443,45935,443,allow,6035,782,5253,16,109,8,8
54665,43785,443,28083,443,allow,6017,1285,4732,18,984,8,10
54666,52881,443,3297,443,allow,130,70,60,2,15,1,1
54667,37145,443,8419,443,allow,4578,2334,2244,21,16,12,9
54668,55604,44235,60786,44235,allow,504,318,186,8,15,5,3
54669,51858,443,51858,443,allow,12505,3792,8713,48,255,24,24
54670,37990,49152,47344,49152,allow,156,156,0,3,7,3,0
54671,51236,443,52300,443,allow,7950,2502,5448,38,15,22,16
54672,60394,80,52231,80,allow,2047,701,1346,16,26,5,11
54673,55847,443,25138,443,allow,8443,1430,7013,17,141,8,9
54674,55462,53,36387,53,allow,579,88,491,4,35,2,2
54675,56782,49135,53247,49135,allow,70,70,0,1,5,1,0
54676,62422,443,30175,443,allow,16258,11067,5191,37,45,21,16
54677,49846,80,53092,80,allow,2644,1918,726,11,89,7,4
54678,49881,80,7229,80,allow,1965,1450,515,7,87,5,2
54679,49901,443,33276,443,allow,5583,1567,4016,16,85,9,7
54680,47694,443,24366,443,allow,23751,3197,20554,42,170,19,23
54681,49889,80,51133,80,allow,1376,946,430,8,87,5,3
54682,27005,1306,35061,1306,allow,858,126,732,2,29,1,1
54683,49650,53,14821,53,allow,821,102,719,2,29,1,1
54684,45159,443,45159,443,allow,5329,2082,3247,22,40,13,9
54685,55786,53,63117,53,allow,177,94,83,2,29,1,1
54686,27005,1104,28939,1104,allow,870,126,744,2,29,1,1
54687,65080,53,41733,53,allow,193,102,91,2,29,1,1
54688,49842,80,44778,80,allow,70094,1629,68465,63,89,16,47
54689,64374,53,64374,53,allow,240,98,142,2,30,1,1
54690,64204,53,27061,53,allow,264,102,162,2,31,1,1
54691,34910,443,46197,443,allow,16227,7159,9068,40,524,21,19
54692,58936,80,60272,80,allow,10003,5095,4908,21,76,12,9
54693,52097,443,1702,443,allow,11181,7329,3852,39,53,20,19
54694,54262,53,54262,53,allow,216,82,134,2,33,1,1
54695,49864,80,42240,80,allow,5205,1474,3731,9,88,5,4
54696,63997,53,40711,53,allow,676,192,484,6,84,3,3
54697,40340,53,40340,53,allow,217,90,127,2,30,1,1
54698,56887,53,51812,53,allow,177,94,83,2,30,1,1
54699,34616,53,34616,53,allow,197,90,107,2,30,1,1
54700,55072,53,58133,53,allow,168,86,82,2,30,1,1
54701,51789,40800,21058,40800,allow,70,70,0,2,8,2,0
54702,35945,8080,16769,8080,allow,170,110,60,2,5,1,1
54703,51687,80,38806,80,allow,1517,481,1036,11,15,6,5
54704,55602,22005,13936,22005,allow,504,318,186,8,15,5,3
54705,49847,80,28928,80,allow,4135,2587,1548,10,89,7,3
54706,49849,80,56031,80,allow,9581,2352,7229,14,89,7,7
54707,65195,53,58646,53,allow,249,94,155,2,30,1,1
54708,64944,443,63703,443,allow,48856,4158,44698,65,120,26,39
54709,53667,80,16085,80,allow,5090,4357,733,17,15,11,6
54710,34597,80,9526,80,allow,1540,553,987,10,15,6,4
54711,51787,35661,32624,35661,allow,70,70,0,2,8,2,0
54712,56794,1,30345,1,allow,70,70,0,1,5,1,0
54713,49891,80,47196,80,allow,1376,946,430,8,86,5,3
54714,35371,443,55003,443,allow,304294,8535,295759,302,132,90,212
54715,49907,53,31143,53,allow,363,98,265,4,54,2,2
54716,56880,53,14600,53,allow,216,102,114,2,30,1,1
54717,49626,53,57027,53,allow,226,110,116,2,30,1,1
54718,53325,443,60728,443,allow,6988,1214,5774,29,315,13,16
54719,65489,53,22228,53,allow,242,102,140,2,30,1,1
54720,45852,53,58364,53,allow,164,78,86,2,30,1,1
54721,64539,53,12093,53,allow,177,94,83,2,30,1,1
54722,55232,53,4973,53,allow,177,94,83,2,30,1,1
54723,46904,443,22687,443,allow,1314,653,661,13,184,7,6
54724,57470,1337,11046,1337,allow,132,132,0,3,1199,3,0
54725,57470,51413,20990,51413,allow,132,132,0,3,1199,3,0
54726,46902,443,9815,443,allow,1312,651,661,13,184,7,6
54727,57470,32554,26489,32554,allow,726,726,0,12,1199,12,0
54728,55877,51413,55340,51413,allow,460,150,310,2,1200,1,1
54729,51221,20864,10145,20864,allow,7308,6812,496,71,3243,63,8
54730,49892,443,33274,443,allow,5737,1602,4135,23,86,13,10
54731,49862,443,6856,443,allow,17924,7867,10057,45,88,24,21
54732,57447,443,54490,443,allow,12192,3788,8404,36,18,18,18
54733,59890,443,21509,443,allow,9801,2337,7464,25,47,13,12
54734,54420,443,57977,443,allow,5809,1552,4257,19,74,11,8
54735,52277,443,12555,443,allow,13832,4868,8964,91,364,37,54
54736,64569,443,62686,443,allow,9157,2109,7048,27,32,15,12
54737,49907,443,5295,443,allow,6754,2219,4535,21,76,11,10
54738,49894,443,43523,443,allow,5597,1462,4135,21,86,11,10
54739,59888,443,25489,443,allow,4350,2061,2289,18,47,10,8
54740,52140,80,9768,80,allow,3476,1433,2043,26,418,14,12
54741,49901,53,27916,53,allow,349,108,241,4,35,2,2
54742,41024,443,41024,443,allow,4639,1732,2907,19,30,11,8
54743,40729,123,44305,123,allow,184,94,90,2,30,1,1
54744,59023,64097,0,0,deny,62,62,0,1,0,1,0
54745,16387,56995,0,0,deny,60,60,0,1,0,1,0
54746,22683,39210,0,0,deny,60,60,0,1,0,1,0
54747,50031,44847,0,0,deny,74,74,0,1,0,1,0
54748,53053,64147,0,0,deny,62,62,0,1,0,1,0
54749,50562,37965,0,0,deny,66,66,0,1,0,1,0
54750,21173,37965,0,0,deny,62,62,0,1,0,1,0
54751,57797,445,0,0,drop,70,70,0,1,0,1,0
54752,57798,445,0,0,drop,70,70,0,1,0,1,0
54753,57794,445,0,0,drop,70,70,0,1,0,1,0
54754,52806,445,0,0,drop,70,70,0,1,0,1,0
54755,20083,6881,0,0,deny,62,62,0,1,0,1,0
54756,8191,51221,0,0,deny,62,62,0,1,0,1,0
54757,43584,24748,0,0,deny,156,156,0,1,0,1,0
54758,7285,51221,0,0,deny,66,66,0,1,0,1,0
54759,64279,23718,0,0,deny,62,62,0,1,0,1,0
54760,14260,36829,0,0,deny,62,62,0,1,0,1,0
54761,26480,64147,0,0,deny,62,62,0,1,0,1,0
54762,53201,445,0,0,drop,66,66,0,1,0,1,0
54763,57791,445,0,0,drop,70,70,0,1,0,1,0
54764,57788,445,0,0,drop,70,70,0,1,0,1,0
54765,52802,445,0,0,drop,70,70,0,1,0,1,0
54766,52793,445,0,0,drop,70,70,0,1,0,1,0
54767,52792,445,0,0,drop,70,70,0,1,0,1,0
54768,53815,443,57260,443,allow,499,425,74,4,0,3,1
54769,53799,443,27170,443,allow,499,425,74,4,0,3,1
54770,53814,443,6695,443,allow,499,425,74,4,0,3,1
54771,61804,51505,0,0,deny,66,66,0,1,0,1,0
54772,32395,30188,0,0,deny,62,62,0,1,0,1,0
54773,52790,445,0,0,drop,70,70,0,1,0,1,0
54774,52789,445,0,0,drop,70,70,0,1,0,1,0
54775,64175,56502,0,0,deny,66,66,0,1,0,1,0
54776,53196,445,0,0,drop,66,66,0,1,0,1,0
54777,52785,445,0,0,drop,70,70,0,1,0,1,0
54778,54991,36829,0,0,deny,66,66,0,1,0,1,0
54779,32185,47807,0,0,deny,159,159,0,1,0,1,0
54780,53192,445,0,0,drop,66,66,0,1,0,1,0
54781,57776,445,0,0,drop,70,70,0,1,0,1,0
54782,25015,64147,0,0,deny,66,66,0,1,0,1,0
54783,28668,8696,0,0,deny,60,60,0,1,0,1,0
54784,57774,445,0,0,drop,70,70,0,1,0,1,0
54785,57772,445,0,0,drop,70,70,0,1,0,1,0
54786,57767,445,0,0,drop,70,70,0,1,0,1,0
54787,53189,445,0,0,drop,66,66,0,1,0,1,0
54788,52779,445,0,0,drop,70,70,0,1,0,1,0
54789,45410,1,0,0,deny,62,62,0,1,0,1,0
54790,50321,40284,0,0,deny,348,348,0,1,0,1,0
54791,57763,445,0,0,drop,70,70,0,1,0,1,0
54792,34822,31573,0,0,deny,62,62,0,1,0,1,0
54793,57761,445,0,0,drop,70,70,0,1,0,1,0
54794,57758,445,0,0,drop,70,70,0,1,0,1,0
54795,57757,445,0,0,drop,70,70,0,1,0,1,0
54796,53183,445,0,0,drop,66,66,0,1,0,1,0
54797,26082,26296,0,0,deny,159,159,0,1,0,1,0
54798,27446,30188,0,0,deny,66,66,0,1,0,1,0
54799,53176,445,0,0,drop,66,66,0,1,0,1,0
54800,53179,445,0,0,drop,66,66,0,1,0,1,0
54801,53175,445,0,0,drop,66,66,0,1,0,1,0
54802,40547,24051,0,0,deny,74,74,0,1,0,1,0
54803,52772,445,0,0,drop,70,70,0,1,0,1,0
54804,53173,445,0,0,drop,66,66,0,1,0,1,0
54805,53172,445,0,0,drop,66,66,0,1,0,1,0
54806,53171,445,0,0,drop,66,66,0,1,0,1,0
54807,52769,445,0,0,drop,70,70,0,1,0,1,0
54808,58326,50584,0,0,deny,62,62,0,1,0,1,0
54809,53779,37965,0,0,deny,66,66,0,1,0,1,0
54810,56946,1,0,0,deny,66,66,0,1,0,1,0
54811,18357,51180,0,0,deny,62,62,0,1,0,1,0
54812,57755,445,0,0,drop,70,70,0,1,0,1,0
54813,57753,445,0,0,drop,70,70,0,1,0,1,0
54814,57752,445,0,0,drop,70,70,0,1,0,1,0
54815,52765,445,0,0,drop,70,70,0,1,0,1,0
54816,53169,445,0,0,drop,66,66,0,1,0,1,0
54817,52764,445,0,0,drop,70,70,0,1,0,1,0
54818,57748,445,0,0,drop,70,70,0,1,0,1,0
54819,53807,443,54173,443,allow,499,425,74,4,0,3,1
54820,53796,443,58960,443,allow,499,425,74,4,0,3,1
54821,53804,443,53478,443,allow,499,425,74,4,0,3,1
54822,53802,443,44070,443,allow,499,425,74,4,0,3,1
54823,53812,443,19260,443,allow,499,425,74,4,0,3,1
54824,53805,443,64828,443,allow,499,425,74,4,0,3,1
54825,53801,443,63448,443,allow,499,425,74,4,0,3,1
54826,53810,443,43179,443,allow,499,425,74,4,0,3,1
54827,53813,443,59809,443,allow,499,425,74,4,0,3,1
54828,53806,443,13248,443,allow,499,425,74,4,0,3,1
54829,53809,443,5069,443,allow,499,425,74,4,0,3,1
54830,53798,443,32162,443,allow,499,425,74,4,0,3,1
54831,53811,443,28685,443,allow,499,425,74,4,0,3,1
54832,53800,443,21628,443,allow,499,425,74,4,0,3,1
54833,53797,443,48154,443,allow,499,425,74,4,0,3,1
54834,53808,443,30751,443,allow,499,425,74,4,0,3,1
54835,53795,443,29582,443,allow,499,425,74,4,0,3,1
54836,53791,443,9232,443,allow,499,425,74,4,0,3,1
54837,53803,443,59546,443,allow,499,425,74,4,0,3,1
54838,53794,443,48669,443,allow,499,425,74,4,0,3,1
54839,53793,443,25367,443,allow,499,425,74,4,0,3,1
54840,53790,443,36167,443,allow,499,425,74,4,0,3,1
54841,53789,443,10563,443,allow,499,425,74,4,0,3,1
54842,53792,443,8707,443,allow,499,425,74,4,0,3,1
54843,0,0,0,0,deny,70,70,0,1,0,1,0
54844,53164,445,0,0,drop,66,66,0,1,0,1,0
54845,46093,32661,0,0,deny,74,74,0,1,0,1,0
54846,64324,37807,0,0,deny,62,62,0,1,0,1,0
54847,65153,38303,0,0,deny,66,66,0,1,0,1,0
54848,53163,445,0,0,drop,66,66,0,1,0,1,0
54849,53161,445,0,0,drop,66,66,0,1,0,1,0
54850,53159,445,0,0,drop,66,66,0,1,0,1,0
54851,48676,53395,0,0,deny,60,60,0,1,0,1,0
54852,52760,445,0,0,drop,70,70,0,1,0,1,0
54853,64889,26467,0,0,deny,66,66,0,1,0,1,0
54854,1660,8696,0,0,deny,62,62,0,1,0,1,0
54855,60550,50584,0,0,deny,62,62,0,1,0,1,0
54856,52758,445,0,0,drop,70,70,0,1,0,1,0
54857,1040,6004,0,0,deny,72,72,0,1,0,1,0
54858,57741,445,0,0,drop,70,70,0,1,0,1,0
54859,443,9986,0,0,deny,297,297,0,1,0,1,0
54860,12605,57470,0,0,deny,62,62,0,1,0,1,0
54861,65501,26467,0,0,deny,66,66,0,1,0,1,0
54862,57734,445,0,0,drop,70,70,0,1,0,1,0
54863,57732,445,0,0,drop,70,70,0,1,0,1,0
54864,59136,50584,0,0,deny,66,66,0,1,0,1,0
54865,60875,50584,0,0,deny,66,66,0,1,0,1,0
54866,52754,445,0,0,drop,70,70,0,1,0,1,0
54867,53151,445,0,0,drop,66,66,0,1,0,1,0
54868,61736,50584,0,0,deny,66,66,0,1,0,1,0
54869,443,5920,0,0,deny,66,66,0,1,0,1,0
54870,42034,28189,0,0,deny,62,62,0,1,0,1,0
54871,12471,48817,0,0,deny,62,62,0,1,0,1,0
54872,45964,2225,0,0,deny,60,60,0,1,0,1,0
54873,53141,445,0,0,drop,66,66,0,1,0,1,0
54874,57720,445,0,0,drop,70,70,0,1,0,1,0
54875,51582,48817,0,0,deny,66,66,0,1,0,1,0
54876,46495,4607,0,0,deny,60,60,0,1,0,1,0
54877,26528,51221,0,0,deny,78,78,0,1,0,1,0
54878,48980,15000,3233,15000,allow,130,70,60,2,5,1,1
54879,56618,443,57435,443,allow,8034,2014,6020,20,15,11,9
54880,64568,443,63585,443,allow,25404,2462,22942,47,32,25,22
54881,55232,53,45264,53,allow,170,87,83,2,30,1,1
54882,59880,443,7834,443,allow,16776,7513,9263,42,47,24,18
54883,27350,80,31798,80,allow,3943,1809,2134,21,82,11,10
54884,43112,443,7009,443,allow,3197,1931,1266,19,15,9,10
54885,56619,443,13830,443,allow,7982,1962,6020,20,15,11,9
54886,26457,80,26457,80,allow,17147,1829,15318,28,17,15,13
54887,50122,443,28442,443,allow,130,70,60,2,15,1,1
54888,43111,443,29874,443,allow,3117,1867,1250,19,15,9,10
54889,51768,61765,15043,61765,allow,66,66,0,1,5,1,0
54890,45587,443,45587,443,allow,5523,2276,3247,22,28,13,9
54891,44695,53,44695,53,allow,198,89,109,2,30,1,1
54892,64979,53,23009,53,allow,188,96,92,2,31,1,1
54893,55917,53,56529,53,allow,170,87,83,2,31,1,1
54894,59343,53,0,0,allow,627,72,555,2,30,1,1
54895,51862,22,51862,22,allow,7902,3301,4601,56,40,26,30
54896,52205,5222,24221,5222,allow,684,280,404,11,26,5,6
54897,52375,80,50220,80,allow,234,234,0,4,12,4,0
54898,43601,443,18392,443,allow,10274,3806,6468,26,413,14,12
54899,50239,443,44236,443,allow,9418,2681,6737,39,256,18,21
54900,38329,80,52994,80,allow,350,210,140,6,16,4,2
54901,37271,443,4038,443,allow,51402,5964,45438,86,153,32,54
54902,56295,443,26147,443,allow,8550,1880,6670,22,376,12,10
54903,56617,443,25954,443,allow,7981,1961,6020,20,16,11,9
54904,37536,80,9440,80,allow,3565,1020,2545,16,15,9,7
54905,58454,443,58454,443,allow,4593,1616,2977,19,76,10,9
54906,59270,53,59270,53,allow,825,99,726,2,30,1,1
54907,56813,53,39428,53,allow,711,87,624,2,30,1,1
54908,8888,53,8888,53,allow,214,97,117,2,30,1,1
54909,55106,53,55106,53,allow,200,90,110,2,30,1,1
54910,53035,5228,40515,5228,allow,2725,1610,1115,20,3600,10,10
54911,56366,53,46809,53,allow,754,94,660,2,31,1,1
54912,53713,443,37609,443,allow,4931,957,3974,17,15,10,7
54913,59487,80,24242,80,allow,350,210,140,6,26,4,2
54914,53714,443,10907,443,allow,4933,957,3976,17,15,10,7
54915,57312,53,57312,53,allow,208,94,114,2,30,1,1
54916,49591,53,51142,53,allow,168,86,82,2,30,1,1
54917,3424,53,3424,53,allow,216,88,128,2,30,1,1
54918,2079,7000,2079,7000,allow,3102,1551,1551,16,16,8,8
54919,56775,53,34626,53,allow,763,101,662,2,30,1,1
54920,50328,53,20316,53,allow,783,96,687,2,30,1,1
54921,56268,53,11800,53,allow,711,87,624,2,31,1,1
54922,49353,53,30816,53,allow,738,86,652,2,31,1,1
54923,30960,45690,12118,45690,allow,330,330,0,6,3609,6,0
54924,49597,53,33201,53,allow,168,86,82,2,31,1,1
54925,55836,53,32275,53,allow,178,91,87,2,31,1,1
54926,65366,53,60695,53,allow,198,101,97,2,31,1,1
54927,55040,53,40859,53,allow,762,98,664,2,31,1,1
54928,56620,53,33976,53,allow,216,110,106,2,31,1,1
54929,49883,53,18157,53,allow,170,87,83,2,30,1,1
54930,55011,53,15618,53,allow,760,96,664,2,31,1,1
54931,56373,53,29361,53,allow,200,102,98,2,31,1,1
54932,65153,53,43651,53,allow,168,86,82,2,31,1,1
54933,65177,53,32886,53,allow,256,93,163,2,31,1,1
54934,30960,45689,37422,45689,allow,330,330,0,6,3609,6,0
54935,56091,53,32743,53,allow,738,86,652,2,31,1,1
54936,50475,53,26369,53,allow,772,100,672,2,31,1,1
54937,55698,53,13157,53,allow,742,88,654,2,31,1,1
54938,55656,53,48878,53,allow,212,108,104,2,31,1,1
54939,57397,53,42342,53,allow,256,93,163,2,31,1,1
54940,64980,53,5647,53,allow,200,102,98,2,31,1,1
54941,61041,443,15332,443,allow,77650,64697,12953,148,902,81,67
54942,10115,52700,0,0,deny,62,62,0,1,0,1,0
54943,8933,56205,0,0,deny,62,62,0,1,0,1,0
54944,60294,30188,0,0,deny,66,66,0,1,0,1,0
54945,52459,5555,0,0,deny,60,60,0,1,0,1,0
54946,53139,445,0,0,drop,66,66,0,1,0,1,0
54947,52741,445,0,0,drop,70,70,0,1,0,1,0
54948,59481,41182,0,0,deny,66,66,0,1,0,1,0
54949,1027,11392,0,0,deny,62,62,0,1,0,1,0
54950,59784,42246,0,0,deny,62,62,0,1,0,1,0
54951,58074,11392,0,0,deny,66,66,0,1,0,1,0
54952,51685,57470,0,0,deny,62,62,0,1,0,1,0
54953,52356,55442,0,0,deny,66,66,0,1,0,1,0
54954,64841,53,24677,53,allow,165,86,79,2,30,1,1
54955,55386,53,14835,53,allow,199,102,97,2,30,1,1
54956,49890,443,15513,443,allow,5597,1462,4135,21,86,11,10
54957,52738,445,0,0,drop,70,70,0,1,0,1,0
54958,53132,445,0,0,drop,66,66,0,1,0,1,0
54959,9246,35440,0,0,deny,66,66,0,1,0,1,0
54960,443,20982,0,0,deny,97,97,0,1,0,1,0
54961,53123,445,0,0,drop,66,66,0,1,0,1,0
54962,62859,35440,0,0,deny,66,66,0,1,0,1,0
54963,53371,26467,0,0,deny,66,66,0,1,0,1,0
54964,14715,56205,0,0,deny,62,62,0,1,0,1,0
54965,30496,57470,0,0,deny,62,62,0,1,0,1,0
54966,59235,52700,0,0,deny,145,145,0,1,0,1,0
54967,52734,445,0,0,drop,70,70,0,1,0,1,0
54968,52732,445,0,0,drop,70,70,0,1,0,1,0
54969,44258,25,0,0,deny,74,74,0,1,0,1,0
54970,64756,11392,0,0,deny,62,62,0,1,0,1,0
54971,57711,445,0,0,drop,70,70,0,1,0,1,0
54972,57708,445,0,0,drop,70,70,0,1,0,1,0
54973,57709,445,0,0,drop,70,70,0,1,0,1,0
54974,52728,445,0,0,drop,70,70,0,1,0,1,0
54975,53113,445,0,0,drop,66,66,0,1,0,1,0
54976,53114,445,0,0,drop,66,66,0,1,0,1,0
54977,53108,445,0,0,drop,66,66,0,1,0,1,0
54978,53115,445,0,0,drop,66,66,0,1,0,1,0
54979,53112,445,0,0,drop,66,66,0,1,0,1,0
54980,53110,445,0,0,drop,66,66,0,1,0,1,0
54981,53111,445,0,0,drop,66,66,0,1,0,1,0
54982,53109,445,0,0,drop,66,66,0,1,0,1,0
54983,17009,53733,0,0,deny,66,66,0,1,0,1,0
54984,14459,11848,0,0,reset-both,148,148,0,1,0,1,0
54985,11464,37965,0,0,deny,62,62,0,1,0,1,0
54986,443,28417,0,0,deny,82,82,0,1,0,1,0
54987,26332,57470,0,0,deny,62,62,0,1,0,1,0
54988,52721,445,0,0,drop,70,70,0,1,0,1,0
54989,64940,36237,0,0,deny,62,62,0,1,0,1,0
54990,57706,445,0,0,drop,70,70,0,1,0,1,0
54991,57701,445,0,0,drop,70,70,0,1,0,1,0
54992,57694,445,0,0,drop,70,70,0,1,0,1,0
54993,52719,445,0,0,drop,70,70,0,1,0,1,0
54994,22587,30188,0,0,deny,66,66,0,1,0,1,0
54995,38645,51221,0,0,deny,62,62,0,1,0,1,0
54996,2923,57470,0,0,deny,66,66,0,1,0,1,0
54997,53096,445,0,0,drop,66,66,0,1,0,1,0
54998,53094,445,0,0,drop,66,66,0,1,0,1,0
54999,53093,445,0,0,drop,66,66,0,1,0,1,0
55000,1227,56205,0,0,deny,66,66,0,1,0,1,0
55001,6712,44818,0,0,deny,66,66,0,1,0,1,0
55002,3564,57470,0,0,deny,62,62,0,1,0,1,0
55003,52718,445,0,0,drop,70,70,0,1,0,1,0
55004,20057,44847,0,0,deny,62,62,0,1,0,1,0
55005,39824,51505,0,0,deny,62,62,0,1,0,1,0
55006,52717,445,0,0,drop,70,70,0,1,0,1,0
55007,52716,445,0,0,drop,70,70,0,1,0,1,0
55008,57691,445,0,0,drop,70,70,0,1,0,1,0
55009,4127,26467,0,0,deny,66,66,0,1,0,1,0
55010,52714,445,0,0,drop,70,70,0,1,0,1,0
55011,49865,443,1213,443,allow,8535,1936,6599,22,87,12,10
55012,49848,443,28970,443,allow,33314,1722,31592,40,88,14,26
55013,49885,443,26423,443,allow,10216,2749,7467,27,86,14,13
55014,64539,53,18826,53,allow,177,94,83,2,29,1,1
55015,49851,80,9497,80,allow,11936,2198,9738,22,88,9,13
55016,53592,23578,40087,23578,allow,70,70,0,2,7,2,0
55017,52118,80,62172,80,allow,3158,1309,1849,28,418,15,13
55018,52126,80,5898,80,allow,3592,2098,1494,26,417,14,12
55019,48220,443,48220,443,allow,4627,1720,2907,18,26,10,8
55020,53664,80,23809,80,allow,3741,3008,733,16,15,10,6
55021,49909,443,16969,443,allow,6754,2219,4535,21,75,11,10
55022,49866,443,6704,443,allow,7128,865,6263,19,87,9,10
55023,49908,443,25535,443,allow,4712,908,3804,18,75,9,9
55024,64380,53,30464,53,allow,196,102,94,2,32,1,1
55025,49342,443,54046,443,allow,10075,6346,3729,48,84,25,23
55026,53604,1046,44060,1046,allow,320,140,180,6,5,3,3
55027,51651,53,58120,53,allow,237,86,151,2,29,1,1
55028,3195,53,3195,53,allow,197,90,107,2,29,1,1
55029,64586,53,31352,53,allow,257,102,155,2,30,1,1
55030,55383,53,13927,53,allow,177,94,83,2,30,1,1
55031,64716,53,5161,53,allow,718,94,624,2,30,1,1
55032,55232,53,8300,53,allow,177,94,83,2,30,1,1
55033,65492,53,43623,53,allow,199,102,97,2,30,1,1
55034,51786,37832,38503,37832,allow,70,70,0,2,8,2,0
55035,51986,80,3605,80,allow,1274,694,580,13,16,6,7
55036,43475,443,10490,443,allow,5578,1646,3932,23,16,13,10
55037,55386,53,64239,53,allow,822,102,720,2,30,1,1
55038,56828,53,33245,53,allow,211,102,109,2,30,1,1
55039,53490,5228,31385,5228,allow,7188,2098,5090,38,113,22,16
55040,46746,443,17806,443,allow,9506,4029,5477,30,330,17,13
55041,35197,443,30510,443,allow,12481,2743,9738,53,20,26,27
55042,50375,80,22563,80,allow,350,210,140,6,15,4,2
55043,51403,443,43951,443,allow,334,70,264,5,17,1,4
55044,49603,53,64849,53,allow,733,94,639,2,30,1,1
55045,59883,443,34270,443,allow,8031,2957,5074,27,46,16,11
55046,65294,53,43260,53,allow,173,94,79,2,30,1,1
55047,65236,53,21854,53,allow,177,94,83,2,30,1,1
55048,65507,53,17701,53,allow,211,102,109,2,30,1,1
55049,65294,53,10566,53,allow,165,86,79,2,30,1,1
55050,65236,53,45022,53,allow,177,94,83,2,30,1,1
55051,51580,80,9107,80,allow,1752,786,966,16,17,9,7
55052,49432,53,25699,53,allow,309,94,215,4,32,2,2
55053,64791,443,54264,443,allow,8580,5765,2815,46,82,22,24
55054,58904,123,61821,123,allow,184,94,90,2,30,1,1
55055,50864,53,14255,53,allow,199,94,105,2,30,1,1
55056,65309,53,31055,53,allow,764,102,662,2,30,1,1
55057,55005,53,64586,53,allow,211,102,109,2,30,1,1
55058,62490,443,60258,443,allow,7206,4320,2886,16,120,8,8
55059,53118,56839,5832,56839,allow,70,70,0,2,8,2,0
55060,49206,80,5739,80,allow,57497,913,56584,52,75,11,41
55061,64967,53,21374,53,allow,389,134,255,2,30,1,1
55062,65492,53,44506,53,allow,822,102,720,2,30,1,1
55063,64113,53,6414,53,allow,216,102,114,2,30,1,1
55064,51832,443,21428,443,allow,2831,740,2091,11,120,5,6
55065,56887,53,53946,53,allow,250,87,163,4,60,2,2
55066,59889,443,40054,443,allow,8305,2325,5980,24,46,13,11
55067,59891,443,64677,443,allow,7718,1947,5771,25,46,14,11
55068,55616,42929,18894,42929,allow,70,70,0,2,8,2,0
55069,55719,8060,46962,8060,allow,70,70,0,1,4,1,0
55070,63782,6969,33183,6969,allow,66,66,0,2,8,2,0
55071,51785,33253,14709,33253,allow,70,70,0,2,8,2,0
55072,53114,32975,63232,32975,allow,70,70,0,1,5,1,0
55073,51792,22318,43615,22318,allow,316,136,180,6,5,3,3
55074,53596,56732,58606,56732,allow,70,70,0,2,7,2,0
55075,55232,53,12562,53,allow,177,94,83,2,29,1,1
55076,60378,11385,17333,11385,allow,1218,774,444,17,26,10,7
55077,52122,80,30528,80,allow,4137,1236,2901,27,418,14,13
55078,49591,53,21458,53,allow,86,86,0,1,29,1,0
55079,49910,443,39120,443,allow,4712,908,3804,18,75,9,9
55080,49869,80,37142,80,allow,2125,1041,1084,11,87,6,5
55081,60403,60092,47131,60092,allow,70,70,0,2,8,2,0
55082,40604,443,31639,443,allow,130,70,60,3,5,2,1
55083,54583,443,25809,443,allow,11307,7633,3674,25,163,18,7
55084,38968,80,48567,80,allow,1280,586,694,10,15,5,5
55085,36535,443,10367,443,allow,416,210,206,7,27,4,3
55086,40511,80,1880,80,allow,1680,950,730,12,15,6,6
55087,46529,80,23858,80,allow,1119,388,731,9,223,5,4
55088,33237,443,28944,443,allow,31065,6730,24335,68,18,37,31
55089,63742,443,58789,443,allow,7444,1915,5529,28,16,16,12
55090,55383,53,49153,53,allow,177,94,83,2,29,1,1
55091,57351,53,48992,53,allow,177,94,83,2,30,1,1
55092,64642,53,40634,53,allow,265,94,171,2,30,1,1
55093,55917,53,40255,53,allow,177,94,83,2,30,1,1
55094,49883,53,14693,53,allow,177,94,83,2,30,1,1
55095,33388,53,33388,53,allow,229,98,131,2,30,1,1
55096,63617,53,24659,53,allow,299,102,197,2,30,1,1
55097,43018,443,63361,443,allow,4664,962,3702,15,120,7,8
55098,65220,53,42472,53,allow,245,94,151,2,30,1,1
55099,59534,53,0,0,allow,627,72,555,2,30,1,1
55100,65396,53,32966,53,allow,178,94,84,2,30,1,1
55101,46730,443,28358,443,allow,7648,1671,5977,25,31,13,12
55102,55917,53,22277,53,allow,177,94,83,2,30,1,1
55103,49597,53,40368,53,allow,86,86,0,1,30,1,0
55104,57351,53,50583,53,allow,177,94,83,2,30,1,1
55105,49890,53,63142,53,allow,767,102,665,2,30,1,1
55106,57152,53,41610,53,allow,733,94,639,2,30,1,1
55107,49591,53,36017,53,allow,168,86,82,2,31,1,1
55108,41816,443,14209,443,allow,88503,3914,84589,114,80,44,70
55109,57589,443,3632,443,allow,2614,1689,925,18,23,10,8
55110,56229,53,12969,53,allow,165,86,79,2,30,1,1
55111,63766,80,33525,80,allow,314,192,122,6,15,4,2
55112,51767,59158,56330,59158,allow,70,70,0,1,5,1,0
55113,26386,53,26386,53,allow,231,90,141,2,30,1,1
55114,64404,53,48455,53,allow,224,94,130,2,30,1,1
55115,64557,53,9245,53,allow,766,102,664,2,30,1,1
55116,57095,53,7010,53,allow,177,94,83,2,30,1,1
55117,39145,443,40241,443,allow,4602,1305,3297,27,183,12,15
55118,56355,53,52899,53,allow,184,94,90,2,31,1,1
55119,6881,6881,44146,6881,allow,502,150,352,2,1199,1,1
55120,52121,443,41012,443,allow,199757,7497,192260,216,45,80,136
55121,64052,53,64052,53,allow,198,90,108,2,30,1,1
55122,59534,53,0,0,allow,216,72,144,2,30,1,1
55123,64841,53,21377,53,allow,173,94,79,2,30,1,1
55124,49883,53,42017,53,allow,177,94,83,2,30,1,1
55125,50233,53,42089,53,allow,748,94,654,2,30,1,1
55126,56196,53,24743,53,allow,498,204,294,6,31,3,3
55127,64979,53,4667,53,allow,194,102,92,2,31,1,1
55128,54967,53,43919,53,allow,178,94,84,2,31,1,1
55129,55617,53,37518,53,allow,194,102,92,2,31,1,1
55130,50594,80,17201,80,allow,3116,452,2664,18,394,5,13
55131,55002,443,31651,443,allow,469783,461079,8704,444,167,329,115
55132,41440,5228,57433,5228,allow,8866,2015,6851,29,4793,14,15
55133,39920,443,36288,443,allow,4552,1255,3297,27,183,12,15
55134,54898,443,38797,443,allow,4559,2054,2505,11,120,6,5
55135,57470,61768,42520,61768,allow,330,330,0,6,1199,6,0
55136,6882,6881,62031,6881,allow,238,118,120,2,1200,1,1
55137,38387,80,17970,80,allow,2008,810,1198,20,394,7,13
55138,15503,26886,1778,26886,allow,481,150,331,2,1200,1,1
55139,44847,31381,18131,31381,allow,150,150,0,1,1200,1,0
55140,57418,443,37526,443,allow,29994,1927,28067,50,20,17,33
55141,52282,80,3560,80,allow,7603,1651,5952,24,16,13,11
55142,34358,80,63755,80,allow,350,210,140,6,16,4,2
55143,29964,53,52267,53,allow,200,86,114,2,30,1,1
55144,53566,8999,11689,8999,allow,3428,1820,1608,21,17,12,9
55145,53576,23505,46519,23505,allow,70,70,0,1,5,1,0
55146,63769,47661,26406,47661,allow,70,70,0,1,5,1,0
55147,59884,443,44531,443,allow,6622,2246,4376,21,46,12,9
55148,51075,80,51075,80,allow,450,246,204,8,26,5,3
55149,52131,443,17836,443,allow,6565,1251,5314,27,31,14,13
55150,33087,443,44739,443,allow,13265,1924,11341,33,201,17,16
55151,63771,7426,20150,7426,allow,70,70,0,1,5,1,0
55152,14431,443,44094,443,allow,2601,1455,1146,18,16,8,10
55153,55089,53,1796,53,allow,199,102,97,2,30,1,1
55154,64308,53,43760,53,allow,181,86,95,2,30,1,1
55155,55089,53,56950,53,allow,199,102,97,2,30,1,1
55156,64599,53,12199,53,allow,767,102,665,2,30,1,1
55157,2362,53,2362,53,allow,225,90,135,2,30,1,1
55158,57095,53,10011,53,allow,177,94,83,2,30,1,1
55159,36255,53,36255,53,allow,197,90,107,2,30,1,1
55160,55346,53,62620,53,allow,177,94,83,2,31,1,1
55161,52710,445,0,0,drop,70,70,0,1,0,1,0
55162,43890,123,0,0,deny,234,234,0,1,0,1,0
55163,17315,11392,0,0,deny,62,62,0,1,0,1,0
55164,57689,445,0,0,drop,70,70,0,1,0,1,0
55165,57679,445,0,0,drop,70,70,0,1,0,1,0
55166,57680,445,0,0,drop,70,70,0,1,0,1,0
55167,57678,445,0,0,drop,70,70,0,1,0,1,0
55168,57441,57470,0,0,deny,66,66,0,1,0,1,0
55169,45941,23386,0,0,deny,60,60,0,1,0,1,0
55170,45941,23386,0,0,deny,60,60,0,1,0,1,0
55171,52698,445,0,0,drop,70,70,0,1,0,1,0
55172,52697,445,0,0,drop,70,70,0,1,0,1,0
55173,52693,445,0,0,drop,70,70,0,1,0,1,0
55174,60480,57470,0,0,deny,62,62,0,1,0,1,0
55175,52687,445,0,0,drop,70,70,0,1,0,1,0
55176,52688,445,0,0,drop,70,70,0,1,0,1,0
55177,56307,52700,0,0,deny,66,66,0,1,0,1,0
55178,52472,7302,0,0,deny,62,62,0,1,0,1,0
55179,61983,50432,0,0,deny,62,62,0,1,0,1,0
55180,46936,35440,0,0,deny,62,62,0,1,0,1,0
55181,53447,44847,0,0,deny,62,62,0,1,0,1,0
55182,7308,50584,0,0,deny,66,66,0,1,0,1,0
55183,38633,51221,0,0,deny,62,62,0,1,0,1,0
55184,58305,51180,0,0,deny,66,66,0,1,0,1,0
55185,12530,35440,0,0,deny,66,66,0,1,0,1,0
55186,57671,445,0,0,drop,70,70,0,1,0,1,0
55187,57669,445,0,0,drop,70,70,0,1,0,1,0
55188,57664,445,0,0,drop,70,70,0,1,0,1,0
55189,54140,43890,0,0,deny,62,62,0,1,0,1,0
55190,52676,445,0,0,drop,70,70,0,1,0,1,0
55191,50820,57470,0,0,deny,66,66,0,1,0,1,0
55192,1024,57470,0,0,deny,62,62,0,1,0,1,0
55193,50067,64147,0,0,deny,66,66,0,1,0,1,0
55194,31112,50584,0,0,deny,66,66,0,1,0,1,0
55195,60196,53,0,0,deny,88,88,0,1,0,1,0
55196,49842,7302,0,0,deny,66,66,0,1,0,1,0
55197,57478,7302,0,0,deny,66,66,0,1,0,1,0
55198,59378,50584,0,0,deny,66,66,0,1,0,1,0
55199,46587,57470,0,0,deny,62,62,0,1,0,1,0
55200,443,10010,0,0,deny,60,60,0,1,0,1,0
55201,3541,22114,0,0,deny,62,62,0,1,0,1,0
55202,61218,22114,0,0,deny,66,66,0,1,0,1,0
55203,44933,23,0,0,deny,60,60,0,1,0,1,0
55204,59701,44847,0,0,deny,62,62,0,1,0,1,0
55205,28668,8696,0,0,deny,60,60,0,1,0,1,0
55206,38976,46824,0,0,deny,62,62,0,1,0,1,0
55207,52671,445,0,0,drop,70,70,0,1,0,1,0
55208,53072,445,0,0,drop,66,66,0,1,0,1,0
55209,57662,445,0,0,drop,70,70,0,1,0,1,0
55210,57661,445,0,0,drop,70,70,0,1,0,1,0
55211,52662,445,0,0,drop,70,70,0,1,0,1,0
55212,52663,445,0,0,drop,70,70,0,1,0,1,0
55213,63547,37965,0,0,deny,66,66,0,1,0,1,0
55214,52658,445,0,0,drop,70,70,0,1,0,1,0
55215,52657,445,0,0,drop,70,70,0,1,0,1,0
55216,1026,30188,0,0,deny,146,146,0,1,0,1,0
55217,63314,57470,0,0,deny,66,66,0,1,0,1,0
55218,51900,48817,0,0,deny,146,146,0,1,0,1,0
55219,52655,445,0,0,drop,70,70,0,1,0,1,0
55220,53065,445,0,0,drop,66,66,0,1,0,1,0
55221,21087,80,21087,80,allow,159790,4676,155114,177,128,67,110
55222,50878,53733,0,0,deny,66,66,0,1,0,1,0
55223,57060,50584,0,0,deny,62,62,0,1,0,1,0
55224,53064,445,0,0,drop,66,66,0,1,0,1,0
55225,56494,15503,0,0,deny,146,146,0,1,0,1,0
55226,57653,445,0,0,drop,70,70,0,1,0,1,0
55227,58468,57587,0,0,deny,66,66,0,1,0,1,0
55228,57645,445,0,0,drop,70,70,0,1,0,1,0
55229,57644,445,0,0,drop,70,70,0,1,0,1,0
55230,57639,445,0,0,drop,70,70,0,1,0,1,0
55231,53062,445,0,0,drop,66,66,0,1,0,1,0
55232,59940,50584,0,0,deny,62,62,0,1,0,1,0
55233,65060,35440,0,0,deny,62,62,0,1,0,1,0
55234,52649,445,0,0,drop,70,70,0,1,0,1,0
55235,9957,32480,0,0,deny,62,62,0,1,0,1,0
55236,53437,44847,0,0,deny,62,62,0,1,0,1,0
55237,8211,28793,0,0,deny,62,62,0,1,0,1,0
55238,57636,445,0,0,drop,70,70,0,1,0,1,0
55239,62804,37965,0,0,deny,62,62,0,1,0,1,0
55240,0,0,0,0,allow,124,64,60,2,0,1,1
55241,57633,445,0,0,drop,70,70,0,1,0,1,0
55242,57632,445,0,0,drop,70,70,0,1,0,1,0
55243,57629,445,0,0,drop,70,70,0,1,0,1,0
55244,53055,445,0,0,drop,66,66,0,1,0,1,0
55245,52642,445,0,0,drop,70,70,0,1,0,1,0
55246,1888,51505,0,0,deny,62,62,0,1,0,1,0
55247,60188,15503,0,0,deny,62,62,0,1,0,1,0
55248,52641,445,0,0,drop,70,70,0,1,0,1,0
55249,53047,445,0,0,drop,66,66,0,1,0,1,0
55250,53048,445,0,0,drop,66,66,0,1,0,1,0
55251,53046,445,0,0,drop,66,66,0,1,0,1,0
55252,63701,46824,0,0,deny,66,66,0,1,0,1,0
55253,53045,445,0,0,drop,66,66,0,1,0,1,0
55254,53043,445,0,0,drop,66,66,0,1,0,1,0
55255,53042,445,0,0,drop,66,66,0,1,0,1,0
55256,50084,26672,0,0,deny,62,62,0,1,0,1,0
55257,52635,445,0,0,drop,70,70,0,1,0,1,0
55258,23274,50584,0,0,deny,62,62,0,1,0,1,0
55259,52103,53733,0,0,deny,66,66,0,1,0,1,0
55260,54062,49813,0,0,deny,62,62,0,1,0,1,0
55261,52634,445,0,0,drop,70,70,0,1,0,1,0
55262,52447,43890,0,0,deny,66,66,0,1,0,1,0
55263,21733,56205,0,0,deny,66,66,0,1,0,1,0
55264,57628,445,0,0,drop,70,70,0,1,0,1,0
55265,57625,445,0,0,drop,70,70,0,1,0,1,0
55266,57621,445,0,0,drop,70,70,0,1,0,1,0
55267,53038,445,0,0,drop,66,66,0,1,0,1,0
55268,57620,445,0,0,drop,70,70,0,1,0,1,0
55269,13654,50584,0,0,deny,146,146,0,1,0,1,0
55270,53037,445,0,0,drop,66,66,0,1,0,1,0
55271,52630,445,0,0,drop,70,70,0,1,0,1,0
55272,59128,44847,0,0,deny,62,62,0,1,0,1,0
55273,53033,445,0,0,drop,66,66,0,1,0,1,0
55274,53035,445,0,0,drop,66,66,0,1,0,1,0
55275,53031,445,0,0,drop,66,66,0,1,0,1,0
55276,52629,445,0,0,drop,70,70,0,1,0,1,0
55277,58396,22114,0,0,deny,66,66,0,1,0,1,0
55278,63615,23,0,0,deny,60,60,0,1,0,1,0
55279,46275,64147,0,0,deny,62,62,0,1,0,1,0
55280,56119,46824,0,0,deny,62,62,0,1,0,1,0
55281,57614,445,0,0,drop,70,70,0,1,0,1,0
55282,29203,26467,0,0,deny,62,62,0,1,0,1,0
55283,54910,32480,0,0,deny,66,66,0,1,0,1,0
55284,50418,80,62798,80,allow,12920,6875,6045,25,27,13,12
55285,50431,80,44826,80,allow,318,192,126,6,27,4,2
55286,50435,80,28947,80,allow,318,192,126,6,27,4,2
55287,2075,7000,2075,7000,allow,5850,4395,1455,18,15,10,8
55288,65287,3389,65287,3389,allow,3409,1454,1955,16,16,8,8
55289,50446,80,5062,80,allow,318,192,126,6,27,4,2
55290,34539,80,34539,80,allow,22098,1602,20496,24,57,6,18
55291,56613,443,29986,443,allow,7981,1961,6020,20,16,11,9
55292,56614,443,40071,443,allow,8034,2014,6020,20,15,11,9
55293,49914,443,44270,443,allow,5895,728,5167,16,27,8,8
55294,52324,443,52324,443,allow,6727,762,5965,15,26,8,7
55295,55089,53,42866,53,allow,198,101,97,2,30,1,1
55296,57257,53,11711,53,allow,764,99,665,2,30,1,1
55297,11295,40040,23656,40040,allow,213,89,124,4,31,2,2
55298,55735,53,17069,53,allow,772,100,672,2,30,1,1
55299,50432,80,29144,80,allow,318,192,126,6,27,4,2
55300,2076,7000,2076,7000,allow,5194,3739,1455,18,15,10,8
55301,51541,3389,51541,3389,allow,3609,1654,1955,19,18,11,8
55302,56615,443,31008,443,allow,7982,1962,6020,20,15,11,9
55303,52322,443,52322,443,allow,6926,828,6098,17,26,9,8
55304,2074,7010,2074,7010,allow,4279,2090,2189,16,15,8,8
55305,57115,53,57910,53,allow,788,108,680,2,30,1,1
55306,57095,53,44244,53,allow,170,87,83,2,30,1,1
55307,56741,53,9430,53,allow,814,110,704,2,30,1,1
55308,50181,80,60161,80,allow,2149,1165,984,15,77,8,7
55309,56357,53,52220,53,allow,172,88,84,2,30,1,1
55310,56616,443,54486,443,allow,8033,2013,6020,20,15,11,9
55311,63760,37264,26706,37264,allow,504,382,122,8,16,6,2
55312,60334,7080,60334,7080,allow,2960,432,2528,11,15,6,5
55313,50427,80,43709,80,allow,312,192,120,6,27,4,2
55314,2078,7000,2078,7000,allow,3006,1615,1391,15,15,8,7
55315,64633,53,4250,53,allow,762,98,664,2,30,1,1
55316,57855,443,34807,443,allow,4370,3370,1000,19,187,10,9
55317,55552,53,38672,53,allow,767,102,665,2,30,1,1
55318,58819,1433,58819,1433,allow,124,60,64,2,5,1,1
55319,55462,53,13103,53,allow,188,96,92,2,30,1,1
55320,56567,53,56060,53,allow,188,96,92,2,31,1,1
55321,58488,3389,58488,3389,allow,3428,1714,1714,16,31,8,8
55322,56771,53,7291,53,allow,270,95,175,4,60,2,2
55323,50755,80,50755,80,allow,450,246,204,8,25,5,3
55324,58054,25,23956,25,allow,1370,496,874,16,16,8,8
55325,65290,3389,65290,3389,allow,3327,1438,1889,15,16,8,7
55326,51784,34568,29870,34568,allow,70,70,0,2,8,2,0
55327,50948,80,50948,80,allow,520,246,274,9,25,5,4
55328,53572,22754,17581,22754,allow,70,70,0,1,5,1,0
55329,2077,7000,2077,7000,allow,3054,1599,1455,16,15,8,8
55330,58509,80,60586,80,allow,1666,1130,536,12,16,7,5
55331,2073,7000,2073,7000,allow,3566,1999,1567,16,15,8,8
55332,55617,18319,24832,18319,allow,320,140,180,6,7,3,3
55333,50966,443,44457,443,allow,7975,3304,4671,19,86,11,8
55334,50428,80,50756,80,allow,312,192,120,6,27,4,2
55335,51765,52862,65009,52862,allow,66,66,0,1,5,1,0
55336,63205,443,63205,443,allow,9324,4240,5084,24,16,13,11
55337,2072,7000,2072,7000,allow,3164,783,2381,15,16,7,8
55338,44805,3389,44805,3389,allow,4870,2631,2239,23,19,13,10
55339,50445,80,48799,80,allow,318,192,126,6,27,4,2
55340,63525,53,0,0,allow,174,77,97,2,30,1,1
55341,55417,53,30758,53,allow,196,100,96,2,30,1,1
55342,56620,53,51991,53,allow,322,110,212,4,30,2,2
55343,65192,53,4438,53,allow,172,88,84,2,30,1,1
55344,55514,53,44502,53,allow,783,96,687,2,30,1,1
55345,55113,53,29716,53,allow,196,100,96,2,31,1,1
55346,56355,53,30971,53,allow,184,94,90,2,31,1,1
55347,56724,53,15012,53,allow,749,89,660,2,31,1,1
55348,55336,53,13699,53,allow,295,101,194,4,31,2,2
55349,56569,53,65375,53,allow,91,91,0,1,31,1,0
55350,55990,53,40258,53,allow,182,93,89,2,30,1,1
55351,52544,19000,32388,19000,allow,492,216,276,2,31,1,1
55352,56386,53,13942,53,allow,170,87,83,2,31,1,1
55353,57040,53,4133,53,allow,810,108,702,2,31,1,1
55354,55282,53,18223,53,allow,771,101,670,2,31,1,1
55355,65188,53,51573,53,allow,731,91,640,2,31,1,1
55356,49432,53,56971,53,allow,170,87,83,2,31,1,1
55357,55582,53,11114,53,allow,778,103,675,2,31,1,1
55358,57350,53,19217,53,allow,771,101,670,2,31,1,1
55359,55826,53,30050,53,allow,86,86,0,1,31,1,0
55360,51221,51413,20920,51413,allow,459,149,310,2,1200,1,1
55361,50584,11830,62858,11830,allow,2118,900,1218,14,4232,7,7
55362,63978,53,11123,53,allow,212,108,104,2,31,1,1
55363,56220,53,22417,53,allow,772,103,669,2,31,1,1
55364,5938,49414,0,0,allow,60,60,0,1,90,1,0
55365,64637,53,20905,53,allow,810,108,702,2,30,1,1
55366,50584,53,43253,53,allow,174,89,85,2,31,1,1
55367,65149,53,43485,53,allow,760,97,663,2,31,1,1
55368,56743,53,42878,53,allow,816,97,719,2,30,1,1
55369,55746,53,61389,53,allow,216,110,106,2,31,1,1
55370,56995,53,58865,53,allow,168,86,82,2,31,1,1
55371,55809,53,62877,53,allow,731,85,646,2,31,1,1
55372,55735,53,65479,53,allow,184,94,90,2,31,1,1
55373,49263,53,10892,53,allow,731,85,646,2,31,1,1
55374,56935,53,37247,53,allow,174,89,85,2,31,1,1
55375,51951,443,56049,443,allow,6633,3485,3148,34,197,19,15
55376,55454,53,60200,53,allow,202,103,99,2,31,1,1
55377,15341,23,0,0,allow,60,60,0,1,90,1,0
55378,10151,19083,54566,19083,allow,489,149,340,2,1200,1,1
55379,55081,53,2837,53,allow,711,87,624,2,31,1,1
55380,56186,53,1999,53,allow,196,100,96,2,31,1,1
55381,55273,53,51928,53,allow,166,85,81,2,31,1,1
55382,56282,53,64449,53,allow,751,95,656,2,31,1,1
55383,56072,53,60907,53,allow,198,101,97,2,31,1,1
55384,57094,53,64941,53,allow,192,98,94,2,31,1,1
55385,45944,443,12806,443,allow,4715,1935,2780,24,183,11,13
55386,57608,445,0,0,drop,70,70,0,1,0,1,0
55387,57604,445,0,0,drop,70,70,0,1,0,1,0
55388,65384,57470,0,0,deny,66,66,0,1,0,1,0
55389,54600,6881,0,0,deny,66,66,0,1,0,1,0
55390,52624,445,0,0,drop,70,70,0,1,0,1,0
55391,26528,51221,0,0,deny,78,78,0,1,0,1,0
55392,63183,64147,0,0,deny,66,66,0,1,0,1,0
55393,443,28417,0,0,deny,82,82,0,1,0,1,0
55394,6881,6881,0,0,deny,146,146,0,1,0,1,0
55395,53023,445,0,0,drop,66,66,0,1,0,1,0
55396,1534,54369,0,0,deny,66,66,0,1,0,1,0
55397,51999,37965,0,0,deny,62,62,0,1,0,1,0
55398,64847,53,37930,53,allow,211,102,109,2,30,1,1
55399,55990,53,28837,53,allow,183,94,89,2,30,1,1
55400,50448,443,40818,443,allow,1119,595,524,12,26,6,6
55401,34489,35440,0,0,deny,62,62,0,1,0,1,0
55402,53013,445,0,0,drop,66,66,0,1,0,1,0
55403,33292,50584,0,0,deny,62,62,0,1,0,1,0
55404,57594,445,0,0,drop,70,70,0,1,0,1,0
55405,48430,22,0,0,deny,60,60,0,1,0,1,0
55406,62189,64147,0,0,deny,145,145,0,1,0,1,0
55407,52611,445,0,0,drop,70,70,0,1,0,1,0
55408,58305,18375,0,0,deny,66,66,0,1,0,1,0
55409,53010,445,0,0,drop,66,66,0,1,0,1,0
55410,61221,35440,0,0,deny,66,66,0,1,0,1,0
55411,52608,445,0,0,drop,70,70,0,1,0,1,0
55412,21420,44847,0,0,deny,66,66,0,1,0,1,0
55413,53591,35889,63951,35889,allow,320,140,180,6,6,3,3
55414,50307,53,50594,53,allow,1370,89,1281,4,33,2,2
55415,27416,53,27416,53,allow,214,82,132,2,32,1,1
55416,56620,53,31427,53,allow,216,110,106,2,30,1,1
55417,64979,53,10691,53,allow,194,102,92,2,30,1,1
55418,50280,53,42526,53,allow,794,102,692,2,30,1,1
55419,51196,443,64591,443,allow,346,140,206,6,130,3,3
55420,49524,443,52573,443,allow,52864,3584,49280,86,95,39,47
55421,56546,443,24280,443,allow,134,60,74,3,5,2,1
55422,55052,80,37545,80,allow,11677266,314362,11362904,12711,129,5174,7537
55423,64776,53,33019,53,allow,935,334,601,8,62,4,4
55424,49202,53,22068,53,allow,498,204,294,6,29,3,3
55425,65357,53,38110,53,allow,194,102,92,2,29,1,1
55426,49229,53,54866,53,allow,178,94,84,2,29,1,1
55427,49320,53,59903,53,allow,177,94,83,2,30,1,1
55428,55417,53,60973,53,allow,198,102,96,2,30,1,1
55429,57201,53,46716,53,allow,214,110,104,2,30,1,1
55430,56229,53,1556,53,allow,173,94,79,2,30,1,1
55431,34360,80,12302,80,allow,494,280,214,8,14,5,3
55432,51009,80,51009,80,allow,450,246,204,8,25,5,3
55433,60750,40010,25363,40010,allow,316,136,180,6,6,3,3
55434,38872,443,38872,443,allow,4480,1573,2907,19,29,11,8
55435,49919,80,50897,80,allow,2821387,64706,2756681,2277,183,418,1859
55436,63779,12226,36658,12226,allow,66,66,0,2,7,2,0
55437,48913,443,1076,443,allow,6922,1618,5304,23,35,12,11
55438,49449,80,49449,80,allow,416,198,218,7,29,4,3
55439,47402,443,25875,443,allow,6118,1180,4938,22,16,11,11
55440,59882,443,38875,443,allow,10017,3031,6986,30,45,17,13
55441,65357,53,40859,53,allow,194,102,92,2,29,1,1
55442,59343,53,0,0,allow,178,72,106,2,29,1,1
55443,50689,80,50689,80,allow,450,246,204,8,25,5,3
55444,50362,53,58174,53,allow,214,110,104,2,29,1,1
55445,38671,443,7350,443,allow,7897,3562,4335,19,16,10,9
55446,49883,53,5470,53,allow,177,94,83,2,29,1,1
55447,65396,53,55502,53,allow,186,102,84,2,29,1,1
55448,55080,53,11951,53,allow,173,94,79,2,29,1,1
55449,52120,443,51831,443,allow,305183,9715,295468,312,44,107,205
55450,40923,53,40923,53,allow,200,90,110,2,29,1,1
55451,4702,53,4702,53,allow,220,90,130,2,29,1,1
55452,53571,19636,6508,19636,allow,70,70,0,1,4,1,0
55453,55089,53,6638,53,allow,199,102,97,2,30,1,1
55454,55346,53,65324,53,allow,177,94,83,2,29,1,1
55455,65192,53,33207,53,allow,178,94,84,2,30,1,1
55456,26447,80,26447,80,allow,12599,1479,11120,28,16,15,13
55457,63630,53,44818,53,allow,278,94,184,2,30,1,1
55458,33243,443,3619,443,allow,35991,3996,31995,58,17,26,32
55459,50450,80,49757,80,allow,26924,4418,22506,34,25,13,21
55460,61364,443,41959,443,allow,8492,2950,5542,27,16,15,12
55461,50437,80,64833,80,allow,314,192,122,6,26,4,2
55462,64730,53,5756,53,allow,261,94,167,2,30,1,1
55463,64836,53,53586,53,allow,241,94,147,2,30,1,1
55464,50440,53,45707,53,allow,216,110,106,2,30,1,1
55465,49597,53,32706,53,allow,168,86,82,2,31,1,1
55466,65030,53,52927,53,allow,785,110,675,2,30,1,1
55467,51406,443,38367,443,allow,8186,2146,6040,29,33,16,13
55468,33242,443,38172,443,allow,14244,2907,11337,33,17,17,16
55469,50426,443,9963,443,allow,5713,1079,4634,15,26,8,7
55470,50421,80,60680,80,allow,7162,3201,3961,19,27,11,8
55471,50462,80,58102,80,allow,4603,2152,2451,14,22,8,6
55472,55836,53,17150,53,allow,181,94,87,2,33,1,1
55473,50438,80,13874,80,allow,314,192,122,6,26,4,2
55474,57095,53,33152,53,allow,177,94,83,2,30,1,1
55475,55735,53,28047,53,allow,184,94,90,2,30,1,1
55476,55101,53,47277,53,allow,197,102,95,2,30,1,1
55477,56719,53,59269,53,allow,185,102,83,2,30,1,1
55478,56719,53,51859,53,allow,185,102,83,2,30,1,1
55479,50440,53,39485,53,allow,216,110,106,2,30,1,1
55480,56567,53,21156,53,allow,194,102,92,2,30,1,1
55481,56373,53,9472,53,allow,200,102,98,2,30,1,1
55482,49422,53,52820,53,allow,719,208,511,6,32,3,3
55483,50449,443,5504,443,allow,7588,1850,5738,19,25,10,9
55484,49353,53,9997,53,allow,237,94,143,2,30,1,1
55485,48409,443,36994,443,allow,5993,1261,4732,18,982,8,10
55486,34355,80,5779,80,allow,416,210,206,7,15,4,3
55487,55746,53,40664,53,allow,216,110,106,2,30,1,1
55488,56386,53,3694,53,allow,177,94,83,2,30,1,1
55489,51487,443,18707,443,allow,10453,3977,6476,27,54,15,12
55490,49432,53,51069,53,allow,177,94,83,2,30,1,1
55491,64980,53,3433,53,allow,200,102,98,2,30,1,1
55492,55990,53,30769,53,allow,183,94,89,2,30,1,1
55493,49564,53,7876,53,allow,168,78,90,2,30,1,1
55494,56995,53,18611,53,allow,168,86,82,2,30,1,1
55495,64840,53,24107,53,allow,356,118,238,2,30,1,1
55496,44587,443,26672,443,allow,16341,3306,13035,42,17,24,18
55497,55077,53,19465,53,allow,277,90,187,4,32,2,2
55498,50439,80,32782,80,allow,318,192,126,6,26,4,2
55499,65291,53,53725,53,allow,889,404,485,10,30,5,5
55500,52704,53,49844,53,allow,168,78,90,2,30,1,1
55501,63067,443,13404,443,allow,2570995,60656,2510339,2538,34,844,1694
55502,34354,80,61619,80,allow,350,210,140,6,15,4,2
55503,51766,48169,32212,48169,allow,70,70,0,1,5,1,0
55504,60038,80,60038,80,allow,12881,767,12114,21,21,9,12
55505,50434,80,31890,80,allow,318,192,126,6,26,4,2
55506,52380,443,20377,443,allow,8659,3601,5058,34,80,18,16
55507,65496,53,6299,53,allow,210,86,124,2,30,1,1
55508,56620,53,63507,53,allow,216,110,106,2,30,1,1
55509,60760,53,0,0,allow,86,86,0,1,30,1,0
55510,56658,53,12429,53,allow,229,94,135,2,30,1,1
55511,49971,53,55758,53,allow,198,102,96,2,30,1,1
55512,57090,53,28237,53,allow,198,102,96,2,30,1,1
55513,34529,443,32303,443,allow,77395,64623,12772,206,188,116,90
55514,37277,80,37277,80,allow,52625,3140,49485,55,52,14,41
55515,49913,443,31997,443,allow,5570,901,4669,16,27,8,8
55516,34359,80,6984,80,allow,350,210,140,6,14,4,2
55517,51764,33432,6081,33432,allow,70,70,0,1,5,1,0
55518,53570,24874,57819,24874,allow,70,70,0,1,4,1,0
55519,53372,443,36591,443,allow,214,140,74,4,20,3,1
55520,63768,55755,10523,55755,allow,70,70,0,1,4,1,0
55521,55417,53,34497,53,allow,198,102,96,2,33,1,1
55522,60402,47094,53695,47094,allow,320,140,180,6,7,3,3
55523,53575,1025,61617,1025,allow,70,70,0,1,4,1,0
55524,50441,80,60802,80,allow,318,192,126,6,26,4,2
55525,50433,80,24726,80,allow,318,192,126,6,26,4,2
55526,65470,443,40363,443,allow,372361,11310,361051,385,16,136,249
55527,50122,443,55695,443,allow,6407,1101,5306,18,26,10,8
55528,49623,53,34250,53,allow,790,110,680,2,29,1,1
55529,50424,443,50613,443,allow,5713,1079,4634,15,26,8,7
55530,53070,53,0,0,allow,168,74,94,2,29,1,1
55531,55080,53,13972,53,allow,165,86,79,2,29,1,1
55532,57201,53,40982,53,allow,214,110,104,2,29,1,1
55533,33246,443,57032,443,allow,8340,2896,5444,28,16,16,12
55534,50362,53,33305,53,allow,214,110,104,2,29,1,1
55535,46159,443,12485,443,allow,124567,6787,117780,175,263,82,93
55536,59321,53,33396,53,allow,209,70,139,2,30,1,1
55537,49320,53,28326,53,allow,185,102,83,2,30,1,1
55538,65130,53,25428,53,allow,646,200,446,6,62,3,3
55539,63942,53,65464,53,allow,214,102,112,2,30,1,1
55540,49405,53,14474,53,allow,94,94,0,1,30,1,0
55541,50106,53,61175,53,allow,209,110,99,2,30,1,1
55542,60375,53,25105,53,allow,226,94,132,2,31,1,1
55543,56386,53,9835,53,allow,177,94,83,2,31,1,1
55544,49068,443,40796,443,allow,8664,2567,6097,20,120,10,10
55545,55439,53,52898,53,allow,209,110,99,2,30,1,1
55546,55776,53,52683,53,allow,216,110,106,2,30,1,1
55547,17481,53,17481,53,allow,198,90,108,2,30,1,1
55548,56567,53,28811,53,allow,194,102,92,2,31,1,1
55549,36157,53,43020,53,allow,164,78,86,2,31,1,1
55550,65366,53,59432,53,allow,199,102,97,2,31,1,1
55551,56186,53,13478,53,allow,198,102,96,2,31,1,1
55552,57094,53,10369,53,allow,196,102,94,2,30,1,1
55553,49591,53,7578,53,allow,168,86,82,2,32,1,1
55554,53117,37529,25510,37529,allow,70,70,0,2,8,2,0
55555,50463,80,9327,80,allow,1718,1247,471,9,15,5,4
55556,50496,443,27297,443,allow,90570,3437,87133,103,90,34,69
55557,50148,80,44851,80,allow,17314,6865,10449,50,79,24,26
55558,33245,443,3684,443,allow,7279,2884,4395,28,16,16,12
55559,63764,12343,45903,12343,allow,504,382,122,8,15,6,2
55560,55462,53,6708,53,allow,194,102,92,2,30,1,1
55561,65366,53,11375,53,allow,199,102,97,2,30,1,1
55562,55107,53,52328,53,allow,214,102,112,2,30,1,1
55563,56373,53,63287,53,allow,200,102,98,2,30,1,1
55564,50613,53,60735,53,allow,814,110,704,2,30,1,1
55565,56373,53,59936,53,allow,200,102,98,2,30,1,1
55566,41886,53,43611,53,allow,168,78,90,2,30,1,1
55567,50440,53,43767,53,allow,216,110,106,2,30,1,1
55568,49971,53,63730,53,allow,198,102,96,2,30,1,1
55569,30188,14432,60719,14432,allow,868,150,718,4,1200,2,2
55570,49433,53,38840,53,allow,167,86,81,2,30,1,1
55571,50922,443,21315,443,allow,6180,1241,4939,18,982,8,10
55572,52321,443,52321,443,allow,6727,762,5965,15,25,8,7
55573,58889,443,61172,443,allow,3956,2519,1437,18,80,10,8
55574,50440,80,41548,80,allow,318,192,126,6,26,4,2
55575,50429,80,32057,80,allow,318,192,126,6,26,4,2
55576,50430,80,29932,80,allow,318,192,126,6,26,4,2
55577,50150,80,7592,80,allow,73454,5461,67993,74,79,22,52
55578,50312,80,40765,80,allow,2699,1007,1692,14,64,7,7
55579,50425,443,34304,443,allow,5653,1079,4574,14,26,8,6
55580,50374,443,61017,443,allow,8485,1804,6681,30,316,14,16
55581,33238,443,21628,443,allow,21538,3952,17586,48,17,27,21
55582,55836,53,27528,53,allow,181,94,87,2,30,1,1
55583,55656,53,37585,53,allow,214,110,104,2,30,1,1
55584,55656,53,7470,53,allow,214,110,104,2,30,1,1
55585,54967,53,27983,53,allow,178,94,84,2,30,1,1
55586,55617,53,59978,53,allow,194,102,92,2,30,1,1
55587,37637,53,37222,53,allow,168,78,90,2,30,1,1
55588,52221,53,10859,53,allow,177,86,91,2,30,1,1
55589,40507,53,2072,53,allow,86,86,0,1,30,1,0
55590,50455,443,11561,443,allow,107749,6262,101487,142,138,58,84
55591,38523,53,38523,53,allow,214,82,132,2,32,1,1
55592,33664,80,55691,80,allow,70,70,0,1,5,1,0
55593,50436,80,19701,80,allow,314,192,122,6,26,4,2
55594,55990,53,6469,53,allow,183,94,89,2,30,1,1
55595,55735,53,52965,53,allow,184,94,90,2,30,1,1
55596,56771,53,2287,53,allow,270,95,175,4,60,2,2
55597,65153,53,29688,53,allow,168,86,82,2,30,1,1
55598,50106,53,26028,53,allow,209,110,99,2,30,1,1
55599,63978,53,60357,53,allow,214,110,104,2,30,1,1
55600,64980,53,54616,53,allow,200,102,98,2,30,1,1
55601,50584,53,20103,53,allow,179,94,85,2,30,1,1
55602,63978,53,35344,53,allow,214,110,104,2,30,1,1
55603,58263,443,17697,443,allow,12494,5331,7163,48,122,21,27
55604,33067,53,0,0,allow,86,86,0,1,30,1,0
55605,55336,53,26759,53,allow,199,102,97,2,31,1,1
55606,50103,53,41648,53,allow,168,86,82,2,31,1,1
55607,56809,53,41798,53,allow,178,94,84,2,31,1,1
55608,64413,443,46827,443,allow,5660875,75934,5584941,4719,141,686,4033
55609,55746,53,54887,53,allow,216,110,106,2,30,1,1
55610,64001,53,4323,53,allow,183,94,89,2,30,1,1
55611,65036,53,40667,53,allow,214,110,104,2,30,1,1
55612,50105,53,29739,53,allow,969,86,883,2,30,1,1
55613,57090,53,19646,53,allow,198,102,96,2,30,1,1
55614,55656,53,44214,53,allow,214,110,104,2,30,1,1
55615,64001,53,1260,53,allow,183,94,89,2,30,1,1
55616,65036,53,28927,53,allow,214,110,104,2,30,1,1
55617,65366,53,12473,53,allow,199,102,97,2,30,1,1
55618,56355,53,13355,53,allow,184,94,90,2,30,1,1
55619,55454,53,12071,53,allow,209,110,99,2,31,1,1
55620,40942,123,62465,123,allow,184,94,90,2,30,1,1
55621,56386,53,21142,53,allow,177,94,83,2,30,1,1
55622,49543,53,11834,53,allow,779,110,669,2,30,1,1
55623,56357,53,34112,53,allow,178,94,84,2,30,1,1
55624,64995,53,33043,53,allow,199,102,97,2,30,1,1
55625,57259,53,43312,53,allow,199,102,97,2,31,1,1
55626,50103,53,21620,53,allow,168,86,82,2,30,1,1
55627,54956,53,56541,53,allow,194,102,92,2,30,1,1
55628,64995,53,32093,53,allow,199,102,97,2,30,1,1
55629,55372,53,55372,53,allow,216,90,126,2,30,1,1
55630,56501,53,9977,53,allow,216,94,122,2,31,1,1
55631,57094,53,18443,53,allow,196,102,94,2,31,1,1
55632,55364,53,26181,53,allow,168,86,82,2,31,1,1
55633,65300,53,9182,53,allow,195,102,93,2,31,1,1
55634,56355,53,43280,53,allow,184,94,90,2,31,1,1
55635,52251,443,26101,443,allow,23328780,730794,22597986,24754,320,8113,16641
55636,35745,443,18614,443,allow,7634,4417,3217,35,197,19,16
55637,55101,53,52227,53,allow,197,102,95,2,31,1,1
55638,49608,53,63046,53,allow,198,110,88,2,31,1,1
55639,49432,53,5253,53,allow,177,94,83,2,31,1,1
55640,56072,53,35892,53,allow,199,102,97,2,31,1,1
55641,8861,443,39985,443,allow,42890,30849,12041,214,420,106,108
55642,39500,443,7473,443,allow,6517,2048,4469,21,90,12,9
55643,50523,443,53596,443,allow,6676,1074,5602,22,84,12,10
55644,38535,443,55811,443,allow,910,358,552,14,47,6,8
55645,43368,80,43368,80,allow,232198,9152,223046,290,21,134,156
55646,50512,443,55722,443,allow,6945,1842,5103,25,87,14,11
55647,54956,53,60675,53,allow,194,102,92,2,31,1,1
55648,63761,25933,42159,25933,allow,436,254,182,7,15,4,3
55649,53593,32022,37169,32022,allow,320,140,180,6,6,3,3
55650,65338,53,10255,53,allow,314,88,226,4,44,2,2
55651,51509,443,60240,443,allow,1307,688,619,14,37,8,6
55652,50586,443,6357,443,allow,2756,1594,1162,20,27,11,9
55653,58703,50584,0,0,deny,66,66,0,1,0,1,0
55654,53004,445,0,0,drop,66,66,0,1,0,1,0
55655,53000,445,0,0,drop,66,66,0,1,0,1,0
55656,21892,15503,0,0,deny,62,62,0,1,0,1,0
55657,21145,11392,0,0,deny,62,62,0,1,0,1,0
55658,39895,26467,0,0,deny,62,62,0,1,0,1,0
55659,52604,445,0,0,drop,70,70,0,1,0,1,0
55660,52602,445,0,0,drop,70,70,0,1,0,1,0
55661,17320,14914,0,0,deny,148,148,0,1,0,1,0
55662,52600,445,0,0,drop,70,70,0,1,0,1,0
55663,62071,22114,0,0,deny,62,62,0,1,0,1,0
55664,56712,46824,0,0,deny,66,66,0,1,0,1,0
55665,60018,64147,0,0,deny,62,62,0,1,0,1,0
55666,57583,445,0,0,drop,70,70,0,1,0,1,0
55667,57581,445,0,0,drop,70,70,0,1,0,1,0
55668,52980,445,0,0,drop,66,66,0,1,0,1,0
55669,52986,445,0,0,drop,66,66,0,1,0,1,0
55670,52983,445,0,0,drop,66,66,0,1,0,1,0
55671,52981,445,0,0,drop,66,66,0,1,0,1,0
55672,52987,445,0,0,drop,66,66,0,1,0,1,0
55673,52988,445,0,0,drop,66,66,0,1,0,1,0
55674,52985,445,0,0,drop,66,66,0,1,0,1,0
55675,52984,445,0,0,drop,66,66,0,1,0,1,0
55676,53469,44847,0,0,deny,66,66,0,1,0,1,0
55677,10533,23,0,0,deny,60,60,0,1,0,1,0
55678,47962,16069,0,0,deny,62,62,0,1,0,1,0
55679,52593,445,0,0,drop,70,70,0,1,0,1,0
55680,52591,445,0,0,drop,70,70,0,1,0,1,0
55681,7905,48817,0,0,deny,146,146,0,1,0,1,0
55682,36906,50584,0,0,deny,62,62,0,1,0,1,0
55683,57579,445,0,0,drop,70,70,0,1,0,1,0
55684,57569,445,0,0,drop,70,70,0,1,0,1,0
55685,57566,445,0,0,drop,70,70,0,1,0,1,0
55686,52590,445,0,0,drop,70,70,0,1,0,1,0
55687,52589,445,0,0,drop,70,70,0,1,0,1,0
55688,52588,445,0,0,drop,70,70,0,1,0,1,0
55689,52968,445,0,0,drop,66,66,0,1,0,1,0
55690,52966,445,0,0,drop,66,66,0,1,0,1,0
55691,52965,445,0,0,drop,66,66,0,1,0,1,0
55692,52586,445,0,0,drop,70,70,0,1,0,1,0
55693,52583,445,0,0,drop,70,70,0,1,0,1,0
55694,62549,64147,0,0,deny,62,62,0,1,0,1,0
55695,58598,50584,0,0,deny,62,62,0,1,0,1,0
55696,443,28417,0,0,deny,82,82,0,1,0,1,0
55697,57562,445,0,0,drop,70,70,0,1,0,1,0
55698,50535,51505,0,0,deny,66,66,0,1,0,1,0
55699,62776,62413,0,0,deny,62,62,0,1,0,1,0
55700,32491,15503,0,0,deny,66,66,0,1,0,1,0
55701,49699,64147,0,0,deny,62,62,0,1,0,1,0
55702,17008,35440,0,0,deny,62,62,0,1,0,1,0
55703,54111,62609,0,0,deny,148,148,0,1,0,1,0
55704,64482,64147,0,0,deny,62,62,0,1,0,1,0
55705,57560,445,0,0,drop,70,70,0,1,0,1,0
55706,24411,12809,0,0,deny,60,60,0,1,0,1,0
55707,52570,445,0,0,drop,70,70,0,1,0,1,0
55708,52569,445,0,0,drop,70,70,0,1,0,1,0
55709,52565,445,0,0,drop,70,70,0,1,0,1,0
55710,57552,445,0,0,drop,70,70,0,1,0,1,0
55711,57550,445,0,0,drop,70,70,0,1,0,1,0
55712,57548,445,0,0,drop,70,70,0,1,0,1,0
55713,52559,445,0,0,drop,70,70,0,1,0,1,0
55714,52560,445,0,0,drop,70,70,0,1,0,1,0
55715,49664,37965,0,0,deny,66,66,0,1,0,1,0
55716,60196,53,0,0,deny,88,88,0,1,0,1,0
55717,55296,23718,0,0,deny,66,66,0,1,0,1,0
55718,12608,21247,0,0,deny,66,66,0,1,0,1,0
55719,57772,50584,0,0,deny,66,66,0,1,0,1,0
55720,29424,37807,0,0,deny,66,66,0,1,0,1,0
55721,60196,53,0,0,deny,88,88,0,1,0,1,0
55722,15274,81,0,0,deny,60,60,0,1,0,1,0
55723,58445,17500,0,0,deny,66,66,0,1,0,1,0
55724,31469,23,0,0,deny,60,60,0,1,0,1,0
55725,40971,1433,0,0,deny,60,60,0,1,0,1,0
55726,28668,8696,0,0,deny,60,60,0,1,0,1,0
55727,21833,22114,0,0,deny,62,62,0,1,0,1,0
55728,52548,445,0,0,drop,70,70,0,1,0,1,0
55729,37902,23718,0,0,deny,146,146,0,1,0,1,0
55730,57543,445,0,0,drop,70,70,0,1,0,1,0
55731,57540,445,0,0,drop,70,70,0,1,0,1,0
55732,57537,445,0,0,drop,70,70,0,1,0,1,0
55733,1176,64147,0,0,deny,62,62,0,1,0,1,0
55734,59592,37965,0,0,deny,62,62,0,1,0,1,0
55735,9412,7302,0,0,deny,66,66,0,1,0,1,0
55736,47910,7454,0,0,deny,60,60,0,1,0,1,0
55737,47910,7454,0,0,deny,60,60,0,1,0,1,0
55738,443,28417,0,0,deny,82,82,0,1,0,1,0
55739,63465,56205,0,0,deny,66,66,0,1,0,1,0
55740,42685,51180,0,0,deny,62,62,0,1,0,1,0
55741,18415,37965,0,0,deny,62,62,0,1,0,1,0
55742,52544,445,0,0,drop,70,70,0,1,0,1,0
55743,58995,443,49054,443,allow,8826,2860,5966,21,9,10,11
55744,26921,37965,0,0,deny,62,62,0,1,0,1,0
55745,37597,50584,0,0,deny,66,66,0,1,0,1,0
55746,51617,21247,0,0,deny,66,66,0,1,0,1,0
55747,59918,44847,0,0,deny,66,66,0,1,0,1,0
55748,36656,64147,0,0,deny,62,62,0,1,0,1,0
55749,52944,445,0,0,drop,66,66,0,1,0,1,0
55750,54343,50584,0,0,deny,66,66,0,1,0,1,0
55751,57533,445,0,0,drop,70,70,0,1,0,1,0
55752,57534,445,0,0,drop,70,70,0,1,0,1,0
55753,80,54605,0,0,deny,66,66,0,1,0,1,0
55754,54471,36237,0,0,deny,66,66,0,1,0,1,0
55755,52533,445,0,0,drop,70,70,0,1,0,1,0
55756,52535,445,0,0,drop,70,70,0,1,0,1,0
55757,52532,445,0,0,drop,70,70,0,1,0,1,0
55758,52531,445,0,0,drop,70,70,0,1,0,1,0
55759,52527,445,0,0,drop,70,70,0,1,0,1,0
55760,1323,64147,0,0,deny,66,66,0,1,0,1,0
55761,443,28417,0,0,deny,82,82,0,1,0,1,0
55762,0,0,0,0,deny,70,70,0,1,0,1,0
55763,0,0,0,0,allow,480,244,236,4,0,2,2
55764,0,0,0,0,deny,182,182,0,1,0,1,0
55765,48087,16069,0,0,deny,62,62,0,1,0,1,0
55766,52940,445,0,0,drop,66,66,0,1,0,1,0
55767,45941,23388,0,0,deny,60,60,0,1,0,1,0
55768,52936,445,0,0,drop,66,66,0,1,0,1,0
55769,16059,22114,0,0,deny,62,62,0,1,0,1,0
55770,57523,445,0,0,drop,70,70,0,1,0,1,0
55771,57515,445,0,0,drop,70,70,0,1,0,1,0
55772,57514,445,0,0,drop,70,70,0,1,0,1,0
55773,57511,445,0,0,drop,70,70,0,1,0,1,0
55774,52522,445,0,0,drop,70,70,0,1,0,1,0
55775,52933,445,0,0,drop,66,66,0,1,0,1,0
55776,61315,48817,0,0,deny,62,62,0,1,0,1,0
55777,57508,445,0,0,drop,70,70,0,1,0,1,0
55778,52514,445,0,0,drop,70,70,0,1,0,1,0
55779,57283,64147,0,0,deny,66,66,0,1,0,1,0
55780,52511,445,0,0,drop,70,70,0,1,0,1,0
55781,57505,445,0,0,drop,70,70,0,1,0,1,0
55782,57504,445,0,0,drop,70,70,0,1,0,1,0
55783,57501,445,0,0,drop,70,70,0,1,0,1,0
55784,20378,23,0,0,deny,60,60,0,1,0,1,0
55785,52926,445,0,0,drop,66,66,0,1,0,1,0
55786,39359,15503,0,0,deny,74,74,0,1,0,1,0
55787,52920,445,0,0,drop,66,66,0,1,0,1,0
55788,52923,445,0,0,drop,66,66,0,1,0,1,0
55789,52919,445,0,0,drop,66,66,0,1,0,1,0
55790,64890,51180,0,0,deny,62,62,0,1,0,1,0
55791,52916,445,0,0,drop,66,66,0,1,0,1,0
55792,52917,445,0,0,drop,66,66,0,1,0,1,0
55793,52915,445,0,0,drop,66,66,0,1,0,1,0
55794,52508,445,0,0,drop,70,70,0,1,0,1,0
55795,31521,57470,0,0,deny,145,145,0,1,0,1,0
55796,52506,445,0,0,drop,70,70,0,1,0,1,0
55797,45908,33330,0,0,deny,60,60,0,1,0,1,0
55798,443,28417,0,0,deny,82,82,0,1,0,1,0
55799,52743,15503,0,0,deny,66,66,0,1,0,1,0
55800,30046,15503,0,0,deny,62,62,0,1,0,1,0
55801,61420,64097,0,0,deny,66,66,0,1,0,1,0
55802,11252,23,0,0,deny,60,60,0,1,0,1,0
55803,57498,445,0,0,drop,70,70,0,1,0,1,0
55804,57499,445,0,0,drop,70,70,0,1,0,1,0
55805,57496,445,0,0,drop,70,70,0,1,0,1,0
55806,52910,445,0,0,drop,66,66,0,1,0,1,0
55807,52502,445,0,0,drop,70,70,0,1,0,1,0
55808,64516,53,13798,53,allow,216,110,106,2,30,1,1
55809,37133,80,37133,80,allow,12799,979,11820,20,17,9,11
55810,57896,443,11349,443,allow,7332,3746,3586,37,176,19,18
55811,51269,36983,55294,36983,allow,70,70,0,2,8,2,0
55812,59819,443,17243,443,allow,1401,864,537,12,29,6,6
55813,63204,443,63204,443,allow,9340,4256,5084,24,16,13,11
55814,40791,443,54664,443,allow,7236,2069,5167,25,25,12,13
55815,57893,443,16617,443,allow,1867,1228,639,18,176,11,7
55816,55943,53,5113,53,allow,1415,94,1321,4,31,2,2
55817,53584,62974,25990,62974,allow,70,70,0,2,8,2,0
55818,49217,53,12085,53,allow,202,103,99,2,31,1,1
55819,49374,53,54400,53,allow,186,95,91,2,31,1,1
55820,55101,53,27553,53,allow,194,99,95,2,30,1,1
55821,35048,80,62136,80,allow,15867,2466,13401,29,33,16,13
55822,53587,32029,60710,32029,allow,70,70,0,2,8,2,0
55823,51780,21130,9712,21130,allow,70,70,0,2,8,2,0
55824,53567,43167,28309,43167,allow,492,306,186,8,16,5,3
55825,65300,53,37068,53,allow,190,97,93,2,31,1,1
55826,59823,443,61551,443,allow,306,180,126,6,29,4,2
55827,51782,10637,37366,10637,allow,70,70,0,2,8,2,0
55828,34166,443,49916,443,allow,8290,2156,6134,24,81,14,10
55829,56611,443,45204,443,allow,7983,1963,6020,20,15,11,9
55830,57884,443,2033,443,allow,3981,1811,2170,26,177,14,12
55831,56809,53,64424,53,allow,172,88,84,2,31,1,1
55832,55364,53,1221,53,allow,168,86,82,2,31,1,1
55833,53564,63344,20702,63344,allow,1721,971,750,15,16,8,7
55834,56610,443,4585,443,allow,8035,2015,6020,20,16,11,9
55835,35567,443,35567,443,allow,5413,2166,3247,22,39,13,9
55836,64680,53,32256,53,allow,768,99,669,2,30,1,1
55837,44913,443,18458,443,allow,414,140,274,7,27,3,4
55838,56612,443,41735,443,allow,8033,2013,6020,20,15,11,9
55839,58992,443,6436,443,allow,3049,1857,1192,20,21,9,11
55840,46684,80,18811,80,allow,4294,1112,3182,15,199,4,11
55841,46982,443,35062,443,allow,3847,2650,1197,22,35,13,9
55842,59817,443,40958,443,allow,1401,864,537,12,29,6,6
55843,59836,443,19606,443,allow,1587,924,663,15,27,7,8
55844,51781,43909,29947,43909,allow,70,70,0,2,8,2,0
55845,53580,48066,41215,48066,allow,70,70,0,2,8,2,0
55846,55655,53,48004,53,allow,304,110,194,4,35,2,2
55847,49888,53,54251,53,allow,196,100,96,2,30,1,1
55848,43597,443,44647,443,allow,47048,9293,37755,63,412,28,35
55849,53246,443,15204,443,allow,134,60,74,3,11,2,1
55850,57901,443,18752,443,allow,3924,1906,2018,26,170,14,12
55851,57892,443,36599,443,allow,6394,3923,2471,42,176,22,20
55852,57905,443,45669,443,allow,1851,1152,699,18,169,10,8
55853,57900,443,44556,443,allow,1798,1159,639,17,170,10,7
55854,50376,53,65518,53,allow,164,84,80,2,31,1,1
55855,64417,53,46438,53,allow,184,94,90,2,31,1,1
55856,55675,53,52778,53,allow,764,99,665,2,31,1,1
55857,54956,53,34992,53,allow,188,96,92,2,31,1,1
55858,44482,443,27809,443,allow,16517,3254,13263,37,271,18,19
55859,34165,443,5648,443,allow,8208,2080,6128,24,81,14,10
55860,45273,53,45273,53,allow,213,79,134,2,32,1,1
55861,39207,80,25613,80,allow,78,78,0,1,5,1,0
55862,57885,443,33287,443,allow,1792,1153,639,17,177,10,7
55863,57904,443,36166,443,allow,4042,2515,1527,28,169,14,14
55864,59818,443,31542,443,allow,1401,864,537,12,29,6,6
55865,57877,443,6198,443,allow,9256443,112898,9143545,7609,178,1428,6181
55866,53579,59332,37605,59332,allow,70,70,0,2,8,2,0
55867,65411,53,35148,53,allow,771,101,670,2,30,1,1
55868,49841,53,53641,53,allow,751,95,656,2,30,1,1
55869,57897,443,36818,443,allow,1865,1226,639,18,176,11,7
55870,64815,53,23371,53,allow,755,94,661,2,30,1,1
55871,56601,53,60579,53,allow,168,78,90,2,30,1,1
55872,64001,53,5288,53,allow,182,93,89,2,30,1,1
55873,56391,53,63935,53,allow,758,93,665,2,31,1,1
55874,55171,53,26173,53,allow,762,97,665,2,31,1,1
55875,65334,443,56103,443,allow,3182,1568,1614,8,120,4,4
55876,43585,443,18767,443,allow,6636,3565,3071,22,187,13,9
55877,64595,53,64819,53,allow,166,85,81,2,31,1,1
55878,55147,53,27402,53,allow,184,94,90,2,31,1,1
55879,64903,53,49771,53,allow,777,87,690,2,31,1,1
55880,52169,443,53007,443,allow,7905,4819,3086,27,139,13,14
55881,56919,53,19863,53,allow,186,95,91,2,31,1,1
55882,5938,51883,0,0,allow,60,60,0,1,91,1,0
55883,5938,16167,0,0,allow,60,60,0,1,91,1,0
55884,55802,443,44281,443,allow,30007,2755,27252,41,136,16,25
55885,56557,53,31623,53,allow,212,108,104,2,31,1,1
55886,56312,53,44683,53,allow,756,95,661,2,31,1,1
55887,55077,53,1629,53,allow,174,89,85,2,31,1,1
55888,64287,53,20763,53,allow,178,91,87,2,31,1,1
55889,55217,53,15991,53,allow,744,89,655,2,31,1,1
55890,57252,53,46137,53,allow,182,93,89,2,31,1,1
55891,56926,53,49989,53,allow,747,93,654,2,31,1,1
55892,21594,22448,0,0,allow,62,62,0,1,61,1,0
55893,5938,39160,0,0,allow,60,60,0,1,91,1,0
55894,54993,53,53914,53,allow,751,95,656,2,31,1,1
55895,5938,35844,0,0,allow,60,60,0,1,91,1,0
55896,64924,53,58224,53,allow,747,93,654,2,31,1,1
55897,56227,53,18236,53,allow,174,89,85,2,31,1,1
55898,64715,53,60812,53,allow,202,103,99,2,31,1,1
55899,65246,53,4675,53,allow,182,93,89,2,31,1,1
55900,65246,53,34223,53,allow,182,93,89,2,31,1,1
55901,49901,53,35015,53,allow,186,95,91,2,31,1,1
55902,55604,53,44456,53,allow,758,93,665,2,31,1,1
55903,43472,5228,13384,5228,allow,2531,1416,1115,17,3600,8,9
55904,57492,445,0,0,drop,70,70,0,1,0,1,0
55905,52909,445,0,0,drop,66,66,0,1,0,1,0
55906,49805,6881,0,0,deny,66,66,0,1,0,1,0
55907,34176,51505,0,0,deny,62,62,0,1,0,1,0
55908,46478,64147,0,0,deny,145,145,0,1,0,1,0
55909,51837,37965,0,0,deny,66,66,0,1,0,1,0
55910,58022,8800,0,0,deny,60,60,0,1,0,1,0
55911,52905,445,0,0,drop,66,66,0,1,0,1,0
55912,52907,445,0,0,drop,66,66,0,1,0,1,0
55913,44594,64147,0,0,deny,66,66,0,1,0,1,0
55914,11648,37965,0,0,deny,145,145,0,1,0,1,0
55915,52501,445,0,0,drop,70,70,0,1,0,1,0
55916,58338,3369,0,0,deny,60,60,0,1,0,1,0
55917,54575,11392,0,0,deny,66,66,0,1,0,1,0
55918,52903,445,0,0,drop,66,66,0,1,0,1,0
55919,42252,33303,0,0,deny,60,60,0,1,0,1,0
55920,28973,30188,0,0,deny,66,66,0,1,0,1,0
55921,57484,445,0,0,drop,70,70,0,1,0,1,0
55922,56609,53,42819,53,allow,199,102,97,2,31,1,1
55923,49573,53,10183,53,allow,770,102,668,2,30,1,1
55924,51763,34121,50527,34121,allow,70,70,0,1,5,1,0
55925,25629,28678,25311,28678,allow,1806,1806,0,22,225,22,0
55926,61345,21247,0,0,deny,66,66,0,1,0,1,0
55927,52496,445,0,0,drop,70,70,0,1,0,1,0
55928,29109,11392,0,0,deny,146,146,0,1,0,1,0
55929,57482,445,0,0,drop,70,70,0,1,0,1,0
55930,57477,445,0,0,drop,70,70,0,1,0,1,0
55931,28498,36237,0,0,deny,62,62,0,1,0,1,0
55932,443,56117,0,0,deny,97,97,0,1,0,1,0
55933,7222,57470,0,0,deny,62,62,0,1,0,1,0
55934,50788,48817,0,0,deny,62,62,0,1,0,1,0
55935,52895,445,0,0,drop,66,66,0,1,0,1,0
55936,11816,50584,0,0,deny,66,66,0,1,0,1,0
55937,52885,445,0,0,drop,66,66,0,1,0,1,0
55938,53553,443,31063,443,allow,3708,1988,1720,20,255,10,10
55939,57898,443,41076,443,allow,240332,6623,233709,258,170,92,166
55940,41699,443,36765,443,allow,40273,3243,37030,60,77,28,32
55941,41689,443,36583,443,allow,1307513,51701,1255812,1486,148,576,910
55942,56344,53,55607,53,allow,167,86,81,2,30,1,1
55943,56430,53,61403,53,allow,193,102,91,2,30,1,1
55944,62880,53,59831,53,allow,248,78,170,2,30,1,1
55945,55336,53,49932,53,allow,199,102,97,2,30,1,1
55946,55273,53,29396,53,allow,167,86,81,2,30,1,1
55947,56082,53,4620,53,allow,182,94,88,2,30,1,1
55948,64945,53,44242,53,allow,243,94,149,2,30,1,1
55949,51342,53,21697,53,allow,199,94,105,2,30,1,1
55950,56609,53,65200,53,allow,199,102,97,2,30,1,1
55951,51512,443,52808,443,allow,626132,21332,604800,730,33,294,436
55952,48304,443,22064,443,allow,6606,2153,4453,22,95,13,9
55953,37695,443,3343,443,allow,1134364,30994,1103370,1170,175,403,767
55954,55113,53,62881,53,allow,198,102,96,2,33,1,1
55955,12945,53,12945,53,allow,233,90,143,2,32,1,1
55956,49176,53,50257,53,allow,528,178,350,6,43,3,3
55957,57890,443,58945,443,allow,3588,1991,1597,27,176,14,13
55958,49433,53,5828,53,allow,167,86,81,2,29,1,1
55959,55776,53,11863,53,allow,216,110,106,2,29,1,1
55960,65138,53,38637,53,allow,765,102,663,2,30,1,1
55961,55988,443,19724,443,allow,14754,7879,6875,37,231,20,17
55962,61363,80,43167,80,allow,1931,752,1179,15,16,8,7
55963,52212,80,6091,80,allow,366,246,120,6,34,4,2
55964,51506,443,52823,443,allow,584947,21842,563105,678,36,286,392
55965,60045,443,35524,443,allow,17161,1619,15542,18,151,4,14
55966,53578,34129,11045,34129,allow,70,70,0,2,7,2,0
55967,56615,80,9225,80,allow,234,234,0,4,11,4,0
55968,51759,55308,19017,55308,allow,70,70,0,1,5,1,0
55969,50531,80,18243,80,allow,1704,799,905,11,83,6,5
55970,50519,443,37665,443,allow,7967,1647,6320,25,85,14,11
55971,64551,53,37333,53,allow,495,127,368,4,33,2,2
55972,50513,443,44199,443,allow,9766,1810,7956,30,86,16,14
55973,51758,31009,29940,31009,allow,70,70,0,1,5,1,0
55974,50604,443,64927,443,allow,1385,783,602,14,23,8,6
55975,51761,19136,25240,19136,allow,70,70,0,1,5,1,0
55976,50602,443,61178,443,allow,3901,1858,2043,19,23,11,8
55977,55615,53,40819,53,allow,225,110,115,2,30,1,1
55978,57257,53,4922,53,allow,173,94,79,2,30,1,1
55979,65285,53,31109,53,allow,294,102,192,2,30,1,1
55980,53017,443,37363,443,allow,15038,4142,10896,48,108,24,24
55981,49456,443,44613,443,allow,939,547,392,11,27,5,6
55982,50022,443,50896,443,allow,70,70,0,2,5,2,0
55983,53028,80,62533,80,allow,70,70,0,1,5,1,0
55984,51760,36558,34247,36558,allow,70,70,0,1,5,1,0
55985,36464,443,36464,443,allow,4373,1466,2907,19,29,11,8
55986,57903,443,52416,443,allow,5465,2653,2812,28,169,14,14
55987,51925,443,7342,443,allow,16797,8530,8267,53,82,30,23
55988,57883,443,47068,443,allow,1786,1147,639,17,177,10,7
55989,50459,53,40007,53,allow,811,94,717,2,30,1,1
55990,49993,53,48809,53,allow,212,102,110,2,30,1,1
55991,55293,53,0,0,allow,166,73,93,2,30,1,1
55992,56186,53,36968,53,allow,198,102,96,2,30,1,1
55993,56809,53,35484,53,allow,178,94,84,2,30,1,1
55994,65246,53,13640,53,allow,767,102,665,2,30,1,1
55995,50542,443,1665,443,allow,5779,1472,4307,22,78,12,10
55996,59828,443,44871,443,allow,306,180,126,6,29,4,2
55997,49851,53,2859,53,allow,306,88,218,4,32,2,2
55998,55480,53,36431,53,allow,378,97,281,4,33,2,2
55999,57872,443,43316,443,allow,183325,10358,172967,289,227,95,194
56000,60397,43129,42698,43129,allow,70,70,0,1,5,1,0
56001,53092,443,13048,443,allow,97276,2756,94520,96,96,21,75
56002,57889,443,40826,443,allow,1851,1212,639,18,177,11,7
56003,56344,53,18094,53,allow,167,86,81,2,30,1,1
56004,56673,443,49966,443,allow,5726,1474,4252,22,81,13,9
56005,50831,443,11343,443,allow,721741,131746,589995,1518,322,787,731
56006,62034,53,62034,53,allow,216,90,126,2,30,1,1
56007,57259,53,43508,53,allow,199,102,97,2,30,1,1
56008,59832,443,5609,443,allow,302,120,182,6,28,3,3
56009,55336,53,7329,53,allow,199,102,97,2,30,1,1
56010,65484,53,31170,53,allow,195,102,93,2,30,1,1
56011,55655,53,10525,53,allow,304,110,194,4,34,2,2
56012,57186,53,41154,53,allow,177,94,83,2,30,1,1
56013,56962,53,9664,53,allow,177,94,83,2,30,1,1
56014,55600,80,5814,80,allow,70,70,0,1,5,1,0
56015,65484,53,32858,53,allow,195,102,93,2,30,1,1
56016,57891,443,65008,443,allow,1856,1217,639,18,176,11,7
56017,55240,53,36394,53,allow,816,102,714,2,30,1,1
56018,64936,53,3056,53,allow,193,102,91,2,30,1,1
56019,41700,443,15367,443,allow,167721,6935,160786,185,77,68,117
56020,49217,53,36290,53,allow,209,110,99,2,30,1,1
56021,53053,443,10274,443,allow,9303,2569,6734,39,106,20,19
56022,53036,443,40328,443,allow,249145,4184,244961,218,107,40,178
56023,51466,4545,51466,4545,allow,156,156,0,3,8,3,0
56024,57888,443,55452,443,allow,113115,8327,104788,184,177,77,107
56025,55454,53,25468,53,allow,209,110,99,2,30,1,1
56026,55273,53,29948,53,allow,167,86,81,2,30,1,1
56027,57186,53,42967,53,allow,177,94,83,2,30,1,1
56028,64516,53,8350,53,allow,216,110,106,2,30,1,1
56029,64652,53,53769,53,allow,198,94,104,2,30,1,1
56030,55077,53,42307,53,allow,179,94,85,2,30,1,1
56031,57369,16881,7618,16881,allow,564,318,246,9,15,5,4
56032,56569,53,5839,53,allow,181,94,87,2,32,1,1
56033,57894,443,52904,443,allow,4544,1112,3432,21,176,12,9
56034,49492,80,50602,80,allow,1680,1210,470,9,15,5,4
56035,49449,443,30580,443,allow,1574,921,653,14,15,7,7
56036,12136,53,12136,53,allow,198,90,108,2,30,1,1
56037,41674,443,45032,443,allow,14424911,433341,13991570,15454,320,5482,9972
56038,53240,443,16717,443,allow,1296713,27754,1268959,1253,118,366,887
56039,55375,53,8307,53,allow,214,110,104,2,30,1,1
56040,55375,53,30516,53,allow,214,110,104,2,30,1,1
56041,36405,53,36515,53,allow,199,94,105,2,30,1,1
56042,49888,53,39344,53,allow,198,102,96,2,30,1,1
56043,55240,53,47282,53,allow,193,102,91,2,30,1,1
56044,50039,53,19771,53,allow,261,110,151,2,30,1,1
56045,64595,53,62622,53,allow,167,86,81,2,30,1,1
56046,60280,443,7130,443,allow,46713,2661,44052,55,120,21,34
56047,45871,443,58048,443,allow,275011,235921,39090,651,350,363,288
56048,56557,53,41528,53,allow,214,110,104,2,30,1,1
56049,37815,443,28606,443,allow,6226,4834,1392,17,125,11,6
56050,64002,53,17468,53,allow,796,105,691,4,59,2,2
56051,55273,53,49246,53,allow,317,85,232,4,60,2,2
56052,49374,53,36144,53,allow,193,102,91,2,30,1,1
56053,51507,443,1531,443,allow,584465,23057,561408,694,36,303,391
56054,40453,443,6651,443,allow,5655,1614,4041,22,30,11,11
56055,35965,443,31855,443,allow,3821,2814,1007,22,17,12,10
56056,52188,443,37924,443,allow,1768,1034,734,16,65,8,8
56057,50511,443,12647,443,allow,6352,1073,5279,22,85,12,10
56058,51516,443,35060,443,allow,1195,634,561,12,21,7,5
56059,51511,443,55401,443,allow,213140,10321,202819,260,33,108,152
56060,50518,443,9409,443,allow,7117,1288,5829,22,84,12,10
56061,53589,40281,13610,40281,allow,70,70,0,2,7,2,0
56062,65469,443,41637,443,allow,92958,4869,88089,109,15,44,65
56063,50514,443,24194,443,allow,11554,3028,8526,34,86,19,15
56064,51498,443,13741,443,allow,134,60,74,3,4,2,1
56065,49345,443,4175,443,allow,61954,10029,51925,114,82,50,64
56066,55655,53,55322,53,allow,304,110,194,4,34,2,2
56067,58027,80,53632,80,allow,1225,711,514,11,15,5,6
56068,55113,53,41095,53,allow,198,102,96,2,29,1,1
56069,55981,53,55529,53,allow,168,78,90,2,30,1,1
56070,51778,60565,25061,60565,allow,70,70,0,2,8,2,0
56071,64980,53,10354,53,allow,200,102,98,2,29,1,1
56072,56935,53,38764,53,allow,179,94,85,2,30,1,1
56073,55375,53,47639,53,allow,214,110,104,2,30,1,1
56074,53016,443,45563,443,allow,50403,2032,48371,66,108,21,45
56075,53583,15354,6378,15354,allow,70,70,0,2,7,2,0
56076,57464,80,36285,80,allow,234,234,0,4,11,4,0
56077,55776,53,40395,53,allow,216,110,106,2,29,1,1
56078,50023,443,17571,443,allow,70,70,0,2,5,2,0
56079,56186,53,3994,53,allow,198,102,96,2,29,1,1
56080,51762,12747,31596,12747,allow,70,70,0,1,5,1,0
56081,64001,53,52493,53,allow,183,94,89,2,29,1,1
56082,64936,53,55896,53,allow,816,102,714,2,30,1,1
56083,65036,53,38858,53,allow,214,110,104,2,29,1,1
56084,49608,53,63386,53,allow,198,110,88,2,29,1,1
56085,64309,53,10386,53,allow,308,94,214,2,30,1,1
56086,55439,53,53595,53,allow,209,110,99,2,29,1,1
56087,57895,443,60971,443,allow,10639,4680,5959,53,176,24,29
56088,64516,53,41634,53,allow,216,110,106,2,30,1,1
56089,63978,53,35845,53,allow,214,110,104,2,30,1,1
56090,56919,53,23336,53,allow,193,102,91,2,30,1,1
56091,45637,443,46378,443,allow,6701,3487,3214,35,196,19,16
56092,55826,53,22161,53,allow,168,86,82,2,30,1,1
56093,55735,53,20718,53,allow,184,94,90,2,30,1,1
56094,64714,53,62163,53,allow,289,134,155,2,30,1,1
56095,58754,53,0,0,allow,258,80,178,2,30,1,1
56096,50458,53,16491,53,allow,458,188,270,6,30,3,3
56097,51543,53,3333,53,allow,78,78,0,1,30,1,0
56098,64839,53,30697,53,allow,443,182,261,6,30,3,3
56099,49259,53,28989,53,allow,168,86,82,2,30,1,1
56100,56246,53,33774,53,allow,209,110,99,2,30,1,1
56101,50121,53,5203,53,allow,152,78,74,2,30,1,1
56102,64287,53,8601,53,allow,181,94,87,2,31,1,1
56103,65420,53,28650,53,allow,166,86,80,2,31,1,1
56104,41690,443,19019,443,allow,1478937,62961,1415976,1678,148,649,1029
56105,54085,443,49010,443,allow,4128,1929,2199,38,48,21,17
56106,64780,443,53095,443,allow,70785,3306,67479,99,80,34,65
56107,51779,49525,24742,49525,allow,70,70,0,2,8,2,0
56108,56779,43137,15198,43137,allow,70,70,0,1,5,1,0
56109,64085,53,10076,53,allow,351,102,249,4,43,2,2
56110,57899,443,40248,443,allow,6115,1035,5080,21,170,11,10
56111,49448,443,34233,443,allow,1574,921,653,14,15,7,7
56112,56430,53,37979,53,allow,193,102,91,2,30,1,1
56113,65429,53,14191,53,allow,200,94,106,2,30,1,1
56114,65265,53,37973,53,allow,821,102,719,2,30,1,1
56115,56072,53,56771,53,allow,199,102,97,2,30,1,1
56116,49693,443,16419,443,allow,12060,4857,7203,25,71,14,11
56117,65192,53,25403,53,allow,249,102,147,2,30,1,1
56118,55364,53,12032,53,allow,168,86,82,2,30,1,1
56119,56962,53,9303,53,allow,177,94,83,2,30,1,1
56120,56252,443,19925,443,allow,6728,1775,4953,25,275,13,12
56121,55918,53,38281,53,allow,184,94,90,2,31,1,1
56122,36826,443,2632,443,allow,6040,1612,4428,21,255,12,9
56123,50636,443,49176,443,allow,7332,1611,5721,17,15,9,8
56124,57902,443,7313,443,allow,1912,1213,699,19,169,11,8
56125,57881,443,48213,443,allow,3486,2064,1422,26,177,14,12
56126,39921,80,15019,80,allow,1151,711,440,10,15,5,5
56127,50420,80,36435,80,allow,5048,4344,704,11,26,6,5
56128,50076,80,31297,80,allow,1052,612,440,10,15,5,5
56129,56072,53,61103,53,allow,199,102,97,2,30,1,1
56130,46827,443,46276,443,allow,8277,1368,6909,31,120,14,17
56131,57882,443,30006,443,allow,22342,1787,20555,38,177,16,22
56132,57880,443,33669,443,allow,1868,1229,639,18,177,11,7
56133,61362,443,33042,443,allow,8167,2671,5496,22,69,11,11
56134,43735,53,12080,53,allow,168,78,90,2,30,1,1
56135,58754,53,0,0,allow,627,80,547,2,30,1,1
56136,56082,53,27828,53,allow,182,94,88,2,30,1,1
56137,64417,53,4241,53,allow,184,94,90,2,30,1,1
56138,59237,53,43242,53,allow,164,78,86,2,30,1,1
56139,49246,53,24337,53,allow,779,86,693,2,30,1,1
56140,55101,53,1606,53,allow,197,102,95,2,30,1,1
56141,56033,443,32455,443,allow,3250,1058,2192,13,136,6,7
56142,49439,53,56004,53,allow,197,102,95,2,31,1,1
56143,49972,53,23300,53,allow,184,94,90,2,30,1,1
56144,55100,53,1559,53,allow,178,94,84,2,30,1,1
56145,56246,53,1913,53,allow,209,110,99,2,30,1,1
56146,49217,53,2129,53,allow,209,110,99,2,31,1,1
56147,54956,53,14576,53,allow,194,102,92,2,31,1,1
56148,49597,53,63650,53,allow,168,86,82,2,31,1,1
56149,56765,53,27082,53,allow,194,102,92,2,31,1,1
56150,49667,53,65196,53,allow,183,94,89,2,30,1,1
56151,49374,53,45816,53,allow,193,102,91,2,30,1,1
56152,41002,53,33121,53,allow,164,78,86,2,30,1,1
56153,49365,53,39023,53,allow,195,102,93,2,30,1,1
56154,64041,53,58555,53,allow,200,102,98,2,31,1,1
56155,49794,53,12589,53,allow,197,102,95,2,30,1,1
56156,56026,53,4908,53,allow,183,94,89,2,31,1,1
56157,50376,53,23494,53,allow,166,86,80,2,31,1,1
56158,55100,53,26652,53,allow,178,94,84,2,31,1,1
56159,65300,53,18303,53,allow,195,102,93,2,31,1,1
56160,58856,443,16403,443,allow,4005,1421,2584,14,136,7,7
56161,45493,5223,26430,5223,allow,4196,1378,2818,21,3002,12,9
56162,19473,32332,63968,32332,allow,481,150,331,2,1200,1,1
56163,48894,53,34771,53,allow,164,78,86,2,31,1,1
56164,50121,53,43532,53,allow,152,78,74,2,31,1,1
56165,56223,53,58545,53,allow,185,102,83,2,31,1,1
56166,64323,53,30451,53,allow,195,102,93,2,31,1,1
56167,44076,443,35127,443,allow,202384,47621,154763,307,198,112,195
56168,15503,37512,24044,37512,allow,528,528,0,9,1199,9,0
56169,64417,53,37642,53,allow,184,94,90,2,31,1,1
56170,60016,443,40510,443,allow,134,60,74,3,6,2,1
56171,64732,53,52596,53,allow,189,102,87,2,30,1,1
56172,57015,53,61760,53,allow,279,94,185,2,30,1,1
56173,51090,53,42988,53,allow,164,78,86,2,30,1,1
56174,57094,53,61596,53,allow,196,102,94,2,30,1,1
56175,55364,53,21776,53,allow,168,86,82,2,31,1,1
56176,56962,53,40705,53,allow,177,94,83,2,31,1,1
56177,59816,443,30172,443,allow,622,310,312,11,29,6,5
56178,51955,443,64636,443,allow,8390,1525,6865,24,26,11,13
56179,50862,443,14909,443,allow,9930,2085,7845,21,318,11,10
56180,33244,443,30372,443,allow,4239,2487,1752,19,16,11,8
56181,49399,80,18487,80,allow,4382,2084,2298,18,66,10,8
56182,49397,80,15765,80,allow,4382,2084,2298,18,66,10,8
56183,57906,443,49224,443,allow,9316,3279,6037,39,186,20,19
56184,60194,80,35341,80,allow,70,70,0,2,8,2,0
56185,33240,443,43731,443,allow,7375,4769,2606,24,16,14,10
56186,49794,53,1835,53,allow,197,102,95,2,30,1,1
56187,64516,53,9042,53,allow,216,110,106,2,30,1,1
56188,49259,53,59958,53,allow,184,102,82,2,30,1,1
56189,49183,53,24061,53,allow,209,110,99,2,31,1,1
56190,57466,445,0,0,drop,70,70,0,1,0,1,0
56191,52483,445,0,0,drop,70,70,0,1,0,1,0
56192,19570,50584,0,0,deny,62,62,0,1,0,1,0
56193,51693,22114,0,0,deny,62,62,0,1,0,1,0
56194,22583,9822,0,0,deny,62,62,0,1,0,1,0
56195,22724,9822,0,0,deny,66,66,0,1,0,1,0
56196,52480,445,0,0,drop,70,70,0,1,0,1,0
56197,52883,445,0,0,drop,66,66,0,1,0,1,0
56198,52459,33890,0,0,deny,60,60,0,1,0,1,0
56199,52876,445,0,0,drop,66,66,0,1,0,1,0
56200,53355,23117,0,0,deny,66,66,0,1,0,1,0
56201,52870,445,0,0,drop,66,66,0,1,0,1,0
56202,52475,445,0,0,drop,70,70,0,1,0,1,0
56203,62767,57470,0,0,deny,74,74,0,1,0,1,0
56204,11983,57470,0,0,deny,62,62,0,1,0,1,0
56205,54631,44847,0,0,deny,70,70,0,1,0,1,0
56206,52474,445,0,0,drop,70,70,0,1,0,1,0
56207,49160,31652,0,0,reset-both,146,146,0,1,0,1,0
56208,18172,23,0,0,deny,60,60,0,1,0,1,0
56209,52472,445,0,0,drop,70,70,0,1,0,1,0
56210,25101,50584,0,0,deny,146,146,0,1,0,1,0
56211,27442,44847,0,0,deny,62,62,0,1,0,1,0
56212,56778,35440,0,0,deny,62,62,0,1,0,1,0
56213,14872,23,0,0,deny,60,60,0,1,0,1,0
56214,57455,445,0,0,drop,70,70,0,1,0,1,0
56215,57452,445,0,0,drop,70,70,0,1,0,1,0
56216,57453,445,0,0,drop,70,70,0,1,0,1,0
56217,25565,62778,0,0,deny,60,60,0,1,0,1,0
56218,52854,445,0,0,drop,66,66,0,1,0,1,0
56219,52860,445,0,0,drop,66,66,0,1,0,1,0
56220,52855,445,0,0,drop,66,66,0,1,0,1,0
56221,52856,445,0,0,drop,66,66,0,1,0,1,0
56222,52857,445,0,0,drop,66,66,0,1,0,1,0
56223,52859,445,0,0,drop,66,66,0,1,0,1,0
56224,52852,445,0,0,drop,66,66,0,1,0,1,0
56225,52853,445,0,0,drop,66,66,0,1,0,1,0
56226,42951,44847,0,0,deny,66,66,0,1,0,1,0
56227,54773,50584,0,0,deny,66,66,0,1,0,1,0
56228,6980,48543,0,0,deny,139,139,0,1,0,1,0
56229,54684,37965,0,0,deny,62,62,0,1,0,1,0
56230,64279,23718,0,0,deny,62,62,0,1,0,1,0
56231,52465,445,0,0,drop,70,70,0,1,0,1,0
56232,53166,61600,0,0,deny,66,66,0,1,0,1,0
56233,52463,445,0,0,drop,70,70,0,1,0,1,0
56234,45964,2666,0,0,deny,60,60,0,1,0,1,0
56235,9095,22114,0,0,deny,62,62,0,1,0,1,0
56236,7444,57470,0,0,deny,66,66,0,1,0,1,0
56237,48180,143,0,0,deny,60,60,0,1,0,1,0
56238,53783,443,19626,443,allow,499,425,74,4,0,3,1
56239,53782,443,62733,443,allow,499,425,74,4,0,3,1
56240,62678,57470,0,0,deny,62,62,0,1,0,1,0
56241,52462,445,0,0,drop,70,70,0,1,0,1,0
56242,52461,445,0,0,drop,70,70,0,1,0,1,0
56243,32395,30188,0,0,deny,62,62,0,1,0,1,0
56244,57447,445,0,0,drop,70,70,0,1,0,1,0
56245,57442,445,0,0,drop,70,70,0,1,0,1,0
56246,57441,445,0,0,drop,70,70,0,1,0,1,0
56247,52460,445,0,0,drop,70,70,0,1,0,1,0
56248,52454,445,0,0,drop,70,70,0,1,0,1,0
56249,52457,445,0,0,drop,70,70,0,1,0,1,0
56250,14082,50584,0,0,deny,62,62,0,1,0,1,0
56251,6712,5632,0,0,deny,60,60,0,1,0,1,0
56252,52838,445,0,0,drop,66,66,0,1,0,1,0
56253,52840,445,0,0,drop,66,66,0,1,0,1,0
56254,52837,445,0,0,drop,66,66,0,1,0,1,0
56255,48706,23393,0,0,deny,60,60,0,1,0,1,0
56256,55254,50584,0,0,deny,66,66,0,1,0,1,0
56257,28668,8696,0,0,deny,60,60,0,1,0,1,0
56258,57434,445,0,0,drop,70,70,0,1,0,1,0
56259,60875,56205,0,0,deny,66,66,0,1,0,1,0
56260,52442,445,0,0,drop,70,70,0,1,0,1,0
56261,52441,445,0,0,drop,70,70,0,1,0,1,0
56262,52439,445,0,0,drop,70,70,0,1,0,1,0
56263,80,37649,0,0,deny,60,60,0,1,0,1,0
56264,53105,42707,0,0,deny,66,66,0,1,0,1,0
56265,52432,445,0,0,drop,70,70,0,1,0,1,0
56266,52431,445,0,0,drop,70,70,0,1,0,1,0
56267,57432,445,0,0,drop,70,70,0,1,0,1,0
56268,20,17095,0,0,deny,554,554,0,1,0,1,0
56269,37008,42707,0,0,deny,62,62,0,1,0,1,0
56270,57427,445,0,0,drop,70,70,0,1,0,1,0
56271,57426,445,0,0,drop,70,70,0,1,0,1,0
56272,57421,445,0,0,drop,70,70,0,1,0,1,0
56273,27446,30188,0,0,deny,66,66,0,1,0,1,0
56274,80,53945,0,0,deny,60,60,0,1,0,1,0
56275,61241,22114,0,0,deny,66,66,0,1,0,1,0
56276,56453,37965,0,0,deny,62,62,0,1,0,1,0
56277,52420,445,0,0,drop,70,70,0,1,0,1,0
56278,47413,23,0,0,deny,60,60,0,1,0,1,0
56279,46349,51505,0,0,deny,70,70,0,1,0,1,0
56280,57415,445,0,0,drop,70,70,0,1,0,1,0
56281,57413,445,0,0,drop,70,70,0,1,0,1,0
56282,57409,445,0,0,drop,70,70,0,1,0,1,0
56283,3521,6881,0,0,deny,66,66,0,1,0,1,0
56284,53779,37965,0,0,deny,66,66,0,1,0,1,0
56285,45410,1,0,0,deny,62,62,0,1,0,1,0
56286,56946,1,0,0,deny,66,66,0,1,0,1,0
56287,17177,64147,0,0,deny,62,62,0,1,0,1,0
56288,52416,445,0,0,drop,70,70,0,1,0,1,0
56289,34129,11045,0,0,deny,62,62,0,1,0,1,0
56290,65153,38303,0,0,deny,66,66,0,1,0,1,0
56291,63670,64097,0,0,deny,66,66,0,1,0,1,0
56292,52407,445,0,0,drop,70,70,0,1,0,1,0
56293,52405,445,0,0,drop,70,70,0,1,0,1,0
56294,50355,43890,0,0,deny,62,62,0,1,0,1,0
56295,52401,445,0,0,drop,70,70,0,1,0,1,0
56296,52402,445,0,0,drop,70,70,0,1,0,1,0
56297,52816,445,0,0,drop,66,66,0,1,0,1,0
56298,6666,8443,0,0,deny,60,60,0,1,0,1,0
56299,57407,445,0,0,drop,70,70,0,1,0,1,0
56300,57404,445,0,0,drop,70,70,0,1,0,1,0
56301,58022,3000,0,0,deny,60,60,0,1,0,1,0
56302,52399,445,0,0,drop,70,70,0,1,0,1,0
56303,38926,37965,0,0,deny,62,62,0,1,0,1,0
56304,80,9918,0,0,deny,60,60,0,1,0,1,0
56305,5379,37965,0,0,deny,62,62,0,1,0,1,0
56306,59136,50584,0,0,deny,66,66,0,1,0,1,0
56307,33908,48983,0,0,deny,145,145,0,1,0,1,0
56308,1040,6004,0,0,deny,72,72,0,1,0,1,0
56309,52812,445,0,0,drop,66,66,0,1,0,1,0
56310,61736,50584,0,0,deny,66,66,0,1,0,1,0
56311,64406,50584,0,0,deny,66,66,0,1,0,1,0
56312,57452,57470,0,0,deny,62,62,0,1,0,1,0
56313,52808,445,0,0,drop,66,66,0,1,0,1,0
56314,52394,445,0,0,drop,70,70,0,1,0,1,0
56315,57393,445,0,0,drop,70,70,0,1,0,1,0
56316,52749,64147,0,0,deny,66,66,0,1,0,1,0
56317,57390,445,0,0,drop,70,70,0,1,0,1,0
56318,57387,445,0,0,drop,70,70,0,1,0,1,0
56319,57383,445,0,0,drop,70,70,0,1,0,1,0
56320,1660,8696,0,0,deny,62,62,0,1,0,1,0
56321,52807,445,0,0,drop,66,66,0,1,0,1,0
56322,1660,8696,0,0,deny,145,145,0,1,0,1,0
56323,12471,48817,0,0,deny,62,62,0,1,0,1,0
56324,51582,48817,0,0,deny,66,66,0,1,0,1,0
56325,52386,445,0,0,drop,70,70,0,1,0,1,0
56326,59481,41182,0,0,deny,66,66,0,1,0,1,0
56327,52385,445,0,0,drop,70,70,0,1,0,1,0
56328,57379,445,0,0,drop,70,70,0,1,0,1,0
56329,21892,15503,0,0,deny,62,62,0,1,0,1,0
56330,1025,35447,0,0,deny,62,62,0,1,0,1,0
56331,55072,53,57853,53,allow,701,88,613,2,30,1,1
56332,56246,53,65270,53,allow,202,103,99,2,30,1,1
56333,50319,53,28862,53,allow,756,95,661,2,30,1,1
56334,45373,443,33904,443,allow,33357,26315,7042,65,273,38,27
56335,57745,15000,1994,15000,allow,130,70,60,2,5,1,1
56336,55974,53,19851,53,allow,762,98,664,2,30,1,1
56337,55605,53,8941,53,allow,711,87,624,2,30,1,1
56338,49445,53,33858,53,allow,770,101,669,2,30,1,1
56339,45118,15000,63789,15000,allow,130,70,60,2,6,1,1
56340,64311,53,1855,53,allow,198,101,97,2,31,1,1
56341,56406,53,47759,53,allow,749,89,660,2,30,1,1
56342,51757,54657,24157,54657,allow,66,66,0,1,5,1,0
56343,51267,38070,5566,38070,allow,210,140,70,4,14,3,1
56344,55427,53,28517,53,allow,772,103,669,2,30,1,1
56345,65359,53,29324,53,allow,186,95,91,2,30,1,1
56346,65060,53,36666,53,allow,761,100,661,2,30,1,1
56347,56609,53,56720,53,allow,198,101,97,2,30,1,1
56348,59888,80,59888,80,allow,55739,967,54772,53,15,13,40
56349,59417,443,49153,443,allow,2898,1700,1198,16,15,8,8
56350,56607,443,1098,443,allow,7862,1873,5989,20,15,11,9
56351,55918,53,15697,53,allow,184,94,90,2,31,1,1
56352,55117,53,60693,53,allow,756,95,661,2,31,1,1
56353,49851,53,28608,53,allow,164,84,80,2,30,1,1
56354,65283,53,18469,53,allow,732,89,643,2,30,1,1
56355,64831,53,59275,53,allow,216,110,106,2,30,1,1
56356,49439,53,62852,53,allow,194,99,95,2,31,1,1
56357,49197,53,27457,53,allow,751,95,656,2,30,1,1
56358,51775,57887,60310,57887,allow,70,70,0,2,8,2,0
56359,50422,443,13716,443,allow,1389,868,521,12,25,6,6
56360,35047,80,8306,80,allow,7891,2035,5856,17,32,10,7
56361,43033,443,43033,443,allow,10239,2017,8222,23,18,14,9
56362,53834,15000,23428,15000,allow,130,70,60,2,6,1,1
56363,62185,53,27701,53,allow,578,286,292,9,15,5,4
56364,21870,53,21870,53,allow,209,77,132,2,32,1,1
56365,64323,53,38959,53,allow,190,97,93,2,31,1,1
56366,2941,7000,2941,7000,allow,3398,947,2451,18,27,9,9
56367,51783,12296,8284,12296,allow,316,136,180,6,6,3,3
56368,63763,17368,8449,17368,allow,66,66,0,1,5,1,0
56369,49537,53,46669,53,allow,269,96,173,4,59,2,2
56370,56608,443,64637,443,allow,8034,2014,6020,20,15,11,9
56371,35049,80,15791,80,allow,5773,1197,4576,14,32,8,6
56372,50347,53,8937,53,allow,756,95,661,2,30,1,1
56373,5588,5588,0,0,allow,3354,1792,1562,46,194,23,23
56374,56609,443,31583,443,allow,7982,1962,6020,20,15,11,9
56375,56818,53,44106,53,allow,755,94,661,2,30,1,1
56376,64900,53,55374,53,allow,778,103,675,2,30,1,1
56377,56962,53,51903,53,allow,170,87,83,2,30,1,1
56378,50240,53,16161,53,allow,733,93,640,2,30,1,1
56379,55008,53,25566,53,allow,762,98,664,2,30,1,1
56380,49972,53,21304,53,allow,184,94,90,2,30,1,1
56381,64618,53,46697,53,allow,196,100,96,2,31,1,1
56382,64653,53,37901,53,allow,755,93,662,2,31,1,1
56383,64041,53,17809,53,allow,200,102,98,2,30,1,1
56384,49687,53,24599,53,allow,775,103,672,2,31,1,1
56385,44588,443,64745,443,allow,8850,2551,6299,32,369,16,16
56386,49978,53,47119,53,allow,774,101,673,2,31,1,1
56387,64438,53,41293,53,allow,184,94,90,2,31,1,1
56388,49670,53,15548,53,allow,168,86,82,2,31,1,1
56389,49539,53,44717,53,allow,170,87,83,2,31,1,1
56390,65131,53,39663,53,allow,168,86,82,2,31,1,1
56391,65189,27216,23592,27216,allow,226,71,155,2,31,1,1
56392,65514,53,6429,53,allow,212,108,104,2,31,1,1
56393,57306,53,11858,53,allow,170,87,83,2,31,1,1
56394,55049,53,52659,53,allow,733,86,647,2,31,1,1
56395,56987,53,30832,53,allow,192,98,94,2,31,1,1
56396,65380,53,11853,53,allow,176,90,86,2,31,1,1
56397,5938,58817,0,0,allow,60,60,0,1,90,1,0
56398,49997,53,52835,53,allow,418,75,343,2,31,1,1
56399,49290,53,15607,53,allow,760,97,663,2,31,1,1
56400,65189,27241,23433,27241,allow,235,71,164,2,31,1,1
56401,49429,53,19123,53,allow,204,104,100,2,31,1,1
56402,49361,53,45475,53,allow,184,94,90,2,31,1,1
56403,56111,53,53180,53,allow,174,89,85,2,31,1,1
56404,37961,443,30943,443,allow,10229,2777,7452,30,361,15,15
56405,56765,53,13979,53,allow,188,96,92,2,31,1,1
56406,56104,53,20610,53,allow,194,99,95,2,31,1,1
56407,65014,53,3896,53,allow,186,95,91,2,31,1,1
56408,65516,53,26116,53,allow,202,103,99,2,31,1,1
56409,50460,53,61853,53,allow,753,96,657,2,31,1,1
56410,56878,53,21554,53,allow,168,86,82,2,31,1,1
56411,64913,53,27699,53,allow,182,93,89,2,31,1,1
56412,57258,53,12137,53,allow,757,98,659,2,31,1,1
56413,65063,53,62698,53,allow,176,90,86,2,31,1,1
56414,49384,53,31275,53,allow,178,91,87,2,31,1,1
56415,47054,443,53511,443,allow,6803,2164,4639,14,121,7,7
56416,6881,6881,2620,6881,allow,150,150,0,1,1200,1,0
56417,62864,443,56821,443,allow,86513,10300,76213,131,137,54,77
56418,55594,53,11300,53,allow,753,96,657,2,31,1,1
56419,52233,443,57646,443,allow,5479,929,4550,20,360,10,10
56420,65336,53,13952,53,allow,782,105,677,2,31,1,1
56421,33000,53,0,0,allow,82,82,0,1,31,1,0
56422,56332,53,13726,53,allow,202,103,99,2,31,1,1
56423,56494,53,64995,53,allow,793,101,692,2,31,1,1
56424,49861,53,49122,53,allow,196,100,96,2,31,1,1
56425,55517,53,21431,53,allow,174,89,85,2,31,1,1
56426,49785,53,38466,53,allow,206,105,101,2,31,1,1
56427,56071,53,41864,53,allow,186,95,91,2,31,1,1
56428,56552,53,11395,53,allow,190,97,93,2,31,1,1
56429,57251,53,30748,53,allow,780,104,676,2,31,1,1
56430,56477,53,34733,53,allow,198,101,97,2,31,1,1
56431,21133,26760,14164,26760,allow,480,149,331,2,1200,1,1
56432,57377,445,0,0,drop,70,70,0,1,0,1,0
56433,57375,445,0,0,drop,70,70,0,1,0,1,0
56434,57373,445,0,0,drop,70,70,0,1,0,1,0
56435,59020,9600,0,0,deny,60,60,0,1,0,1,0
56436,52799,445,0,0,drop,66,66,0,1,0,1,0
56437,43671,37965,0,0,deny,62,62,0,1,0,1,0
56438,29623,37807,0,0,deny,62,62,0,1,0,1,0
56439,1027,11392,0,0,deny,62,62,0,1,0,1,0
56440,12821,37965,0,0,deny,66,66,0,1,0,1,0
56441,21274,30188,0,0,deny,62,62,0,1,0,1,0
56442,52795,445,0,0,drop,66,66,0,1,0,1,0
56443,52791,445,0,0,drop,66,66,0,1,0,1,0
56444,52790,445,0,0,drop,66,66,0,1,0,1,0
56445,52379,445,0,0,drop,70,70,0,1,0,1,0
56446,52378,445,0,0,drop,70,70,0,1,0,1,0
56447,52789,445,0,0,drop,66,66,0,1,0,1,0
56448,52788,445,0,0,drop,66,66,0,1,0,1,0
56449,52786,445,0,0,drop,66,66,0,1,0,1,0
56450,56100,53,41303,53,allow,177,94,83,2,30,1,1
56451,56705,53,17593,53,allow,168,78,90,2,30,1,1
56452,9246,35440,0,0,deny,66,66,0,1,0,1,0
56453,51829,36134,0,0,deny,66,66,0,1,0,1,0
56454,50143,35253,0,0,deny,66,66,0,1,0,1,0
56455,52374,445,0,0,drop,70,70,0,1,0,1,0
56456,64051,36829,0,0,deny,66,66,0,1,0,1,0
56457,57370,445,0,0,drop,70,70,0,1,0,1,0
56458,57371,445,0,0,drop,70,70,0,1,0,1,0
56459,57366,445,0,0,drop,70,70,0,1,0,1,0
56460,49160,34021,0,0,reset-both,146,146,0,1,0,1,0
56461,52782,445,0,0,drop,66,66,0,1,0,1,0
56462,57364,445,0,0,drop,70,70,0,1,0,1,0
56463,52373,445,0,0,drop,70,70,0,1,0,1,0
56464,443,14315,0,0,deny,158,158,0,1,0,1,0
56465,52781,445,0,0,drop,66,66,0,1,0,1,0
56466,53298,26467,0,0,deny,62,62,0,1,0,1,0
56467,58468,37965,0,0,deny,66,66,0,1,0,1,0
56468,52779,445,0,0,drop,66,66,0,1,0,1,0
56469,52777,445,0,0,drop,66,66,0,1,0,1,0
56470,52775,445,0,0,drop,66,66,0,1,0,1,0
56471,443,15564,0,0,deny,85,85,0,1,0,1,0
56472,17009,53733,0,0,deny,66,66,0,1,0,1,0
56473,52368,445,0,0,drop,70,70,0,1,0,1,0
56474,65209,57866,0,0,deny,66,66,0,1,0,1,0
56475,59315,35440,0,0,deny,62,62,0,1,0,1,0
56476,64771,53,10938,53,allow,228,110,118,2,30,1,1
56477,55989,443,55989,443,allow,4378,1471,2907,19,29,11,8
56478,55147,53,9806,53,allow,184,94,90,2,30,1,1
56479,64243,53,24679,53,allow,244,94,150,2,30,1,1
56480,55147,53,22954,53,allow,184,94,90,2,30,1,1
56481,49266,53,16843,53,allow,199,102,97,2,30,1,1
56482,39047,443,36034,443,allow,10831,1381,9450,22,19,12,10
56483,49398,80,11997,80,allow,3651,2020,1631,16,65,9,7
56484,50457,443,62733,443,allow,3091,1708,1383,15,21,9,6
56485,55599,80,22870,80,allow,1165,473,692,10,14,5,5
56486,63762,41373,27152,41373,allow,70,70,0,1,4,1,0
56487,50393,53,2809,53,allow,759,94,665,2,29,1,1
56488,49667,53,34670,53,allow,183,94,89,2,29,1,1
56489,11295,40018,57800,40018,allow,213,89,124,4,31,2,2
56490,56883,53,10133,53,allow,184,94,90,2,30,1,1
56491,49400,80,44770,80,allow,3651,2020,1631,16,65,9,7
56492,50384,443,60892,443,allow,7723,2591,5132,23,49,12,11
56493,54168,80,20934,80,allow,1582,1003,579,12,360,6,6
56494,49424,53,45939,53,allow,198,102,96,2,32,1,1
56495,64613,53,15938,53,allow,179,94,85,2,30,1,1
56496,63757,51413,50296,51413,allow,70,70,0,1,4,1,0
56497,25061,53,25061,53,allow,214,82,132,2,32,1,1
56498,33241,443,5641,443,allow,37452,28136,9316,56,15,33,23
56499,59815,443,31852,443,allow,4586,955,3631,17,28,9,8
56500,56765,53,64406,53,allow,194,102,92,2,29,1,1
56501,57257,53,41032,53,allow,173,94,79,2,29,1,1
56502,55605,27274,9607,27274,allow,130,70,60,2,4,1,1
56503,49888,53,1710,53,allow,198,102,96,2,29,1,1
56504,55077,53,32952,53,allow,179,94,85,2,29,1,1
56505,49872,53,49872,53,allow,218,90,128,2,29,1,1
56506,55739,53,37345,53,allow,458,188,270,6,29,3,3
56507,55429,53,62139,53,allow,182,102,80,2,30,1,1
56508,49817,53,35154,53,allow,286,110,176,2,30,1,1
56509,56100,53,9631,53,allow,177,94,83,2,30,1,1
56510,49896,443,39739,443,allow,151170,17408,133762,256,130,118,138
56511,65211,53,54701,53,allow,183,94,89,2,30,1,1
56512,64685,53,15480,53,allow,199,102,97,2,30,1,1
56513,56335,53,48756,53,allow,816,102,714,2,30,1,1
56514,49972,53,40776,53,allow,184,94,90,2,30,1,1
56515,56987,53,21347,53,allow,196,102,94,2,30,1,1
56516,64093,53,8656,53,allow,225,110,115,2,30,1,1
56517,64715,53,47413,53,allow,209,110,99,2,30,1,1
56518,57252,53,53751,53,allow,183,94,89,2,30,1,1
56519,49539,53,50465,53,allow,177,94,83,2,30,1,1
56520,49167,53,55909,53,allow,193,102,91,2,30,1,1
56521,51776,14645,41362,14645,allow,70,70,0,2,8,2,0
56522,51752,7000,51752,7000,allow,3638,2087,1551,17,16,10,7
56523,34079,80,3796,80,allow,5053,4178,875,17,15,9,8
56524,64643,53,40117,53,allow,177,94,83,2,30,1,1
56525,50575,53,5901,53,allow,766,102,664,2,30,1,1
56526,51953,443,64481,443,allow,8900,2020,6880,28,25,15,13
56527,65246,53,37552,53,allow,183,94,89,2,30,1,1
56528,56456,53,8981,53,allow,195,102,93,2,30,1,1
56529,56456,53,17169,53,allow,195,102,93,2,30,1,1
56530,64685,53,31549,53,allow,199,102,97,2,30,1,1
56531,64585,53,51194,53,allow,210,110,100,2,30,1,1
56532,64874,53,28911,53,allow,808,110,698,2,30,1,1
56533,49433,53,41471,53,allow,165,86,79,2,30,1,1
56534,55918,53,24727,53,allow,184,94,90,2,30,1,1
56535,56223,53,26337,53,allow,177,94,83,2,30,1,1
56536,65249,53,5221,53,allow,166,86,80,2,30,1,1
56537,55429,53,31053,53,allow,182,102,80,2,30,1,1
56538,44690,443,54599,443,allow,1648,813,835,17,185,9,8
56539,64585,53,55669,53,allow,210,110,100,2,30,1,1
56540,65189,27015,29892,27015,allow,295,78,217,2,30,1,1
56541,64417,53,47310,53,allow,369,94,275,4,49,2,2
56542,49968,53,46436,53,allow,285,94,191,2,30,1,1
56543,64715,53,35107,53,allow,209,110,99,2,30,1,1
56544,64831,53,56461,53,allow,216,110,106,2,30,1,1
56545,56335,53,52497,53,allow,193,102,91,2,30,1,1
56546,49622,53,47185,53,allow,185,102,83,2,30,1,1
56547,49634,443,60698,443,allow,20860,1618,19242,35,122,15,20
56548,49537,53,59309,53,allow,269,96,173,4,59,2,2
56549,65091,80,65091,80,allow,18499242,314733,18184509,19253,37,4700,14553
56550,50648,80,55586,80,allow,132,132,0,2,8,2,0
56551,51773,23728,42323,23728,allow,70,70,0,2,8,2,0
56552,63366,30365,45991,30365,allow,738,318,420,12,163,5,7
56553,49851,53,3240,53,allow,166,86,80,2,30,1,1
56554,56649,53,35726,53,allow,152,78,74,2,30,1,1
56555,51468,80,31366,80,allow,3389,2054,1335,19,25,11,8
56556,34275,443,58408,443,allow,4880,3216,1664,29,79,15,14
56557,42358,80,63133,80,allow,1081,641,440,9,14,4,5
56558,26833,443,13799,443,allow,21487,16430,5057,39,21,22,17
56559,51774,16930,45672,16930,allow,70,70,0,2,8,2,0
56560,58924,443,13598,443,allow,7783,2690,5093,24,255,13,11
56561,63759,64509,61744,64509,allow,70,70,0,1,4,1,0
56562,57257,80,32555,80,allow,1369,495,874,12,361,6,6
56563,56919,53,23059,53,allow,423,95,328,4,34,2,2
56564,64700,53,51210,53,allow,458,188,270,6,29,3,3
56565,64595,53,24899,53,allow,167,86,81,2,29,1,1
56566,49739,443,63017,443,allow,3085,1404,1681,15,15,7,8
56567,64732,53,44138,53,allow,189,102,87,2,29,1,1
56568,49888,53,17695,53,allow,198,102,96,2,29,1,1
56569,49217,53,20500,53,allow,209,110,99,2,29,1,1
56570,54287,443,51264,443,allow,8603,853,7750,27,92,9,18
56571,51268,47662,5610,47662,allow,70,70,0,2,8,2,0
56572,55596,14795,19064,14795,allow,630,444,186,9,16,6,3
56573,56919,53,16423,53,allow,193,102,91,2,29,1,1
56574,64936,53,18480,53,allow,749,94,655,2,29,1,1
56575,49365,53,27288,53,allow,195,102,93,2,29,1,1
56576,55147,53,48564,53,allow,184,94,90,2,30,1,1
56577,64552,53,41507,53,allow,754,94,660,2,30,1,1
56578,49530,53,54763,53,allow,265,102,163,2,30,1,1
56579,49622,53,45379,53,allow,185,102,83,2,30,1,1
56580,56557,53,49880,53,allow,214,110,104,2,29,1,1
56581,49399,53,15486,53,allow,775,102,673,2,30,1,1
56582,65211,53,44478,53,allow,183,94,89,2,30,1,1
56583,49901,53,39046,53,allow,193,102,91,2,29,1,1
56584,64595,53,55733,53,allow,167,86,81,2,30,1,1
56585,64311,53,39516,53,allow,199,102,97,2,30,1,1
56586,65189,27237,9524,27237,allow,234,78,156,2,30,1,1
56587,56111,53,49193,53,allow,179,94,85,2,31,1,1
56588,64403,53,2532,53,allow,199,102,97,2,31,1,1
56589,56552,53,3851,53,allow,195,102,93,2,31,1,1
56590,51637,443,21678,443,allow,3110,1049,2061,14,136,7,7
56591,49167,53,5532,53,allow,816,102,714,2,30,1,1
56592,56121,53,17284,53,allow,207,86,121,2,30,1,1
56593,56552,53,34046,53,allow,195,102,93,2,30,1,1
56594,1927,53,62865,53,allow,210,78,132,2,30,1,1
56595,65189,27015,61124,27015,allow,250,78,172,2,30,1,1
56596,65189,27015,46211,27015,allow,267,78,189,2,30,1,1
56597,55461,53,35895,53,allow,198,110,88,2,30,1,1
56598,49917,53,18720,53,allow,209,110,99,2,30,1,1
56599,65189,27017,19229,27017,allow,239,78,161,2,30,1,1
56600,65189,27015,18038,27015,allow,257,78,179,2,30,1,1
56601,65189,27207,3306,27207,allow,230,78,152,2,30,1,1
56602,65189,27015,25952,27015,allow,281,78,203,2,30,1,1
56603,55918,53,15262,53,allow,184,94,90,2,31,1,1
56604,65189,27015,36838,27015,allow,257,78,179,2,30,1,1
56605,10089,80,55892,80,allow,130,70,60,2,15,1,1
56606,3303,80,51748,80,allow,2338,1419,919,10,15,5,5
56607,51756,41471,58464,41471,allow,70,70,0,1,5,1,0
56608,51158,443,53566,443,allow,3155111,84086,3071025,3163,75,1072,2091
56609,46438,443,46438,443,allow,5337,2090,3247,22,39,13,9
56610,56026,53,28063,53,allow,183,94,89,2,30,1,1
56611,57252,53,53666,53,allow,183,94,89,2,30,1,1
56612,49433,53,27774,53,allow,173,94,79,2,30,1,1
56613,56104,53,22926,53,allow,197,102,95,2,30,1,1
56614,34947,53,51809,53,allow,168,78,90,2,30,1,1
56615,49860,53,63227,53,allow,184,102,82,2,30,1,1
56616,64026,53,1792,53,allow,211,102,109,2,30,1,1
56617,43693,53,25103,53,allow,164,78,86,2,30,1,1
56618,56649,53,31076,53,allow,168,94,74,2,30,1,1
56619,57252,53,37679,53,allow,183,94,89,2,30,1,1
56620,55512,53,3521,53,allow,458,188,270,6,30,3,3
56621,56809,53,37761,53,allow,178,94,84,2,30,1,1
56622,64311,53,19538,53,allow,199,102,97,2,30,1,1
56623,64585,53,40349,53,allow,210,110,100,2,30,1,1
56624,56246,53,30677,53,allow,209,110,99,2,30,1,1
56625,65359,53,28420,53,allow,193,102,91,2,30,1,1
56626,65249,53,21680,53,allow,182,102,80,2,30,1,1
56627,65529,53,50654,53,allow,821,102,719,2,30,1,1
56628,64715,53,61600,53,allow,209,110,99,2,30,1,1
56629,56227,53,28291,53,allow,179,94,85,2,30,1,1
56630,40193,443,57432,443,allow,1462,735,727,15,185,8,7
56631,45109,443,1117,443,allow,11156,3899,7257,31,234,17,14
56632,64913,53,27503,53,allow,183,94,89,2,30,1,1
56633,53115,40693,38172,40693,allow,70,70,0,2,8,2,0
56634,49728,443,15564,443,allow,7626,1676,5950,29,63,10,19
56635,57249,443,12847,443,allow,7965,2643,5322,42,15,24,18
56636,49183,53,29477,53,allow,209,110,99,2,30,1,1
56637,65420,53,11720,53,allow,166,86,80,2,30,1,1
56638,64643,53,62127,53,allow,177,94,83,2,30,1,1
56639,56557,53,47692,53,allow,214,110,104,2,30,1,1
56640,64287,53,53632,53,allow,181,94,87,2,30,1,1
56641,56004,53,34719,53,allow,177,94,83,2,30,1,1
56642,57152,53,2032,53,allow,183,94,89,2,30,1,1
56643,56126,53,43934,53,allow,183,94,89,2,30,1,1
56644,65189,27015,44891,27015,allow,255,78,177,2,30,1,1
56645,56126,53,32815,53,allow,183,94,89,2,30,1,1
56646,65189,30015,16566,30015,allow,276,78,198,2,30,1,1
56647,49696,53,30519,53,allow,178,94,84,2,30,1,1
56648,56609,53,37814,53,allow,199,102,97,2,30,1,1
56649,56987,53,59227,53,allow,196,102,94,2,30,1,1
56650,65516,53,16518,53,allow,209,110,99,2,31,1,1
56651,57306,53,15056,53,allow,177,94,83,2,31,1,1
56652,55688,53,48185,53,allow,183,94,89,2,31,1,1
56653,57007,53,19153,53,allow,183,94,89,2,31,1,1
56654,64618,53,21647,53,allow,198,102,96,2,30,1,1
56655,56104,53,63968,53,allow,197,102,95,2,30,1,1
56656,64438,53,59049,53,allow,184,94,90,2,30,1,1
56657,56111,53,45505,53,allow,179,94,85,2,30,1,1
56658,55467,53,34377,53,allow,193,102,91,2,30,1,1
56659,65189,28515,39536,28515,allow,266,78,188,2,30,1,1
56660,56883,53,20999,53,allow,184,94,90,2,30,1,1
56661,56071,53,13568,53,allow,193,102,91,2,30,1,1
56662,49361,53,51044,53,allow,184,94,90,2,31,1,1
56663,55517,53,14797,53,allow,179,94,85,2,31,1,1
56664,37965,16153,40075,16153,allow,1320,1320,0,21,1682,21,0
56665,65189,27015,1984,27015,allow,260,78,182,2,30,1,1
56666,56332,53,1947,53,allow,209,110,99,2,31,1,1
56667,65469,53,29881,53,allow,195,102,93,2,31,1,1
56668,54990,53,46533,53,allow,166,86,80,2,31,1,1
56669,64618,53,55916,53,allow,198,102,96,2,31,1,1
56670,57172,53,10868,53,allow,196,102,94,2,31,1,1
56671,49174,53,1263,53,allow,166,86,80,2,31,1,1
56672,59103,443,51275,443,allow,4209,2056,2153,50,277,24,26
56673,38444,443,18273,443,allow,3547,955,2592,13,120,6,7
56674,49204,443,40475,443,allow,1786,172,1614,7,120,3,4
56675,64041,53,11407,53,allow,200,102,98,2,31,1,1
56676,53430,443,50940,443,allow,4383,2064,2319,11,120,6,5
56677,56071,53,32735,53,allow,193,102,91,2,31,1,1
56678,58427,5223,31205,5223,allow,13841,6601,7240,42,622,19,23
56679,61146,443,19937,443,allow,8580941,269463,8311478,9202,122,3016,6186
56680,49160,1025,14161,1025,allow,868,150,718,4,1200,2,2
56681,37965,48782,19115,48782,allow,132,132,0,3,1199,3,0
56682,56601,53,16656,53,allow,239,94,145,2,31,1,1
56683,44839,443,23952,443,allow,3188,2056,1132,23,121,13,10
56684,56033,53,58148,53,allow,213,102,111,2,31,1,1
56685,49861,53,27236,53,allow,198,102,96,2,31,1,1
56686,50326,53,27014,53,allow,720,94,626,2,31,1,1
56687,65359,53,19133,53,allow,193,102,91,2,31,1,1
56688,55461,53,48907,53,allow,198,110,88,2,31,1,1
56689,49384,53,17338,53,allow,181,94,87,2,31,1,1
56690,55857,53,56112,53,allow,199,102,97,2,31,1,1
56691,49901,53,59612,53,allow,193,102,91,2,31,1,1
56692,56783,53,24430,53,allow,199,102,97,2,31,1,1
56693,64831,53,30238,53,allow,216,110,106,2,31,1,1
56694,49860,53,48565,53,allow,168,86,82,2,31,1,1
56695,57172,53,34011,53,allow,196,102,94,2,31,1,1
56696,49972,53,6023,53,allow,314,94,220,4,31,2,2
56697,64288,443,27448,443,allow,252,70,182,3,120,1,2
56698,55688,53,29682,53,allow,183,94,89,2,31,1,1
56699,36366,443,13851,443,allow,6147,910,5237,18,16,10,8
56700,53237,443,53237,443,allow,1210,637,573,14,34,7,7
56701,46167,80,10521,80,allow,78,78,0,1,5,1,0
56702,57007,53,36349,53,allow,183,94,89,2,31,1,1
56703,64403,53,9122,53,allow,199,102,97,2,31,1,1
56704,49537,53,25046,53,allow,269,96,173,4,59,2,2
56705,46052,443,47336,443,allow,9815,5382,4433,51,237,20,31
56706,43357,443,59688,443,allow,1053,566,487,10,15,6,4
56707,53236,443,53236,443,allow,1210,637,573,14,34,7,7
56708,45169,443,45169,443,allow,282,140,142,5,152,3,2
56709,65131,53,4831,53,allow,168,86,82,2,30,1,1
56710,57357,445,0,0,drop,70,70,0,1,0,1,0
56711,33822,57470,0,0,deny,66,66,0,1,0,1,0
56712,57353,445,0,0,drop,70,70,0,1,0,1,0
56713,57349,445,0,0,drop,70,70,0,1,0,1,0
56714,11716,37965,0,0,deny,62,62,0,1,0,1,0
56715,4910,2149,0,0,deny,62,62,0,1,0,1,0
56716,52766,445,0,0,drop,66,66,0,1,0,1,0
56717,51745,30188,0,0,deny,62,62,0,1,0,1,0
56718,52355,445,0,0,drop,70,70,0,1,0,1,0
56719,31845,55777,0,0,deny,62,62,0,1,0,1,0
56720,16293,57470,0,0,deny,62,62,0,1,0,1,0
56721,52757,445,0,0,drop,66,66,0,1,0,1,0
56722,22587,30188,0,0,deny,66,66,0,1,0,1,0
56723,57336,445,0,0,drop,70,70,0,1,0,1,0
56724,19747,37965,0,0,deny,62,62,0,1,0,1,0
56725,9448,57866,0,0,deny,146,146,0,1,0,1,0
56726,52352,445,0,0,drop,70,70,0,1,0,1,0
56727,64341,57470,0,0,deny,62,62,0,1,0,1,0
56728,52755,445,0,0,drop,66,66,0,1,0,1,0
56729,2522,64147,0,0,deny,62,62,0,1,0,1,0
56730,56307,52700,0,0,deny,66,66,0,1,0,1,0
56731,10003,64147,0,0,deny,62,62,0,1,0,1,0
56732,10115,52700,0,0,deny,62,62,0,1,0,1,0
56733,52247,51505,0,0,deny,146,146,0,1,0,1,0
56734,6712,44818,0,0,deny,66,66,0,1,0,1,0
56735,63379,36237,0,0,deny,62,62,0,1,0,1,0
56736,52747,445,0,0,drop,66,66,0,1,0,1,0
56737,52348,445,0,0,drop,70,70,0,1,0,1,0
56738,18357,51180,0,0,deny,62,62,0,1,0,1,0
56739,58305,51180,0,0,deny,66,66,0,1,0,1,0
56740,52346,445,0,0,drop,70,70,0,1,0,1,0
56741,52740,445,0,0,drop,66,66,0,1,0,1,0
56742,12530,35440,0,0,deny,66,66,0,1,0,1,0
56743,7308,50584,0,0,deny,66,66,0,1,0,1,0
56744,52344,445,0,0,drop,70,70,0,1,0,1,0
56745,10586,37965,0,0,deny,62,62,0,1,0,1,0
56746,53777,443,29327,443,allow,495,421,74,4,0,3,1
56747,53769,443,28627,443,allow,499,425,74,4,0,3,1
56748,4540,23,0,0,deny,60,60,0,1,0,1,0
56749,31112,50584,0,0,deny,66,66,0,1,0,1,0
56750,47103,55378,0,0,deny,146,146,0,1,0,1,0
56751,57329,445,0,0,drop,70,70,0,1,0,1,0
56752,57325,445,0,0,drop,70,70,0,1,0,1,0
56753,57324,445,0,0,drop,70,70,0,1,0,1,0
56754,59378,50584,0,0,deny,66,66,0,1,0,1,0
56755,63305,62413,0,0,deny,66,66,0,1,0,1,0
56756,52732,445,0,0,drop,66,66,0,1,0,1,0
56757,52731,445,0,0,drop,66,66,0,1,0,1,0
56758,52730,445,0,0,drop,66,66,0,1,0,1,0
56759,52726,445,0,0,drop,66,66,0,1,0,1,0
56760,52724,445,0,0,drop,66,66,0,1,0,1,0
56761,52729,445,0,0,drop,66,66,0,1,0,1,0
56762,52725,445,0,0,drop,66,66,0,1,0,1,0
56763,52727,445,0,0,drop,66,66,0,1,0,1,0
56764,65250,22114,0,0,deny,66,66,0,1,0,1,0
56765,52337,445,0,0,drop,70,70,0,1,0,1,0
56766,56217,5900,0,0,deny,60,60,0,1,0,1,0
56767,43129,20220,0,0,deny,62,62,0,1,0,1,0
56768,14715,56205,0,0,deny,62,62,0,1,0,1,0
56769,52335,445,0,0,drop,70,70,0,1,0,1,0
56770,58950,5900,0,0,deny,60,60,0,1,0,1,0
56771,64024,57470,0,0,deny,62,62,0,1,0,1,0
56772,52334,445,0,0,drop,70,70,0,1,0,1,0
56773,6881,55108,0,0,deny,143,143,0,1,0,1,0
56774,45941,23386,0,0,deny,60,60,0,1,0,1,0
56775,52333,445,0,0,drop,70,70,0,1,0,1,0
56776,26722,11446,0,0,deny,66,66,0,1,0,1,0
56777,52332,445,0,0,drop,70,70,0,1,0,1,0
56778,63547,37965,0,0,deny,66,66,0,1,0,1,0
56779,52330,445,0,0,drop,70,70,0,1,0,1,0
56780,52328,445,0,0,drop,70,70,0,1,0,1,0
56781,11464,37965,0,0,deny,62,62,0,1,0,1,0
56782,53015,64147,0,0,deny,145,145,0,1,0,1,0
56783,50052,65008,0,0,deny,60,60,0,1,0,1,0
56784,57321,445,0,0,drop,70,70,0,1,0,1,0
56785,57319,445,0,0,drop,70,70,0,1,0,1,0
56786,57317,445,0,0,drop,70,70,0,1,0,1,0
56787,64756,11392,0,0,deny,62,62,0,1,0,1,0
56788,3802,55777,0,0,deny,66,66,0,1,0,1,0
56789,52709,445,0,0,drop,66,66,0,1,0,1,0
56790,52710,445,0,0,drop,66,66,0,1,0,1,0
56791,52712,445,0,0,drop,66,66,0,1,0,1,0
56792,1028,62609,0,0,deny,148,148,0,1,0,1,0
56793,52314,445,0,0,drop,70,70,0,1,0,1,0
56794,52313,445,0,0,drop,70,70,0,1,0,1,0
56795,52309,445,0,0,drop,70,70,0,1,0,1,0
56796,61912,17546,0,0,deny,66,66,0,1,0,1,0
56797,57306,445,0,0,drop,70,70,0,1,0,1,0
56798,52303,445,0,0,drop,70,70,0,1,0,1,0
56799,52304,445,0,0,drop,70,70,0,1,0,1,0
56800,40547,24051,0,0,deny,74,74,0,1,0,1,0
56801,57304,445,0,0,drop,70,70,0,1,0,1,0
56802,50734,37965,0,0,deny,62,62,0,1,0,1,0
56803,57301,445,0,0,drop,70,70,0,1,0,1,0
56804,57294,445,0,0,drop,70,70,0,1,0,1,0
56805,57293,445,0,0,drop,70,70,0,1,0,1,0
56806,43235,23,0,0,deny,60,60,0,1,0,1,0
56807,42745,50011,0,0,deny,62,62,0,1,0,1,0
56808,60480,57470,0,0,deny,62,62,0,1,0,1,0
56809,19610,9571,0,0,deny,62,62,0,1,0,1,0
56810,22541,64147,0,0,deny,62,62,0,1,0,1,0
56811,30598,46824,0,0,deny,62,62,0,1,0,1,0
56812,39810,48817,0,0,deny,148,148,0,1,0,1,0
56813,46093,32661,0,0,deny,74,74,0,1,0,1,0
56814,52292,445,0,0,drop,70,70,0,1,0,1,0
56815,39824,51505,0,0,deny,62,62,0,1,0,1,0
56816,65512,44847,0,0,deny,66,66,0,1,0,1,0
56817,13372,50584,0,0,deny,66,66,0,1,0,1,0
56818,59055,11392,0,0,deny,66,66,0,1,0,1,0
56819,57286,445,0,0,drop,70,70,0,1,0,1,0
56820,57284,445,0,0,drop,70,70,0,1,0,1,0
56821,57281,445,0,0,drop,70,70,0,1,0,1,0
56822,52103,53733,0,0,deny,66,66,0,1,0,1,0
56823,61185,54532,0,0,deny,62,62,0,1,0,1,0
56824,52288,445,0,0,drop,70,70,0,1,0,1,0
56825,49628,35440,0,0,deny,66,66,0,1,0,1,0
56826,52519,44847,0,0,deny,62,62,0,1,0,1,0
56827,1749,64147,0,0,deny,62,62,0,1,0,1,0
56828,25772,7302,0,0,deny,62,62,0,1,0,1,0
56829,52278,445,0,0,drop,70,70,0,1,0,1,0
56830,52277,445,0,0,drop,70,70,0,1,0,1,0
56831,49976,22114,0,0,deny,66,66,0,1,0,1,0
56832,52275,445,0,0,drop,70,70,0,1,0,1,0
56833,52273,445,0,0,drop,70,70,0,1,0,1,0
56834,45079,31573,0,0,deny,66,66,0,1,0,1,0
56835,55413,37965,0,0,deny,62,62,0,1,0,1,0
56836,52271,445,0,0,drop,70,70,0,1,0,1,0
56837,46774,64147,0,0,deny,145,145,0,1,0,1,0
56838,35036,26296,0,0,deny,159,159,0,1,0,1,0
56839,57654,35440,0,0,deny,66,66,0,1,0,1,0
56840,52690,445,0,0,drop,66,66,0,1,0,1,0
56841,57278,445,0,0,drop,70,70,0,1,0,1,0
56842,57276,445,0,0,drop,70,70,0,1,0,1,0
56843,51151,64147,0,0,deny,62,62,0,1,0,1,0
56844,6881,6881,0,0,deny,62,62,0,1,0,1,0
56845,63183,64147,0,0,deny,66,66,0,1,0,1,0
56846,52266,445,0,0,drop,70,70,0,1,0,1,0
56847,52683,445,0,0,drop,66,66,0,1,0,1,0
56848,64252,53,36702,53,allow,198,101,97,2,31,1,1
56849,49696,53,54642,53,allow,172,88,84,2,30,1,1
56850,34114,443,15852,443,allow,6206,1695,4511,25,16,13,12
56851,53560,42459,25720,42459,allow,552,306,246,9,17,5,4
56852,47510,443,50202,443,allow,5149,852,4297,16,15,9,7
56853,64403,53,60359,53,allow,198,101,97,2,30,1,1
56854,47087,15000,40073,15000,allow,138,78,60,2,5,1,1
56855,50930,443,54294,443,allow,134,60,74,3,10,2,1
56856,60395,6890,18737,6890,allow,70,70,0,1,5,1,0
56857,49945,53,48312,53,allow,281,97,184,4,58,2,2
56858,56750,53,47077,53,allow,711,87,624,2,30,1,1
56859,49175,53,59846,53,allow,186,95,91,2,30,1,1
56860,65469,53,59478,53,allow,190,97,93,2,30,1,1
56861,50391,8080,50391,8080,allow,1614,785,829,11,54,6,5
56862,50387,8080,50387,8080,allow,7241,3224,4017,23,61,14,9
56863,49421,443,54717,443,allow,5422,801,4621,21,173,9,12
56864,51614,15000,49065,15000,allow,130,70,60,2,5,1,1
56865,48271,15000,29989,15000,allow,130,70,60,2,5,1,1
56866,56604,443,5643,443,allow,7915,1926,5989,20,15,11,9
56867,65498,53,36093,53,allow,202,103,99,2,31,1,1
56868,57010,53,20752,53,allow,198,101,97,2,30,1,1
56869,56603,443,20013,443,allow,7890,1901,5989,20,16,11,9
56870,53565,58695,4400,58695,allow,70,70,0,1,5,1,0
56871,45554,443,45554,443,allow,4617,1710,2907,19,26,11,8
56872,55317,443,24510,443,allow,5692,1239,4453,23,16,13,10
56873,50388,8080,50388,8080,allow,4417,2499,1918,18,56,10,8
56874,55353,53,50744,53,allow,168,86,82,2,30,1,1
56875,53229,443,53229,443,allow,1402,856,546,12,34,6,6
56876,53232,443,53232,443,allow,1270,697,573,15,33,8,7
56877,15629,53,15629,53,allow,209,77,132,2,32,1,1
56878,56606,443,12642,443,allow,7914,1925,5989,20,15,11,9
56879,40103,443,24820,443,allow,161,101,60,2,5,1,1
56880,55467,53,15072,53,allow,186,95,91,2,30,1,1
56881,55670,53,52397,53,allow,774,101,673,2,30,1,1
56882,65357,53,15221,53,allow,176,90,86,2,30,1,1
56883,57051,443,6628,443,allow,594793,518081,76712,1350,1004,781,569
56884,65231,53,23789,53,allow,200,102,98,2,31,1,1
56885,57007,53,22184,53,allow,182,93,89,2,31,1,1
56886,53165,443,53165,443,allow,208,66,142,4,148,2,2
56887,56605,443,61768,443,allow,7863,1874,5989,20,15,11,9
56888,53234,443,53234,443,allow,1276,703,573,15,33,8,7
56889,65258,53,4624,53,allow,186,95,91,2,31,1,1
56890,59031,80,8208,80,allow,4119,611,3508,12,18,4,8
56891,47164,15000,48096,15000,allow,130,70,60,2,5,1,1
56892,25803,53,25803,53,allow,231,88,143,2,33,1,1
56893,51753,15038,53015,15038,allow,66,66,0,1,5,1,0
56894,19876,53,19876,53,allow,209,77,132,2,33,1,1
56895,51772,59814,12241,59814,allow,70,70,0,2,8,2,0
56896,56918,53,41255,53,allow,778,103,675,2,30,1,1
56897,5588,5588,0,0,allow,3354,1792,1562,46,195,23,23
56898,65131,53,35643,53,allow,168,86,82,2,30,1,1
56899,56883,53,62227,53,allow,184,94,90,2,30,1,1
56900,49676,53,36174,53,allow,733,86,647,2,30,1,1
56901,65189,27015,25924,27015,allow,233,71,162,2,30,1,1
56902,56425,53,17413,53,allow,760,97,663,2,30,1,1
56903,55688,53,32958,53,allow,182,93,89,2,30,1,1
56904,65189,27255,47951,27255,allow,278,71,207,2,30,1,1
56905,59948,443,41928,443,allow,349197,16542,332655,411,129,150,261
56906,49229,53,8820,53,allow,88,88,0,1,31,1,0
56907,57416,53,62592,53,allow,186,95,91,2,31,1,1
56908,49632,443,26348,443,allow,3618,961,2657,13,121,6,7
56909,49486,53,33759,53,allow,170,87,83,2,31,1,1
56910,65040,53,62726,53,allow,176,90,86,2,31,1,1
56911,50604,53,2592,53,allow,752,93,659,2,31,1,1
56912,64885,53,64870,53,allow,753,93,660,2,31,1,1
56913,65048,53,26939,53,allow,188,96,92,2,31,1,1
56914,55634,53,60487,53,allow,204,104,100,2,31,1,1
56915,64216,53,11505,53,allow,182,93,89,2,30,1,1
56916,57172,53,55364,53,allow,192,98,94,2,31,1,1
56917,55796,53,45006,53,allow,192,98,94,2,31,1,1
56918,49777,53,59395,53,allow,164,84,80,2,31,1,1
56919,64986,53,47302,53,allow,176,90,86,2,31,1,1
56920,55705,53,57706,53,allow,202,103,99,2,31,1,1
56921,56802,53,9464,53,allow,753,93,660,2,31,1,1
56922,49917,53,47966,53,allow,752,93,659,2,31,1,1
56923,49369,53,3787,53,allow,182,93,89,2,31,1,1
56924,65179,53,5745,53,allow,184,94,90,2,31,1,1
56925,56901,53,23977,53,allow,710,89,621,2,31,1,1
56926,56167,53,36482,53,allow,172,88,84,2,31,1,1
56927,50265,41071,33048,41071,allow,1716,1716,0,27,2188,27,0
56928,57139,53,1323,53,allow,164,84,80,2,31,1,1
56929,58034,443,61141,443,allow,4553,856,3697,17,362,9,8
56930,49983,53,22293,53,allow,206,105,101,2,31,1,1
56931,65424,53,25204,53,allow,204,104,100,2,31,1,1
56932,55743,53,6640,53,allow,748,106,642,2,31,1,1
56933,64949,53,23952,53,allow,208,106,102,2,31,1,1
56934,34734,443,41689,443,allow,7974,2716,5258,50,7261,26,24
56935,52680,445,0,0,drop,66,66,0,1,0,1,0
56936,1534,54369,0,0,deny,66,66,0,1,0,1,0
56937,57266,445,0,0,drop,70,70,0,1,0,1,0
56938,51105,50584,0,0,deny,62,62,0,1,0,1,0
56939,57262,445,0,0,drop,70,70,0,1,0,1,0
56940,57255,445,0,0,drop,70,70,0,1,0,1,0
56941,54836,443,5754,443,allow,119863,100823,19040,322,229,183,139
56942,50166,53,40117,53,allow,211,78,133,2,30,1,1
56943,50583,53,37919,53,allow,819,102,717,2,30,1,1
56944,56878,53,41614,53,allow,168,86,82,2,30,1,1
56945,49429,53,36318,53,allow,210,110,100,2,30,1,1
56946,56445,53,29245,53,allow,199,102,97,2,30,1,1
56947,56354,53,51631,53,allow,200,94,106,2,30,1,1
56948,53230,443,53230,443,allow,1462,916,546,13,34,7,6
56949,44879,443,44879,443,allow,7123,1020,6103,19,151,11,8
56950,49738,443,52506,443,allow,3085,1404,1681,15,15,7,8
56951,19371,53,19371,53,allow,214,82,132,2,31,1,1
56952,53235,443,53235,443,allow,1270,697,573,15,33,8,7
56953,44368,443,44368,443,allow,7123,1020,6103,19,151,11,8
56954,37109,80,41807,80,allow,763,434,329,8,14,5,3
56955,63672,443,63672,443,allow,4398,1491,2907,19,27,11,8
56956,63203,443,63203,443,allow,9324,4240,5084,24,16,13,11
56957,43218,443,21139,443,allow,7375,2087,5288,24,255,12,12
56958,51413,443,36557,443,allow,202,70,132,3,11,1,2
56959,55609,39869,9261,39869,allow,70,70,0,2,8,2,0
56960,65529,53,6825,53,allow,198,102,96,2,29,1,1
56961,49670,53,58566,53,allow,168,86,82,2,29,1,1
56962,59882,53,29947,53,allow,244,86,158,2,29,1,1
56963,65131,53,1840,53,allow,168,86,82,2,29,1,1
56964,57152,53,61515,53,allow,183,94,89,2,29,1,1
56965,57306,53,25248,53,allow,177,94,83,2,29,1,1
56966,52957,53,50377,53,allow,168,78,90,2,29,1,1
56967,55215,53,18031,53,allow,315,126,189,2,29,1,1
56968,56441,53,35817,53,allow,209,110,99,2,29,1,1
56969,64041,53,24835,53,allow,200,102,98,2,29,1,1
56970,44603,53,44603,53,allow,229,98,131,2,29,1,1
56971,65189,27212,4653,27212,allow,254,78,176,2,29,1,1
56972,55688,53,38445,53,allow,183,94,89,2,29,1,1
56973,49266,53,6643,53,allow,199,102,97,2,29,1,1
56974,65189,28115,45956,28115,allow,284,78,206,2,29,1,1
56975,49917,53,29420,53,allow,209,110,99,2,29,1,1
56976,65189,27015,11223,27015,allow,275,78,197,2,29,1,1
56977,65488,53,4906,53,allow,232,110,122,2,29,1,1
56978,65189,27015,42181,27015,allow,262,78,184,2,29,1,1
56979,56004,53,27325,53,allow,177,94,83,2,29,1,1
56980,65189,27268,56111,27268,allow,232,78,154,2,29,1,1
56981,55857,53,40207,53,allow,199,102,97,2,29,1,1
56982,65189,27016,20619,27016,allow,249,78,171,2,29,1,1
56983,49439,53,40925,53,allow,197,102,95,2,30,1,1
56984,65189,27015,60711,27015,allow,278,78,200,2,29,1,1
56985,65189,28015,14178,28015,allow,240,78,162,2,29,1,1
56986,64011,53,63004,53,allow,228,110,118,2,29,1,1
56987,65189,27202,50060,27202,allow,230,78,152,2,29,1,1
56988,55346,53,11251,53,allow,396,102,294,2,30,1,1
56989,49945,53,50921,53,allow,281,97,184,4,58,2,2
56990,50966,443,34957,443,allow,6350,1072,5278,18,40,10,8
56991,55614,29731,2636,29731,allow,70,70,0,2,8,2,0
56992,55615,13826,16063,13826,allow,70,70,0,2,8,2,0
56993,58053,25,49850,25,allow,1316,442,874,15,16,7,8
56994,65504,53,33205,53,allow,193,102,91,2,30,1,1
56995,56332,53,27865,53,allow,209,110,99,2,30,1,1
56996,49730,53,24529,53,allow,211,110,101,2,30,1,1
56997,50238,53,50499,53,allow,438,180,258,6,30,3,3
56998,56987,53,64863,53,allow,196,102,94,2,30,1,1
56999,65063,53,50094,53,allow,180,94,86,2,30,1,1
57000,57077,53,61276,53,allow,166,86,80,2,30,1,1
57001,55469,443,55469,443,allow,4579,1672,2907,19,29,11,8
57002,57010,53,26340,53,allow,199,102,97,2,30,1,1
57003,57306,53,20608,53,allow,573,186,387,6,71,3,3
57004,56477,53,13759,53,allow,199,102,97,2,30,1,1
57005,65380,53,10002,53,allow,180,94,86,2,30,1,1
57006,41343,443,31271,443,allow,7601,1595,6006,25,35,12,13
57007,56144,53,15210,53,allow,177,94,83,2,30,1,1
57008,49539,53,64502,53,allow,340,87,253,4,50,2,2
57009,56783,53,42766,53,allow,199,102,97,2,30,1,1
57010,56783,21279,18481,21279,allow,70,70,0,2,8,2,0
57011,65357,53,23805,53,allow,180,94,86,2,30,1,1
57012,6040,53,41772,53,allow,323,94,229,2,30,1,1
57013,49968,53,43611,53,allow,751,94,657,2,30,1,1
57014,37889,53,32762,53,allow,199,94,105,2,30,1,1
57015,57331,53,38724,53,allow,166,86,80,2,30,1,1
57016,50583,53,45479,53,allow,196,102,94,2,30,1,1
57017,55502,53,15110,53,allow,194,102,92,2,30,1,1
57018,65014,53,57511,53,allow,193,102,91,2,30,1,1
57019,65380,53,23186,53,allow,180,94,86,2,30,1,1
57020,57010,53,46777,53,allow,199,102,97,2,30,1,1
57021,56357,53,47293,53,allow,196,102,94,2,30,1,1
57022,65516,53,21286,53,allow,209,110,99,2,30,1,1
57023,65063,53,22032,53,allow,180,94,86,2,30,1,1
57024,49486,53,9984,53,allow,177,94,83,2,30,1,1
57025,42936,53,47625,53,allow,199,94,105,2,30,1,1
57026,56006,53,47168,53,allow,210,102,108,2,30,1,1
57027,55353,53,65240,53,allow,168,86,82,2,30,1,1
57028,55705,53,14171,53,allow,209,110,99,2,30,1,1
57029,59424,443,18512,443,allow,252,70,182,3,120,1,2
57030,46451,443,47700,443,allow,350492,17722,332770,449,125,169,280
57031,56477,53,54398,53,allow,199,102,97,2,30,1,1
57032,49384,53,27649,53,allow,181,94,87,2,30,1,1
57033,51771,19103,40132,19103,allow,70,70,0,2,8,2,0
57034,51411,443,11555,443,allow,202,70,132,3,11,1,2
57035,41972,5222,18449,5222,allow,5709,2977,2732,62,621,31,31
57036,37694,443,63637,443,allow,234688,15158,219530,324,173,157,167
57037,64913,53,26175,53,allow,555,195,360,6,62,3,3
57038,57010,53,64390,53,allow,199,102,97,2,30,1,1
57039,65417,53,53892,53,allow,183,94,89,2,30,1,1
57040,54984,53,62420,53,allow,994,86,908,2,30,1,1
57041,49439,53,11369,53,allow,197,102,95,2,30,1,1
57042,59614,53,24145,53,allow,417,78,339,2,30,1,1
57043,56899,53,4081,53,allow,258,102,156,2,30,1,1
57044,56375,53,53548,53,allow,184,102,82,2,30,1,1
57045,55057,53,28179,53,allow,889,404,485,10,30,5,5
57046,65231,53,56850,53,allow,200,102,98,2,30,1,1
57047,51755,24236,52970,24236,allow,136,136,0,3,13,3,0
57048,51754,1182,24029,1182,allow,70,70,0,1,5,1,0
57049,49478,53,32475,53,allow,551,114,437,4,37,2,2
57050,65295,53,41511,53,allow,944,205,739,6,45,3,3
57051,51715,443,35378,443,allow,4175264,89546,4085718,4141,532,1111,3030
57052,49730,53,46996,53,allow,211,110,101,2,30,1,1
57053,55722,53,19688,53,allow,226,110,116,2,30,1,1
57054,41780,53,0,0,allow,86,86,0,1,30,1,0
57055,65131,53,31647,53,allow,168,86,82,2,30,1,1
57056,49183,53,46145,53,allow,817,102,715,2,30,1,1
57057,55502,53,12440,53,allow,817,102,715,2,30,1,1
57058,64913,53,45899,53,allow,183,94,89,2,30,1,1
57059,49885,53,57862,53,allow,786,110,676,2,30,1,1
57060,57416,53,21354,53,allow,193,102,91,2,30,1,1
57061,55706,53,9851,53,allow,258,102,156,2,30,1,1
57062,49638,53,6600,53,allow,210,110,100,2,30,1,1
57063,49638,53,20349,53,allow,210,110,100,2,30,1,1
57064,65014,53,36571,53,allow,193,102,91,2,30,1,1
57065,50017,53,65009,53,allow,741,94,647,2,30,1,1
57066,38317,443,31937,443,allow,9834,4297,5537,26,326,12,14
57067,51322,443,58671,443,allow,6250,1422,4828,20,17,10,10
57068,50716,80,11421,80,allow,1106,326,780,12,140,6,6
57069,35866,80,8550,80,allow,1114,534,580,12,15,7,5
57070,35353,443,65162,443,allow,1833,991,842,14,224,7,7
57071,58362,443,29130,443,allow,13272,2360,10912,37,208,19,18
57072,35354,443,9498,443,allow,2392,917,1475,16,224,8,8
57073,42597,443,21561,443,allow,6131,1399,4732,20,979,10,10
57074,49420,443,10802,443,allow,4932,1046,3886,21,173,10,11
57075,33521,80,30889,80,allow,3429,1679,1750,14,22,8,6
57076,56614,80,65163,80,allow,234,234,0,4,11,4,0
57077,39358,443,53461,443,allow,9115,6806,2309,37,80,20,17
57078,53231,443,53231,443,allow,1402,856,546,12,34,6,6
57079,49288,443,9666,443,allow,7846,2369,5477,23,385,10,13
57080,12162,53,12162,53,allow,233,90,143,2,33,1,1
57081,64287,53,8913,53,allow,280,91,189,4,33,2,2
57082,60400,56243,28136,56243,allow,70,70,0,2,8,2,0
57083,51295,443,27138,443,allow,7448,1737,5711,24,201,13,11
57084,55467,53,6293,53,allow,320,95,225,4,41,2,2
57085,64618,53,41913,53,allow,305,100,205,4,54,2,2
57086,59418,443,19462,443,allow,7222,1633,5589,24,201,13,11
57087,35267,80,35004,80,allow,613,539,74,7,15,6,1
57088,49235,53,43539,53,allow,164,78,86,2,29,1,1
57089,56441,53,4935,53,allow,209,110,99,2,29,1,1
57090,1928,53,30597,53,allow,210,78,132,2,29,1,1
57091,65189,28215,62292,28215,allow,259,78,181,2,29,1,1
57092,56883,53,30894,53,allow,184,94,90,2,29,1,1
57093,65189,27016,36079,27016,allow,78,78,0,1,29,1,0
57094,65189,27257,41492,27257,allow,252,78,174,2,29,1,1
57095,65189,27214,42310,27214,allow,231,78,153,2,29,1,1
57096,50006,53,41506,53,allow,994,86,908,2,29,1,1
57097,64323,53,18965,53,allow,195,102,93,2,30,1,1
57098,55467,53,17631,53,allow,193,102,91,2,29,1,1
57099,61858,10443,43005,10443,allow,10747,2507,8240,26,48,14,12
57100,65514,53,14703,53,allow,214,110,104,2,29,1,1
57101,65056,53,34239,53,allow,199,102,97,2,29,1,1
57102,65189,28125,44608,28125,allow,78,78,0,1,29,1,0
57103,55517,53,26427,53,allow,179,94,85,2,29,1,1
57104,54990,53,62190,53,allow,166,86,80,2,29,1,1
57105,65056,53,26315,53,allow,199,102,97,2,29,1,1
57106,49429,53,17254,53,allow,210,110,100,2,29,1,1
57107,64311,53,4229,53,allow,199,102,97,2,29,1,1
57108,49539,53,25645,53,allow,177,94,83,2,30,1,1
57109,65131,53,44924,53,allow,168,86,82,2,30,1,1
57110,49851,53,9637,53,allow,166,86,80,2,29,1,1
57111,49183,53,53469,53,allow,194,102,92,2,30,1,1
57112,55634,53,8065,53,allow,210,110,100,2,30,1,1
57113,42151,53,3505,53,allow,168,78,90,2,30,1,1
57114,49341,53,47990,53,allow,199,102,97,2,31,1,1
57115,56375,53,4600,53,allow,184,102,82,2,30,1,1
57116,49785,53,52317,53,allow,211,110,101,2,30,1,1
57117,65380,53,28417,53,allow,180,94,86,2,30,1,1
57118,56963,53,26493,53,allow,210,110,100,2,30,1,1
57119,55796,53,36094,53,allow,196,102,94,2,30,1,1
57120,56111,53,5335,53,allow,179,94,85,2,30,1,1
57121,65258,53,48935,53,allow,193,102,91,2,30,1,1
57122,54031,53,23447,53,allow,168,78,90,2,30,1,1
57123,64739,53,35789,53,allow,164,86,78,2,31,1,1
57124,56477,53,18413,53,allow,386,101,285,4,31,2,2
57125,64831,53,42481,53,allow,216,110,106,2,30,1,1
57126,57570,443,58853,443,allow,6226,4213,2013,30,79,18,12
57127,27464,53,27464,53,allow,233,90,143,2,32,1,1
57128,50390,8080,50390,8080,allow,378,180,198,7,54,4,3
57129,64403,53,16361,53,allow,783,197,586,6,70,3,3
57130,65014,53,29342,53,allow,193,102,91,2,30,1,1
57131,65063,53,52560,53,allow,180,94,86,2,30,1,1
57132,49785,53,47696,53,allow,211,110,101,2,30,1,1
57133,65359,53,55689,53,allow,193,102,91,2,30,1,1
57134,56104,53,24374,53,allow,197,102,95,2,30,1,1
57135,64216,53,1409,53,allow,183,94,89,2,30,1,1
57136,49229,53,18433,53,allow,178,94,84,2,31,1,1
57137,49361,53,25462,53,allow,184,94,90,2,30,1,1
57138,50885,80,41376,80,allow,291594,13131,278463,312,159,116,196
57139,60401,30046,28995,30046,allow,70,70,0,2,8,2,0
57140,35790,443,59845,443,allow,6777,1527,5250,24,201,13,11
57141,52404,443,21006,443,allow,132575,6675,125900,206,94,91,115
57142,50389,8080,50389,8080,allow,5724,1509,4215,18,55,10,8
57143,49812,53,36103,53,allow,1411,98,1313,4,52,2,2
57144,65504,53,23026,53,allow,193,102,91,2,30,1,1
57145,65417,53,31307,53,allow,183,94,89,2,30,1,1
57146,60601,53,19741,53,allow,451,86,365,2,30,1,1
57147,56144,53,34369,53,allow,177,94,83,2,30,1,1
57148,64121,53,21027,53,allow,365,102,263,2,31,1,1
57149,55199,443,3846,443,allow,18132,8636,9496,40,176,23,17
57150,48673,443,24154,443,allow,18147,9173,8974,42,175,24,18
57151,51467,443,7148,443,allow,20313,6637,13676,45,24,23,22
57152,55610,23383,23402,23383,allow,70,70,0,2,8,2,0
57153,49562,443,58637,443,allow,9908,4692,5216,30,92,16,14
57154,49361,53,49782,53,allow,166,86,80,2,30,1,1
57155,64323,53,64062,53,allow,195,102,93,2,30,1,1
57156,56357,53,43441,53,allow,819,102,717,2,30,1,1
57157,49175,53,18016,53,allow,193,102,91,2,30,1,1
57158,59645,53,23128,53,allow,263,94,169,2,30,1,1
57159,64438,53,4120,53,allow,184,94,90,2,30,1,1
57160,56332,53,16709,53,allow,209,110,99,2,30,1,1
57161,65514,53,43311,53,allow,214,110,104,2,30,1,1
57162,64216,53,16244,53,allow,183,94,89,2,30,1,1
57163,43326,443,42679,443,allow,10063,2126,7937,36,120,18,18
57164,55353,53,1525,53,allow,168,86,82,2,30,1,1
57165,56605,53,38242,53,allow,341,110,231,2,30,1,1
57166,64252,53,2072,53,allow,199,102,97,2,30,1,1
57167,65258,53,25267,53,allow,193,102,91,2,30,1,1
57168,65469,53,49560,53,allow,195,102,93,2,30,1,1
57169,64235,53,40648,53,allow,197,102,95,2,30,1,1
57170,56963,53,63248,53,allow,210,110,100,2,30,1,1
57171,49983,53,2734,53,allow,211,110,101,2,30,1,1
57172,65448,53,6069,53,allow,264,110,154,2,30,1,1
57173,65498,53,57439,53,allow,209,110,99,2,30,1,1
57174,64216,53,45002,53,allow,295,93,202,4,30,2,2
57175,65040,53,10817,53,allow,180,94,86,2,31,1,1
57176,56326,53,47935,53,allow,177,94,83,2,31,1,1
57177,49670,53,59914,53,allow,168,86,82,2,31,1,1
57178,57470,2710,46091,2710,allow,124,124,0,3,1199,3,0
57179,49732,53,17684,53,allow,178,94,84,2,30,1,1
57180,64986,53,8227,53,allow,180,94,86,2,30,1,1
57181,55958,53,25725,53,allow,209,102,107,2,30,1,1
57182,56765,53,52447,53,allow,194,102,92,2,30,1,1
57183,64254,53,19864,53,allow,197,94,103,2,30,1,1
57184,65498,53,39980,53,allow,209,110,99,2,30,1,1
57185,65424,53,39053,53,allow,210,110,100,2,31,1,1
57186,56953,53,15670,53,allow,421,78,343,2,31,1,1
57187,49486,53,40876,53,allow,177,94,83,2,31,1,1
57188,65514,53,32610,53,allow,214,110,104,2,31,1,1
57189,57172,53,27478,53,allow,196,102,94,2,31,1,1
57190,55145,443,65048,443,allow,13231,6169,7062,38,120,19,19
57191,65498,53,26410,53,allow,209,110,99,2,30,1,1
57192,49785,53,63638,53,allow,211,110,101,2,30,1,1
57193,49777,53,14014,53,allow,166,86,80,2,30,1,1
57194,49429,53,19279,53,allow,210,110,100,2,30,1,1
57195,55796,53,53720,53,allow,196,102,94,2,30,1,1
57196,55975,53,28209,53,allow,195,102,93,2,30,1,1
57197,57007,53,62995,53,allow,183,94,89,2,31,1,1
57198,49670,53,37029,53,allow,168,86,82,2,30,1,1
57199,64420,53,18764,53,allow,386,102,284,2,30,1,1
57200,49831,53,24463,53,allow,364,102,262,2,30,1,1
57201,65024,53,10602,53,allow,196,94,102,2,30,1,1
57202,49696,53,9591,53,allow,178,94,84,2,30,1,1
57203,49862,53,52956,53,allow,715,94,621,2,31,1,1
57204,49861,53,56690,53,allow,198,102,96,2,31,1,1
57205,55975,53,44915,53,allow,195,102,93,2,31,1,1
57206,64677,53,13173,53,allow,195,102,93,2,31,1,1
57207,49175,53,45258,53,allow,193,102,91,2,31,1,1
57208,55286,53,22334,53,allow,194,102,92,2,31,1,1
57209,64517,53,18639,53,allow,194,102,92,2,31,1,1
57210,65231,53,37315,53,allow,200,102,98,2,31,1,1
57211,49696,53,25941,53,allow,178,94,84,2,31,1,1
57212,6881,30096,6963,30096,allow,509,150,359,2,1199,1,1
57213,39402,443,48958,443,allow,6417,1255,5162,24,360,12,12
57214,17750,14132,3203,14132,allow,150,150,0,1,1200,1,0
57215,6881,20326,20950,20326,allow,509,150,359,2,1200,1,1
57216,49478,53,58294,53,allow,164,86,78,2,31,1,1
57217,56279,443,57070,443,allow,97608,4852,92756,108,121,37,71
57218,56445,53,26251,53,allow,199,102,97,2,30,1,1
57219,49861,53,42147,53,allow,198,102,96,2,30,1,1
57220,49486,53,16915,53,allow,177,94,83,2,30,1,1
57221,49369,53,54778,53,allow,183,94,89,2,30,1,1
57222,64531,53,60188,53,allow,183,94,89,2,30,1,1
57223,49983,53,17295,53,allow,211,110,101,2,31,1,1
57224,65258,53,31384,53,allow,193,102,91,2,31,1,1
57225,55796,53,15761,53,allow,196,102,94,2,31,1,1
57226,64873,53,31946,53,allow,195,94,101,2,31,1,1
57227,50022,53,5739,53,allow,179,94,85,2,31,1,1
57228,49777,53,45833,53,allow,166,86,80,2,31,1,1
57229,60384,443,37407,443,allow,39385,3771,35614,67,129,27,40
57230,49803,443,21959,443,allow,9506,1461,8045,20,158,9,11
57231,48847,443,1416,443,allow,2523,1483,1040,19,276,10,9
57232,37965,25180,40858,25180,allow,858,858,0,14,1199,14,0
57233,64408,53,9592,53,allow,257,126,131,2,31,1,1
57234,53558,30815,59383,30815,allow,492,306,186,8,16,5,3
57235,51676,443,25301,443,allow,90135,76061,14074,251,247,132,119
57236,64949,53,48447,53,allow,212,110,102,2,31,1,1
57237,55353,53,50896,53,allow,311,86,225,4,55,2,2
57238,41833,443,22584,443,allow,50425,3972,46453,63,122,25,38
57239,47884,443,47884,443,allow,4672,1765,2907,18,28,10,8
57240,53561,35885,5770,35885,allow,70,70,0,1,5,1,0
57241,57267,443,26309,443,allow,126,60,66,3,6,2,1
57242,57257,445,0,0,drop,70,70,0,1,0,1,0
57243,52678,445,0,0,drop,66,66,0,1,0,1,0
57244,52258,445,0,0,drop,70,70,0,1,0,1,0
57245,52257,445,0,0,drop,70,70,0,1,0,1,0
57246,13747,8887,13747,8887,deny,500,500,0,1,0,1,0
57247,33289,50584,0,0,deny,146,146,0,1,0,1,0
57248,61221,35440,0,0,deny,66,66,0,1,0,1,0
57249,57251,445,0,0,drop,70,70,0,1,0,1,0
57250,58305,18375,0,0,deny,66,66,0,1,0,1,0
57251,62338,50011,0,0,deny,62,62,0,1,0,1,0
57252,57249,445,0,0,drop,70,70,0,1,0,1,0
57253,57248,445,0,0,drop,70,70,0,1,0,1,0
57254,57246,445,0,0,drop,70,70,0,1,0,1,0
57255,52251,445,0,0,drop,70,70,0,1,0,1,0
57256,52671,445,0,0,drop,66,66,0,1,0,1,0
57257,48676,53398,0,0,deny,60,60,0,1,0,1,0
57258,52250,445,0,0,drop,70,70,0,1,0,1,0
57259,52665,445,0,0,drop,66,66,0,1,0,1,0
57260,52666,445,0,0,drop,66,66,0,1,0,1,0
57261,52664,445,0,0,drop,66,66,0,1,0,1,0
57262,58703,50584,0,0,deny,66,66,0,1,0,1,0
57263,26324,30188,0,0,deny,62,62,0,1,0,1,0
57264,52660,445,0,0,drop,66,66,0,1,0,1,0
57265,52661,445,0,0,drop,66,66,0,1,0,1,0
57266,52658,445,0,0,drop,66,66,0,1,0,1,0
57267,52246,445,0,0,drop,70,70,0,1,0,1,0
57268,56703,50584,0,0,deny,62,62,0,1,0,1,0
57269,51191,26467,0,0,deny,66,66,0,1,0,1,0
57270,63583,37965,0,0,deny,62,62,0,1,0,1,0
57271,16393,22114,0,0,deny,66,66,0,1,0,1,0
57272,52245,445,0,0,drop,70,70,0,1,0,1,0
57273,61426,64910,0,0,deny,66,66,0,1,0,1,0
57274,57244,445,0,0,drop,70,70,0,1,0,1,0
57275,57241,445,0,0,drop,70,70,0,1,0,1,0
57276,57240,445,0,0,drop,70,70,0,1,0,1,0
57277,5223,59023,0,0,deny,66,66,0,1,0,1,0
57278,52657,445,0,0,drop,66,66,0,1,0,1,0
57279,30599,46824,0,0,deny,66,66,0,1,0,1,0
57280,57236,445,0,0,drop,70,70,0,1,0,1,0
57281,443,46382,0,0,deny,66,66,0,1,0,1,0
57282,52652,445,0,0,drop,66,66,0,1,0,1,0
57283,52651,445,0,0,drop,66,66,0,1,0,1,0
57284,53772,443,49684,443,allow,499,425,74,4,0,3,1
57285,53770,443,15341,443,allow,499,425,74,4,0,3,1
57286,53768,443,3588,443,allow,499,425,74,4,0,3,1
57287,53755,443,8268,443,allow,499,425,74,4,0,3,1
57288,53771,443,40823,443,allow,499,425,74,4,0,3,1
57289,53760,443,44529,443,allow,499,425,74,4,0,3,1
57290,53765,443,33408,443,allow,499,425,74,4,0,3,1
57291,53759,443,57982,443,allow,499,425,74,4,0,3,1
57292,53763,443,53593,443,allow,499,425,74,4,0,3,1
57293,53773,443,19967,443,allow,499,425,74,4,0,3,1
57294,53766,443,46858,443,allow,499,425,74,4,0,3,1
57295,53774,443,4137,443,allow,499,425,74,4,0,3,1
57296,53761,443,39818,443,allow,499,425,74,4,0,3,1
57297,53762,443,60750,443,allow,499,425,74,4,0,3,1
57298,53750,443,4212,443,allow,499,425,74,4,0,3,1
57299,53757,443,15611,443,allow,499,425,74,4,0,3,1
57300,53767,443,6984,443,allow,499,425,74,4,0,3,1
57301,53764,443,56074,443,allow,499,425,74,4,0,3,1
57302,53752,443,21616,443,allow,499,425,74,4,0,3,1
57303,53753,443,5988,443,allow,499,425,74,4,0,3,1
57304,53758,443,30147,443,allow,499,425,74,4,0,3,1
57305,53754,443,24588,443,allow,499,425,74,4,0,3,1
57306,53756,443,48419,443,allow,499,425,74,4,0,3,1
57307,53751,443,44095,443,allow,499,425,74,4,0,3,1
57308,52649,445,0,0,drop,66,66,0,1,0,1,0
57309,56712,46824,0,0,deny,66,66,0,1,0,1,0
57310,56119,46824,0,0,deny,62,62,0,1,0,1,0
57311,39823,36237,0,0,deny,62,62,0,1,0,1,0
57312,52647,445,0,0,drop,66,66,0,1,0,1,0
57313,64219,51050,0,0,deny,66,66,0,1,0,1,0
57314,52240,445,0,0,drop,70,70,0,1,0,1,0
57315,54062,31573,0,0,deny,66,66,0,1,0,1,0
57316,62071,22114,0,0,deny,62,62,0,1,0,1,0
57317,57232,445,0,0,drop,70,70,0,1,0,1,0
57318,32511,23,0,0,deny,60,60,0,1,0,1,0
57319,3270,35440,0,0,deny,66,66,0,1,0,1,0
57320,57225,445,0,0,drop,70,70,0,1,0,1,0
57321,57224,445,0,0,drop,70,70,0,1,0,1,0
57322,36906,50584,0,0,deny,62,62,0,1,0,1,0
57323,13654,50584,0,0,deny,62,62,0,1,0,1,0
57324,52638,445,0,0,drop,66,66,0,1,0,1,0
57325,40834,50584,0,0,deny,62,62,0,1,0,1,0
57326,52227,445,0,0,drop,70,70,0,1,0,1,0
57327,58486,57470,0,0,deny,66,66,0,1,0,1,0
57328,32491,15503,0,0,deny,66,66,0,1,0,1,0
57329,50535,51505,0,0,deny,66,66,0,1,0,1,0
57330,52224,445,0,0,drop,70,70,0,1,0,1,0
57331,52629,445,0,0,drop,66,66,0,1,0,1,0
57332,42252,33303,0,0,deny,60,60,0,1,0,1,0
57333,57210,445,0,0,drop,70,70,0,1,0,1,0
57334,24480,35440,0,0,deny,66,66,0,1,0,1,0
57335,52497,47967,0,0,deny,143,143,0,1,0,1,0
57336,52626,445,0,0,drop,66,66,0,1,0,1,0
57337,16660,55783,0,0,deny,62,62,0,1,0,1,0
57338,52220,445,0,0,drop,70,70,0,1,0,1,0
57339,52218,445,0,0,drop,70,70,0,1,0,1,0
57340,52618,445,0,0,drop,66,66,0,1,0,1,0
57341,26110,2310,0,0,deny,148,148,0,1,0,1,0
57342,52216,445,0,0,drop,70,70,0,1,0,1,0
57343,52615,445,0,0,drop,66,66,0,1,0,1,0
57344,51265,31652,0,0,reset-both,72,72,0,1,0,1,0
57345,19156,3846,0,0,deny,145,145,0,1,0,1,0
57346,54339,23117,0,0,deny,66,66,0,1,0,1,0
57347,9412,7302,0,0,deny,66,66,0,1,0,1,0
57348,63465,56205,0,0,deny,66,66,0,1,0,1,0
57349,52209,445,0,0,drop,70,70,0,1,0,1,0
57350,57199,445,0,0,drop,70,70,0,1,0,1,0
57351,57196,445,0,0,drop,70,70,0,1,0,1,0
57352,57197,445,0,0,drop,70,70,0,1,0,1,0
57353,52596,445,0,0,drop,66,66,0,1,0,1,0
57354,52600,445,0,0,drop,66,66,0,1,0,1,0
57355,52603,445,0,0,drop,66,66,0,1,0,1,0
57356,52602,445,0,0,drop,66,66,0,1,0,1,0
57357,52598,445,0,0,drop,66,66,0,1,0,1,0
57358,52601,445,0,0,drop,66,66,0,1,0,1,0
57359,52604,445,0,0,drop,66,66,0,1,0,1,0
57360,52599,445,0,0,drop,66,66,0,1,0,1,0
57361,1024,64147,0,0,deny,62,62,0,1,0,1,0
57362,52207,445,0,0,drop,70,70,0,1,0,1,0
57363,37597,50584,0,0,deny,66,66,0,1,0,1,0
57364,443,31353,0,0,deny,97,97,0,1,0,1,0
57365,443,49313,0,0,deny,97,97,0,1,0,1,0
57366,51617,21247,0,0,deny,66,66,0,1,0,1,0
57367,58445,17500,0,0,deny,66,66,0,1,0,1,0
57368,52206,445,0,0,drop,70,70,0,1,0,1,0
57369,57772,50584,0,0,deny,66,66,0,1,0,1,0
57370,52205,445,0,0,drop,70,70,0,1,0,1,0
57371,52204,445,0,0,drop,70,70,0,1,0,1,0
57372,52200,445,0,0,drop,70,70,0,1,0,1,0
57373,52201,445,0,0,drop,70,70,0,1,0,1,0
57374,44546,32468,0,0,deny,146,146,0,1,0,1,0
57375,62549,64147,0,0,deny,62,62,0,1,0,1,0
57376,54343,50584,0,0,deny,66,66,0,1,0,1,0
57377,1323,64147,0,0,deny,66,66,0,1,0,1,0
57378,60018,64147,0,0,deny,62,62,0,1,0,1,0
57379,63852,35440,0,0,deny,66,66,0,1,0,1,0
57380,0,0,0,0,allow,320,320,0,5,0,5,0
57381,57194,445,0,0,drop,70,70,0,1,0,1,0
57382,57189,445,0,0,drop,70,70,0,1,0,1,0
57383,57181,445,0,0,drop,70,70,0,1,0,1,0
57384,16716,57470,0,0,deny,145,145,0,1,0,1,0
57385,52186,445,0,0,drop,70,70,0,1,0,1,0
57386,52185,445,0,0,drop,70,70,0,1,0,1,0
57387,52179,445,0,0,drop,70,70,0,1,0,1,0
57388,52583,445,0,0,drop,66,66,0,1,0,1,0
57389,52584,445,0,0,drop,66,66,0,1,0,1,0
57390,52582,445,0,0,drop,66,66,0,1,0,1,0
57391,52175,445,0,0,drop,70,70,0,1,0,1,0
57392,52176,445,0,0,drop,70,70,0,1,0,1,0
57393,24375,12809,0,0,deny,60,60,0,1,0,1,0
57394,57179,445,0,0,drop,70,70,0,1,0,1,0
57395,26921,37965,0,0,deny,62,62,0,1,0,1,0
57396,50439,64147,0,0,deny,66,66,0,1,0,1,0
57397,26924,37965,0,0,deny,66,66,0,1,0,1,0
57398,57176,445,0,0,drop,70,70,0,1,0,1,0
57399,57164,445,0,0,drop,70,70,0,1,0,1,0
57400,57168,445,0,0,drop,70,70,0,1,0,1,0
57401,57167,445,0,0,drop,70,70,0,1,0,1,0
57402,11410,36237,0,0,deny,146,146,0,1,0,1,0
57403,52164,445,0,0,drop,70,70,0,1,0,1,0
57404,34756,8055,0,0,deny,159,159,0,1,0,1,0
57405,57283,64147,0,0,deny,66,66,0,1,0,1,0
57406,65384,57470,0,0,deny,66,66,0,1,0,1,0
57407,47910,7454,0,0,deny,60,60,0,1,0,1,0
57408,13864,30718,0,0,deny,60,60,0,1,0,1,0
57409,49831,30188,0,0,deny,62,62,0,1,0,1,0
57410,63667,57470,0,0,deny,145,145,0,1,0,1,0
57411,59168,39004,0,0,deny,62,62,0,1,0,1,0
57412,51815,51221,0,0,deny,74,74,0,1,0,1,0
57413,24592,50584,0,0,deny,62,62,0,1,0,1,0
57414,57157,445,0,0,drop,70,70,0,1,0,1,0
57415,57156,445,0,0,drop,70,70,0,1,0,1,0
57416,57153,445,0,0,drop,70,70,0,1,0,1,0
57417,8976,44847,0,0,deny,66,66,0,1,0,1,0
57418,52160,445,0,0,drop,70,70,0,1,0,1,0
57419,47888,2310,0,0,deny,145,145,0,1,0,1,0
57420,52150,445,0,0,drop,70,70,0,1,0,1,0
57421,52151,445,0,0,drop,70,70,0,1,0,1,0
57422,52146,445,0,0,drop,70,70,0,1,0,1,0
57423,52147,445,0,0,drop,70,70,0,1,0,1,0
57424,52144,445,0,0,drop,70,70,0,1,0,1,0
57425,56445,53,52720,53,allow,198,101,97,2,30,1,1
57426,42135,443,55299,443,allow,6531,1249,5282,24,286,13,11
57427,62228,443,62228,443,allow,296688,57600,239088,332,96,141,191
57428,34366,443,43232,443,allow,1053,566,487,10,16,6,4
57429,42699,5222,6919,5222,allow,420,156,264,7,18,3,4
57430,35052,80,38624,80,allow,350,210,140,6,30,4,2
57431,49341,53,42621,53,allow,198,101,97,2,30,1,1
57432,50022,53,39220,53,allow,174,89,85,2,30,1,1
57433,64631,443,8739,443,allow,8701,3408,5293,48,256,22,26
57434,49332,53,40502,53,allow,281,98,183,4,57,2,2
57435,55046,80,55074,80,allow,1056,682,374,10,16,6,4
57436,11073,3389,11073,3389,allow,4085,1916,2169,21,18,12,9
57437,65115,53,24765,53,allow,186,95,91,2,30,1,1
57438,55975,53,65159,53,allow,190,97,93,2,30,1,1
57439,56326,53,54656,53,allow,170,87,83,2,30,1,1
57440,56830,53,35063,53,allow,752,93,659,2,30,1,1
57441,50881,80,50881,80,allow,13503,1052,12451,23,21,10,13
57442,49699,53,40136,53,allow,266,89,177,4,58,2,2
57443,43108,443,11094,443,allow,3117,1867,1250,19,16,9,10
57444,59416,443,46812,443,allow,2834,1700,1134,16,15,8,8
57445,55598,41565,5694,41565,allow,70,70,0,1,5,1,0
57446,49643,443,30041,443,allow,1640,1089,551,14,15,8,6
57447,56602,443,27563,443,allow,7942,1953,5989,20,15,11,9
57448,31123,53,31123,53,allow,231,88,143,2,34,1,1
57449,35050,80,51635,80,allow,350,210,140,6,30,4,2
57450,63749,13219,47890,13219,allow,504,382,122,8,15,6,2
57451,50566,443,50394,443,allow,11116,4583,6533,39,256,19,20
57452,56774,39553,19722,39553,allow,66,66,0,1,5,1,0
57453,58508,443,23694,443,allow,3386,1894,1492,20,25,10,10
57454,55286,53,55062,53,allow,188,96,92,2,30,1,1
57455,64235,53,36798,53,allow,194,99,95,2,30,1,1
57456,62229,443,62229,443,allow,211574,21152,190422,236,96,92,144
57457,35051,80,55027,80,allow,350,210,140,6,30,4,2
57458,64850,53,42650,53,allow,192,98,94,2,31,1,1
57459,24608,53,24608,53,allow,209,77,132,2,33,1,1
57460,45202,443,49520,443,allow,15153,8118,7035,45,271,22,23
57461,59415,443,30552,443,allow,2854,1700,1154,16,16,8,8
57462,60884,443,11637,443,allow,7411,3022,4389,26,46,15,11
57463,56601,443,9573,443,allow,7889,1900,5989,20,15,11,9
57464,59829,443,18743,443,allow,182,60,122,4,26,2,2
57465,49644,80,17566,80,allow,2950,601,2349,12,15,6,6
57466,38599,443,40890,443,allow,3605,1648,1957,20,255,10,10
57467,57367,443,24702,443,allow,7498,2799,4699,24,17,13,11
57468,56773,53,6473,53,allow,735,88,647,2,30,1,1
57469,56600,443,35329,443,allow,7941,1952,5989,20,15,11,9
57470,52346,5222,7493,5222,allow,3983,1663,2320,40,151,19,21
57471,56868,53,63238,53,allow,752,93,659,2,30,1,1
57472,64531,53,46731,53,allow,182,93,89,2,30,1,1
57473,63943,53,51755,53,allow,274,90,184,4,56,2,2
57474,50069,53,5416,53,allow,174,89,85,2,30,1,1
57475,34070,53,34070,53,allow,250,108,142,2,30,1,1
57476,65451,53,43825,53,allow,172,88,84,2,31,1,1
57477,64997,53,9569,53,allow,164,84,80,2,31,1,1
57478,64517,53,41007,53,allow,188,96,92,2,31,1,1
57479,57470,55000,8797,55000,allow,726,726,0,12,1200,12,0
57480,64677,53,35002,53,allow,190,97,93,2,31,1,1
57481,56744,53,44320,53,allow,740,93,647,2,31,1,1
57482,60366,443,31619,443,allow,14484,7411,7073,26,60,15,11
57483,56066,53,46856,53,allow,208,106,102,2,30,1,1
57484,49635,53,55370,53,allow,204,104,100,2,30,1,1
57485,54998,53,35657,53,allow,174,89,85,2,31,1,1
57486,49297,53,13905,53,allow,182,93,89,2,31,1,1
57487,64914,53,32177,53,allow,168,86,82,2,31,1,1
57488,56320,53,39261,53,allow,182,93,89,2,31,1,1
57489,64546,53,12738,53,allow,182,93,89,2,31,1,1
57490,64608,53,13914,53,allow,208,106,102,2,31,1,1
57491,57102,53,62083,53,allow,761,100,661,2,31,1,1
57492,64689,53,18910,53,allow,182,93,89,2,31,1,1
57493,54943,60038,0,0,allow,66,66,0,1,90,1,0
57494,64982,53,19403,53,allow,190,97,93,2,31,1,1
57495,57470,35667,24783,35667,allow,132,132,0,3,1200,3,0
57496,65098,53,21613,53,allow,740,93,647,2,31,1,1
57497,65371,53,39965,53,allow,198,101,97,2,31,1,1
57498,64726,53,62108,53,allow,172,88,84,2,31,1,1
57499,55964,443,21962,443,allow,4455,798,3657,17,136,7,10
57500,65513,53,35186,53,allow,190,97,93,2,31,1,1
57501,57470,54154,42196,54154,allow,480,149,331,2,1200,1,1
57502,6881,6881,0,0,deny,62,62,0,1,0,1,0
57503,18655,50584,0,0,deny,62,62,0,1,0,1,0
57504,28973,30188,0,0,deny,66,66,0,1,0,1,0
57505,42237,36237,0,0,deny,66,66,0,1,0,1,0
57506,57414,57470,0,0,deny,146,146,0,1,0,1,0
57507,52560,445,0,0,drop,66,66,0,1,0,1,0
57508,51172,443,45149,443,allow,1472,965,507,13,20,7,6
57509,50153,80,50079,80,allow,41846,1261,40585,45,75,13,32
57510,49332,53,38516,53,allow,281,98,183,4,57,2,2
57511,51413,443,51090,443,allow,63766,32148,31618,103,42,51,52
57512,57150,445,0,0,drop,70,70,0,1,0,1,0
57513,57149,445,0,0,drop,70,70,0,1,0,1,0
57514,26531,37965,0,0,deny,62,62,0,1,0,1,0
57515,24144,57470,0,0,deny,62,62,0,1,0,1,0
57516,61345,21247,0,0,deny,66,66,0,1,0,1,0
57517,53987,57470,0,0,deny,66,66,0,1,0,1,0
57518,52137,445,0,0,drop,70,70,0,1,0,1,0
57519,50784,52952,0,0,deny,62,62,0,1,0,1,0
57520,52913,2767,0,0,deny,66,66,0,1,0,1,0
57521,30114,65151,0,0,deny,60,60,0,1,0,1,0
57522,59879,55783,0,0,deny,66,66,0,1,0,1,0
57523,52555,445,0,0,drop,66,66,0,1,0,1,0
57524,64158,53,28086,53,allow,211,102,109,2,30,1,1
57525,55705,53,50083,53,allow,209,110,99,2,30,1,1
57526,54998,53,11974,53,allow,179,94,85,2,30,1,1
57527,49635,53,17449,53,allow,210,110,100,2,30,1,1
57528,49940,443,15585,443,allow,4363,1298,3065,17,127,8,9
57529,49260,53,30297,53,allow,791,85,706,4,57,2,2
57530,65266,53,28016,53,allow,536,113,423,4,56,2,2
57531,62230,443,62230,443,allow,119850,11021,108829,134,95,50,84
57532,50901,80,56736,80,allow,11091,2772,8319,22,154,12,10
57533,51777,63497,24893,63497,allow,316,136,180,6,6,3,3
57534,51177,443,18641,443,allow,154,94,60,2,4,1,1
57535,64252,53,63394,53,allow,381,101,280,4,43,2,2
57536,65040,53,46633,53,allow,180,94,86,2,29,1,1
57537,64999,53,64999,53,allow,230,90,140,2,30,1,1
57538,49228,443,49228,443,allow,32952,11546,21406,60,71,36,24
57539,60775,443,60775,443,allow,4652,1745,2907,19,29,11,8
57540,59978,443,59552,443,allow,10132,5161,4971,42,15,25,17
57541,49175,53,11847,53,allow,193,102,91,2,29,1,1
57542,60749,40010,57224,40010,allow,316,136,180,6,5,3,3
57543,64711,53,52164,53,allow,178,94,84,2,29,1,1
57544,35370,443,45689,443,allow,87183,4177,83006,104,126,34,70
57545,57139,53,34151,53,allow,166,86,80,2,29,1,1
57546,55747,53,57229,53,allow,215,102,113,2,29,1,1
57547,65040,53,64566,53,allow,180,94,86,2,29,1,1
57548,65469,53,34501,53,allow,195,102,93,2,29,1,1
57549,64956,53,13763,53,allow,565,92,473,4,38,2,2
57550,55705,53,38579,53,allow,209,110,99,2,29,1,1
57551,55634,53,37153,53,allow,210,110,100,2,30,1,1
57552,53555,57861,41718,57861,allow,492,306,186,8,15,5,3
57553,55286,53,58993,53,allow,194,102,92,2,29,1,1
57554,57139,53,51563,53,allow,166,86,80,2,30,1,1
57555,55517,53,64032,53,allow,179,94,85,2,29,1,1
57556,49341,53,19411,53,allow,199,102,97,2,29,1,1
57557,51779,3389,21341,3389,allow,62242217,4119315,58122902,123738,4772,43917,79821
57558,2070,53,2070,53,allow,233,90,143,2,32,1,1
57559,36074,80,23733,80,allow,1158,792,366,10,17,6,4
57560,59977,443,64573,443,allow,7971,2647,5324,38,15,24,14
57561,50203,80,15124,80,allow,4020,1978,2042,16,66,9,7
57562,64079,53,36707,53,allow,232,94,138,2,30,1,1
57563,49332,53,50877,53,allow,281,98,183,4,57,2,2
57564,46590,443,20776,443,allow,6665,1130,5535,24,287,13,11
57565,50307,443,50307,443,allow,4378,1471,2907,19,30,11,8
57566,57127,53,41259,53,allow,195,102,93,2,30,1,1
57567,60886,443,34294,443,allow,3855,2679,1176,28,45,15,13
57568,39821,443,37984,443,allow,11179,7205,3974,47,136,26,21
57569,51171,443,60392,443,allow,1532,965,567,14,20,7,7
57570,49367,53,7025,53,allow,548,112,436,4,36,2,2
57571,34239,80,12111,80,allow,1056,682,374,10,15,6,4
57572,63226,443,50931,443,allow,4462,2023,2439,33,125,17,16
57573,64986,53,27800,53,allow,180,94,86,2,30,1,1
57574,55597,7485,34248,7485,allow,70,70,0,1,5,1,0
57575,8984,443,5920,443,allow,13750,4934,8816,64,167,31,33
57576,25776,53,25776,53,allow,233,90,143,2,32,1,1
57577,56167,53,17314,53,allow,178,94,84,2,30,1,1
57578,60405,443,60867,443,allow,6570,1988,4582,19,57,10,9
57579,45564,443,3708,443,allow,69614,5520,64094,100,21,52,48
57580,64739,53,12107,53,allow,172,94,78,2,30,1,1
57581,50149,80,19755,80,allow,78701,4331,74370,77,75,21,56
57582,49920,80,51045,80,allow,3649288,78688,3570600,2923,179,528,2395
57583,57416,53,2716,53,allow,193,102,91,2,30,1,1
57584,65048,53,32798,53,allow,194,102,92,2,30,1,1
57585,63998,53,51868,53,allow,263,126,137,2,30,1,1
57586,64531,53,41084,53,allow,183,94,89,2,30,1,1
57587,49983,53,57759,53,allow,211,110,101,2,30,1,1
57588,64388,53,48927,53,allow,248,102,146,2,30,1,1
57589,49820,53,40891,53,allow,211,102,109,2,30,1,1
57590,64126,53,25754,53,allow,255,102,153,2,30,1,1
57591,60887,443,40935,443,allow,3795,2679,1116,27,45,15,12
57592,45174,443,32047,443,allow,6196,1417,4779,21,665,11,10
57593,43120,80,4226,80,allow,1151,711,440,10,15,5,5
57594,50419,80,40888,80,allow,3664,1440,2224,12,23,6,6
57595,50193,443,31534,443,allow,2404,1121,1283,14,115,7,7
57596,63943,53,16297,53,allow,258,90,168,4,56,2,2
57597,49777,53,60241,53,allow,272,84,188,4,60,2,2
57598,50069,53,27415,53,allow,179,94,85,2,30,1,1
57599,49369,53,21146,53,allow,183,94,89,2,30,1,1
57600,49297,53,2852,53,allow,183,94,89,2,30,1,1
57601,57139,53,32218,53,allow,166,86,80,2,30,1,1
57602,54998,53,33990,53,allow,179,94,85,2,30,1,1
57603,60875,443,9147,443,allow,45373,35377,9996,88,72,48,40
57604,56782,49135,47020,49135,allow,70,70,0,2,8,2,0
57605,60278,80,27803,80,allow,1422,734,688,7,99,4,3
57606,55563,53,20716,53,allow,290,118,172,2,30,1,1
57607,65140,53,14760,53,allow,752,110,642,2,30,1,1
57608,56167,53,49116,53,allow,178,94,84,2,30,1,1
57609,59717,443,16330,443,allow,303966,26201,277765,521,167,208,313
57610,61592,443,6581,443,allow,19544,8237,11307,29,121,13,16
57611,47817,443,11040,443,allow,18158,2080,16078,34,122,19,15
57612,51414,443,43551,443,allow,78740,40216,38524,126,42,66,60
57613,45633,80,23400,80,allow,1573,702,871,12,45,7,5
57614,46341,443,54451,443,allow,9172,3518,5654,39,103,21,18
57615,56521,443,48766,443,allow,8760,3693,5067,20,90,12,8
57616,49699,53,32857,53,allow,266,89,177,4,58,2,2
57617,46974,443,29237,443,allow,5861,1151,4710,18,34,10,8
57618,56552,53,47161,53,allow,195,102,93,2,29,1,1
57619,50016,80,57935,80,allow,827,687,140,6,32,4,2
57620,56071,53,60998,53,allow,193,102,91,2,29,1,1
57621,64986,53,30082,53,allow,180,94,86,2,30,1,1
57622,53447,80,56181,80,allow,1517,481,1036,11,15,6,5
57623,57134,53,48452,53,allow,178,94,84,2,30,1,1
57624,51769,19165,28138,19165,allow,70,70,0,2,8,2,0
57625,65179,53,52575,53,allow,184,94,90,2,30,1,1
57626,55595,33677,1152,33677,allow,210,140,70,4,14,3,1
57627,49341,53,41507,53,allow,199,102,97,2,30,1,1
57628,53537,34901,47127,34901,allow,672,426,246,11,21,7,4
57629,65115,53,52563,53,allow,193,102,91,2,30,1,1
57630,62234,443,62234,443,allow,187597,6822,180775,203,92,67,136
57631,64213,53,34758,53,allow,342,105,237,4,53,2,2
57632,55286,53,38062,53,allow,194,102,92,2,29,1,1
57633,63747,80,64940,80,allow,314,192,122,6,15,4,2
57634,49384,53,28172,53,allow,181,94,87,2,29,1,1
57635,64252,53,2109,53,allow,199,102,97,2,29,1,1
57636,49699,53,7442,53,allow,266,89,177,4,58,2,2
57637,64438,53,9645,53,allow,184,94,90,2,29,1,1
57638,65185,53,26657,53,allow,453,186,267,6,30,3,3
57639,49361,53,37385,53,allow,184,94,90,2,29,1,1
57640,56402,53,29838,53,allow,322,134,188,2,30,1,1
57641,57416,53,8404,53,allow,193,102,91,2,29,1,1
57642,55955,53,39332,53,allow,164,86,78,2,30,1,1
57643,64997,53,31899,53,allow,166,86,80,2,30,1,1
57644,65179,53,63378,53,allow,184,94,90,2,31,1,1
57645,50022,53,26770,53,allow,179,94,85,2,31,1,1
57646,65179,53,56146,53,allow,184,94,90,2,30,1,1
57647,58080,3389,58080,3389,allow,3564,1850,1714,18,32,10,8
57648,55664,53,37409,53,allow,195,102,93,2,30,1,1
57649,64546,53,39505,53,allow,183,94,89,2,31,1,1
57650,49945,53,3434,53,allow,281,97,184,4,57,2,2
57651,64124,80,34060,80,allow,1517,481,1036,11,15,6,5
57652,60883,443,40215,443,allow,11586,5435,6151,46,46,25,21
57653,42790,443,55460,443,allow,13859,3232,10627,50,256,21,29
57654,54932,443,37338,443,allow,84306,6712,77594,156,236,58,98
57655,59814,443,30492,443,allow,1560,977,583,15,30,8,7
57656,36811,80,46728,80,allow,1475,837,638,10,15,5,5
57657,50423,80,33009,80,allow,23470,2457,21013,31,22,13,18
57658,49369,53,36980,53,allow,183,94,89,2,30,1,1
57659,56641,53,52292,53,allow,453,186,267,6,30,3,3
57660,40926,53,16373,53,allow,168,78,90,2,30,1,1
57661,57127,53,41835,53,allow,195,102,93,2,30,1,1
57662,59089,443,40663,443,allow,77560,5020,72540,93,121,34,59
57663,52221,443,62267,443,allow,4567,717,3850,17,148,7,10
57664,60885,443,21890,443,allow,3855,2679,1176,28,45,15,13
57665,56784,23140,27615,23140,allow,70,70,0,1,5,1,0
57666,64783,53,41526,53,allow,561,99,462,4,38,2,2
57667,63227,443,37596,443,allow,1373,734,639,17,125,10,7
57668,56759,53,42507,53,allow,338,118,220,2,30,1,1
57669,55937,53,58356,53,allow,179,94,85,2,30,1,1
57670,57268,53,42841,53,allow,205,94,111,2,30,1,1
57671,56167,53,4828,53,allow,178,94,84,2,30,1,1
57672,64850,53,49939,53,allow,196,102,94,2,30,1,1
57673,55955,53,59392,53,allow,164,86,78,2,30,1,1
57674,65522,53,17756,53,allow,1281,94,1187,2,30,1,1
57675,57323,53,57323,53,allow,216,98,118,2,30,1,1
57676,64859,53,0,0,allow,220,81,139,2,30,1,1
57677,37168,443,5501,443,allow,4871,923,3948,19,360,10,9
57678,56932,53,30512,53,allow,172,94,78,2,30,1,1
57679,55975,53,39571,53,allow,195,102,93,2,30,1,1
57680,31710,53,31710,53,allow,233,90,143,2,32,1,1
57681,60195,80,59592,80,allow,70,70,0,1,5,1,0
57682,56775,20617,21189,20617,allow,70,70,0,1,5,1,0
57683,51752,31677,14033,31677,allow,70,70,0,1,5,1,0
57684,52194,80,42397,80,allow,1151,711,440,10,15,5,5
57685,57134,53,29907,53,allow,178,94,84,2,30,1,1
57686,49229,53,43907,53,allow,178,94,84,2,30,1,1
57687,56326,53,34552,53,allow,177,94,83,2,30,1,1
57688,55634,53,10243,53,allow,210,110,100,2,30,1,1
57689,64303,53,3497,53,allow,212,102,110,2,30,1,1
57690,49478,53,25544,53,allow,172,94,78,2,30,1,1
57691,51459,53,51459,53,allow,256,114,142,2,30,1,1
57692,42758,123,49346,123,allow,184,94,90,2,30,1,1
57693,64235,53,18011,53,allow,197,102,95,2,30,1,1
57694,65231,53,2677,53,allow,200,102,98,2,30,1,1
57695,52088,53,34492,53,allow,168,78,90,2,30,1,1
57696,59475,53,33895,53,allow,179,86,93,2,30,1,1
57697,65451,53,9414,53,allow,178,94,84,2,30,1,1
57698,49635,53,59666,53,allow,210,110,100,2,30,1,1
57699,50022,53,51786,53,allow,179,94,85,2,30,1,1
57700,55664,53,32292,53,allow,195,102,93,2,30,1,1
57701,65371,53,1608,53,allow,199,102,97,2,30,1,1
57702,65424,53,5090,53,allow,210,110,100,2,31,1,1
57703,65513,53,29862,53,allow,195,102,93,2,31,1,1
57704,65048,53,7806,53,allow,194,102,92,2,30,1,1
57705,56066,53,20182,53,allow,212,110,102,2,30,1,1
57706,56418,53,19002,53,allow,183,94,89,2,30,1,1
57707,49442,53,40025,53,allow,198,94,104,2,31,1,1
57708,64850,53,36878,53,allow,196,102,94,2,31,1,1
57709,64677,53,46523,53,allow,195,102,93,2,31,1,1
57710,65451,53,7550,53,allow,178,94,84,2,31,1,1
57711,35685,443,31847,443,allow,2967,876,2091,11,120,5,6
57712,64011,443,26030,443,allow,4196,1407,2789,19,135,9,10
57713,33814,443,5866,443,allow,8601,2870,5731,40,225,22,18
57714,56288,53,49732,53,allow,183,94,89,2,31,1,1
57715,49631,443,48718,443,allow,8558,1006,7552,16,121,7,9
57716,38659,443,10582,443,allow,11202,2200,9002,39,131,20,19
57717,6881,6881,52538,6881,allow,118,118,0,1,1200,1,0
57718,37965,20926,65479,20926,allow,481,150,331,2,1199,1,1
57719,48991,80,63971,80,allow,121475,5644,115831,163,145,81,82
57720,56418,53,28996,53,allow,183,94,89,2,31,1,1
57721,65115,53,25677,53,allow,368,95,273,4,61,2,2
57722,57415,443,15579,443,allow,28216,10325,17891,93,23,42,51
57723,44928,443,35200,443,allow,9345,2224,7121,40,112,22,18
57724,43227,443,48195,443,allow,460628,23936,436692,580,124,264,316
57725,58190,53,48181,53,allow,648,86,562,4,51,2,2
57726,60538,80,60538,80,allow,318,120,198,6,26,3,3
57727,53915,443,38797,443,allow,7917,2410,5507,32,26,18,14
57728,54998,53,29340,53,allow,438,89,349,4,60,2,2
57729,49424,53,11040,53,allow,198,102,96,2,33,1,1
57730,60539,80,60539,80,allow,318,120,198,6,26,3,3
57731,48892,443,58975,443,allow,740,210,530,12,110,4,8
57732,64055,53,48031,53,allow,501,94,407,4,52,2,2
57733,56656,53,3129,53,allow,255,88,167,4,53,2,2
57734,57351,62413,0,0,deny,62,62,0,1,0,1,0
57735,61616,23,0,0,deny,60,60,0,1,0,1,0
57736,52552,445,0,0,drop,66,66,0,1,0,1,0
57737,57140,445,0,0,drop,70,70,0,1,0,1,0
57738,59585,36237,0,0,deny,62,62,0,1,0,1,0
57739,52128,445,0,0,drop,70,70,0,1,0,1,0
57740,57132,445,0,0,drop,70,70,0,1,0,1,0
57741,57130,445,0,0,drop,70,70,0,1,0,1,0
57742,57129,445,0,0,drop,70,70,0,1,0,1,0
57743,52126,445,0,0,drop,70,70,0,1,0,1,0
57744,52549,445,0,0,drop,66,66,0,1,0,1,0
57745,80,37649,0,0,deny,60,60,0,1,0,1,0
57746,20726,2767,0,0,deny,66,66,0,1,0,1,0
57747,11816,50584,0,0,deny,66,66,0,1,0,1,0
57748,80,53945,0,0,deny,60,60,0,1,0,1,0
57749,52121,445,0,0,drop,70,70,0,1,0,1,0
57750,7275,39827,0,0,deny,74,74,0,1,0,1,0
57751,57123,445,0,0,drop,70,70,0,1,0,1,0
57752,60292,7129,0,0,deny,62,62,0,1,0,1,0
57753,52120,445,0,0,drop,70,70,0,1,0,1,0
57754,57121,445,0,0,drop,70,70,0,1,0,1,0
57755,57119,445,0,0,drop,70,70,0,1,0,1,0
57756,57117,445,0,0,drop,70,70,0,1,0,1,0
57757,52543,445,0,0,drop,66,66,0,1,0,1,0
57758,25360,51505,0,0,deny,66,66,0,1,0,1,0
57759,32215,22114,0,0,deny,66,66,0,1,0,1,0
57760,54276,39004,0,0,deny,66,66,0,1,0,1,0
57761,52537,445,0,0,drop,66,66,0,1,0,1,0
57762,52536,445,0,0,drop,66,66,0,1,0,1,0
57763,52534,445,0,0,drop,66,66,0,1,0,1,0
57764,12283,25773,0,0,reset-both,139,139,0,1,0,1,0
57765,1024,64147,0,0,deny,62,62,0,1,0,1,0
57766,52116,445,0,0,drop,70,70,0,1,0,1,0
57767,52531,445,0,0,drop,66,66,0,1,0,1,0
57768,52533,445,0,0,drop,66,66,0,1,0,1,0
57769,52532,445,0,0,drop,66,66,0,1,0,1,0
57770,59023,64097,0,0,deny,66,66,0,1,0,1,0
57771,43457,31573,0,0,deny,146,146,0,1,0,1,0
57772,53355,23117,0,0,deny,66,66,0,1,0,1,0
57773,52115,445,0,0,drop,70,70,0,1,0,1,0
57774,53053,64147,0,0,deny,66,66,0,1,0,1,0
57775,80,9918,0,0,deny,60,60,0,1,0,1,0
57776,37577,443,55436,443,allow,499,425,74,4,0,3,1
57777,37580,443,1520,443,allow,499,425,74,4,0,3,1
57778,37578,443,38222,443,allow,499,425,74,4,0,3,1
57779,37579,443,43995,443,allow,499,425,74,4,0,3,1
57780,37576,443,42873,443,allow,499,425,74,4,0,3,1
57781,37575,443,28180,443,allow,499,425,74,4,0,3,1
57782,62780,35440,0,0,deny,66,66,0,1,0,1,0
57783,57116,445,0,0,drop,70,70,0,1,0,1,0
57784,57114,445,0,0,drop,70,70,0,1,0,1,0
57785,57110,445,0,0,drop,70,70,0,1,0,1,0
57786,52528,445,0,0,drop,66,66,0,1,0,1,0
57787,22683,39210,0,0,deny,60,60,0,1,0,1,0
57788,57108,445,0,0,drop,70,70,0,1,0,1,0
57789,52524,445,0,0,drop,66,66,0,1,0,1,0
57790,11458,2767,0,0,deny,62,62,0,1,0,1,0
57791,26439,37965,0,0,deny,66,66,0,1,0,1,0
57792,52521,445,0,0,drop,66,66,0,1,0,1,0
57793,52522,445,0,0,drop,66,66,0,1,0,1,0
57794,52110,445,0,0,drop,70,70,0,1,0,1,0
57795,53475,3389,0,0,deny,62,62,0,1,0,1,0
57796,61043,57470,0,0,deny,78,78,0,1,0,1,0
57797,52519,445,0,0,drop,66,66,0,1,0,1,0
57798,42951,44847,0,0,deny,66,66,0,1,0,1,0
57799,12232,41864,0,0,deny,139,139,0,1,0,1,0
57800,14615,57866,0,0,deny,62,62,0,1,0,1,0
57801,53166,61600,0,0,deny,66,66,0,1,0,1,0
57802,54773,50584,0,0,deny,66,66,0,1,0,1,0
57803,53211,22114,0,0,deny,62,62,0,1,0,1,0
57804,57101,445,0,0,drop,70,70,0,1,0,1,0
57805,57097,445,0,0,drop,70,70,0,1,0,1,0
57806,57094,445,0,0,drop,70,70,0,1,0,1,0
57807,58977,37965,0,0,deny,66,66,0,1,0,1,0
57808,45603,35894,0,0,deny,145,145,0,1,0,1,0
57809,61804,51505,0,0,deny,66,66,0,1,0,1,0
57810,52508,445,0,0,drop,66,66,0,1,0,1,0
57811,52097,445,0,0,drop,70,70,0,1,0,1,0
57812,51196,53,0,0,allow,206,83,123,2,0,1,1
57813,49424,53,32316,53,allow,100,100,0,1,0,1,0
57814,6057,51221,0,0,deny,62,62,0,1,0,1,0
57815,59156,50584,0,0,deny,62,62,0,1,0,1,0
57816,19858,64147,0,0,deny,62,62,0,1,0,1,0
57817,55254,50584,0,0,deny,66,66,0,1,0,1,0
57818,52094,445,0,0,drop,70,70,0,1,0,1,0
57819,21777,50584,0,0,deny,62,62,0,1,0,1,0
57820,60875,56205,0,0,deny,66,66,0,1,0,1,0
57821,52501,445,0,0,drop,66,66,0,1,0,1,0
57822,57080,445,0,0,drop,70,70,0,1,0,1,0
57823,52498,445,0,0,drop,66,66,0,1,0,1,0
57824,52089,445,0,0,drop,70,70,0,1,0,1,0
57825,45964,3111,0,0,deny,60,60,0,1,0,1,0
57826,52088,445,0,0,drop,70,70,0,1,0,1,0
57827,42572,995,0,0,deny,60,60,0,1,0,1,0
57828,39941,995,0,0,deny,60,60,0,1,0,1,0
57829,52086,445,0,0,drop,70,70,0,1,0,1,0
57830,58382,50584,0,0,deny,62,62,0,1,0,1,0
57831,52492,445,0,0,drop,66,66,0,1,0,1,0
57832,52486,445,0,0,drop,66,66,0,1,0,1,0
57833,40547,24051,0,0,deny,74,74,0,1,0,1,0
57834,443,23220,0,0,deny,100,100,0,1,0,1,0
57835,3521,6881,0,0,deny,66,66,0,1,0,1,0
57836,52079,445,0,0,drop,70,70,0,1,0,1,0
57837,5575,8889,5575,8889,deny,497,497,0,1,0,1,0
57838,3225,64147,0,0,deny,62,62,0,1,0,1,0
57839,52077,445,0,0,drop,70,70,0,1,0,1,0
57840,57071,445,0,0,drop,70,70,0,1,0,1,0
57841,57070,445,0,0,drop,70,70,0,1,0,1,0
57842,57068,445,0,0,drop,70,70,0,1,0,1,0
57843,52475,445,0,0,drop,66,66,0,1,0,1,0
57844,52476,445,0,0,drop,66,66,0,1,0,1,0
57845,52474,445,0,0,drop,66,66,0,1,0,1,0
57846,52469,445,0,0,drop,66,66,0,1,0,1,0
57847,52470,445,0,0,drop,66,66,0,1,0,1,0
57848,52473,445,0,0,drop,66,66,0,1,0,1,0
57849,52472,445,0,0,drop,66,66,0,1,0,1,0
57850,52471,445,0,0,drop,66,66,0,1,0,1,0
57851,46093,32661,0,0,deny,74,74,0,1,0,1,0
57852,52076,445,0,0,drop,70,70,0,1,0,1,0
57853,63670,64097,0,0,deny,66,66,0,1,0,1,0
57854,52075,445,0,0,drop,70,70,0,1,0,1,0
57855,52074,445,0,0,drop,70,70,0,1,0,1,0
57856,52068,445,0,0,drop,70,70,0,1,0,1,0
57857,52067,445,0,0,drop,70,70,0,1,0,1,0
57858,27368,22114,0,0,deny,62,62,0,1,0,1,0
57859,49516,35894,0,0,deny,62,62,0,1,0,1,0
57860,52055,445,0,0,drop,70,70,0,1,0,1,0
57861,52054,445,0,0,drop,70,70,0,1,0,1,0
57862,52049,445,0,0,drop,70,70,0,1,0,1,0
57863,1284,50584,0,0,deny,62,62,0,1,0,1,0
57864,57063,445,0,0,drop,70,70,0,1,0,1,0
57865,57057,445,0,0,drop,70,70,0,1,0,1,0
57866,57056,445,0,0,drop,70,70,0,1,0,1,0
57867,20844,64147,0,0,deny,66,66,0,1,0,1,0
57868,52045,445,0,0,drop,70,70,0,1,0,1,0
57869,52044,445,0,0,drop,70,70,0,1,0,1,0
57870,62678,57470,0,0,deny,62,62,0,1,0,1,0
57871,64788,43890,0,0,deny,62,62,0,1,0,1,0
57872,52456,445,0,0,drop,66,66,0,1,0,1,0
57873,52455,445,0,0,drop,66,66,0,1,0,1,0
57874,52453,445,0,0,drop,66,66,0,1,0,1,0
57875,64406,50584,0,0,deny,66,66,0,1,0,1,0
57876,57452,57470,0,0,deny,62,62,0,1,0,1,0
57877,36881,56205,0,0,deny,146,146,0,1,0,1,0
57878,57050,445,0,0,drop,70,70,0,1,0,1,0
57879,49800,5900,0,0,deny,60,60,0,1,0,1,0
57880,52749,64147,0,0,deny,66,66,0,1,0,1,0
57881,30307,51505,0,0,deny,62,62,0,1,0,1,0
57882,57048,445,0,0,drop,70,70,0,1,0,1,0
57883,57043,445,0,0,drop,70,70,0,1,0,1,0
57884,57038,445,0,0,drop,70,70,0,1,0,1,0
57885,57039,445,0,0,drop,70,70,0,1,0,1,0
57886,59523,37965,0,0,deny,62,62,0,1,0,1,0
57887,52033,445,0,0,drop,70,70,0,1,0,1,0
57888,46495,4607,0,0,deny,60,60,0,1,0,1,0
57889,29623,37807,0,0,deny,62,62,0,1,0,1,0
57890,8910,62413,0,0,deny,146,146,0,1,0,1,0
57891,55045,53,38947,53,allow,747,92,655,2,30,1,1
57892,54854,443,6189,443,allow,32544,28348,4196,63,332,31,32
57893,5530,80,5530,80,allow,514,246,268,9,91,5,4
57894,43107,443,43113,443,allow,3051,1801,1250,18,16,8,10
57895,50497,443,10813,443,allow,1642025,26957,1615068,1478,17,406,1072
57896,49897,80,15304,80,allow,188,128,60,3,15,2,1
57897,137,137,20437,137,allow,384,384,0,5,51,5,0
57898,56418,53,62864,53,allow,182,93,89,2,30,1,1
57899,55337,53,11833,53,allow,294,106,188,4,56,2,2
57900,58215,443,23391,443,allow,7337,1630,5707,23,256,12,11
57901,51768,61765,18579,61765,allow,70,70,0,2,8,2,0
57902,51751,55855,62891,55855,allow,66,66,0,1,5,1,0
57903,51749,1408,5548,1408,allow,66,66,0,1,5,1,0
57904,55540,53,5728,53,allow,757,98,659,2,31,1,1
57905,50128,53,3916,53,allow,757,98,659,2,30,1,1
57906,59850,443,34758,443,allow,10260,1360,8900,22,18,7,15
57907,63745,39800,55951,39800,allow,504,382,122,8,16,6,2
57908,56376,53,45759,53,allow,196,100,96,2,30,1,1
57909,59800,443,57363,443,allow,94202,5247,88955,115,37,41,74
57910,59846,443,17762,443,allow,23856,3218,20638,40,18,16,24
57911,59849,443,38799,443,allow,8368,1360,7008,19,18,7,12
57912,60962,443,57911,443,allow,50093,8331,41762,75,48,36,39
57913,47822,80,47822,80,allow,1435,1293,142,5,15,3,2
57914,63750,63343,14942,63343,allow,66,66,0,1,5,1,0
57915,56656,53,54597,53,allow,255,88,167,4,53,2,2
57916,59838,443,12869,443,allow,5520,3416,2104,27,22,13,14
57917,45268,443,29338,443,allow,7503,2345,5158,34,256,17,17
57918,60537,80,60537,80,allow,318,120,198,6,25,3,3
57919,56288,53,56709,53,allow,182,93,89,2,31,1,1
57920,59409,443,2486,443,allow,7775,3174,4601,25,16,11,14
57921,59839,443,29303,443,allow,93467,4007,89460,107,22,33,74
57922,56772,61424,62775,61424,allow,66,66,0,1,5,1,0
57923,59725,443,1736,443,allow,89790,6036,83754,112,55,41,71
57924,47150,9339,62687,9339,allow,179194,19657,159537,415,149,202,213
57925,64327,53,64327,53,allow,243,100,143,2,30,1,1
57926,59845,443,19704,443,allow,14702,1976,12726,28,18,10,18
57927,57342,80,40590,80,allow,1056,682,374,10,15,6,4
57928,49631,443,7469,443,allow,11772,5416,6356,25,49,15,10
57929,48556,80,48556,80,allow,19225,817,18408,29,15,13,16
57930,59835,443,54646,443,allow,13306,9499,3807,32,23,17,15
57931,53112,29258,48583,29258,allow,70,70,0,1,5,1,0
57932,4009,53,4009,53,allow,231,88,143,2,33,1,1
57933,54204,443,50779,443,allow,18159,12786,5373,34,270,19,15
57934,59905,443,62793,443,allow,21212,14546,6666,43,362,24,19
57935,42881,443,61289,443,allow,28707,2793,25914,58,115,29,29
57936,49625,443,57635,443,allow,4252,726,3526,13,16,7,6
57937,60391,47212,11970,47212,allow,164,70,94,2,5,1,1
57938,60392,1134,49045,1134,allow,70,70,0,1,5,1,0
57939,61645,443,61645,443,allow,4702,1795,2907,19,28,11,8
57940,39611,443,31755,443,allow,234,234,0,4,12,4,0
57941,55394,53,55394,53,allow,197,76,121,2,30,1,1
57942,65159,53,15273,53,allow,286,103,183,4,52,2,2
57943,64811,53,2888,53,allow,186,95,91,2,30,1,1
57944,64706,53,4952,53,allow,174,89,85,2,30,1,1
57945,55664,53,44957,53,allow,190,97,93,2,30,1,1
57946,49672,53,36267,53,allow,761,100,661,2,30,1,1
57947,33845,53,0,0,allow,82,82,0,1,30,1,0
57948,65372,53,1041,53,allow,196,100,96,2,31,1,1
57949,58035,80,30742,80,allow,100364,4917,95447,133,241,67,66
57950,5938,6987,0,0,allow,60,60,0,1,90,1,0
57951,57614,443,56701,443,allow,25824,14215,11609,65,757,32,33
57952,6882,6889,43478,6889,allow,221,111,110,2,1200,1,1
57953,54677,5228,25400,5228,allow,6679,2730,3949,43,4309,23,20
57954,46844,53,0,0,allow,82,82,0,1,31,1,0
57955,56727,53,26195,53,allow,762,101,661,2,31,1,1
57956,56458,53,36864,53,allow,192,98,94,2,31,1,1
57957,60593,80,31498,80,allow,123436,6053,117383,165,241,83,82
57958,64840,53,31006,53,allow,186,95,91,2,31,1,1
57959,56924,53,30417,53,allow,216,110,106,2,31,1,1
57960,54489,443,33538,443,allow,4263,2019,2244,14,136,7,7
57961,50584,55727,63781,55727,allow,2268,1050,1218,15,5442,8,7
57962,30960,45686,49488,45686,allow,330,330,0,6,3609,6,0
57963,12605,57470,0,0,deny,62,62,0,1,0,1,0
57964,12821,37965,0,0,deny,66,66,0,1,0,1,0
57965,21274,30188,0,0,deny,62,62,0,1,0,1,0
57966,52029,445,0,0,drop,70,70,0,1,0,1,0
57967,51685,57470,0,0,deny,66,66,0,1,0,1,0
57968,62859,35440,0,0,deny,66,66,0,1,0,1,0
57969,56526,443,61934,443,allow,7563,3697,3866,19,15,10,9
57970,29363,443,29363,443,allow,29861,6027,23834,65,37,34,31
57971,57028,445,0,0,drop,70,70,0,1,0,1,0
57972,57026,445,0,0,drop,70,70,0,1,0,1,0
57973,57024,445,0,0,drop,70,70,0,1,0,1,0
57974,64051,36829,0,0,deny,66,66,0,1,0,1,0
57975,52019,445,0,0,drop,70,70,0,1,0,1,0
57976,52020,445,0,0,drop,70,70,0,1,0,1,0
57977,58468,37965,0,0,deny,66,66,0,1,0,1,0
57978,5914,10214,0,0,deny,100,100,0,1,0,1,0
57979,6889,41864,0,0,deny,143,143,0,1,0,1,0
57980,52016,445,0,0,drop,70,70,0,1,0,1,0
57981,52015,445,0,0,drop,70,70,0,1,0,1,0
57982,57165,34101,0,0,deny,62,62,0,1,0,1,0
57983,43671,37965,0,0,deny,62,62,0,1,0,1,0
57984,52012,445,0,0,drop,70,70,0,1,0,1,0
57985,30496,57470,0,0,deny,62,62,0,1,0,1,0
57986,50143,35253,0,0,deny,66,66,0,1,0,1,0
57987,52433,445,0,0,drop,66,66,0,1,0,1,0
57988,1025,35447,0,0,deny,62,62,0,1,0,1,0
57989,57022,445,0,0,drop,70,70,0,1,0,1,0
57990,57021,445,0,0,drop,70,70,0,1,0,1,0
57991,65209,57866,0,0,deny,66,66,0,1,0,1,0
57992,55286,37965,0,0,deny,66,66,0,1,0,1,0
57993,52007,445,0,0,drop,70,70,0,1,0,1,0
57994,6666,6379,0,0,deny,60,60,0,1,0,1,0
57995,26332,57470,0,0,deny,62,62,0,1,0,1,0
57996,52427,445,0,0,drop,66,66,0,1,0,1,0
57997,51999,445,0,0,drop,70,70,0,1,0,1,0
57998,52424,445,0,0,drop,66,66,0,1,0,1,0
57999,51998,445,0,0,drop,70,70,0,1,0,1,0
58000,57010,445,0,0,drop,70,70,0,1,0,1,0
58001,52676,53733,0,0,deny,62,62,0,1,0,1,0
58002,57004,445,0,0,drop,70,70,0,1,0,1,0
58003,57002,445,0,0,drop,70,70,0,1,0,1,0
58004,57001,445,0,0,drop,70,70,0,1,0,1,0
58005,4594,35993,0,0,deny,62,62,0,1,0,1,0
58006,32892,23,0,0,deny,60,60,0,1,0,1,0
58007,56380,80,20906,80,allow,1466,729,737,12,16,7,5
58008,44410,443,17016,443,allow,2359,1436,923,18,38,10,8
58009,64914,53,27750,53,allow,168,86,82,2,30,1,1
58010,56320,53,53678,53,allow,183,94,89,2,30,1,1
58011,51103,53,0,0,allow,174,77,97,2,30,1,1
58012,35991,443,1116,443,allow,10857,4247,6610,27,121,13,14
58013,49332,53,28193,53,allow,281,98,183,4,56,2,2
58014,64235,53,30515,53,allow,321,99,222,4,52,2,2
58015,5234,28162,61929,28162,allow,449555,320,449235,719,50,6,713
58016,60536,80,60536,80,allow,318,120,198,6,25,3,3
58017,51770,37237,29637,37237,allow,316,136,180,6,6,3,3
58018,58682,80,4123,80,allow,1345,726,619,16,362,8,8
58019,55337,53,8346,53,allow,294,106,188,4,56,2,2
58020,48893,443,17087,443,allow,16227,2037,14190,40,109,19,21
58021,56656,53,41327,53,allow,255,88,167,4,52,2,2
58022,49888,443,12324,443,allow,1072526,64733,1007793,1501,232,690,811
58023,57417,443,11340,443,allow,43052,2466,40586,64,18,21,43
58024,55337,53,22307,53,allow,294,106,188,4,55,2,2
58025,47264,443,35933,443,allow,7201,3870,3331,33,315,17,16
58026,63943,53,24441,53,allow,509,176,333,6,56,3,3
58027,58704,80,26628,80,allow,4115,3452,663,13,15,7,6
58028,55719,8060,30409,8060,allow,70,70,0,2,7,2,0
58029,56816,80,41001,80,allow,420340,15216,405124,441,376,163,278
58030,60004,443,3185,443,allow,134,60,74,3,4,2,1
58031,49699,53,17835,53,allow,266,89,177,4,58,2,2
58032,65424,53,57166,53,allow,210,110,100,2,29,1,1
58033,60535,80,60535,80,allow,318,120,198,6,25,3,3
58034,64546,53,11850,53,allow,183,94,89,2,29,1,1
58035,48012,443,51500,443,allow,1429,1295,134,10,29,8,2
58036,51137,80,51137,80,allow,66992,5462,61530,79,26,30,49
58037,56425,80,34044,80,allow,17188,1559,15629,25,31,10,15
58038,64914,53,63909,53,allow,86,86,0,1,29,1,0
58039,56656,53,40908,53,allow,255,88,167,4,53,2,2
58040,64982,53,7068,53,allow,321,97,224,4,57,2,2
58041,28122,443,63914,443,allow,7808,2487,5321,34,446,16,18
58042,123,123,44322,123,allow,184,94,90,2,29,1,1
58043,65159,53,20643,53,allow,286,103,183,4,51,2,2
58044,64939,53,4454,53,allow,199,94,105,2,29,1,1
58045,64531,53,56972,53,allow,183,94,89,2,29,1,1
58046,55931,53,41701,53,allow,294,118,176,2,29,1,1
58047,61041,53,61041,53,allow,214,90,124,2,29,1,1
58048,65532,53,19828,53,allow,819,102,717,2,30,1,1
58049,64689,53,34039,53,allow,183,94,89,2,30,1,1
58050,55372,53,7739,53,allow,448,184,264,6,30,3,3
58051,59811,443,39338,443,allow,36149,11297,24852,56,29,25,31
58052,53209,443,56508,443,allow,11086,2564,8522,42,186,21,21
58053,50945,80,50945,80,allow,78911,2499,76412,88,26,32,56
58054,55013,53,33517,53,allow,821,102,719,2,30,1,1
58055,65168,53,45025,53,allow,749,94,655,2,30,1,1
58056,64982,53,35426,53,allow,195,102,93,2,30,1,1
58057,50165,53,36668,53,allow,211,78,133,2,30,1,1
58058,59416,443,53026,443,allow,10642,3654,6988,26,125,14,12
58059,49830,443,7649,443,allow,6131,1960,4171,18,15,10,8
58060,55013,53,27966,53,allow,198,102,96,2,30,1,1
58061,64823,53,7121,53,allow,199,102,97,2,31,1,1
58062,49418,27015,10254,27015,allow,78,78,0,1,30,1,0
58063,64982,53,7315,53,allow,195,102,93,2,30,1,1
58064,64689,53,48296,53,allow,183,94,89,2,30,1,1
58065,49748,53,20050,53,allow,763,102,661,2,30,1,1
58066,51767,59158,21535,59158,allow,70,70,0,2,8,2,0
58067,12116,53,12116,53,allow,214,82,132,2,33,1,1
58068,64608,53,12446,53,allow,212,110,102,2,30,1,1
58069,50367,53,23115,53,allow,198,102,96,2,30,1,1
58070,56403,443,35663,443,allow,24745,1926,22819,39,170,18,21
58071,51008,80,51008,80,allow,114613,6365,108248,134,26,51,83
58072,56339,53,35770,53,allow,280,78,202,2,30,1,1
58073,56320,53,14969,53,allow,183,94,89,2,30,1,1
58074,56288,53,30293,53,allow,183,94,89,2,30,1,1
58075,64677,53,6467,53,allow,195,102,93,2,30,1,1
58076,50291,53,32259,53,allow,86,86,0,1,30,1,0
58077,49418,27017,44700,27017,allow,78,78,0,1,30,1,0
58078,55038,443,25937,443,allow,11429,4904,6525,33,156,18,15
58079,28064,53,28064,53,allow,233,90,143,2,32,1,1
58080,56023,53,4937,53,allow,338,106,232,4,37,2,2
58081,50880,80,50880,80,allow,163985,6578,157407,188,26,72,116
58082,47400,80,1203,80,allow,1052,612,440,10,15,5,5
58083,49297,53,48060,53,allow,183,94,89,2,30,1,1
58084,5405,53,5405,53,allow,645,90,555,2,30,1,1
58085,5284,53,5284,53,allow,178,82,96,2,30,1,1
58086,64703,53,15968,53,allow,314,92,222,4,31,2,2
58087,61938,443,14944,443,allow,7118,2462,4656,18,75,10,8
58088,49346,53,23031,53,allow,228,110,118,2,30,1,1
58089,64608,53,62804,53,allow,212,110,102,2,30,1,1
58090,64726,53,39418,53,allow,178,94,84,2,30,1,1
58091,56376,53,65133,53,allow,198,102,96,2,30,1,1
58092,44929,443,17835,443,allow,554,280,274,9,111,5,4
58093,50916,80,44611,80,allow,11456216,116932,11339284,9298,139,1683,7615
58094,49267,443,42451,443,allow,19851,15702,4149,63,109,34,29
58095,55337,53,17571,53,allow,294,106,188,4,56,2,2
58096,59813,443,22135,443,allow,23244,13793,9451,50,29,26,24
58097,59937,443,7727,443,allow,8852,1428,7424,22,199,11,11
58098,51658,80,26955,80,allow,39464,2150,37314,81,20,26,55
58099,10018,80,16761,80,allow,1052,612,440,10,15,5,5
58100,52513,443,40002,443,allow,5096,810,4286,15,15,8,7
58101,56767,34578,60694,34578,allow,564,318,246,9,16,5,4
58102,51750,54567,46467,54567,allow,70,70,0,1,5,1,0
58103,54410,443,16745,443,allow,7256,1669,5587,27,318,15,12
58104,51266,16103,36869,16103,allow,70,70,0,1,5,1,0
58105,52640,6881,33244,6881,allow,719,413,306,10,14,5,5
58106,65067,53,43932,53,allow,411,115,296,4,38,2,2
58107,52087,443,46518,443,allow,5780,1646,4134,22,15,11,11
58108,37433,443,8364,443,allow,8641,955,7686,19,259,8,11
58109,53521,443,50004,443,allow,130,70,60,2,15,1,1
58110,57948,443,32601,443,allow,5914,1514,4400,23,15,12,11
58111,56609,80,38761,80,allow,234,234,0,4,12,4,0
58112,37385,443,16177,443,allow,8824,2041,6783,34,255,17,17
58113,59936,443,17847,443,allow,34167,3638,30529,50,200,23,27
58114,65048,53,15306,53,allow,297,96,201,4,42,2,2
58115,64680,53,61021,53,allow,808,272,536,8,78,4,4
58116,56932,53,43209,53,allow,172,94,78,2,29,1,1
58117,64811,53,37013,53,allow,193,102,91,2,29,1,1
58118,49635,53,38499,53,allow,210,110,100,2,29,1,1
58119,50688,80,50688,80,allow,167293,8028,159265,186,26,68,118
58120,46625,80,46625,80,allow,51574,3466,48108,63,156,23,40
58121,46899,80,46899,80,allow,82739,3221,79518,91,156,28,63
58122,49845,443,22803,443,allow,10396,4585,5811,38,54,21,17
58123,55664,53,1350,53,allow,195,102,93,2,30,1,1
58124,65159,53,25271,53,allow,286,103,183,4,52,2,2
58125,56326,53,1837,53,allow,177,94,83,2,29,1,1
58126,65115,53,24571,53,allow,193,102,91,2,29,1,1
58127,49945,53,14331,53,allow,281,97,184,4,56,2,2
58128,64706,53,11232,53,allow,179,94,85,2,29,1,1
58129,49099,53,46349,53,allow,238,94,144,2,30,1,1
58130,49297,53,44299,53,allow,183,94,89,2,30,1,1
58131,1926,53,62848,53,allow,210,78,132,2,30,1,1
58132,49589,53,21247,53,allow,198,94,104,2,30,1,1
58133,64726,53,24139,53,allow,178,94,84,2,30,1,1
58134,65186,27126,54671,27126,allow,268,78,190,2,30,1,1
58135,65183,27126,22289,27126,allow,268,78,190,2,30,1,1
58136,49378,53,33691,53,allow,179,86,93,2,30,1,1
58137,50791,53,50791,53,allow,231,90,141,2,30,1,1
58138,48817,64245,48817,64245,allow,481,150,331,2,1200,1,1
58139,57338,80,37762,80,allow,1420,715,705,12,16,7,5
58140,50367,53,53044,53,allow,821,102,719,2,30,1,1
58141,64914,53,55728,53,allow,168,86,82,2,30,1,1
58142,64546,53,29110,53,allow,183,94,89,2,30,1,1
58143,64706,53,5159,53,allow,179,94,85,2,30,1,1
58144,59848,53,28215,53,allow,239,102,137,2,30,1,1
58145,56320,53,53146,53,allow,183,94,89,2,30,1,1
58146,64689,53,60672,53,allow,183,94,89,2,30,1,1
58147,64811,53,21833,53,allow,193,102,91,2,30,1,1
58148,49418,27015,32814,27015,allow,257,78,179,2,30,1,1
58149,59810,443,31870,443,allow,27370,17071,10299,51,30,26,25
58150,53114,32975,31768,32975,allow,70,70,0,2,8,2,0
58151,61716,80,3411,80,allow,9323,5142,4181,23,20,12,11
58152,53108,7003,16327,7003,allow,512,326,186,9,22,6,3
58153,65468,443,32669,443,allow,421329,12430,408899,433,16,152,281
58154,65451,53,45725,53,allow,178,94,84,2,30,1,1
58155,52483,443,4472,443,allow,12863,8410,4453,22,31,13,9
58156,64726,53,25224,53,allow,178,94,84,2,30,1,1
58157,50386,8080,50386,8080,allow,5533,2632,2901,20,46,12,8
58158,64706,53,6789,53,allow,179,94,85,2,30,1,1
58159,64850,53,16958,53,allow,196,102,94,2,30,1,1
58160,64823,53,51719,53,allow,199,102,97,2,30,1,1
58161,49418,27016,64137,27016,allow,270,78,192,2,30,1,1
58162,56376,53,35947,53,allow,198,102,96,2,30,1,1
58163,64608,53,18292,53,allow,212,110,102,2,30,1,1
58164,42112,443,17056,443,allow,11459,2165,9294,29,259,11,18
58165,56773,28093,43311,28093,allow,70,70,0,1,5,1,0
58166,46624,80,46624,80,allow,34504,2526,31978,45,156,16,29
58167,6712,80,6712,80,allow,514,246,268,9,82,5,4
58168,1925,53,9734,53,allow,210,78,132,2,30,1,1
58169,1923,53,53314,53,allow,260,86,174,2,30,1,1
58170,49667,53,65184,53,allow,448,184,264,6,30,3,3
58171,65185,27126,57830,27126,allow,268,78,190,2,30,1,1
58172,65126,53,60546,53,allow,718,94,624,2,30,1,1
58173,58873,53,50618,53,allow,168,78,90,2,30,1,1
58174,65513,53,15039,53,allow,195,102,93,2,31,1,1
58175,58499,123,31733,123,allow,184,94,90,2,30,1,1
58176,48040,53,11212,53,allow,168,78,90,2,30,1,1
58177,64322,53,52794,53,allow,250,94,156,2,30,1,1
58178,49418,27015,15763,27015,allow,248,78,170,2,30,1,1
58179,56376,53,49970,53,allow,198,102,96,2,31,1,1
58180,56458,53,9119,53,allow,196,102,94,2,31,1,1
58181,34726,53,62948,53,allow,168,78,90,2,30,1,1
58182,56953,443,22328,443,allow,7245,1282,5963,16,135,7,9
58183,64517,53,39078,53,allow,194,102,92,2,31,1,1
58184,65167,443,56897,443,allow,4925,2188,2737,36,360,16,20
58185,44847,6882,30467,6882,allow,502,150,352,2,1200,1,1
58186,55877,39578,13811,39578,allow,150,150,0,1,1200,1,0
58187,64997,53,57263,53,allow,166,86,80,2,31,1,1
58188,65532,53,33764,53,allow,196,102,94,2,30,1,1
58189,49566,53,59606,53,allow,200,94,106,2,30,1,1
58190,39785,443,37102,443,allow,7967,2261,5706,18,121,8,10
58191,46013,80,29418,80,allow,134,60,74,3,6,2,1
58192,52034,80,13450,80,allow,4185,3462,723,14,16,7,7
58193,49828,443,20161,443,allow,5927,1644,4283,18,16,10,8
58194,64139,53,9779,53,allow,498,93,405,4,47,2,2
58195,65011,53,37444,53,allow,183,94,89,2,31,1,1
58196,53575,1025,56604,1025,allow,70,70,0,2,8,2,0
58197,50334,53,13800,53,allow,216,110,106,2,30,1,1
58198,65187,27126,30981,27126,allow,268,78,190,2,30,1,1
58199,49893,443,25504,443,allow,617481,41514,575967,856,221,381,475
58200,65371,53,53875,53,allow,356,101,255,4,55,2,2
58201,57221,443,19947,443,allow,7306,2784,4522,22,202,12,10
58202,43895,443,52101,443,allow,1442,721,721,15,199,8,7
58203,55730,53,15730,53,allow,196,102,94,2,30,1,1
58204,64619,53,62516,53,allow,229,94,135,2,30,1,1
58205,65371,53,17018,53,allow,199,102,97,2,30,1,1
58206,52420,445,0,0,drop,66,66,0,1,0,1,0
58207,64776,50584,0,0,deny,62,62,0,1,0,1,0
58208,51992,445,0,0,drop,70,70,0,1,0,1,0
58209,51991,445,0,0,drop,70,70,0,1,0,1,0
58210,19747,37965,0,0,deny,62,62,0,1,0,1,0
58211,57441,57470,0,0,deny,66,66,0,1,0,1,0
58212,56996,445,0,0,drop,70,70,0,1,0,1,0
58213,56993,445,0,0,drop,70,70,0,1,0,1,0
58214,56990,445,0,0,drop,70,70,0,1,0,1,0
58215,56991,445,0,0,drop,70,70,0,1,0,1,0
58216,52472,7302,0,0,deny,66,66,0,1,0,1,0
58217,38848,11119,0,0,deny,146,146,0,1,0,1,0
58218,52415,445,0,0,drop,66,66,0,1,0,1,0
58219,51987,445,0,0,drop,70,70,0,1,0,1,0
58220,53447,44847,0,0,deny,66,66,0,1,0,1,0
58221,61983,50432,0,0,deny,66,66,0,1,0,1,0
58222,52407,445,0,0,drop,66,66,0,1,0,1,0
58223,52412,445,0,0,drop,66,66,0,1,0,1,0
58224,52406,445,0,0,drop,66,66,0,1,0,1,0
58225,59701,44847,0,0,deny,66,66,0,1,0,1,0
58226,20650,26467,0,0,deny,62,62,0,1,0,1,0
58227,52403,445,0,0,drop,66,66,0,1,0,1,0
58228,52405,445,0,0,drop,66,66,0,1,0,1,0
58229,52404,445,0,0,drop,66,66,0,1,0,1,0
58230,51985,445,0,0,drop,70,70,0,1,0,1,0
58231,1227,56205,0,0,deny,66,66,0,1,0,1,0
58232,56987,445,0,0,drop,70,70,0,1,0,1,0
58233,56986,445,0,0,drop,70,70,0,1,0,1,0
58234,56984,445,0,0,drop,70,70,0,1,0,1,0
58235,54140,43890,0,0,deny,66,66,0,1,0,1,0
58236,52439,35894,0,0,deny,70,70,0,1,0,1,0
58237,9092,26672,0,0,deny,60,60,0,1,0,1,0
58238,52399,445,0,0,drop,66,66,0,1,0,1,0
58239,56980,445,0,0,drop,70,70,0,1,0,1,0
58240,51981,445,0,0,drop,70,70,0,1,0,1,0
58241,58248,50584,0,0,deny,62,62,0,1,0,1,0
58242,55074,53,55407,53,allow,770,101,669,2,0,1,1
58243,52397,445,0,0,drop,66,66,0,1,0,1,0
58244,4903,42873,0,0,deny,70,70,0,1,0,1,0
58245,80,37649,0,0,deny,60,60,0,1,0,1,0
58246,52395,445,0,0,drop,66,66,0,1,0,1,0
58247,52393,445,0,0,drop,66,66,0,1,0,1,0
58248,27010,64147,0,0,deny,62,62,0,1,0,1,0
58249,46587,57470,0,0,deny,66,66,0,1,0,1,0
58250,80,53945,0,0,deny,60,60,0,1,0,1,0
58251,63305,62413,0,0,deny,66,66,0,1,0,1,0
58252,52391,445,0,0,drop,66,66,0,1,0,1,0
58253,28839,30188,0,0,deny,62,62,0,1,0,1,0
58254,17315,11392,0,0,deny,66,66,0,1,0,1,0
58255,59411,37965,0,0,deny,62,62,0,1,0,1,0
58256,56973,445,0,0,drop,70,70,0,1,0,1,0
58257,10248,21247,0,0,deny,62,62,0,1,0,1,0
58258,80,9918,0,0,deny,60,60,0,1,0,1,0
58259,14397,37965,0,0,deny,62,62,0,1,0,1,0
58260,56968,445,0,0,drop,70,70,0,1,0,1,0
58261,56965,445,0,0,drop,70,70,0,1,0,1,0
58262,52208,43890,0,0,deny,62,62,0,1,0,1,0
58263,38976,46824,0,0,deny,62,62,0,1,0,1,0
58264,54305,35440,0,0,deny,62,62,0,1,0,1,0
58265,26722,11446,0,0,deny,66,66,0,1,0,1,0
58266,51968,445,0,0,drop,70,70,0,1,0,1,0
58267,63314,57470,0,0,deny,66,66,0,1,0,1,0
58268,52383,445,0,0,drop,66,66,0,1,0,1,0
58269,16293,57470,0,0,deny,62,62,0,1,0,1,0
58270,51965,445,0,0,drop,70,70,0,1,0,1,0
58271,44538,50584,0,0,deny,62,62,0,1,0,1,0
58272,40547,24051,0,0,deny,74,74,0,1,0,1,0
58273,59940,50584,0,0,deny,66,66,0,1,0,1,0
58274,52373,445,0,0,drop,66,66,0,1,0,1,0
58275,33931,50584,0,0,deny,62,62,0,1,0,1,0
58276,65060,35440,0,0,deny,66,66,0,1,0,1,0
58277,56952,445,0,0,drop,70,70,0,1,0,1,0
58278,9957,32480,0,0,deny,66,66,0,1,0,1,0
58279,38645,51221,0,0,deny,62,62,0,1,0,1,0
58280,53437,44847,0,0,deny,66,66,0,1,0,1,0
58281,51961,445,0,0,drop,70,70,0,1,0,1,0
58282,26365,22,0,0,deny,60,60,0,1,0,1,0
58283,55749,37965,0,0,deny,66,66,0,1,0,1,0
58284,33979,23,0,0,deny,60,60,0,1,0,1,0
58285,18545,23,0,0,deny,60,60,0,1,0,1,0
58286,51959,445,0,0,drop,70,70,0,1,0,1,0
58287,46093,32661,0,0,deny,74,74,0,1,0,1,0
58288,52370,445,0,0,drop,66,66,0,1,0,1,0
58289,30129,37965,0,0,deny,72,72,0,1,0,1,0
58290,62804,37965,0,0,deny,66,66,0,1,0,1,0
58291,0,0,0,0,allow,156,156,0,2,0,2,0
58292,0,0,0,0,allow,244,244,0,2,0,2,0
58293,51957,445,0,0,drop,70,70,0,1,0,1,0
58294,64948,25198,0,0,deny,145,145,0,1,0,1,0
58295,8211,28793,0,0,deny,66,66,0,1,0,1,0
58296,53300,37807,0,0,deny,62,62,0,1,0,1,0
58297,60188,15503,0,0,deny,66,66,0,1,0,1,0
58298,52364,445,0,0,drop,66,66,0,1,0,1,0
58299,65512,44847,0,0,deny,66,66,0,1,0,1,0
58300,52361,445,0,0,drop,66,66,0,1,0,1,0
58301,55937,53,29379,53,allow,174,89,85,2,0,1,1
58302,34531,23117,0,0,deny,62,62,0,1,0,1,0
58303,25602,64147,0,0,deny,62,62,0,1,0,1,0
58304,51760,50584,0,0,deny,66,66,0,1,0,1,0
58305,51244,3855,0,0,deny,100,100,0,1,0,1,0
58306,51815,51221,0,0,deny,74,74,0,1,0,1,0
58307,59055,11392,0,0,deny,66,66,0,1,0,1,0
58308,43129,20220,0,0,deny,62,62,0,1,0,1,0
58309,51950,445,0,0,drop,70,70,0,1,0,1,0
58310,6889,48817,0,0,deny,143,143,0,1,0,1,0
58311,51948,445,0,0,drop,70,70,0,1,0,1,0
58312,25091,64147,0,0,deny,66,66,0,1,0,1,0
58313,49628,35440,0,0,deny,66,66,0,1,0,1,0
58314,59128,44847,0,0,deny,66,66,0,1,0,1,0
58315,56945,445,0,0,drop,70,70,0,1,0,1,0
58316,63701,46824,0,0,deny,66,66,0,1,0,1,0
58317,56941,445,0,0,drop,70,70,0,1,0,1,0
58318,56940,445,0,0,drop,70,70,0,1,0,1,0
58319,51947,445,0,0,drop,70,70,0,1,0,1,0
58320,21733,56205,0,0,deny,66,66,0,1,0,1,0
58321,52347,445,0,0,drop,66,66,0,1,0,1,0
58322,52346,445,0,0,drop,66,66,0,1,0,1,0
58323,52345,445,0,0,drop,66,66,0,1,0,1,0
58324,52342,445,0,0,drop,66,66,0,1,0,1,0
58325,52341,445,0,0,drop,66,66,0,1,0,1,0
58326,52344,445,0,0,drop,66,66,0,1,0,1,0
58327,52348,445,0,0,drop,66,66,0,1,0,1,0
58328,52340,445,0,0,drop,66,66,0,1,0,1,0
58329,51946,445,0,0,drop,70,70,0,1,0,1,0
58330,51945,445,0,0,drop,70,70,0,1,0,1,0
58331,50084,26672,0,0,deny,62,62,0,1,0,1,0
58332,51941,445,0,0,drop,70,70,0,1,0,1,0
58333,51939,445,0,0,drop,70,70,0,1,0,1,0
58334,45079,31573,0,0,deny,66,66,0,1,0,1,0
58335,42632,44847,0,0,deny,62,62,0,1,0,1,0
58336,57654,35440,0,0,deny,66,66,0,1,0,1,0
58337,49976,22114,0,0,deny,66,66,0,1,0,1,0
58338,51927,445,0,0,drop,70,70,0,1,0,1,0
58339,51926,445,0,0,drop,70,70,0,1,0,1,0
58340,15131,50584,0,0,deny,62,62,0,1,0,1,0
58341,51923,445,0,0,drop,70,70,0,1,0,1,0
58342,51914,445,0,0,drop,70,70,0,1,0,1,0
58343,51913,445,0,0,drop,70,70,0,1,0,1,0
58344,59732,443,44274,443,allow,34866,3347,31519,55,54,22,33
58345,53572,22754,38870,22754,allow,70,70,0,2,8,2,0
58346,46714,80,46714,80,allow,83777,2610,81167,90,155,27,63
58347,59407,443,31789,443,allow,3298,2132,1166,16,15,8,8
58348,3697,80,55800,80,allow,6688,1208,5480,20,104,12,8
58349,65011,53,38944,53,allow,182,93,89,2,30,1,1
58350,56769,11155,5156,11155,allow,66,66,0,1,5,1,0
58351,51746,17867,44740,17867,allow,136,136,0,3,14,3,0
58352,49768,80,40790,80,allow,254,128,126,5,15,3,2
58353,49825,443,10152,443,allow,15401,3011,12390,37,65,21,16
58354,44796,443,34897,443,allow,8158,2927,5231,25,85,15,10
58355,44776,443,54500,443,allow,10087,4073,6014,33,88,18,15
58356,56628,53,54812,53,allow,789,110,679,2,30,1,1
58357,49580,53,21716,53,allow,192,98,94,2,30,1,1
58358,48790,443,60676,443,allow,7298,2661,4637,21,19,11,10
58359,59405,443,60870,443,allow,9052,2120,6932,28,23,14,14
58360,64613,53,26326,53,allow,89,89,0,1,30,1,0
58361,58006,443,30394,443,allow,9596,1688,7908,26,255,13,13
58362,56598,443,16755,443,allow,8630,2126,6504,20,15,11,9
58363,40764,443,58656,443,allow,3321,1297,2024,13,28,7,6
58364,57064,443,57064,443,allow,4378,1471,2907,19,29,11,8
58365,33317,53,33317,53,allow,231,88,143,2,32,1,1
58366,59795,443,6313,443,allow,120014,7352,112662,155,37,64,91
58367,52458,53,52458,53,allow,231,88,143,2,33,1,1
58368,51765,52862,26786,52862,allow,70,70,0,2,7,2,0
58369,51747,54301,33615,54301,allow,136,136,0,3,14,3,0
58370,53557,39731,45884,39731,allow,70,70,0,1,5,1,0
58371,51145,80,27456,80,allow,78198970,2041652,76157318,79332,368,28698,50634
58372,42105,53,20788,53,allow,168,78,90,2,30,1,1
58373,56597,443,58985,443,allow,8700,2196,6504,21,16,12,9
58374,50317,443,44223,443,allow,13565,6019,7546,35,112,19,16
58375,54506,443,29033,443,allow,89702,83941,5761,91,181,66,25
58376,56857,53,30246,53,allow,711,87,624,2,30,1,1
58377,59340,53,59340,53,allow,215,90,125,2,30,1,1
58378,49996,53,3392,53,allow,182,93,89,2,31,1,1
58379,49418,27015,26473,27015,allow,280,71,209,2,31,1,1
58380,55577,53,64711,53,allow,198,101,97,2,31,1,1
58381,59408,443,57336,443,allow,2914,1780,1134,16,15,8,8
58382,51649,80,42317,80,allow,1965,1402,563,13,16,7,6
58383,50116,22,50116,22,allow,60,60,0,1,5,1,0
58384,40408,1488,40408,1488,allow,156,156,0,3,8,3,0
58385,59808,443,39380,443,allow,23950,2135,21815,43,35,16,27
58386,52920,443,42636,443,allow,6253,2132,4121,19,16,10,9
58387,59847,443,63269,443,allow,21180,2662,18518,34,17,14,20
58388,59788,443,40327,443,allow,134688,7027,127661,166,37,64,102
58389,65312,53,47796,53,allow,180,92,88,2,30,1,1
58390,49418,27015,16562,27015,allow,269,71,198,2,31,1,1
58391,49418,27018,39372,27018,allow,259,71,188,2,31,1,1
58392,52060,443,18866,443,allow,40726,3421,37305,52,121,20,32
58393,60730,443,28797,443,allow,14776,5238,9538,41,175,21,20
58394,55088,53,2549,53,allow,186,95,91,2,31,1,1
58395,51135,443,21022,443,allow,640504,257235,383269,1476,797,643,833
58396,44219,443,26012,443,allow,35920,26656,9264,60,128,30,30
58397,40893,123,36091,123,allow,184,94,90,2,31,1,1
58398,49418,27018,26196,27018,allow,71,71,0,1,31,1,0
58399,49418,27017,43664,27017,allow,259,71,188,2,31,1,1
58400,49418,27018,46953,27018,allow,249,71,178,2,31,1,1
58401,57949,5228,62651,5228,allow,2655,1540,1115,19,3601,9,10
58402,54316,53,0,0,allow,325,77,248,2,31,1,1
58403,49418,27020,19032,27020,allow,246,71,175,2,31,1,1
58404,49418,27015,41865,27015,allow,242,71,171,2,31,1,1
58405,49418,27014,49598,27014,allow,235,71,164,2,31,1,1
58406,42071,443,52227,443,allow,9366,5830,3536,23,121,12,11
58407,1987,26467,0,0,deny,62,62,0,1,0,1,0
58408,56939,445,0,0,drop,70,70,0,1,0,1,0
58409,56937,445,0,0,drop,70,70,0,1,0,1,0
58410,56926,445,0,0,drop,70,70,0,1,0,1,0
58411,38633,51221,0,0,deny,66,66,0,1,0,1,0
58412,46849,36237,0,0,deny,62,62,0,1,0,1,0
58413,61013,41705,0,0,deny,66,66,0,1,0,1,0
58414,52326,445,0,0,drop,66,66,0,1,0,1,0
58415,52328,445,0,0,drop,66,66,0,1,0,1,0
58416,52327,445,0,0,drop,66,66,0,1,0,1,0
58417,56922,445,0,0,drop,70,70,0,1,0,1,0
58418,25536,50584,0,0,deny,62,62,0,1,0,1,0
58419,49418,27015,24745,27015,allow,270,78,192,2,30,1,1
58420,65463,53,50986,53,allow,177,94,83,2,30,1,1
58421,46275,64147,0,0,deny,62,62,0,1,0,1,0
58422,56920,445,0,0,drop,70,70,0,1,0,1,0
58423,51902,445,0,0,drop,70,70,0,1,0,1,0
58424,33292,50584,0,0,deny,66,66,0,1,0,1,0
58425,39165,23,0,0,deny,60,60,0,1,0,1,0
58426,56911,445,0,0,drop,70,70,0,1,0,1,0
58427,56912,445,0,0,drop,70,70,0,1,0,1,0
58428,56908,445,0,0,drop,70,70,0,1,0,1,0
58429,58022,5555,0,0,deny,60,60,0,1,0,1,0
58430,34489,35440,0,0,deny,66,66,0,1,0,1,0
58431,51999,37965,0,0,deny,62,62,0,1,0,1,0
58432,30084,21247,0,0,deny,146,146,0,1,0,1,0
58433,19610,9571,0,0,deny,62,62,0,1,0,1,0
58434,26324,30188,0,0,deny,62,62,0,1,0,1,0
58435,51895,445,0,0,drop,70,70,0,1,0,1,0
58436,38980,17,0,0,deny,60,60,0,1,0,1,0
58437,80,37649,0,0,deny,60,60,0,1,0,1,0
58438,52975,23718,0,0,deny,62,62,0,1,0,1,0
58439,56458,53,38538,53,allow,196,102,94,2,30,1,1
58440,64997,53,25843,53,allow,166,86,80,2,30,1,1
58441,38604,53,38604,53,allow,203,82,121,2,30,1,1
58442,50089,443,48630,443,allow,12446,2347,10099,44,190,23,21
58443,60747,40010,30374,40010,allow,316,136,180,6,6,3,3
58444,53571,19636,50196,19636,allow,70,70,0,2,7,2,0
58445,49216,53,31679,53,allow,789,110,679,2,29,1,1
58446,49418,27025,65106,27025,allow,240,78,162,2,30,1,1
58447,57968,443,57498,443,allow,6254,1581,4673,21,190,12,9
58448,51062,80,29351,80,allow,36568,23029,13539,94,194,47,47
58449,55084,443,37269,443,allow,5556,1438,4118,22,196,12,10
58450,38570,443,8181,443,allow,6260,1587,4673,21,191,12,9
58451,44099,443,28525,443,allow,6235,1562,4673,21,191,12,9
58452,65513,53,57723,53,allow,195,102,93,2,29,1,1
58453,53559,58968,6999,58968,allow,70,70,0,1,4,1,0
58454,63769,47661,30265,47661,allow,66,66,0,2,7,2,0
58455,53895,53,0,0,allow,86,86,0,1,29,1,0
58456,56215,53,45300,53,allow,168,78,90,2,29,1,1
58457,63771,7426,29432,7426,allow,66,66,0,2,7,2,0
58458,65188,27126,32293,27126,allow,268,78,190,2,29,1,1
58459,14430,443,35759,443,allow,2629,1470,1159,18,15,8,10
58460,64355,53,49915,53,allow,402,118,284,2,29,1,1
58461,47739,53,26929,53,allow,168,78,90,2,29,1,1
58462,56418,53,6346,53,allow,183,94,89,2,29,1,1
58463,64645,53,50507,53,allow,391,96,295,4,49,2,2
58464,56239,53,9531,53,allow,179,86,93,2,29,1,1
58465,56288,53,34669,53,allow,183,94,89,2,30,1,1
58466,65184,27126,4649,27126,allow,268,78,190,2,29,1,1
58467,65463,53,23022,53,allow,177,94,83,2,30,1,1
58468,49418,23010,54751,23010,allow,288,78,210,2,30,1,1
58469,56845,53,40181,53,allow,730,102,628,2,30,1,1
58470,49418,27400,52679,27400,allow,78,78,0,1,30,1,0
58471,40215,443,8042,443,allow,6423,1543,4880,21,191,12,9
58472,51766,48169,62941,48169,allow,70,70,0,2,7,2,0
58473,56924,53,7241,53,allow,216,110,106,2,30,1,1
58474,64527,53,58780,53,allow,228,102,126,2,30,1,1
58475,64871,53,62774,53,allow,263,94,169,2,31,1,1
58476,49418,27017,57316,27017,allow,262,78,184,2,30,1,1
58477,49418,27118,47467,27118,allow,78,78,0,1,30,1,0
58478,49918,443,49171,443,allow,10385,3107,7278,28,16,16,12
58479,32160,53,32160,53,allow,233,90,143,2,32,1,1
58480,51988,53,22023,53,allow,78,78,0,1,30,1,0
58481,41907,53,41907,53,allow,233,90,143,2,33,1,1
58482,49418,27015,40892,27015,allow,250,78,172,2,30,1,1
58483,18837,53,18837,53,allow,233,90,143,2,32,1,1
58484,53551,60444,1391,60444,allow,492,306,186,8,15,5,3
58485,56509,80,38678,80,allow,3697,832,2865,12,15,7,5
58486,35374,443,7317,443,allow,1558,971,587,14,123,8,6
58487,36682,80,24588,80,allow,130,70,60,2,15,1,1
58488,56114,53,2423,53,allow,216,110,106,2,30,1,1
58489,63128,443,30036,443,allow,4994,379,4615,9,15,4,5
58490,44211,53,44211,53,allow,850,114,736,2,30,1,1
58491,65312,53,52827,53,allow,182,94,88,2,30,1,1
58492,65312,53,55577,53,allow,182,94,88,2,30,1,1
58493,57132,53,36267,53,allow,177,94,83,2,30,1,1
58494,56458,53,47423,53,allow,196,102,94,2,30,1,1
58495,57321,53,18718,53,allow,199,102,97,2,30,1,1
58496,51550,53,60452,53,allow,168,78,90,2,30,1,1
58497,37696,443,12389,443,allow,32798,2912,29886,58,170,29,29
58498,56770,52920,10024,52920,allow,70,70,0,1,5,1,0
58499,64145,53,5953,53,allow,504,105,399,4,35,2,2
58500,49230,443,49230,443,allow,123041,10988,112053,185,67,86,99
58501,65372,53,40284,53,allow,198,102,96,2,30,1,1
58502,49301,53,20768,53,allow,214,102,112,2,30,1,1
58503,44116,123,64380,123,allow,184,94,90,2,30,1,1
58504,64840,53,3676,53,allow,193,102,91,2,30,1,1
58505,56924,53,61139,53,allow,216,110,106,2,30,1,1
58506,64281,53,41166,53,allow,492,90,402,4,45,2,2
58507,39042,443,60755,443,allow,3589,1251,2338,15,20,9,6
58508,57321,53,57606,53,allow,199,102,97,2,30,1,1
58509,65312,53,9346,53,allow,182,94,88,2,30,1,1
58510,57367,53,52070,53,allow,177,94,83,2,30,1,1
58511,50550,443,42250,443,allow,8123,1809,6314,22,71,12,10
58512,43893,443,47910,443,allow,1440,719,721,15,198,8,7
58513,49774,443,43328,443,allow,8130,2220,5910,23,16,13,10
58514,36258,443,41571,443,allow,1128432,47396,1081036,1242,142,458,784
58515,3688,80,37150,80,allow,7072,1145,5927,20,105,12,8
58516,53570,24874,32383,24874,allow,70,70,0,2,7,2,0
58517,41210,443,11454,443,allow,234,234,0,4,11,4,0
58518,49418,27015,12745,27015,allow,227,78,149,2,30,1,1
58519,65467,443,32500,443,allow,92244,4799,87445,107,15,43,64
58520,52795,443,15981,443,allow,1444,723,721,15,198,8,7
58521,51105,80,8408,80,allow,366,240,126,7,20,5,2
58522,46989,80,46989,80,allow,82082,3212,78870,90,155,27,63
58523,53556,1024,47936,1024,allow,70,70,0,1,4,1,0
58524,51764,33432,19826,33432,allow,70,70,0,2,8,2,0
58525,46053,443,15914,443,allow,6999,1563,5436,18,186,3,15
58526,53553,2297,50955,2297,allow,70,70,0,1,4,1,0
58527,63768,55755,28718,55755,allow,66,66,0,2,7,2,0
58528,53111,50809,43690,50809,allow,70,70,0,1,4,1,0
58529,52459,33899,52459,33899,allow,66,66,0,1,5,1,0
58530,49418,53,51153,53,allow,379,93,286,4,37,2,2
58531,53576,23505,43782,23505,allow,70,70,0,2,7,2,0
58532,55612,36239,64723,36239,allow,320,140,180,6,5,3,3
58533,30296,53,30296,53,allow,233,90,143,2,33,1,1
58534,35373,443,52870,443,allow,255313,6947,248366,253,123,74,179
58535,46910,443,1706,443,allow,5714,1536,4178,24,21,13,11
58536,51221,64509,12506,64509,allow,3564,3564,0,55,4073,55,0
58537,55730,53,1752,53,allow,819,102,717,2,29,1,1
58538,57731,443,57731,443,allow,5508,2261,3247,22,38,13,9
58539,50334,53,27323,53,allow,216,110,106,2,29,1,1
58540,64811,53,25235,53,allow,193,102,91,2,29,1,1
58541,56114,53,59313,53,allow,216,110,106,2,30,1,1
58542,64517,53,41974,53,allow,194,102,92,2,29,1,1
58543,64877,53,24531,53,allow,309,110,199,2,30,1,1
58544,50164,53,36057,53,allow,260,86,174,2,29,1,1
58545,64580,53,58796,53,allow,200,94,106,2,30,1,1
58546,52652,443,42861,443,allow,283768,16167,267601,384,116,148,236
58547,56924,53,48740,53,allow,216,110,106,2,30,1,1
58548,56431,53,52567,53,allow,323,110,213,2,30,1,1
58549,51120,443,19662,443,allow,2940,787,2153,11,119,5,6
58550,37472,443,30492,443,allow,17764,5080,12684,46,121,22,24
58551,49418,27015,51226,27015,allow,274,78,196,2,30,1,1
58552,49418,27018,13297,27018,allow,259,78,181,2,30,1,1
58553,64320,53,48665,53,allow,199,102,97,2,30,1,1
58554,49418,27018,36116,27018,allow,256,78,178,2,30,1,1
58555,65011,53,28977,53,allow,183,94,89,2,31,1,1
58556,49418,27015,50232,27015,allow,286,78,208,2,31,1,1
58557,35005,53,35005,53,allow,233,90,143,2,33,1,1
58558,24276,53,24276,53,allow,233,90,143,2,33,1,1
58559,56771,43648,21453,43648,allow,70,70,0,1,5,1,0
58560,58552,443,44204,443,allow,28468,2316,26152,43,42,15,28
58561,58541,28678,6280,28678,allow,1806,1806,0,22,224,22,0
58562,51747,7000,51747,7000,allow,3132,815,2317,14,15,7,7
58563,55577,53,12118,53,allow,199,102,97,2,30,1,1
58564,49827,443,50182,443,allow,5863,1580,4283,17,15,9,8
58565,3694,80,3582,80,allow,6919,1220,5699,20,104,12,8
58566,8168,80,8168,80,allow,282487,10736,271751,315,52,124,191
58567,64275,53,2712,53,allow,644,198,446,6,48,3,3
58568,57132,53,31918,53,allow,177,94,83,2,30,1,1
58569,55577,53,47306,53,allow,199,102,97,2,30,1,1
58570,65443,53,31902,53,allow,730,102,628,2,30,1,1
58571,49418,27200,10128,27200,allow,78,78,0,1,30,1,0
58572,55788,53,26476,53,allow,231,110,121,2,30,1,1
58573,49418,27015,52335,27015,allow,295,78,217,2,30,1,1
58574,51715,443,60037,443,allow,4887,2346,2541,16,120,8,8
58575,53888,443,42576,443,allow,8935,4627,4308,22,121,12,10
58576,49418,27015,20814,27015,allow,249,78,171,2,30,1,1
58577,48233,443,29829,443,allow,9759,3896,5863,28,230,15,13
58578,3691,80,6351,80,allow,6826,1214,5612,20,105,12,8
58579,65372,53,29268,53,allow,198,102,96,2,30,1,1
58580,49996,53,62453,53,allow,183,94,89,2,30,1,1
58581,49580,53,4352,53,allow,196,102,94,2,30,1,1
58582,49580,53,60391,53,allow,196,102,94,2,30,1,1
58583,49418,27017,6721,27017,allow,300,78,222,2,30,1,1
58584,49418,27015,7927,27015,allow,295,78,217,2,31,1,1
58585,49418,27018,21489,27018,allow,255,78,177,2,31,1,1
58586,15503,56331,21797,56331,allow,481,150,331,2,1200,1,1
58587,57470,52339,38751,52339,allow,594,594,0,10,1199,10,0
58588,49418,27017,9977,27017,allow,260,78,182,2,31,1,1
58589,49418,52013,42400,52013,allow,278,78,200,2,31,1,1
58590,49418,27016,31344,27016,allow,250,78,172,2,31,1,1
58591,53541,443,39871,443,allow,10583,1889,8694,28,251,10,18
58592,57470,53377,9260,53377,allow,594,594,0,10,1199,10,0
58593,45294,443,12924,443,allow,6290,4832,1458,18,120,11,7
58594,49759,53,30943,53,allow,216,110,106,2,31,1,1
58595,49418,27017,45242,27017,allow,259,78,181,2,31,1,1
58596,57268,443,29567,443,allow,11546,3604,7942,38,120,20,18
58597,49418,27017,22257,27017,allow,271,78,193,2,31,1,1
58598,49418,27018,42742,27018,allow,274,78,196,2,31,1,1
58599,55461,443,1970,443,allow,6314,4856,1458,18,120,11,7
58600,64336,443,26343,443,allow,10099,4296,5803,30,124,13,17
58601,49418,27035,7817,27035,allow,250,78,172,2,31,1,1
58602,64613,53,60043,53,allow,179,94,85,2,30,1,1
58603,57661,53,46284,53,allow,70,70,0,1,30,1,0
58604,49418,27015,20912,27015,allow,302,78,224,2,30,1,1
58605,49418,27016,50703,27016,allow,258,78,180,2,31,1,1
58606,55593,80,19208,80,allow,3276,404,2872,11,15,5,6
58607,51104,80,56002,80,allow,1524,1028,496,10,21,7,3
58608,34217,443,35043,443,allow,6650,1556,5094,23,18,13,10
58609,65318,80,50736,80,allow,2356,499,1857,10,134,6,4
58610,64613,53,44378,53,allow,179,94,85,2,30,1,1
58611,49418,27016,1873,27016,allow,281,78,203,2,31,1,1
58612,65449,53,65266,53,allow,507,193,314,6,57,3,3
58613,55608,17425,43686,17425,allow,320,140,180,6,7,3,3
58614,39799,443,18557,443,allow,5597,3595,2002,42,68,23,19
58615,55577,53,3000,53,allow,699,204,495,6,57,3,3
58616,5115,53,5115,53,allow,216,90,126,2,30,1,1
58617,55519,53,47075,53,allow,193,102,91,2,30,1,1
58618,57271,53,58158,53,allow,288,94,194,2,30,1,1
58619,6666,8888,0,0,deny,60,60,0,1,0,1,0
58620,80,53945,0,0,deny,60,60,0,1,0,1,0
58621,50422,50584,0,0,deny,62,62,0,1,0,1,0
58622,51887,445,0,0,drop,70,70,0,1,0,1,0
58623,51886,445,0,0,drop,70,70,0,1,0,1,0
58624,56901,445,0,0,drop,70,70,0,1,0,1,0
58625,56900,445,0,0,drop,70,70,0,1,0,1,0
58626,56896,445,0,0,drop,70,70,0,1,0,1,0
58627,80,9918,0,0,deny,60,60,0,1,0,1,0
58628,59943,37807,0,0,deny,146,146,0,1,0,1,0
58629,51880,445,0,0,drop,70,70,0,1,0,1,0
58630,51881,445,0,0,drop,70,70,0,1,0,1,0
58631,51877,445,0,0,drop,70,70,0,1,0,1,0
58632,16393,22114,0,0,deny,66,66,0,1,0,1,0
58633,60960,49049,0,0,deny,62,62,0,1,0,1,0
58634,62930,21247,0,0,deny,66,66,0,1,0,1,0
58635,30920,64147,0,0,deny,62,62,0,1,0,1,0
58636,64982,50584,0,0,deny,146,146,0,1,0,1,0
58637,34228,45129,0,0,deny,148,148,0,1,0,1,0
58638,6881,6881,0,0,deny,62,62,0,1,0,1,0
58639,54062,31573,0,0,deny,66,66,0,1,0,1,0
58640,50181,64147,0,0,deny,66,66,0,1,0,1,0
58641,52303,445,0,0,drop,66,66,0,1,0,1,0
58642,56895,445,0,0,drop,70,70,0,1,0,1,0
58643,56894,445,0,0,drop,70,70,0,1,0,1,0
58644,51872,445,0,0,drop,70,70,0,1,0,1,0
58645,3270,35440,0,0,deny,66,66,0,1,0,1,0
58646,48478,49903,0,0,deny,62,62,0,1,0,1,0
58647,51864,445,0,0,drop,70,70,0,1,0,1,0
58648,34916,51185,0,0,deny,62,62,0,1,0,1,0
58649,51861,445,0,0,drop,70,70,0,1,0,1,0
58650,52298,445,0,0,drop,66,66,0,1,0,1,0
58651,38053,50584,0,0,deny,146,146,0,1,0,1,0
58652,35657,48637,0,0,deny,62,62,0,1,0,1,0
58653,25523,35974,0,0,deny,62,62,0,1,0,1,0
58654,52296,445,0,0,drop,66,66,0,1,0,1,0
58655,56881,445,0,0,drop,70,70,0,1,0,1,0
58656,58598,50584,0,0,deny,66,66,0,1,0,1,0
58657,56878,445,0,0,drop,70,70,0,1,0,1,0
58658,56874,445,0,0,drop,70,70,0,1,0,1,0
58659,56872,445,0,0,drop,70,70,0,1,0,1,0
58660,443,43775,0,0,deny,97,97,0,1,0,1,0
58661,49699,64147,0,0,deny,66,66,0,1,0,1,0
58662,52294,445,0,0,drop,66,66,0,1,0,1,0
58663,51858,445,0,0,drop,70,70,0,1,0,1,0
58664,51856,445,0,0,drop,70,70,0,1,0,1,0
58665,60923,49903,0,0,deny,66,66,0,1,0,1,0
58666,62392,15503,0,0,deny,62,62,0,1,0,1,0
58667,5575,8889,5575,8889,deny,498,498,0,1,0,1,0
58668,9092,26672,0,0,deny,60,60,0,1,0,1,0
58669,56869,445,0,0,drop,70,70,0,1,0,1,0
58670,49664,37965,0,0,deny,66,66,0,1,0,1,0
58671,24480,35440,0,0,deny,66,66,0,1,0,1,0
58672,51852,445,0,0,drop,70,70,0,1,0,1,0
58673,56865,445,0,0,drop,70,70,0,1,0,1,0
58674,56864,445,0,0,drop,70,70,0,1,0,1,0
58675,56861,445,0,0,drop,70,70,0,1,0,1,0
58676,55296,23718,0,0,deny,66,66,0,1,0,1,0
58677,52287,445,0,0,drop,66,66,0,1,0,1,0
58678,47962,16069,0,0,deny,62,62,0,1,0,1,0
58679,51851,445,0,0,drop,70,70,0,1,0,1,0
58680,52282,445,0,0,drop,66,66,0,1,0,1,0
58681,52283,445,0,0,drop,66,66,0,1,0,1,0
58682,52280,445,0,0,drop,66,66,0,1,0,1,0
58683,52276,445,0,0,drop,66,66,0,1,0,1,0
58684,52277,445,0,0,drop,66,66,0,1,0,1,0
58685,52275,445,0,0,drop,66,66,0,1,0,1,0
58686,62452,21247,0,0,deny,62,62,0,1,0,1,0
58687,64482,64147,0,0,deny,66,66,0,1,0,1,0
58688,16387,26193,0,0,deny,60,60,0,1,0,1,0
58689,16387,35308,0,0,deny,60,60,0,1,0,1,0
58690,16387,56995,0,0,deny,60,60,0,1,0,1,0
58691,23528,44847,0,0,deny,146,146,0,1,0,1,0
58692,51846,445,0,0,drop,70,70,0,1,0,1,0
58693,56860,445,0,0,drop,70,70,0,1,0,1,0
58694,56858,445,0,0,drop,70,70,0,1,0,1,0
58695,56854,445,0,0,drop,70,70,0,1,0,1,0
58696,56967,35440,0,0,deny,66,66,0,1,0,1,0
58697,61426,64910,0,0,deny,66,66,0,1,0,1,0
58698,52273,445,0,0,drop,66,66,0,1,0,1,0
58699,54339,23117,0,0,deny,66,66,0,1,0,1,0
58700,56852,445,0,0,drop,70,70,0,1,0,1,0
58701,52269,445,0,0,drop,66,66,0,1,0,1,0
58702,52267,445,0,0,drop,66,66,0,1,0,1,0
58703,52265,445,0,0,drop,66,66,0,1,0,1,0
58704,37876,5900,0,0,deny,60,60,0,1,0,1,0
58705,52263,445,0,0,drop,66,66,0,1,0,1,0
58706,50668,58833,0,0,deny,62,62,0,1,0,1,0
58707,30303,19391,0,0,deny,181,181,0,1,0,1,0
58708,80,37649,0,0,deny,60,60,0,1,0,1,0
58709,80,53945,0,0,deny,60,60,0,1,0,1,0
58710,54471,36237,0,0,deny,66,66,0,1,0,1,0
58711,56844,445,0,0,drop,70,70,0,1,0,1,0
58712,33832,55108,0,0,deny,148,148,0,1,0,1,0
58713,59918,44847,0,0,deny,66,66,0,1,0,1,0
58714,51833,445,0,0,drop,70,70,0,1,0,1,0
58715,43580,57470,0,0,deny,145,145,0,1,0,1,0
58716,443,11135,0,0,deny,66,66,0,1,0,1,0
58717,80,9918,0,0,deny,60,60,0,1,0,1,0
58718,56836,445,0,0,drop,70,70,0,1,0,1,0
58719,56837,445,0,0,drop,70,70,0,1,0,1,0
58720,46557,57866,0,0,deny,62,62,0,1,0,1,0
58721,63852,35440,0,0,deny,66,66,0,1,0,1,0
58722,0,0,0,0,deny,60,60,0,1,0,1,0
58723,48087,16069,0,0,deny,66,66,0,1,0,1,0
58724,52255,445,0,0,drop,66,66,0,1,0,1,0
58725,5223,44091,0,0,deny,220,220,0,1,0,1,0
58726,34211,23,0,0,deny,60,60,0,1,0,1,0
58727,52245,445,0,0,drop,66,66,0,1,0,1,0
58728,50439,64147,0,0,deny,66,66,0,1,0,1,0
58729,51826,445,0,0,drop,70,70,0,1,0,1,0
58730,56825,445,0,0,drop,70,70,0,1,0,1,0
58731,1024,64147,0,0,deny,62,62,0,1,0,1,0
58732,51824,445,0,0,drop,70,70,0,1,0,1,0
58733,42685,51180,0,0,deny,62,62,0,1,0,1,0
58734,1431,30041,0,0,deny,62,62,0,1,0,1,0
58735,51822,445,0,0,drop,70,70,0,1,0,1,0
58736,39217,31573,0,0,deny,146,146,0,1,0,1,0
58737,31748,56205,0,0,deny,146,146,0,1,0,1,0
58738,13654,50584,0,0,deny,62,62,0,1,0,1,0
58739,52243,445,0,0,drop,66,66,0,1,0,1,0
58740,44491,50584,0,0,deny,146,146,0,1,0,1,0
58741,40834,50584,0,0,deny,62,62,0,1,0,1,0
58742,52236,445,0,0,drop,66,66,0,1,0,1,0
58743,64890,51180,0,0,deny,66,66,0,1,0,1,0
58744,52231,445,0,0,drop,66,66,0,1,0,1,0
58745,24592,50584,0,0,deny,62,62,0,1,0,1,0
58746,25880,44847,0,0,deny,146,146,0,1,0,1,0
58747,51815,445,0,0,drop,70,70,0,1,0,1,0
58748,60192,35440,0,0,deny,62,62,0,1,0,1,0
58749,8976,44847,0,0,deny,66,66,0,1,0,1,0
58750,51815,51221,0,0,deny,74,74,0,1,0,1,0
58751,56327,44512,0,0,deny,66,66,0,1,0,1,0
58752,51813,445,0,0,drop,70,70,0,1,0,1,0
58753,49418,27016,14268,27016,allow,236,71,165,2,30,1,1
58754,49418,27016,42028,27016,allow,246,71,175,2,30,1,1
58755,49418,52013,5997,52013,allow,257,71,186,2,30,1,1
58756,39396,443,4891,443,allow,7531,2720,4811,24,331,13,11
58757,61459,80,3928,80,allow,4671,2593,2078,15,85,9,6
58758,43106,443,35974,443,allow,3259,1913,1346,18,16,8,10
58759,44740,443,62303,443,allow,5954,1454,4500,22,142,13,9
58760,49418,27015,34023,27015,allow,249,71,178,2,30,1,1
58761,49418,27015,33472,27015,allow,71,71,0,1,30,1,0
58762,49418,27015,48509,27015,allow,266,71,195,2,31,1,1
58763,49418,27013,52057,27013,allow,230,71,159,2,31,1,1
58764,65339,53,50441,53,allow,186,95,91,2,31,1,1
58765,49418,27019,50504,27019,allow,71,71,0,1,30,1,0
58766,43105,443,31281,443,allow,3115,1849,1266,18,16,8,10
58767,64992,53,63333,53,allow,170,87,83,2,30,1,1
58768,49418,27016,27118,27016,allow,231,71,160,2,30,1,1
58769,55231,443,25575,443,allow,10684454,328574,10355880,11599,77,3693,7906
58770,65317,80,47905,80,allow,1014,507,507,8,133,5,3
58771,55519,53,8879,53,allow,186,95,91,2,30,1,1
58772,49418,27016,26293,27016,allow,257,71,186,2,30,1,1
58773,51117,60038,0,0,allow,66,66,0,1,90,1,0
58774,51101,80,9411,80,allow,366,240,126,7,20,5,2
58775,53974,53,45539,53,allow,578,286,292,9,15,5,4
58776,60022,443,60022,443,allow,18674,1910,16764,32,18,17,15
58777,49759,53,28731,53,allow,216,110,106,2,30,1,1
58778,50614,443,33140,443,allow,3499,1732,1767,15,16,9,6
58779,50447,443,44649,443,allow,12362,3372,8990,34,143,18,16
58780,49418,27017,46358,27017,allow,252,71,181,2,30,1,1
58781,57367,53,62826,53,allow,170,87,83,2,30,1,1
58782,45713,53,45713,53,allow,217,87,130,2,30,1,1
58783,6354,53,6354,53,allow,217,87,130,2,30,1,1
58784,49418,27019,38743,27019,allow,251,71,180,2,30,1,1
58785,49418,27018,61835,27018,allow,248,71,177,2,30,1,1
58786,51425,53,0,0,allow,194,87,107,2,30,1,1
58787,49418,27016,46428,27016,allow,249,71,178,2,30,1,1
58788,49418,27015,56301,27015,allow,258,71,187,2,30,1,1
58789,49418,27017,12752,27017,allow,283,71,212,2,31,1,1
58790,49418,27015,14381,27015,allow,248,71,177,2,31,1,1
58791,51744,1678,56992,1678,allow,66,66,0,1,5,1,0
58792,51341,7000,51341,7000,allow,3132,815,2317,14,16,7,7
58793,51745,2572,3211,2572,allow,66,66,0,1,5,1,0
58794,54631,443,58856,443,allow,8367,3945,4422,81,616,42,39
58795,28470,80,28470,80,allow,355544,12402,343142,378,26,134,244
58796,35647,3389,35647,3389,allow,4575,2400,2175,20,18,11,9
58797,50496,443,2792,443,allow,751676,8792,742884,617,16,123,494
58798,43230,80,43230,80,allow,6776,692,6084,16,20,8,8
58799,64320,53,33961,53,allow,198,101,97,2,30,1,1
58800,49418,27016,22907,27016,allow,254,71,183,2,30,1,1
58801,10001,40041,23223,40041,allow,151,89,62,2,30,1,1
58802,28858,80,28858,80,allow,83253,4938,78315,99,26,39,60
58803,49418,27017,63792,27017,allow,256,71,185,2,30,1,1
58804,53670,53,0,0,allow,82,82,0,1,30,1,0
58805,29245,80,29245,80,allow,27233,4047,23186,44,27,20,24
58806,49418,27017,33582,27017,allow,71,71,0,1,30,1,0
58807,49418,27015,17910,27015,allow,232,71,161,2,31,1,1
58808,63810,443,22948,443,allow,8243,4867,3376,33,137,16,17
58809,62524,123,21935,123,allow,184,94,90,2,31,1,1
58810,60354,443,37287,443,allow,10223,3933,6290,49,115,22,27
58811,61143,443,58972,443,allow,6391,3788,2603,14,121,7,7
58812,53442,443,36564,443,allow,28728581,857403,27871178,29322,132,8944,20378
58813,61475,443,7125,443,allow,198481,12339,186142,247,64,112,135
58814,23151,53,23151,53,allow,194,87,107,2,31,1,1
58815,60962,53,0,0,allow,180,80,100,2,31,1,1
58816,59455,53,0,0,allow,221,81,140,2,31,1,1
58817,30960,45673,1133,45673,allow,462,462,0,8,3633,8,0
58818,64025,24855,0,0,allow,66,66,0,1,90,1,0
58819,51812,445,0,0,drop,70,70,0,1,0,1,0
58820,61315,48817,0,0,deny,62,62,0,1,0,1,0
58821,51811,445,0,0,drop,70,70,0,1,0,1,0
58822,51810,445,0,0,drop,70,70,0,1,0,1,0
58823,64897,2323,0,0,deny,60,60,0,1,0,1,0
58824,51806,445,0,0,drop,70,70,0,1,0,1,0
58825,51807,445,0,0,drop,70,70,0,1,0,1,0
58826,56815,445,0,0,drop,70,70,0,1,0,1,0
58827,56813,445,0,0,drop,70,70,0,1,0,1,0
58828,56812,445,0,0,drop,70,70,0,1,0,1,0
58829,18655,50584,0,0,deny,62,62,0,1,0,1,0
58830,52214,445,0,0,drop,66,66,0,1,0,1,0
58831,52220,445,0,0,drop,66,66,0,1,0,1,0
58832,51837,37965,0,0,deny,66,66,0,1,0,1,0
58833,52219,445,0,0,drop,66,66,0,1,0,1,0
58834,52217,445,0,0,drop,66,66,0,1,0,1,0
58835,52215,445,0,0,deny,66,66,0,1,0,1,0
58836,52216,445,0,0,drop,66,66,0,1,0,1,0
58837,52213,445,0,0,drop,66,66,0,1,0,1,0
58838,52212,445,0,0,drop,66,66,0,1,0,1,0
58839,36656,64147,0,0,deny,62,62,0,1,0,1,0
58840,51792,445,0,0,drop,70,70,0,1,0,1,0
58841,51791,445,0,0,drop,70,70,0,1,0,1,0
58842,51788,445,0,0,drop,70,70,0,1,0,1,0
58843,49418,27017,35147,27017,allow,78,78,0,1,30,1,0
58844,40583,80,60376,80,allow,898,543,355,10,255,6,4
58845,28275,80,28275,80,allow,303421,10894,292527,324,26,116,208
58846,20898,53,20898,53,allow,233,90,143,2,32,1,1
58847,51758,31009,36831,31009,allow,70,70,0,2,8,2,0
58848,45057,443,53651,443,allow,1394,733,661,14,80,8,6
58849,49418,27017,15205,27017,allow,252,78,174,2,30,1,1
58850,49996,53,6579,53,allow,183,94,89,2,30,1,1
58851,55899,443,47257,443,allow,4819,2304,2515,16,135,8,8
58852,49418,27016,47902,27016,allow,245,78,167,2,30,1,1
58853,65319,80,8384,80,allow,2284,484,1800,10,133,6,4
58854,58052,25,34376,25,allow,540,256,284,9,30,5,4
58855,63741,36776,9191,36776,allow,70,70,0,1,4,1,0
58856,10002,40012,52638,40012,allow,261,198,63,2,29,1,1
58857,49418,27015,8182,27015,allow,252,78,174,2,29,1,1
58858,49418,27016,33402,27016,allow,259,78,181,2,29,1,1
58859,49418,27015,20028,27015,allow,264,78,186,2,29,1,1
58860,49418,27015,52265,27015,allow,266,78,188,2,30,1,1
58861,49418,27015,32130,27015,allow,260,78,182,2,30,1,1
58862,49418,49000,14471,49000,allow,270,78,192,2,30,1,1
58863,51060,80,61015,80,allow,4632,2660,1972,49,193,26,23
58864,51231,443,1331,443,allow,1396,735,661,14,80,8,6
58865,41502,443,22197,443,allow,1053,566,487,10,48,6,4
58866,50448,443,27905,443,allow,10382,3262,7120,30,142,16,14
58867,50912,80,58684,80,allow,9578491,119422,9459069,8079,137,1689,6390
58868,57886,80,60119,80,allow,6526,1210,5316,15,17,8,7
58869,41999,80,10138,80,allow,38137,1920,36217,51,81,24,27
58870,63742,26305,40966,26305,allow,70,70,0,1,4,1,0
58871,50048,80,54605,80,allow,2140,1030,1110,22,149,8,14
58872,38091,7275,44065,7275,allow,350,210,140,6,15,4,2
58873,65011,53,20412,53,allow,183,94,89,2,29,1,1
58874,56955,53,20294,53,allow,184,86,98,2,29,1,1
58875,64520,53,44752,53,allow,184,86,98,2,29,1,1
58876,38211,123,28193,123,allow,184,94,90,2,29,1,1
58877,49418,27015,10652,27015,allow,224,78,146,2,30,1,1
58878,57367,53,51549,53,allow,177,94,83,2,29,1,1
58879,49815,53,18819,53,allow,212,102,110,2,29,1,1
58880,49418,27015,65524,27015,allow,287,78,209,2,30,1,1
58881,49527,53,19400,53,allow,200,94,106,2,30,1,1
58882,55088,53,55518,53,allow,193,102,91,2,30,1,1
58883,49418,27015,2773,27015,allow,243,78,165,2,30,1,1
58884,64828,53,62244,53,allow,260,102,158,2,30,1,1
58885,56018,443,53493,443,allow,162,102,60,2,5,1,1
58886,58876,80,60067,80,allow,32098,2435,29663,47,75,24,23
58887,47812,443,45871,443,allow,25864,15150,10714,105,217,54,51
58888,44861,443,26247,443,allow,1053,566,487,10,47,6,4
58889,34183,443,44472,443,allow,10459,2529,7930,31,375,13,18
58890,60139,53,31222,53,allow,218,78,140,2,30,1,1
58891,45601,443,27195,443,allow,5378,984,4394,18,17,10,8
58892,63112,443,43251,443,allow,3695,2713,982,21,82,12,9
58893,46342,53,46342,53,allow,233,90,143,2,32,1,1
58894,56335,53,31703,53,allow,260,102,158,2,30,1,1
58895,63770,24466,46194,24466,allow,312,132,180,6,6,3,3
58896,51495,443,20935,443,allow,55465,11462,44003,89,31,43,46
58897,55971,53,55971,53,allow,233,90,143,2,33,1,1
58898,51760,36558,43821,36558,allow,70,70,0,2,8,2,0
58899,10092,443,29539,443,allow,130,70,60,3,5,2,1
58900,60329,7000,60329,7000,allow,3959,1738,2221,15,15,8,7
58901,35735,80,48997,80,allow,1155,781,374,10,15,6,4
58902,50597,443,31048,443,allow,8031,1915,6116,24,17,12,12
58903,54889,53,54889,53,allow,832,106,726,2,30,1,1
58904,50579,443,37078,443,allow,2707,1383,1324,29,36,16,13
58905,28391,80,28391,80,allow,12237,2818,9419,27,26,14,13
58906,57298,8765,45553,8765,allow,2466,1350,1116,37,569,19,18
58907,60397,43129,12174,43129,allow,70,70,0,2,8,2,0
58908,64320,53,61236,53,allow,199,102,97,2,30,1,1
58909,55377,53,9978,53,allow,228,110,118,2,30,1,1
58910,62877,53,36980,53,allow,248,78,170,2,30,1,1
58911,64891,53,17816,53,allow,211,102,109,2,30,1,1
58912,49418,27015,23061,27015,allow,256,78,178,2,30,1,1
58913,49482,53,59102,53,allow,196,94,102,2,30,1,1
58914,55088,53,58589,53,allow,193,102,91,2,30,1,1
58915,65147,53,52735,53,allow,323,102,221,2,30,1,1
58916,49418,27015,26438,27015,allow,78,78,0,1,30,1,0
58917,64314,53,49422,53,allow,319,126,193,2,30,1,1
58918,49418,27025,2656,27025,allow,250,78,172,2,30,1,1
58919,49418,27015,42227,27015,allow,251,78,173,2,30,1,1
58920,40500,53,40500,53,allow,203,82,121,2,30,1,1
58921,49807,53,0,0,allow,218,77,141,2,30,1,1
58922,56650,53,58049,53,allow,253,102,151,2,30,1,1
58923,59112,53,0,0,allow,296,76,220,2,30,1,1
58924,49418,27018,53537,27018,allow,256,78,178,2,30,1,1
58925,49418,27016,30888,27016,allow,255,78,177,2,30,1,1
58926,65381,53,45140,53,allow,241,110,131,2,30,1,1
58927,49418,27015,37811,27015,allow,236,78,158,2,30,1,1
58928,51761,19136,54705,19136,allow,70,70,0,2,8,2,0
58929,50444,80,3294,80,allow,378,192,186,7,19,4,3
58930,65399,53,0,0,allow,191,75,116,2,30,1,1
58931,61320,53,0,0,allow,194,80,114,2,30,1,1
58932,49418,27015,40733,27015,allow,242,78,164,2,30,1,1
58933,65339,53,24574,53,allow,193,102,91,2,30,1,1
58934,57040,53,51890,53,allow,236,94,142,2,30,1,1
58935,50533,443,28213,443,allow,3518,1654,1864,10,120,5,5
58936,51221,19072,17591,19072,allow,330,330,0,6,1200,6,0
58937,44516,443,57254,443,allow,4709,2451,2258,18,304,8,10
58938,49418,27111,53348,27111,allow,258,78,180,2,30,1,1
58939,6881,8999,10252,8999,allow,502,150,352,2,1199,1,1
58940,49418,27016,45260,27016,allow,255,78,177,2,30,1,1
58941,49418,27015,38539,27015,allow,249,78,171,2,30,1,1
58942,65256,53,29045,53,allow,357,105,252,4,57,2,2
58943,64946,53,64946,53,allow,233,90,143,2,33,1,1
58944,49418,27019,26998,27019,allow,242,78,164,2,30,1,1
58945,63744,47106,28036,47106,allow,70,70,0,1,4,1,0
58946,65316,80,11827,80,allow,2430,531,1899,10,133,6,4
58947,53549,40826,14418,40826,allow,492,306,186,8,14,5,3
58948,49418,27333,30238,27333,allow,254,78,176,2,30,1,1
58949,61717,80,65373,80,allow,6160,2912,3248,17,18,9,8
58950,63743,46081,6085,46081,allow,70,70,0,1,4,1,0
58951,50443,80,16210,80,allow,378,192,186,7,19,4,3
58952,47123,443,37885,443,allow,1053,566,487,10,43,6,4
58953,49759,53,16085,53,allow,216,110,106,2,29,1,1
58954,49903,53,18446,53,allow,215,102,113,2,29,1,1
58955,50445,443,50834,443,allow,14431,2090,12341,42,142,20,22
58956,48568,443,2828,443,allow,56258,45661,10597,165,244,88,77
58957,53547,27759,47610,27759,allow,684,432,252,10,16,6,4
58958,49575,53,59647,53,allow,244,102,142,2,29,1,1
58959,49418,27016,34441,27016,allow,263,78,185,2,29,1,1
58960,49418,27015,32548,27015,allow,255,78,177,2,29,1,1
58961,56779,43137,58075,43137,allow,70,70,0,2,8,2,0
58962,64654,53,63011,53,allow,240,110,130,2,30,1,1
58963,55600,80,11201,80,allow,70,70,0,2,8,2,0
58964,51763,34121,10888,34121,allow,70,70,0,2,8,2,0
58965,59794,443,46382,443,allow,408,78,330,6,25,1,5
58966,57367,53,32502,53,allow,177,94,83,2,30,1,1
58967,49996,53,8571,53,allow,183,94,89,2,30,1,1
58968,49418,27017,24547,27017,allow,258,78,180,2,29,1,1
58969,49580,53,62367,53,allow,196,102,94,2,30,1,1
58970,49418,27016,62306,27016,allow,261,78,183,2,30,1,1
58971,49810,53,13654,53,allow,244,94,150,2,30,1,1
58972,55088,53,3753,53,allow,193,102,91,2,29,1,1
58973,49418,27016,5778,27016,allow,263,78,185,2,29,1,1
58974,49418,31000,20791,31000,allow,78,78,0,1,30,1,0
58975,49640,53,5967,53,allow,402,118,284,2,30,1,1
58976,54987,53,61181,53,allow,215,102,113,2,30,1,1
58977,49115,443,63602,443,allow,361013,18864,342149,392,296,110,282
58978,60383,16881,9133,16881,allow,564,318,246,9,18,5,4
58979,45055,443,37161,443,allow,1392,731,661,14,80,8,6
58980,60390,56494,54167,56494,allow,70,70,0,1,5,1,0
58981,52953,80,11532,80,allow,3247,1730,1517,12,36,7,5
58982,40465,443,49132,443,allow,1053,566,487,10,47,6,4
58983,51607,53,31669,53,allow,284,86,198,2,30,1,1
58984,49418,27016,58886,27016,allow,242,78,164,2,30,1,1
58985,49418,27020,23482,27020,allow,248,78,170,2,30,1,1
58986,49418,31000,56556,31000,allow,260,78,182,2,30,1,1
58987,52751,443,8615,443,allow,5378,984,4394,18,17,10,8
58988,49174,443,55183,443,allow,524887,14310,510577,546,18,201,345
58989,49759,53,4425,53,allow,381,110,271,4,32,2,2
58990,51759,55308,58744,55308,allow,70,70,0,2,8,2,0
58991,63563,24096,60999,24096,allow,198,198,0,1,5,1,0
58992,47651,443,48756,443,allow,1053,566,487,10,43,6,4
58993,50416,80,7917,80,allow,11343,3864,7479,22,21,11,11
58994,50442,80,8641,80,allow,378,192,186,7,19,4,3
58995,55627,53,18188,53,allow,240,110,130,2,30,1,1
58996,50912,443,28892,443,allow,8527,2387,6140,21,31,11,10
58997,49418,27015,19557,27015,allow,255,78,177,2,30,1,1
58998,49418,27015,62235,27015,allow,258,78,180,2,30,1,1
58999,64992,53,56297,53,allow,177,94,83,2,30,1,1
59000,123,123,4741,123,allow,184,94,90,2,30,1,1
59001,55167,443,39745,443,allow,12946,5235,7711,38,185,21,17
59002,49545,443,58325,443,allow,7189,1694,5495,31,131,14,17
59003,59836,443,35828,443,allow,1394,733,661,14,80,8,6
59004,51762,12747,44025,12747,allow,70,70,0,2,8,2,0
59005,47894,443,64449,443,allow,70,70,0,2,5,2,0
59006,53225,443,23994,443,allow,6659,1215,5444,17,15,9,8
59007,28608,80,28608,80,allow,602483,18143,584340,627,27,219,408
59008,64320,53,46178,53,allow,199,102,97,2,30,1,1
59009,49418,27016,26183,27016,allow,262,78,184,2,30,1,1
59010,49418,27018,39364,27018,allow,247,78,169,2,30,1,1
59011,49418,30000,55086,30000,allow,280,78,202,2,30,1,1
59012,3027,53,3027,53,allow,199,90,109,2,30,1,1
59013,49418,27222,49485,27222,allow,245,78,167,2,30,1,1
59014,49418,27015,26832,27015,allow,248,78,170,2,30,1,1
59015,45225,443,59513,443,allow,11233,3101,8132,37,150,18,19
59016,49418,27017,11133,27017,allow,247,78,169,2,30,1,1
59017,37525,443,14541,443,allow,9082,3492,5590,26,61,15,11
59018,57333,53,41487,53,allow,258,110,148,2,31,1,1
59019,49246,53,63715,53,allow,286,102,184,2,31,1,1
59020,49561,53,53882,53,allow,211,102,109,2,30,1,1
59021,49160,63307,39518,63307,allow,854,150,704,4,1200,2,2
59022,10151,55149,20876,55149,allow,481,150,331,2,1200,1,1
59023,51221,27417,45430,27417,allow,481,150,331,2,1200,1,1
59024,65339,53,13346,53,allow,949,285,664,8,39,4,4
59025,53110,8830,57205,8830,allow,70,70,0,1,5,1,0
59026,53464,443,61601,443,allow,6550,1555,4995,25,53,13,12
59027,57470,10748,14210,10748,allow,594,594,0,10,1200,10,0
59028,53554,8999,45352,8999,allow,130,70,60,2,5,1,1
59029,59635,7275,39827,7275,allow,448,78,370,6,25,1,5
59030,64090,53,12119,53,allow,227,102,125,2,30,1,1
59031,57470,6881,51127,6881,allow,594,594,0,10,1200,10,0
59032,63762,41373,50271,41373,allow,66,66,0,2,8,2,0
59033,50690,443,43818,443,allow,354,294,60,2,5,1,1
59034,49418,27015,50177,27015,allow,78,78,0,1,30,1,0
59035,7222,57470,0,0,deny,62,62,0,1,0,1,0
59036,51782,445,0,0,drop,70,70,0,1,0,1,0
59037,51781,445,0,0,deny,70,70,0,1,0,1,0
59038,55056,56205,0,0,deny,62,62,0,1,0,1,0
59039,53987,57470,0,0,deny,66,66,0,1,0,1,0
59040,24144,57470,0,0,deny,62,62,0,1,0,1,0
59041,16660,55783,0,0,deny,62,62,0,1,0,1,0
59042,45908,3383,0,0,deny,60,60,0,1,0,1,0
59043,50877,30041,0,0,deny,62,62,0,1,0,1,0
59044,56805,445,0,0,drop,70,70,0,1,0,1,0
59045,56804,445,0,0,drop,70,70,0,1,0,1,0
59046,56797,445,0,0,drop,70,70,0,1,0,1,0
59047,52913,2767,0,0,deny,66,66,0,1,0,1,0
59048,50788,48817,0,0,deny,66,66,0,1,0,1,0
59049,52200,445,0,0,drop,66,66,0,1,0,1,0
59050,52199,445,0,0,drop,66,66,0,1,0,1,0
59051,52197,445,0,0,drop,66,66,0,1,0,1,0
59052,59879,55783,0,0,deny,66,66,0,1,0,1,0
59053,56794,445,0,0,drop,70,70,0,1,0,1,0
59054,51770,445,0,0,drop,70,70,0,1,0,1,0
59055,20726,2767,0,0,deny,66,66,0,1,0,1,0
59056,56792,445,0,0,drop,70,70,0,1,0,1,0
59057,19570,50584,0,0,deny,66,66,0,1,0,1,0
59058,56791,445,0,0,drop,70,70,0,1,0,1,0
59059,56784,445,0,0,drop,70,70,0,1,0,1,0
59060,56783,445,0,0,drop,70,70,0,1,0,1,0
59061,51766,445,0,0,drop,70,70,0,1,0,1,0
59062,61764,57470,0,0,deny,146,146,0,1,0,1,0
59063,54276,39004,0,0,deny,66,66,0,1,0,1,0
59064,59168,39004,0,0,deny,62,62,0,1,0,1,0
59065,3783,40740,0,0,deny,160,160,0,1,0,1,0
59066,32215,22114,0,0,deny,66,66,0,1,0,1,0
59067,51755,445,0,0,drop,70,70,0,1,0,1,0
59068,51756,445,0,0,drop,70,70,0,1,0,1,0
59069,56778,35440,0,0,deny,66,66,0,1,0,1,0
59070,1027,44847,0,0,deny,62,62,0,1,0,1,0
59071,59023,64097,0,0,deny,66,66,0,1,0,1,0
59072,51754,445,0,0,drop,70,70,0,1,0,1,0
59073,51753,445,0,0,drop,70,70,0,1,0,1,0
59074,49001,65473,0,0,deny,174,174,0,1,0,1,0
59075,51749,445,0,0,drop,70,70,0,1,0,1,0
59076,56773,445,0,0,drop,70,70,0,1,0,1,0
59077,56771,445,0,0,drop,70,70,0,1,0,1,0
59078,56768,445,0,0,drop,70,70,0,1,0,1,0
59079,54631,44847,0,0,deny,74,74,0,1,0,1,0
59080,53053,64147,0,0,deny,66,66,0,1,0,1,0
59081,25360,51505,0,0,deny,66,66,0,1,0,1,0
59082,1024,64147,0,0,deny,62,62,0,1,0,1,0
59083,4366,51505,0,0,deny,62,62,0,1,0,1,0
59084,61865,35440,0,0,deny,66,66,0,1,0,1,0
59085,53406,44847,0,0,deny,62,62,0,1,0,1,0
59086,27442,44847,0,0,deny,62,62,0,1,0,1,0
59087,47173,35440,0,0,deny,62,62,0,1,0,1,0
59088,51744,445,0,0,drop,70,70,0,1,0,1,0
59089,16221,50584,0,0,deny,62,62,0,1,0,1,0
59090,52174,445,0,0,drop,66,66,0,1,0,1,0
59091,52802,56205,0,0,deny,62,62,0,1,0,1,0
59092,56767,445,0,0,drop,70,70,0,1,0,1,0
59093,56766,445,0,0,drop,70,70,0,1,0,1,0
59094,51734,445,0,0,drop,70,70,0,1,0,1,0
59095,9092,26672,0,0,deny,60,60,0,1,0,1,0
59096,7444,57470,0,0,deny,66,66,0,1,0,1,0
59097,51733,445,0,0,drop,70,70,0,1,0,1,0
59098,19858,38211,0,0,deny,145,145,0,1,0,1,0
59099,8023,64147,0,0,deny,146,146,0,1,0,1,0
59100,2467,2767,0,0,deny,62,62,0,1,0,1,0
59101,42345,443,8962,443,allow,7593,2146,5447,21,10,12,9
59102,52172,445,0,0,drop,66,66,0,1,0,1,0
59103,61804,51505,0,0,deny,66,66,0,1,0,1,0
59104,14082,50584,0,0,deny,66,66,0,1,0,1,0
59105,52168,445,0,0,drop,66,66,0,1,0,1,0
59106,56754,445,0,0,drop,70,70,0,1,0,1,0
59107,51723,445,0,0,drop,70,70,0,1,0,1,0
59108,54684,37965,0,0,deny,62,62,0,1,0,1,0
59109,51722,445,0,0,drop,70,70,0,1,0,1,0
59110,56751,445,0,0,drop,70,70,0,1,0,1,0
59111,56747,445,0,0,drop,70,70,0,1,0,1,0
59112,56746,445,0,0,drop,70,70,0,1,0,1,0
59113,52167,445,0,0,drop,66,66,0,1,0,1,0
59114,61566,44847,0,0,deny,62,62,0,1,0,1,0
59115,51718,445,0,0,drop,70,70,0,1,0,1,0
59116,56739,445,0,0,drop,70,70,0,1,0,1,0
59117,56247,23,0,0,deny,60,60,0,1,0,1,0
59118,51717,445,0,0,drop,70,70,0,1,0,1,0
59119,56737,445,0,0,drop,70,70,0,1,0,1,0
59120,56735,445,0,0,drop,70,70,0,1,0,1,0
59121,56733,445,0,0,drop,70,70,0,1,0,1,0
59122,52159,445,0,0,drop,66,66,0,1,0,1,0
59123,62696,50584,0,0,deny,62,62,0,1,0,1,0
59124,63065,54369,0,0,deny,66,66,0,1,0,1,0
59125,52156,445,0,0,drop,66,66,0,1,0,1,0
59126,52150,445,0,0,drop,66,66,0,1,0,1,0
59127,52154,445,0,0,drop,66,66,0,1,0,1,0
59128,61241,22114,0,0,deny,66,66,0,1,0,1,0
59129,52148,445,0,0,drop,66,66,0,1,0,1,0
59130,52149,445,0,0,drop,66,66,0,1,0,1,0
59131,52146,445,0,0,drop,66,66,0,1,0,1,0
59132,1873,37965,0,0,deny,62,62,0,1,0,1,0
59133,56453,37965,0,0,deny,66,66,0,1,0,1,0
59134,1025,35447,0,0,deny,62,62,0,1,0,1,0
59135,6881,26296,0,0,deny,143,143,0,1,0,1,0
59136,8999,64910,0,0,deny,146,146,0,1,0,1,0
59137,58382,50584,0,0,deny,62,62,0,1,0,1,0
59138,45941,23388,0,0,deny,60,60,0,1,0,1,0
59139,51712,445,0,0,drop,70,70,0,1,0,1,0
59140,56732,445,0,0,drop,70,70,0,1,0,1,0
59141,56728,445,0,0,drop,70,70,0,1,0,1,0
59142,56727,445,0,0,drop,70,70,0,1,0,1,0
59143,6904,30228,0,0,deny,146,146,0,1,0,1,0
59144,46349,51505,0,0,deny,74,74,0,1,0,1,0
59145,52143,445,0,0,drop,66,66,0,1,0,1,0
59146,56724,445,0,0,drop,70,70,0,1,0,1,0
59147,11951,45026,0,0,deny,60,60,0,1,0,1,0
59148,19642,23,0,0,deny,60,60,0,1,0,1,0
59149,52141,445,0,0,drop,66,66,0,1,0,1,0
59150,52139,445,0,0,drop,66,66,0,1,0,1,0
59151,52138,445,0,0,drop,66,66,0,1,0,1,0
59152,52135,445,0,0,drop,66,66,0,1,0,1,0
59153,16524,22114,0,0,deny,62,62,0,1,0,1,0
59154,50355,43890,0,0,deny,66,66,0,1,0,1,0
59155,51699,445,0,0,drop,70,70,0,1,0,1,0
59156,12471,31573,0,0,deny,62,62,0,1,0,1,0
59157,56716,445,0,0,drop,70,70,0,1,0,1,0
59158,56715,445,0,0,drop,70,70,0,1,0,1,0
59159,56707,445,0,0,drop,70,70,0,1,0,1,0
59160,51696,445,0,0,drop,70,70,0,1,0,1,0
59161,58338,3375,0,0,deny,60,60,0,1,0,1,0
59162,38926,37965,0,0,deny,62,62,0,1,0,1,0
59163,1811,35440,0,0,deny,62,62,0,1,0,1,0
59164,5379,37965,0,0,deny,66,66,0,1,0,1,0
59165,52127,445,0,0,drop,66,66,0,1,0,1,0
59166,51691,445,0,0,drop,70,70,0,1,0,1,0
59167,51690,445,0,0,drop,70,70,0,1,0,1,0
59168,52117,445,0,0,drop,66,66,0,1,0,1,0
59169,56696,445,0,0,drop,70,70,0,1,0,1,0
59170,51688,445,0,0,drop,70,70,0,1,0,1,0
59171,63925,37965,0,0,deny,62,62,0,1,0,1,0
59172,52115,445,0,0,drop,66,66,0,1,0,1,0
59173,52108,445,0,0,drop,66,66,0,1,0,1,0
59174,50972,3544,39467,3544,allow,258,107,151,2,30,1,1
59175,37616,443,9088,443,allow,702409,17257,685152,698,32,233,465
59176,49418,27017,55350,27017,allow,275,71,204,2,31,1,1
59177,49418,27015,13881,27015,allow,237,71,166,2,31,1,1
59178,49418,27015,34985,27015,allow,239,71,168,2,31,1,1
59179,57086,53,16252,53,allow,711,87,624,2,30,1,1
59180,61476,443,42404,443,allow,230640,12863,217777,253,62,98,155
59181,49418,27015,42209,27015,allow,234,71,163,2,31,1,1
59182,37584,80,39013,80,allow,3587,2484,1103,19,135,10,9
59183,51741,48440,47763,48440,allow,136,136,0,3,14,3,0
59184,51740,35988,5363,35988,allow,136,136,0,3,14,3,0
59185,38659,15000,47156,15000,allow,138,78,60,2,5,1,1
59186,49418,27022,63608,27022,allow,229,71,158,2,31,1,1
59187,49418,27015,37107,27015,allow,223,71,152,2,31,1,1
59188,49418,27015,14560,27015,allow,71,71,0,1,30,1,0
59189,45859,443,65407,443,allow,5508,999,4509,20,255,11,9
59190,54144,443,45159,443,allow,5736,1990,3746,25,16,14,11
59191,49418,27015,52121,27015,allow,232,71,161,2,31,1,1
59192,58851,443,62485,443,allow,15848,13507,2341,37,32,19,18
59193,49418,27015,37886,27015,allow,219,71,148,2,31,1,1
59194,49418,27016,40313,27016,allow,71,71,0,1,30,1,0
59195,56683,443,56683,443,allow,4533,1626,2907,19,28,11,8
59196,52096,443,15286,443,allow,283,163,120,4,15,2,2
59197,50458,80,53639,80,allow,1426,865,561,9,15,5,4
59198,57385,80,37415,80,allow,2546,1294,1252,17,138,9,8
59199,55363,443,55363,443,allow,5458,2211,3247,22,39,13,9
59200,58506,53,0,0,allow,192,86,106,2,30,1,1
59201,5588,5588,0,0,allow,3354,1792,1562,46,193,23,23
59202,57477,53,0,0,allow,186,83,103,2,30,1,1
59203,49418,27018,3626,27018,allow,71,71,0,1,30,1,0
59204,65518,53,19504,53,allow,701,88,613,2,30,1,1
59205,5938,20273,0,0,allow,60,60,0,1,90,1,0
59206,44277,443,64665,443,allow,36026,28458,7568,70,407,30,40
59207,49418,27015,36683,27015,allow,251,71,180,2,31,1,1
59208,49418,27017,34824,27017,allow,255,71,184,2,31,1,1
59209,43103,443,44934,443,allow,3149,1899,1250,19,15,9,10
59210,43104,443,41004,443,allow,3067,1817,1250,18,15,8,10
59211,51757,54657,4096,54657,allow,70,70,0,2,8,2,0
59212,63763,17368,13988,17368,allow,66,66,0,2,8,2,0
59213,50532,443,27098,443,allow,7416,1777,5639,23,74,12,11
59214,53550,1,57289,1,allow,70,70,0,1,5,1,0
59215,46339,443,43068,443,allow,4392,1781,2611,21,20,12,9
59216,59793,443,27595,443,allow,840,456,384,14,25,8,6
59217,7487,443,7487,443,allow,4265,1184,3081,18,16,9,9
59218,8978,443,11135,443,allow,49938,20855,29083,165,216,81,84
59219,41643,443,51338,443,allow,16032,13508,2524,37,36,19,18
59220,62731,443,62731,443,allow,9938,3644,6294,31,18,18,13
59221,48889,443,65230,443,allow,87648,6895,80753,131,364,66,65
59222,62108,443,7391,443,allow,9652,2914,6738,22,124,11,11
59223,19473,6889,63001,6889,allow,480,149,331,2,1200,1,1
59224,65306,443,3584,443,allow,5756,1781,3975,23,136,11,12
59225,51681,445,0,0,drop,70,70,0,1,0,1,0
59226,6881,6881,0,0,deny,62,62,0,1,0,1,0
59227,52099,445,0,0,drop,66,66,0,1,0,1,0
59228,26211,1433,0,0,deny,60,60,0,1,0,1,0
59229,51679,445,0,0,drop,70,70,0,1,0,1,0
59230,62859,35440,0,0,deny,66,66,0,1,0,1,0
59231,49418,27015,49804,27015,allow,248,78,170,2,30,1,1
59232,49766,80,16081,80,allow,254,128,126,5,15,3,2
59233,6712,123,0,0,deny,90,90,0,1,0,1,0
59234,51678,445,0,0,drop,70,70,0,1,0,1,0
59235,61000,15503,0,0,deny,146,146,0,1,0,1,0
59236,51677,445,0,0,drop,70,70,0,1,0,1,0
59237,51676,445,0,0,drop,70,70,0,1,0,1,0
59238,51673,445,0,0,drop,70,70,0,1,0,1,0
59239,51672,445,0,0,drop,70,70,0,1,0,1,0
59240,39715,35440,0,0,deny,146,146,0,1,0,1,0
59241,11404,64147,0,0,deny,62,62,0,1,0,1,0
59242,53298,26467,0,0,deny,66,66,0,1,0,1,0
59243,30111,2323,0,0,deny,60,60,0,1,0,1,0
59244,56687,445,0,0,drop,70,70,0,1,0,1,0
59245,56686,445,0,0,drop,70,70,0,1,0,1,0
59246,56683,445,0,0,drop,70,70,0,1,0,1,0
59247,29706,50584,0,0,deny,62,62,0,1,0,1,0
59248,52088,445,0,0,drop,66,66,0,1,0,1,0
59249,52090,445,0,0,drop,66,66,0,1,0,1,0
59250,52084,445,0,0,drop,66,66,0,1,0,1,0
59251,51650,80,36691,80,allow,141348,4210,137138,161,17,58,103
59252,53300,443,53300,443,allow,4406,1499,2907,19,30,11,8
59253,49256,53,47190,53,allow,177,94,83,2,30,1,1
59254,63609,53,0,0,allow,182,81,101,2,30,1,1
59255,55216,53,0,0,allow,192,86,106,2,30,1,1
59256,46893,443,27910,443,allow,622,70,552,10,180,2,8
59257,64112,443,40510,443,allow,4116645,96572,4020073,4029,58,1356,2673
59258,55606,21802,21715,21802,allow,320,140,180,6,5,3,3
59259,49767,80,10412,80,allow,70,70,0,1,4,1,0
59260,50979,80,12190,80,allow,576971,8128,568843,497,38,114,383
59261,37267,443,16640,443,allow,3296,1636,1660,17,255,9,8
59262,49892,443,4679,443,allow,6966,1436,5530,32,600,13,19
59263,49540,443,8159,443,allow,7454,2377,5077,33,130,15,18
59264,36151,443,3051,443,allow,22856,2980,19876,43,116,19,24
59265,56033,443,58131,443,allow,8396,1919,6477,27,116,12,15
59266,10080,443,4270,443,allow,130,70,60,3,5,2,1
59267,36209,443,44738,443,allow,656609,25419,631190,752,62,322,430
59268,51738,47483,4479,47483,allow,70,70,0,1,5,1,0
59269,40334,443,51232,443,allow,8296,3123,5173,40,132,14,26
59270,51656,80,50242,80,allow,152651,4700,147951,174,17,65,109
59271,32053,443,32053,443,allow,28195,6044,22151,58,17,30,28
59272,58941,80,60543,80,allow,1114,534,580,12,15,7,5
59273,53574,23650,56670,23650,allow,320,140,180,6,5,3,3
59274,63759,64509,33605,64509,allow,66,66,0,2,7,2,0
59275,51743,40358,22101,40358,allow,136,136,0,3,14,3,0
59276,56602,80,9300,80,allow,234,234,0,4,11,4,0
59277,49418,27015,54748,27015,allow,78,78,0,1,29,1,0
59278,61723,443,17384,443,allow,6962,979,5983,19,15,10,9
59279,63675,123,55630,123,allow,184,94,90,2,29,1,1
59280,49418,27015,38933,27015,allow,78,78,0,1,29,1,0
59281,64992,53,39214,53,allow,177,94,83,2,29,1,1
59282,49418,27015,35776,27015,allow,78,78,0,1,29,1,0
59283,64992,53,21333,53,allow,177,94,83,2,29,1,1
59284,42307,443,58231,443,allow,101673,5966,95707,121,178,47,74
59285,56928,80,39650,80,allow,526,304,222,8,35,5,3
59286,49418,27015,60296,27015,allow,253,78,175,2,31,1,1
59287,50520,443,34844,443,allow,9942,1211,8731,26,77,14,12
59288,49418,27018,24351,27018,allow,240,78,162,2,30,1,1
59289,53286,443,1896,443,allow,123194,68738,54456,402,287,167,235
59290,49214,443,4327,443,allow,17273,11238,6035,73,919,36,37
59291,56781,17548,14113,17548,allow,70,70,0,1,5,1,0
59292,47705,443,21979,443,allow,25643,2181,23462,44,363,18,26
59293,51756,41471,23556,41471,allow,70,70,0,2,8,2,0
59294,47832,80,56253,80,allow,1151,711,440,10,15,5,5
59295,51407,443,57078,443,allow,202,70,132,3,11,1,2
59296,65178,53,0,0,allow,190,85,105,2,30,1,1
59297,59573,443,39847,443,allow,289380,13628,275752,335,70,142,193
59298,49418,27015,5163,27015,allow,265,78,187,2,31,1,1
59299,64532,53,56480,53,allow,258,110,148,2,30,1,1
59300,56927,80,6442,80,allow,214,140,74,4,35,3,1
59301,49418,27015,55530,27015,allow,244,78,166,2,30,1,1
59302,55146,53,47576,53,allow,277,110,167,2,30,1,1
59303,56709,53,55050,53,allow,211,102,109,2,30,1,1
59304,43032,443,31725,443,allow,6792,3009,3783,20,46,12,8
59305,55312,443,20877,443,allow,7952,3638,4314,36,149,17,19
59306,49418,27015,12957,27015,allow,271,78,193,2,31,1,1
59307,49418,27015,22382,27015,allow,243,78,165,2,31,1,1
59308,49418,27013,52000,27013,allow,241,78,163,2,30,1,1
59309,49418,27444,10177,27444,allow,258,78,180,2,30,1,1
59310,45292,443,27457,443,allow,26444,2671,23773,52,363,25,27
59311,59937,443,12788,443,allow,70,70,0,1,5,1,0
59312,54346,443,30268,443,allow,12594,5098,7496,32,36,17,15
59313,58530,53,0,0,allow,188,84,104,2,30,1,1
59314,49256,53,12893,53,allow,177,94,83,2,30,1,1
59315,59431,443,29795,443,allow,12756,3596,9160,31,299,16,15
59316,61721,443,43568,443,allow,9676,2327,7349,25,16,15,10
59317,57357,53,10860,53,allow,231,94,137,2,30,1,1
59318,58110,53,0,0,allow,178,79,99,2,30,1,1
59319,50972,3544,44578,3544,allow,409,107,302,4,30,2,2
59320,49418,27015,47175,27015,allow,234,78,156,2,30,1,1
59321,49418,27016,3773,27016,allow,242,78,164,2,30,1,1
59322,56744,31151,15345,31151,allow,1703,524,1179,9,30,5,4
59323,49522,80,55749,80,allow,6908,1652,5256,26,225,12,14
59324,59957,443,65089,443,allow,8677,2714,5963,21,114,13,8
59325,55611,53,41439,53,allow,768,200,568,6,53,3,3
59326,52496,443,9919,443,allow,9500,4662,4838,20,16,11,9
59327,51652,80,57447,80,allow,141220,4280,136940,159,17,59,100
59328,51499,443,1743,443,allow,6848,769,6079,17,15,9,8
59329,54528,443,20055,443,allow,6256,1871,4385,20,45,12,8
59330,53573,14856,10337,14856,allow,320,140,180,6,5,3,3
59331,47893,443,63291,443,allow,172,172,0,2,4,2,0
59332,49418,27014,18652,27014,allow,249,78,171,2,31,1,1
59333,49418,27015,11506,27015,allow,248,78,170,2,30,1,1
59334,50208,1688,43148,1688,allow,70,70,0,1,5,1,0
59335,46822,443,53756,443,allow,71073,4403,66670,99,116,41,58
59336,53548,23310,59949,23310,allow,70,70,0,1,4,1,0
59337,53298,443,53298,443,allow,4348,1441,2907,19,29,11,8
59338,33841,443,9860,443,allow,12521,6232,6289,43,80,22,21
59339,53552,8999,43016,8999,allow,70,70,0,1,4,1,0
59340,35428,443,14497,443,allow,9592,2361,7231,25,15,14,11
59341,55605,27274,38364,27274,allow,130,70,60,3,5,2,1
59342,56468,80,52689,80,allow,214,140,74,4,26,3,1
59343,63757,51413,7176,51413,allow,66,66,0,2,7,2,0
59344,59938,443,3054,443,allow,70,70,0,1,5,1,0
59345,51742,20110,30208,20110,allow,136,136,0,3,14,3,0
59346,47892,443,55293,443,allow,172,172,0,2,5,2,0
59347,50521,443,9816,443,allow,11880,1972,9908,29,78,15,14
59348,57287,53,47799,53,allow,305,102,203,2,29,1,1
59349,55807,53,4924,53,allow,257,102,155,2,29,1,1
59350,58331,443,26953,443,allow,31515,26798,4717,91,82,49,42
59351,55851,53,42151,53,allow,277,110,167,2,30,1,1
59352,65339,53,32222,53,allow,193,102,91,2,29,1,1
59353,49418,27015,18735,27015,allow,244,78,166,2,30,1,1
59354,40329,80,42227,80,allow,2128,798,1330,14,46,7,7
59355,64843,443,36183,443,allow,13583,4157,9426,26,120,11,15
59356,55267,53,26990,53,allow,214,102,112,2,29,1,1
59357,64201,53,27931,53,allow,200,94,106,2,29,1,1
59358,64785,53,44600,53,allow,281,94,187,2,29,1,1
59359,65057,53,8165,53,allow,211,94,117,2,30,1,1
59360,64236,53,6587,53,allow,211,102,109,2,30,1,1
59361,53483,443,14059,443,allow,8333,2292,6041,27,360,15,12
59362,49418,4444,6124,4444,allow,238,78,160,2,31,1,1
59363,51498,443,60787,443,allow,7211,823,6388,16,15,10,6
59364,56760,48386,9485,48386,allow,268,70,198,4,19,1,3
59365,59308,443,6790,443,allow,12169,4963,7206,60,262,31,29
59366,49211,443,58097,443,allow,9739,3414,6325,59,928,30,29
59367,53821,53,5224,53,allow,199,94,105,2,30,1,1
59368,46758,123,10814,123,allow,184,94,90,2,30,1,1
59369,56374,53,9778,53,allow,212,102,110,2,30,1,1
59370,57664,443,45877,443,allow,5111,2193,2918,19,120,9,10
59371,33107,443,39338,443,allow,35031,3490,31541,60,363,28,32
59372,44155,443,5461,443,allow,5157,917,4240,20,360,10,10
59373,49418,27015,33694,27015,allow,246,78,168,2,31,1,1
59374,50464,80,5838,80,allow,26020,2247,23773,47,18,23,24
59375,40243,443,64916,443,allow,284,164,120,4,15,2,2
59376,49418,27017,12250,27017,allow,239,78,161,2,30,1,1
59377,58420,443,23233,443,allow,17161,1619,15542,18,149,4,14
59378,26805,443,51742,443,allow,21055,15996,5059,39,22,22,17
59379,64027,53,2870,53,allow,360,97,263,4,38,2,2
59380,62757,123,11526,123,allow,184,94,90,2,30,1,1
59381,50089,53,56216,53,allow,718,94,624,2,30,1,1
59382,64194,53,10058,53,allow,262,126,136,2,30,1,1
59383,64114,53,0,0,allow,200,90,110,2,30,1,1
59384,56120,53,44279,53,allow,177,94,83,2,30,1,1
59385,56120,53,38603,53,allow,177,94,83,2,30,1,1
59386,41485,443,16482,443,allow,29513,23962,5551,40,121,24,16
59387,49418,29999,25371,29999,allow,244,78,166,2,31,1,1
59388,58721,443,55162,443,allow,7973,4166,3807,28,141,14,14
59389,64494,443,46008,443,allow,2872,717,2155,14,135,6,8
59390,60711,443,38043,443,allow,12258,1451,10807,27,360,13,14
59391,6881,39927,58260,39927,allow,228,118,110,2,1199,1,1
59392,56035,443,61035,443,allow,10622,4094,6528,29,514,16,13
59393,52556,443,21958,443,allow,5696,2392,3304,23,135,10,13
59394,43108,443,38121,443,allow,7578,2358,5220,18,121,8,10
59395,36192,443,26140,443,allow,4555,859,3696,17,360,9,8
59396,57470,14806,59723,14806,allow,132,132,0,3,1199,3,0
59397,43345,443,34624,443,allow,7767,1069,6698,23,3971,7,16
59398,57470,33159,38691,33159,allow,594,594,0,10,1199,10,0
59399,6881,6881,22683,6881,allow,502,150,352,2,1200,1,1
59400,46697,5228,40766,5228,allow,9263,549,8714,17,3638,5,12
59401,14667,443,14667,443,allow,20280,2078,18202,35,17,19,16
59402,61376,443,37067,443,allow,31612,3374,28238,59,271,29,30
59403,51204,123,19622,123,allow,184,94,90,2,30,1,1
59404,55326,53,27995,53,allow,177,94,83,2,30,1,1
59405,56096,443,56096,443,allow,5493,2246,3247,22,39,13,9
59406,50036,53,50623,53,allow,353,118,235,2,31,1,1
59407,49418,27001,19678,27001,allow,274,78,196,2,31,1,1
59408,59787,443,59787,443,allow,5525,2278,3247,22,40,13,9
59409,55366,53,65278,53,allow,79,79,0,2,35,2,0
59410,50907,80,50964,80,allow,16037318,218904,15818414,13595,136,2976,10619
59411,65347,53,20093,53,allow,352,94,258,2,30,1,1
59412,54576,443,43696,443,allow,5670,3091,2579,16,121,8,8
59413,52092,445,0,0,drop,66,66,0,1,0,1,0
59414,52087,445,0,0,drop,66,66,0,1,0,1,0
59415,52091,445,0,0,drop,66,66,0,1,0,1,0
59416,52085,445,0,0,drop,66,66,0,1,0,1,0
59417,52086,445,0,0,drop,66,66,0,1,0,1,0
59418,51658,445,0,0,drop,70,70,0,1,0,1,0
59419,51657,445,0,0,drop,70,70,0,1,0,1,0
59420,51655,445,0,0,drop,70,70,0,1,0,1,0
59421,51648,445,0,0,drop,70,70,0,1,0,1,0
59422,51647,445,0,0,drop,70,70,0,1,0,1,0
59423,51829,36134,0,0,deny,66,66,0,1,0,1,0
59424,59315,35440,0,0,deny,66,66,0,1,0,1,0
59425,17177,64147,0,0,deny,62,62,0,1,0,1,0
59426,20389,64147,0,0,deny,62,62,0,1,0,1,0
59427,28124,37965,0,0,deny,145,145,0,1,0,1,0
59428,12311,6881,0,0,deny,62,62,0,1,0,1,0
59429,42946,31573,0,0,deny,146,146,0,1,0,1,0
59430,1227,56205,0,0,deny,66,66,0,1,0,1,0
59431,56678,445,0,0,drop,70,70,0,1,0,1,0
59432,56675,445,0,0,drop,70,70,0,1,0,1,0
59433,56669,445,0,0,drop,70,70,0,1,0,1,0
59434,4910,2149,0,0,deny,66,66,0,1,0,1,0
59435,57441,57470,0,0,deny,66,66,0,1,0,1,0
59436,52072,445,0,0,drop,66,66,0,1,0,1,0
59437,52071,445,0,0,drop,66,66,0,1,0,1,0
59438,52070,445,0,0,drop,66,66,0,1,0,1,0
59439,30496,57470,0,0,deny,62,62,0,1,0,1,0
59440,51636,445,0,0,drop,70,70,0,1,0,1,0
59441,42128,54532,0,0,deny,60,60,0,1,0,1,0
59442,64000,44847,0,0,deny,62,62,0,1,0,1,0
59443,56666,445,0,0,drop,70,70,0,1,0,1,0
59444,60246,44612,0,0,deny,62,62,0,1,0,1,0
59445,50052,65008,0,0,deny,60,60,0,1,0,1,0
59446,27368,22114,0,0,deny,62,62,0,1,0,1,0
59447,11136,15503,0,0,deny,62,62,0,1,0,1,0
59448,56663,445,0,0,drop,70,70,0,1,0,1,0
59449,58329,62413,0,0,deny,62,62,0,1,0,1,0
59450,56654,445,0,0,drop,70,70,0,1,0,1,0
59451,56655,445,0,0,drop,70,70,0,1,0,1,0
59452,56652,445,0,0,drop,70,70,0,1,0,1,0
59453,40082,22,0,0,deny,60,60,0,1,0,1,0
59454,51632,445,0,0,drop,70,70,0,1,0,1,0
59455,64341,57470,0,0,deny,62,62,0,1,0,1,0
59456,31845,55777,0,0,deny,62,62,0,1,0,1,0
59457,59597,37965,0,0,deny,66,66,0,1,0,1,0
59458,38681,15503,0,0,deny,74,74,0,1,0,1,0
59459,53447,44847,0,0,deny,66,66,0,1,0,1,0
59460,51623,445,0,0,drop,70,70,0,1,0,1,0
59461,51622,445,0,0,drop,70,70,0,1,0,1,0
59462,63379,36237,0,0,deny,66,66,0,1,0,1,0
59463,51617,445,0,0,drop,70,70,0,1,0,1,0
59464,51620,445,0,0,drop,70,70,0,1,0,1,0
59465,52472,7302,0,0,deny,66,66,0,1,0,1,0
59466,51616,445,0,0,drop,70,70,0,1,0,1,0
59467,10003,64147,0,0,deny,62,62,0,1,0,1,0
59468,30307,51505,0,0,deny,62,62,0,1,0,1,0
59469,56641,445,0,0,drop,70,70,0,1,0,1,0
59470,56640,445,0,0,drop,70,70,0,1,0,1,0
59471,56639,445,0,0,drop,70,70,0,1,0,1,0
59472,9067,44847,0,0,deny,62,62,0,1,0,1,0
59473,54140,43890,0,0,deny,66,66,0,1,0,1,0
59474,9092,26672,0,0,deny,60,60,0,1,0,1,0
59475,61983,50432,0,0,deny,66,66,0,1,0,1,0
59476,51963,22114,0,0,deny,62,62,0,1,0,1,0
59477,51609,445,0,0,drop,70,70,0,1,0,1,0
59478,1024,22114,0,0,deny,146,146,0,1,0,1,0
59479,12605,57470,0,0,deny,62,62,0,1,0,1,0
59480,10586,37965,0,0,deny,62,62,0,1,0,1,0
59481,46587,57470,0,0,deny,66,66,0,1,0,1,0
59482,51732,50584,0,0,deny,146,146,0,1,0,1,0
59483,28839,30188,0,0,deny,62,62,0,1,0,1,0
59484,65016,37965,0,0,deny,66,66,0,1,0,1,0
59485,17315,11392,0,0,deny,66,66,0,1,0,1,0
59486,52050,445,0,0,drop,66,66,0,1,0,1,0
59487,56638,445,0,0,drop,70,70,0,1,0,1,0
59488,56637,445,0,0,drop,70,70,0,1,0,1,0
59489,60617,64147,0,0,deny,62,62,0,1,0,1,0
59490,27010,64147,0,0,deny,62,62,0,1,0,1,0
59491,51602,445,0,0,drop,70,70,0,1,0,1,0
59492,51599,445,0,0,drop,70,70,0,1,0,1,0
59493,10248,21247,0,0,deny,62,62,0,1,0,1,0
59494,59701,44847,0,0,deny,66,66,0,1,0,1,0
59495,58458,17,0,0,deny,60,60,0,1,0,1,0
59496,2522,64147,0,0,deny,62,62,0,1,0,1,0
59497,64024,57470,0,0,deny,66,66,0,1,0,1,0
59498,48386,9485,0,0,deny,60,60,0,1,0,1,0
59499,61148,37965,0,0,deny,66,66,0,1,0,1,0
59500,26332,57470,0,0,deny,62,62,0,1,0,1,0
59501,63314,57470,0,0,deny,66,66,0,1,0,1,0
59502,52041,445,0,0,drop,66,66,0,1,0,1,0
59503,51596,445,0,0,drop,70,70,0,1,0,1,0
59504,51594,445,0,0,drop,70,70,0,1,0,1,0
59505,52040,445,0,0,drop,66,66,0,1,0,1,0
59506,56628,445,0,0,drop,70,70,0,1,0,1,0
59507,3802,55777,0,0,deny,66,66,0,1,0,1,0
59508,52788,64147,0,0,deny,62,62,0,1,0,1,0
59509,55966,57866,0,0,deny,62,62,0,1,0,1,0
59510,29313,48817,0,0,deny,145,145,0,1,0,1,0
59511,56620,445,0,0,drop,70,70,0,1,0,1,0
59512,56618,445,0,0,drop,70,70,0,1,0,1,0
59513,56616,445,0,0,drop,70,70,0,1,0,1,0
59514,52037,445,0,0,drop,66,66,0,1,0,1,0
59515,25595,2323,0,0,deny,60,60,0,1,0,1,0
59516,50116,22,0,0,deny,60,60,0,1,0,1,0
59517,51590,445,0,0,drop,70,70,0,1,0,1,0
59518,59940,50584,0,0,deny,66,66,0,1,0,1,0
59519,65060,35440,0,0,deny,66,66,0,1,0,1,0
59520,33931,50584,0,0,deny,62,62,0,1,0,1,0
59521,9957,32480,0,0,deny,66,66,0,1,0,1,0
59522,51589,445,0,0,drop,70,70,0,1,0,1,0
59523,53437,44847,0,0,deny,66,66,0,1,0,1,0
59524,51339,50584,0,0,deny,62,62,0,1,0,1,0
59525,56613,445,0,0,deny,70,70,0,1,0,1,0
59526,44538,50584,0,0,deny,62,62,0,1,0,1,0
59527,56608,445,0,0,drop,70,70,0,1,0,1,0
59528,56606,445,0,0,drop,70,70,0,1,0,1,0
59529,56604,445,0,0,drop,70,70,0,1,0,1,0
59530,30129,37965,0,0,deny,72,72,0,1,0,1,0
59531,52188,1433,0,0,deny,60,60,0,1,0,1,0
59532,62804,37965,0,0,deny,66,66,0,1,0,1,0
59533,0,0,0,0,deny,60,60,0,1,0,1,0
59534,52029,445,0,0,drop,66,66,0,1,0,1,0
59535,3001,28680,0,0,deny,148,148,0,1,0,1,0
59536,8211,28793,0,0,deny,66,66,0,1,0,1,0
59537,46389,27098,0,0,deny,66,66,0,1,0,1,0
59538,52027,445,0,0,drop,66,66,0,1,0,1,0
59539,52025,445,0,0,drop,66,66,0,1,0,1,0
59540,52022,445,0,0,drop,66,66,0,1,0,1,0
59541,60188,15503,0,0,deny,66,66,0,1,0,1,0
59542,8889,19777,0,0,deny,60,60,0,1,0,1,0
59543,22541,64147,0,0,deny,66,66,0,1,0,1,0
59544,52020,445,0,0,drop,66,66,0,1,0,1,0
59545,52021,445,0,0,drop,66,66,0,1,0,1,0
59546,55468,23,0,0,deny,60,60,0,1,0,1,0
59547,51584,445,0,0,drop,70,70,0,1,0,1,0
59548,52690,7302,0,0,deny,66,66,0,1,0,1,0
59549,56601,445,0,0,drop,70,70,0,1,0,1,0
59550,56600,445,0,0,drop,70,70,0,1,0,1,0
59551,56598,445,0,0,drop,70,70,0,1,0,1,0
59552,52017,445,0,0,drop,66,66,0,1,0,1,0
59553,32710,22114,0,0,deny,62,62,0,1,0,1,0
59554,56595,445,0,0,drop,70,70,0,1,0,1,0
59555,5223,34403,0,0,deny,220,220,0,1,0,1,0
59556,21733,56205,0,0,deny,66,66,0,1,0,1,0
59557,52012,445,0,0,drop,66,66,0,1,0,1,0
59558,30598,46824,0,0,deny,62,62,0,1,0,1,0
59559,52519,44847,0,0,deny,66,66,0,1,0,1,0
59560,53408,50243,0,0,deny,145,145,0,1,0,1,0
59561,1749,64147,0,0,deny,66,66,0,1,0,1,0
59562,52010,445,0,0,drop,66,66,0,1,0,1,0
59563,52009,445,0,0,drop,66,66,0,1,0,1,0
59564,50734,37965,0,0,deny,62,62,0,1,0,1,0
59565,59128,44847,0,0,deny,66,66,0,1,0,1,0
59566,25772,7302,0,0,deny,66,66,0,1,0,1,0
59567,52007,445,0,0,drop,66,66,0,1,0,1,0
59568,50084,26672,0,0,deny,62,62,0,1,0,1,0
59569,54894,9571,0,0,deny,66,66,0,1,0,1,0
59570,51571,445,0,0,drop,70,70,0,1,0,1,0
59571,55413,37965,0,0,deny,66,66,0,1,0,1,0
59572,42632,44847,0,0,deny,62,62,0,1,0,1,0
59573,61185,54532,0,0,deny,62,62,0,1,0,1,0
59574,42745,50011,0,0,deny,62,62,0,1,0,1,0
59575,50084,26672,0,0,deny,145,145,0,1,0,1,0
59576,56587,445,0,0,drop,70,70,0,1,0,1,0
59577,51568,445,0,0,drop,70,70,0,1,0,1,0
59578,63701,46824,0,0,deny,66,66,0,1,0,1,0
59579,38976,46824,0,0,deny,62,62,0,1,0,1,0
59580,35347,20238,0,0,deny,62,62,0,1,0,1,0
59581,56583,445,0,0,drop,70,70,0,1,0,1,0
59582,56581,445,0,0,drop,70,70,0,1,0,1,0
59583,15131,50584,0,0,deny,62,62,0,1,0,1,0
59584,51151,64147,0,0,deny,66,66,0,1,0,1,0
59585,38645,51221,0,0,deny,62,62,0,1,0,1,0
59586,42209,36237,0,0,deny,146,146,0,1,0,1,0
59587,51413,32480,0,0,deny,72,72,0,1,0,1,0
59588,4515,37807,0,0,deny,146,146,0,1,0,1,0
59589,49418,27025,19302,27025,allow,71,71,0,1,30,1,0
59590,49418,27021,53913,27021,allow,232,71,161,2,30,1,1
59591,49418,27015,47844,27015,allow,214,71,143,2,30,1,1
59592,49418,23333,56641,23333,allow,244,71,173,2,30,1,1
59593,50502,123,48233,123,allow,184,94,90,2,30,1,1
59594,61699,443,44016,443,allow,16358,3103,13255,39,19,19,20
59595,50605,443,19181,443,allow,13409,3033,10376,29,124,15,14
59596,64567,443,24686,443,allow,24984,2042,22942,41,32,19,22
59597,49418,37579,44074,37579,allow,239,71,168,2,30,1,1
59598,60395,6890,41049,6890,allow,70,70,0,2,8,2,0
59599,55326,53,8434,53,allow,170,87,83,2,30,1,1
59600,51164,443,40341,443,allow,7569,2113,5456,26,361,14,12
59601,49418,30007,64637,30007,allow,242,71,171,2,30,1,1
59602,53538,33791,33383,33791,allow,618,432,186,9,17,6,3
59603,49418,37569,43147,37569,allow,237,71,166,2,30,1,1
59604,37174,443,43183,443,allow,752907,69016,683891,1372,231,537,835
59605,49418,27026,25116,27026,allow,71,71,0,1,30,1,0
59606,49418,27022,21779,27022,allow,71,71,0,1,30,1,0
59607,49418,30006,39633,30006,allow,244,71,173,2,30,1,1
59608,62995,3389,62995,3389,allow,4213,2429,1784,18,32,9,9
59609,32971,443,32971,443,allow,18895,2061,16834,34,17,18,16
59610,18796,443,17365,443,allow,2227,1018,1209,17,15,8,9
59611,53574,443,38690,443,allow,117116,5692,111424,153,18,56,97
59612,52625,53,52625,53,allow,231,88,143,2,32,1,1
59613,53565,58695,57027,58695,allow,70,70,0,2,8,2,0
59614,35065,443,35065,443,allow,5537,2290,3247,22,39,13,9
59615,28539,53,28539,53,allow,231,88,143,2,32,1,1
59616,50622,53,42098,53,allow,202,83,119,2,30,1,1
59617,46327,25903,25335,25903,allow,332,192,140,6,25,4,2
59618,39207,80,48256,80,allow,234,234,0,4,12,4,0
59619,36712,53,0,0,allow,138,69,69,2,30,1,1
59620,50437,3389,50437,3389,allow,3444,1730,1714,16,31,8,8
59621,49418,27019,20347,27019,allow,71,71,0,1,30,1,0
59622,49418,27015,42779,27015,allow,227,71,156,2,30,1,1
59623,49418,27015,63577,27015,allow,71,71,0,1,30,1,0
59624,49418,12345,11846,12345,allow,249,71,178,2,30,1,1
59625,49418,30010,58880,30010,allow,238,71,167,2,30,1,1
59626,14469,443,14469,443,allow,274,132,142,5,15,3,2
59627,50501,443,19632,443,allow,1499,930,569,16,78,9,7
59628,42040,5228,16525,5228,allow,60,60,0,1,5,1,0
59629,47091,443,36299,443,allow,6326,4367,1959,31,144,17,14
59630,51753,15038,3918,15038,allow,70,70,0,2,7,2,0
59631,44206,53,19423,53,allow,202,83,119,2,30,1,1
59632,50172,443,41441,443,allow,161,101,60,2,5,1,1
59633,53760,80,45731,80,allow,1667,619,1048,10,45,6,4
59634,49418,30003,43016,30003,allow,71,71,0,1,30,1,0
59635,49418,27015,44388,27015,allow,71,71,0,1,30,1,0
59636,49418,27016,19249,27016,allow,240,71,169,2,30,1,1
59637,49418,16666,10447,16666,allow,71,71,0,1,30,1,0
59638,65348,53,36995,53,allow,170,87,83,2,30,1,1
59639,49418,30002,50815,30002,allow,242,71,171,2,30,1,1
59640,5938,19141,0,0,allow,60,60,0,1,91,1,0
59641,50895,443,43273,443,allow,14584,6798,7786,37,181,18,19
59642,30960,45684,7454,45684,allow,330,330,0,6,3609,6,0
59643,37965,22343,64266,22343,allow,1307,594,713,17,1657,10,7
59644,51997,445,0,0,drop,66,66,0,1,0,1,0
59645,21492,51505,0,0,deny,62,62,0,1,0,1,0
59646,11716,37965,0,0,deny,62,62,0,1,0,1,0
59647,51563,445,0,0,drop,70,70,0,1,0,1,0
59648,38633,51221,0,0,deny,66,66,0,1,0,1,0
59649,54424,50584,0,0,deny,146,146,0,1,0,1,0
59650,25536,50584,0,0,deny,62,62,0,1,0,1,0
59651,51562,445,0,0,drop,70,70,0,1,0,1,0
59652,443,9986,0,0,deny,352,352,0,1,0,1,0
59653,51105,50584,0,0,deny,66,66,0,1,0,1,0
59654,35644,67,0,0,deny,60,60,0,1,0,1,0
59655,51560,445,0,0,drop,70,70,0,1,0,1,0
59656,49418,26259,63056,26259,allow,254,78,176,2,30,1,1
59657,49418,27016,30078,27016,allow,78,78,0,1,30,1,0
59658,49418,30008,26844,30008,allow,236,78,158,2,30,1,1
59659,34464,443,64076,443,allow,1402,910,492,11,360,6,5
59660,57370,443,5735,443,allow,7211,823,6388,16,15,10,6
59661,48252,443,35978,443,allow,283034,39462,243572,536,224,257,279
59662,49418,37569,8517,37569,allow,246,78,168,2,30,1,1
59663,52555,443,31121,443,allow,4362,1826,2536,18,134,8,10
59664,55015,443,30029,443,allow,8133,2402,5731,35,255,17,18
59665,49400,80,14888,80,allow,40119,2475,37644,49,84,16,33
59666,52122,443,45457,443,allow,5841,1986,3855,19,15,11,8
59667,49224,443,16302,443,allow,93540,22718,70822,155,918,65,90
59668,7686,80,7686,80,allow,176670,11287,165383,216,46,96,120
59669,38136,443,41208,443,allow,3919,1099,2820,35,627,9,26
59670,49233,443,34014,443,allow,9622,3524,6098,59,916,29,30
59671,49201,443,23062,443,allow,13738,6378,7360,70,981,33,37
59672,49189,443,36551,443,allow,15611,1501,14110,32,361,14,18
59673,55326,53,39375,53,allow,177,94,83,2,29,1,1
59674,49418,27015,35116,27015,allow,78,78,0,1,30,1,0
59675,49418,27001,35049,27001,allow,256,78,178,2,30,1,1
59676,40232,53,19769,53,allow,205,86,119,2,29,1,1
59677,49418,27015,31380,27015,allow,239,78,161,2,30,1,1
59678,49418,33086,18224,33086,allow,237,78,159,2,30,1,1
59679,56739,42421,49450,42421,allow,2810,1382,1428,12,31,6,6
59680,49418,27015,24624,27015,allow,78,78,0,1,30,1,0
59681,55594,53,28823,53,allow,168,78,90,2,30,1,1
59682,56845,443,17798,443,allow,16207,6355,9852,84,195,43,41
59683,60386,9136,45378,9136,allow,624,318,306,10,16,5,5
59684,57714,53,57714,53,allow,233,90,143,2,32,1,1
59685,63758,57825,49491,57825,allow,312,132,180,6,6,3,3
59686,51739,62163,32244,62163,allow,70,70,0,1,5,1,0
59687,63737,80,37849,80,allow,314,192,122,6,15,4,2
59688,37352,80,54268,80,allow,1115,562,553,13,362,6,7
59689,49418,27015,22086,27015,allow,78,78,0,1,30,1,0
59690,49418,28002,23648,28002,allow,271,78,193,2,30,1,1
59691,42128,80,52556,80,allow,1139,506,633,10,15,6,4
59692,49418,27053,45679,27053,allow,78,78,0,1,30,1,0
59693,56843,443,16451,443,allow,54661,36820,17841,266,201,128,138
59694,51399,443,28295,443,allow,642,582,60,2,5,1,1
59695,65198,53,6063,53,allow,448,94,354,4,49,2,2
59696,49418,33032,30338,33032,allow,78,78,0,1,30,1,0
59697,49418,27015,38880,27015,allow,78,78,0,1,30,1,0
59698,47808,53,24079,53,allow,168,78,90,2,30,1,1
59699,34465,443,9083,443,allow,1402,910,492,11,360,6,5
59700,34466,443,32529,443,allow,1402,910,492,11,360,6,5
59701,49418,33098,30068,33098,allow,78,78,0,1,30,1,0
59702,56844,443,48471,443,allow,10878,4815,6063,60,196,31,29
59703,65426,53,23528,53,allow,706,195,511,6,52,3,3
59704,39356,443,35388,443,allow,7134,2290,4844,29,80,15,14
59705,56541,443,9751,443,allow,130,70,60,2,15,1,1
59706,49418,27015,59160,27015,allow,78,78,0,1,30,1,0
59707,49418,30050,47158,30050,allow,78,78,0,1,30,1,0
59708,64805,53,57151,53,allow,215,102,113,2,30,1,1
59709,49418,33058,55897,33058,allow,244,78,166,2,30,1,1
59710,57144,8525,57144,8525,allow,138,78,60,2,5,1,1
59711,50550,443,50550,443,allow,5642,2395,3247,22,38,13,9
59712,42686,443,38351,443,allow,190,70,120,4,15,2,2
59713,44320,443,12809,443,allow,7244,1861,5383,26,330,14,12
59714,57598,443,10245,443,allow,12463,6762,5701,28,31,14,14
59715,49418,27015,25961,27015,allow,234,78,156,2,30,1,1
59716,49418,27015,26023,27015,allow,78,78,0,1,30,1,0
59717,49418,32036,34122,32036,allow,243,78,165,2,30,1,1
59718,49418,27056,31810,27056,allow,269,78,191,2,30,1,1
59719,56846,443,26374,443,allow,9370,3805,5565,43,181,21,22
59720,44512,443,54023,443,allow,1101393,30310,1071083,1137,109,381,756
59721,50516,443,49495,443,allow,12855,2077,10778,30,78,15,15
59722,38653,443,63492,443,allow,6969,2162,4807,20,15,11,9
59723,49228,443,26216,443,allow,13758,6577,7181,66,918,34,32
59724,55212,443,36417,443,allow,10500,5056,5444,23,143,11,12
59725,60964,443,25466,443,allow,2080,1376,704,17,30,9,8
59726,44516,443,18408,443,allow,156324,6993,149331,192,108,81,111
59727,44514,443,59227,443,allow,448741,15805,432936,491,109,181,310
59728,51774,80,22011,80,allow,240,120,120,5,27,3,2
59729,45619,80,13038,80,allow,1052,612,440,10,15,5,5
59730,50497,443,60901,443,allow,1322,725,597,14,78,7,7
59731,46291,443,48252,443,allow,70,70,0,1,5,1,0
59732,49418,27015,58093,27015,allow,78,78,0,1,30,1,0
59733,50996,443,60752,443,allow,12654,1719,10935,28,21,15,13
59734,59770,443,37125,443,allow,7316,1933,5383,27,16,15,12
59735,49418,29999,18255,29999,allow,239,78,161,2,30,1,1
59736,35164,443,44026,443,allow,5505,995,4510,20,255,11,9
59737,53227,53,29917,53,allow,205,86,119,2,29,1,1
59738,49260,53,27595,53,allow,177,86,91,2,29,1,1
59739,60384,64170,40565,64170,allow,504,318,186,8,16,5,3
59740,49619,53,1376,53,allow,184,86,98,2,30,1,1
59741,49418,27015,11221,27015,allow,240,78,162,2,30,1,1
59742,65348,53,2839,53,allow,177,94,83,2,30,1,1
59743,49418,27015,25593,27015,allow,258,78,180,2,30,1,1
59744,49418,27080,21881,27080,allow,238,78,160,2,30,1,1
59745,49418,27054,42342,27054,allow,272,78,194,2,30,1,1
59746,49418,26169,6616,26169,allow,78,78,0,1,30,1,0
59747,49418,32038,58741,32038,allow,235,78,157,2,30,1,1
59748,49418,32058,6170,32058,allow,78,78,0,1,30,1,0
59749,58663,53,40233,53,allow,167,78,89,2,30,1,1
59750,55454,443,35001,443,allow,1784,247,1537,7,120,4,3
59751,55455,443,13171,443,allow,1786,172,1614,7,120,3,4
59752,50540,443,25941,443,allow,134507,6585,127922,148,121,51,97
59753,50265,13302,54682,13302,allow,2118,858,1260,28,1267,14,14
59754,51754,1182,55646,1182,allow,70,70,0,2,7,2,0
59755,54020,53,54020,53,allow,233,90,143,2,32,1,1
59756,51398,443,32490,443,allow,322,262,60,2,5,1,1
59757,51942,443,54861,443,allow,2646,1322,1324,28,36,15,13
59758,51620,443,24957,443,allow,3330,2281,1049,17,16,9,8
59759,49418,27017,19640,27017,allow,78,78,0,1,30,1,0
59760,49418,33071,57943,33071,allow,78,78,0,1,30,1,0
59761,64133,53,49082,53,allow,225,110,115,2,30,1,1
59762,49418,50019,9812,50019,allow,268,78,190,2,30,1,1
59763,53084,443,55326,443,allow,490914,83866,407048,1048,332,526,522
59764,38993,443,34045,443,allow,7089,1290,5799,24,16,12,12
59765,23589,53,23589,53,allow,220,90,130,2,30,1,1
59766,34294,53,17102,53,allow,168,78,90,2,30,1,1
59767,53860,53,53860,53,allow,197,90,107,2,30,1,1
59768,57235,443,36461,443,allow,8954,3404,5550,34,46,19,15
59769,55326,53,7571,53,allow,177,94,83,2,30,1,1
59770,56841,443,47510,443,allow,156805,44621,112184,289,215,137,152
59771,49418,27015,63355,27015,allow,244,78,166,2,30,1,1
59772,49418,33056,16028,33056,allow,237,78,159,2,30,1,1
59773,49418,27058,37318,27058,allow,263,78,185,2,30,1,1
59774,49418,27055,11921,27055,allow,269,78,191,2,30,1,1
59775,49418,32056,18212,32056,allow,245,78,167,2,30,1,1
59776,51221,27048,22916,27048,allow,132,132,0,3,1200,3,0
59777,54659,443,56106,443,allow,1773,1038,735,17,278,9,8
59778,21133,6085,5257,6085,allow,481,150,331,2,1199,1,1
59779,50096,53,50096,53,allow,197,90,107,2,30,1,1
59780,55440,53,55440,53,allow,220,90,130,2,30,1,1
59781,48755,53,17288,53,allow,168,78,90,2,30,1,1
59782,58662,53,17171,53,allow,167,78,89,2,31,1,1
59783,63926,53,50565,53,allow,260,102,158,2,31,1,1
59784,65183,53,44616,53,allow,718,94,624,2,31,1,1
59785,59124,443,60758,443,allow,27431,19413,8018,71,175,36,35
59786,63627,443,58785,443,allow,17242,3015,14227,19,143,5,14
59787,63584,443,24147,443,allow,3182,1568,1614,8,120,4,4
59788,6881,51413,35496,51413,allow,475,150,325,2,1200,1,1
59789,49664,443,7925,443,allow,134,60,74,3,6,2,1
59790,52495,443,36037,443,allow,32875,8836,24039,37,16,15,22
59791,63425,443,8137,443,allow,22815,20019,2796,55,81,31,24
59792,50913,80,46319,80,allow,12767608,157856,12609752,11936,135,2227,9709
59793,50906,80,26380,80,allow,13949172,164502,13784670,11537,135,2287,9250
59794,58837,3389,58837,3389,allow,4429,2581,1848,21,33,11,10
59795,56680,8100,35918,8100,allow,78,78,0,1,5,1,0
59796,53544,22051,5386,22051,allow,70,70,0,1,5,1,0
59797,50488,443,22994,443,allow,9765,2106,7659,27,83,14,13
59798,49449,80,5830,80,allow,1948,912,1036,13,56,7,6
59799,50382,443,9728,443,allow,10423,2542,7881,48,20,24,24
59800,50897,80,4903,80,allow,13981183,155668,13825515,11482,136,2194,9288
59801,44187,53,44187,53,allow,233,90,143,2,32,1,1
59802,65367,443,29972,443,allow,5666,4417,1249,23,86,12,11
59803,50910,80,20207,80,allow,14877069,179445,14697624,12450,135,2531,9919
59804,50900,80,32944,80,allow,14423569,189925,14233644,12194,135,2586,9608
59805,49624,53,37843,53,allow,216,94,122,2,30,1,1
59806,57082,53,1107,53,allow,211,102,109,2,30,1,1
59807,39054,53,31083,53,allow,168,78,90,2,30,1,1
59808,65348,53,40565,53,allow,177,94,83,2,30,1,1
59809,51989,445,0,0,drop,66,66,0,1,0,1,0
59810,35516,22,0,0,deny,60,60,0,1,0,1,0
59811,56564,9571,0,0,deny,78,78,0,1,0,1,0
59812,56567,445,0,0,drop,70,70,0,1,0,1,0
59813,33292,50584,0,0,deny,66,66,0,1,0,1,0
59814,34489,35440,0,0,deny,66,66,0,1,0,1,0
59815,51986,445,0,0,drop,66,66,0,1,0,1,0
59816,62338,50011,0,0,deny,66,66,0,1,0,1,0
59817,62532,57354,0,0,deny,159,159,0,1,0,1,0
59818,47013,37965,0,0,deny,62,62,0,1,0,1,0
59819,51553,445,0,0,drop,70,70,0,1,0,1,0
59820,54976,2273,0,0,deny,60,60,0,1,0,1,0
59821,51977,445,0,0,drop,66,66,0,1,0,1,0
59822,51549,445,0,0,drop,70,70,0,1,0,1,0
59823,51975,445,0,0,drop,66,66,0,1,0,1,0
59824,51548,445,0,0,drop,70,70,0,1,0,1,0
59825,51547,445,0,0,drop,70,70,0,1,0,1,0
59826,12694,12446,0,0,deny,62,62,0,1,0,1,0
59827,56703,50584,0,0,deny,66,66,0,1,0,1,0
59828,51546,445,0,0,deny,70,70,0,1,0,1,0
59829,51328,30228,0,0,deny,109,109,0,1,0,1,0
59830,58003,1433,0,0,deny,60,60,0,1,0,1,0
59831,51544,445,0,0,drop,70,70,0,1,0,1,0
59832,51540,445,0,0,drop,70,70,0,1,0,1,0
59833,51191,26467,0,0,deny,66,66,0,1,0,1,0
59834,63583,37965,0,0,deny,66,66,0,1,0,1,0
59835,30599,46824,0,0,deny,66,66,0,1,0,1,0
59836,56556,445,0,0,drop,70,70,0,1,0,1,0
59837,56555,445,0,0,drop,70,70,0,1,0,1,0
59838,51528,445,0,0,drop,70,70,0,1,0,1,0
59839,51527,445,0,0,drop,70,70,0,1,0,1,0
59840,51961,445,0,0,drop,66,66,0,1,0,1,0
59841,51962,445,0,0,drop,66,66,0,1,0,1,0
59842,51963,445,0,0,deny,66,66,0,1,0,1,0
59843,51960,445,0,0,drop,66,66,0,1,0,1,0
59844,51959,445,0,0,drop,66,66,0,1,0,1,0
59845,51957,445,0,0,drop,66,66,0,1,0,1,0
59846,51956,445,0,0,drop,66,66,0,1,0,1,0
59847,3964,51505,0,0,deny,62,62,0,1,0,1,0
59848,51525,445,0,0,drop,70,70,0,1,0,1,0
59849,64166,35440,0,0,deny,62,62,0,1,0,1,0
59850,51517,445,0,0,drop,70,70,0,1,0,1,0
59851,51518,445,0,0,drop,70,70,0,1,0,1,0
59852,64219,51050,0,0,deny,66,66,0,1,0,1,0
59853,51953,37965,0,0,deny,66,66,0,1,0,1,0
59854,42128,54532,0,0,deny,60,60,0,1,0,1,0
59855,39823,36237,0,0,deny,66,66,0,1,0,1,0
59856,57098,1,0,0,deny,78,78,0,1,0,1,0
59857,34531,23117,0,0,deny,62,62,0,1,0,1,0
59858,61845,11392,0,0,deny,62,62,0,1,0,1,0
59859,56553,445,0,0,drop,70,70,0,1,0,1,0
59860,56547,445,0,0,drop,70,70,0,1,0,1,0
59861,56539,445,0,0,drop,70,70,0,1,0,1,0
59862,51506,445,0,0,drop,70,70,0,1,0,1,0
59863,8622,64147,0,0,deny,66,66,0,1,0,1,0
59864,51943,445,0,0,drop,66,66,0,1,0,1,0
59865,51940,445,0,0,drop,66,66,0,1,0,1,0
59866,51941,445,0,0,drop,66,66,0,1,0,1,0
59867,56537,445,0,0,drop,70,70,0,1,0,1,0
59868,58598,50584,0,0,deny,66,66,0,1,0,1,0
59869,56535,445,0,0,drop,70,70,0,1,0,1,0
59870,49699,64147,0,0,deny,66,66,0,1,0,1,0
59871,51502,445,0,0,drop,70,70,0,1,0,1,0
59872,56531,445,0,0,drop,70,70,0,1,0,1,0
59873,56527,445,0,0,drop,70,70,0,1,0,1,0
59874,56524,445,0,0,drop,70,70,0,1,0,1,0
59875,14613,12446,0,0,deny,66,66,0,1,0,1,0
59876,49664,37965,0,0,deny,66,66,0,1,0,1,0
59877,51999,37965,0,0,deny,62,62,0,1,0,1,0
59878,18085,26467,0,0,deny,62,62,0,1,0,1,0
59879,55296,23718,0,0,deny,66,66,0,1,0,1,0
59880,51491,445,0,0,drop,70,70,0,1,0,1,0
59881,51493,445,0,0,drop,70,70,0,1,0,1,0
59882,42463,56205,0,0,deny,146,146,0,1,0,1,0
59883,51489,445,0,0,drop,70,70,0,1,0,1,0
59884,51488,445,0,0,drop,70,70,0,1,0,1,0
59885,51486,445,0,0,drop,70,70,0,1,0,1,0
59886,8999,43109,0,0,deny,146,146,0,1,0,1,0
59887,46275,64147,0,0,deny,62,62,0,1,0,1,0
59888,64482,64147,0,0,deny,66,66,0,1,0,1,0
59889,56516,445,0,0,drop,70,70,0,1,0,1,0
59890,56514,445,0,0,drop,70,70,0,1,0,1,0
59891,56511,445,0,0,drop,70,70,0,1,0,1,0
59892,24351,57470,0,0,deny,62,62,0,1,0,1,0
59893,51774,29434,0,0,deny,146,146,0,1,0,1,0
59894,51480,445,0,0,drop,70,70,0,1,0,1,0
59895,43129,20220,0,0,deny,62,62,0,1,0,1,0
59896,8999,1,0,0,deny,62,62,0,1,0,1,0
59897,54280,3359,0,0,deny,60,60,0,1,0,1,0
59898,54826,56205,0,0,deny,62,62,0,1,0,1,0
59899,51472,445,0,0,drop,70,70,0,1,0,1,0
59900,51918,445,0,0,drop,66,66,0,1,0,1,0
59901,56510,445,0,0,drop,70,70,0,1,0,1,0
59902,56508,445,0,0,drop,70,70,0,1,0,1,0
59903,51471,445,0,0,drop,70,70,0,1,0,1,0
59904,59918,44847,0,0,deny,66,66,0,1,0,1,0
59905,54471,36237,0,0,deny,66,66,0,1,0,1,0
59906,8999,1,0,0,deny,146,146,0,1,0,1,0
59907,5200,6643,0,0,deny,145,145,0,1,0,1,0
59908,51463,445,0,0,drop,70,70,0,1,0,1,0
59909,50853,50584,0,0,deny,62,62,0,1,0,1,0
59910,51462,445,0,0,drop,70,70,0,1,0,1,0
59911,37571,443,14290,443,allow,499,425,74,4,0,3,1
59912,37574,443,27983,443,allow,499,425,74,4,0,3,1
59913,37573,443,61773,443,allow,499,425,74,4,0,3,1
59914,37572,443,25877,443,allow,499,425,74,4,0,3,1
59915,37570,443,49846,443,allow,499,425,74,4,0,3,1
59916,37569,443,25156,443,allow,499,425,74,4,0,3,1
59917,0,0,0,0,allow,320,320,0,5,0,5,0
59918,51914,445,0,0,drop,66,66,0,1,0,1,0
59919,48087,16069,0,0,deny,66,66,0,1,0,1,0
59920,47962,16069,0,0,deny,62,62,0,1,0,1,0
59921,14309,56205,0,0,deny,62,62,0,1,0,1,0
59922,51911,445,0,0,drop,66,66,0,1,0,1,0
59923,56495,445,0,0,drop,70,70,0,1,0,1,0
59924,58876,57470,0,0,deny,66,66,0,1,0,1,0
59925,56490,445,0,0,drop,70,70,0,1,0,1,0
59926,56489,445,0,0,drop,70,70,0,1,0,1,0
59927,56488,445,0,0,drop,70,70,0,1,0,1,0
59928,51458,445,0,0,drop,70,70,0,1,0,1,0
59929,51908,445,0,0,drop,66,66,0,1,0,1,0
59930,51457,445,0,0,drop,70,70,0,1,0,1,0
59931,56482,445,0,0,drop,70,70,0,1,0,1,0
59932,56480,445,0,0,drop,70,70,0,1,0,1,0
59933,56477,445,0,0,drop,70,70,0,1,0,1,0
59934,56478,445,0,0,drop,70,70,0,1,0,1,0
59935,51534,26467,0,0,deny,62,62,0,1,0,1,0
59936,51902,445,0,0,drop,66,66,0,1,0,1,0
59937,51452,445,0,0,drop,70,70,0,1,0,1,0
59938,51893,445,0,0,drop,66,66,0,1,0,1,0
59939,51896,445,0,0,drop,66,66,0,1,0,1,0
59940,51897,445,0,0,drop,66,66,0,1,0,1,0
59941,51891,445,0,0,drop,66,66,0,1,0,1,0
59942,51892,445,0,0,drop,66,66,0,1,0,1,0
59943,51889,445,0,0,drop,66,66,0,1,0,1,0
59944,42685,51180,0,0,deny,62,62,0,1,0,1,0
59945,56753,44847,0,0,deny,62,62,0,1,0,1,0
59946,49831,30188,0,0,deny,66,66,0,1,0,1,0
59947,64890,51180,0,0,deny,66,66,0,1,0,1,0
59948,50200,44847,0,0,deny,70,70,0,1,0,1,0
59949,56474,445,0,0,drop,70,70,0,1,0,1,0
59950,56471,445,0,0,drop,70,70,0,1,0,1,0
59951,56469,445,0,0,drop,70,70,0,1,0,1,0
59952,51887,445,0,0,drop,66,66,0,1,0,1,0
59953,56467,445,0,0,drop,70,70,0,1,0,1,0
59954,443,10010,0,0,deny,60,60,0,1,0,1,0
59955,51884,445,0,0,drop,66,66,0,1,0,1,0
59956,51882,445,0,0,drop,66,66,0,1,0,1,0
59957,51881,445,0,0,drop,66,66,0,1,0,1,0
59958,37616,443,4256,443,allow,18611,3046,15565,41,362,20,21
59959,61385,80,34601,80,allow,30257,2427,27830,45,255,22,23
59960,61390,80,4844,80,allow,13706,1388,12318,26,255,14,12
59961,51318,443,40980,443,allow,11191,4657,6534,32,129,14,18
59962,57512,80,20735,80,allow,1377,881,496,12,48,7,5
59963,65381,80,14160,80,allow,1630,982,648,13,78,7,6
59964,49736,443,37577,443,allow,378,192,186,7,15,4,3
59965,54688,443,54688,443,allow,149676,25300,124376,220,110,122,98
59966,51265,63960,62847,63960,allow,70,70,0,1,5,1,0
59967,56778,35292,48198,35292,allow,70,70,0,1,5,1,0
59968,65387,443,41173,443,allow,2289,1583,706,14,18,8,6
59969,61389,80,44525,80,allow,17407,1529,15878,30,255,16,14
59970,61388,80,19899,80,allow,14158,1392,12766,26,255,14,12
59971,17750,6881,6103,6881,allow,149,149,0,1,1200,1,0
59972,5938,26428,0,0,allow,60,60,0,1,90,1,0
59973,61706,80,6564,80,allow,1840,1242,598,11,16,6,5
59974,62462,53,62462,53,allow,238,99,139,2,30,1,1
59975,51564,443,53413,443,allow,2888,1566,1322,17,18,9,8
59976,61387,80,56509,80,allow,28791,2297,26494,41,255,20,21
59977,17861,443,17861,443,allow,1155,728,427,11,26,7,4
59978,65362,80,32536,80,allow,1347,771,576,11,86,7,4
59979,58046,53,58046,53,allow,231,88,143,2,32,1,1
59980,7665,80,7665,80,allow,110567,7016,103551,135,46,60,75
59981,42213,443,21488,443,allow,4622,926,3696,18,255,10,8
59982,52629,53,0,0,allow,232,77,155,2,33,1,1
59983,41322,443,7553,443,allow,153,93,60,2,5,1,1
59984,55598,41565,26251,41565,allow,70,70,0,2,8,2,0
59985,52540,443,62112,443,allow,153,93,60,2,5,1,1
59986,49175,2710,9134,2710,allow,66,66,0,1,5,1,0
59987,54614,443,21022,443,allow,36109,16793,19316,62,19,32,30
59988,50475,443,44824,443,allow,3893,1910,1983,36,255,17,19
59989,43422,80,45475,80,allow,3863,875,2988,12,16,8,4
59990,56981,443,53338,443,allow,7238,2601,4637,20,22,10,10
59991,33911,53,0,0,allow,82,82,0,1,30,1,0
59992,5588,5588,0,0,allow,3498,1872,1626,48,205,24,24
59993,51953,443,6688,443,allow,7571,3372,4199,33,88,17,16
59994,52000,80,35865,80,allow,3495,1150,2345,17,18,8,9
59995,55744,80,6834,80,allow,5146,3694,1452,20,249,10,10
59996,61386,80,24052,80,allow,17583,1529,16054,30,255,16,14
59997,56774,39553,10646,39553,allow,70,70,0,2,8,2,0
59998,54105,443,23340,443,allow,2227,1018,1209,17,16,8,9