t_id,SourcePort,Destination Port,NATSourcePort,NATDestinationPort,Action,Bytes,BytesSent,BytesReceived,Packets,ElapsedTime,pkts_sent,pkts_received
1,57222,53,54587,53,allow,177,94,83,2,30,1,1
2,56258,3389,56258,3389,allow,4768,1600,3168,19,17,10,9
3,6881,50321,43265,50321,allow,238,118,120,2,1199,1,1
4,50553,3389,50553,3389,allow,3327,1438,1889,15,17,8,7
5,50002,443,45848,443,allow,25358,6778,18580,31,16,13,18
6,51465,443,39975,443,allow,3961,1595,2366,21,16,12,9
7,60513,47094,45469,47094,allow,320,140,180,6,7,3,3
8,50049,443,21285,443,allow,7912,3269,4643,23,96,12,11
9,52244,58774,2211,58774,allow,70,70,0,1,5,1,0
10,50627,443,16215,443,allow,8256,1674,6582,31,75,15,16
11,43676,80,45378,80,allow,696,378,318,12,35,7,5
12,52190,443,16680,443,allow,7942,870,7072,22,15,10,12
13,50690,80,20479,80,allow,4805,3639,1166,16,31,9,7
14,55597,53,45448,53,allow,168,86,82,2,30,1,1
15,49164,443,45916,443,allow,7292,950,6342,19,75,9,10
16,36887,443,63451,443,allow,10922,2532,8390,27,28,13,14
17,1939,53,33288,53,allow,210,78,132,2,30,1,1
18,50281,53,33175,53,allow,195,102,93,2,30,1,1
19,57222,53,51448,53,allow,177,94,83,2,30,1,1
20,56710,53,57885,53,allow,177,94,83,2,30,1,1
21,48488,443,26104,443,allow,12993,3240,9753,36,24,18,18
22,50691,80,62082,80,allow,4237,3610,627,15,31,8,7
23,50693,80,54649,80,allow,4465,3390,1075,14,30,8,6
24,1940,53,23603,53,allow,210,78,132,2,30,1,1
25,50172,53,37056,53,allow,211,78,133,2,30,1,1
26,38802,53,38802,53,allow,216,90,126,2,30,1,1
27,50281,53,8038,53,allow,195,102,93,2,30,1,1
28,50051,443,1683,443,allow,7912,3269,4643,23,96,12,11
29,52192,443,41129,443,allow,13948,1150,12798,29,15,14,15
30,57886,443,10717,443,allow,33667,25477,8190,60,33,34,26
31,50289,80,7131,80,allow,7166,1086,6080,18,87,9,9
32,58615,443,30095,443,allow,6796,1541,5255,23,121,11,12
33,38551,53,14191,53,allow,168,78,90,2,30,1,1
34,64787,53,29856,53,allow,728,102,626,2,30,1,1
35,34529,443,30445,443,allow,62652,30891,31761,158,381,67,91
36,52184,443,13267,443,allow,13902,3253,10649,26,135,14,12
37,60377,443,34261,443,allow,8678,2974,5704,50,123,27,23
38,59347,80,59347,80,allow,108790,4633,104157,192,15,66,126
39,50077,443,40548,443,allow,7976,3333,4643,23,25,12,11
40,50149,80,2917,80,allow,11574,901,10673,20,46,11,9
41,50004,443,10108,443,allow,8745,2603,6142,19,15,11,8
42,60411,80,48309,80,allow,1589,941,648,11,121,6,5
43,60354,80,7611,80,allow,644,256,388,8,124,5,3
44,60399,80,36861,80,allow,1168,815,353,10,122,6,4
45,60348,80,15161,80,allow,10335,1617,8718,19,124,9,10
46,60420,80,1065,80,allow,14498,6454,8044,24,120,12,12
47,60423,443,61729,443,allow,6849,1103,5746,23,120,12,11
48,60360,443,62556,443,allow,5212,1101,4111,22,123,12,10
49,60363,443,28558,443,allow,5214,1101,4113,22,123,12,10
50,9523,443,27776,443,allow,7199,1410,5789,22,33,11,11
51,63842,45682,31353,45682,allow,4687209,3850148,837061,4974,107,3004,1970
52,60430,443,49199,443,allow,5696,1143,4553,23,119,12,11
53,59878,443,30562,443,allow,3864,2812,1052,17,112,8,9
54,53179,12502,28254,12502,allow,70,70,0,2,7,2,0
55,60414,80,46472,80,allow,5124,3499,1625,14,121,8,6
56,60400,80,41884,80,allow,1704,808,896,10,122,6,4
57,60407,443,49458,443,allow,8328,1611,6717,25,121,14,11
58,60398,80,57820,80,allow,378,192,186,7,122,4,3
59,60339,80,1887,80,allow,35136,7862,27274,53,124,26,27
60,38641,443,31615,443,allow,318,192,126,6,14,4,2
61,54996,53,2476,53,allow,168,86,82,2,31,1,1
62,48066,443,56844,443,allow,62,62,0,1,4,1,0
63,60811,40010,33835,40010,allow,316,136,180,6,5,3,3
64,52103,80,61932,80,allow,68083,5515,62568,90,38,40,50
65,52195,443,11275,443,allow,13948,1150,12798,29,15,14,15
66,50000,53,16568,53,allow,502,115,387,4,52,2,2
67,52193,443,50924,443,allow,13948,1150,12798,29,15,14,15
68,55234,53,5157,53,allow,177,94,83,2,29,1,1
69,50692,80,30484,80,allow,5727,3584,2143,15,31,8,7
70,60370,80,40899,80,allow,1243,769,474,9,123,6,3
71,65401,53,57745,53,allow,235,102,133,2,29,1,1
72,51737,53,3505,53,allow,231,78,153,2,30,1,1
73,50685,80,6959,80,allow,63891,26626,37265,86,34,39,47
74,52191,443,46265,443,allow,7882,810,7072,21,15,9,12
75,54557,80,41721,80,allow,2091,799,1292,10,15,6,4
76,48818,443,11974,443,allow,4167,1669,2498,23,15,12,11
77,64223,53,57211,53,allow,199,94,105,2,30,1,1
78,49245,53,34102,53,allow,376,126,250,2,29,1,1
79,65258,443,17337,443,allow,6043,1568,4475,11,120,4,7
80,64399,53,50659,53,allow,230,110,120,2,29,1,1
81,55234,53,22160,53,allow,177,94,83,2,30,1,1
82,64593,53,56394,53,allow,94,94,0,1,30,1,0
83,56911,53,36658,53,allow,177,94,83,2,31,1,1
84,53977,22266,9645,22266,allow,492,306,186,8,17,5,3
85,50148,80,57004,80,allow,9058,868,8190,18,46,10,8
86,53178,42671,48767,42671,allow,70,70,0,2,8,2,0
87,52181,443,64436,443,allow,7855,815,7040,21,15,9,12
88,65004,53,23515,53,allow,323,94,229,2,30,1,1
89,46265,443,19534,443,allow,173828,9311,164517,245,448,118,127
90,49158,443,27828,443,allow,14490,4227,10263,35,36,19,16
91,33067,53,47200,53,allow,168,78,90,2,30,1,1
92,56911,53,39355,53,allow,177,94,83,2,30,1,1
93,22767,53,22767,53,allow,226,106,120,2,30,1,1
94,52715,443,38027,443,allow,164840,5975,158865,179,122,61,118
95,33845,80,39303,80,allow,424,210,214,7,27,4,3
96,61442,443,19223,443,allow,3403,1891,1512,24,42,13,11
97,9446,443,50836,443,allow,8672,1863,6809,22,46,11,11
98,52194,443,38386,443,allow,12374,1090,11284,27,15,13,14
99,58306,443,59387,443,allow,864,436,428,13,29,7,6
100,42412,443,55628,443,allow,204,70,134,4,26,2,2
101,56710,53,52813,53,allow,177,94,83,2,30,1,1
102,61396,443,45721,443,allow,550484,8433,542051,541,246,99,442
103,61273,443,55960,443,allow,19675,8597,11078,137,480,68,69
104,50016,53,14072,53,allow,766,103,663,4,41,2,2
105,58307,443,36806,443,allow,934,506,428,14,29,8,6
106,55182,53,36739,53,allow,293,94,199,2,30,1,1
107,56911,53,31733,53,allow,177,94,83,2,30,1,1
108,41631,443,38429,443,allow,20180,2917,17263,35,124,14,21
109,38637,443,8499,443,allow,12339,2392,9947,36,287,15,21
110,45317,53,22055,53,allow,86,86,0,1,30,1,0
111,56704,53,2427,53,allow,318,94,224,2,30,1,1
112,49410,53,62890,53,allow,177,94,83,2,30,1,1
113,56504,53,45710,53,allow,102,102,0,1,30,1,0
114,50003,443,32664,443,allow,13812,3042,10770,29,16,15,14
115,40737,443,35009,443,allow,44004,3909,40095,80,135,38,42
116,38082,443,14308,443,allow,284,164,120,4,15,2,2
117,36036,443,36036,443,allow,261234,32183,229051,326,212,153,173
118,55476,53,58894,53,allow,232,110,122,2,30,1,1
119,49395,53,40831,53,allow,390,111,279,4,53,2,2
120,56172,53,35826,53,allow,253,87,166,4,30,2,2
121,56624,53,36589,53,allow,177,94,83,2,31,1,1
122,57470,20220,32069,20220,allow,870,330,540,12,2308,6,6
123,33856,443,15413,443,allow,8171028,105740,8065288,6637,149,745,5892
124,59983,443,26904,443,allow,296863,14073,282790,351,127,130,221
125,15503,63425,41497,63425,allow,481,150,331,2,1200,1,1
126,53987,16571,20059,16571,allow,70,70,0,1,5,1,0
127,53986,54070,39036,54070,allow,70,70,0,1,5,1,0
128,64094,1024,62040,1024,allow,70,70,0,1,5,1,0
129,64095,1976,59706,1976,allow,70,70,0,1,5,1,0
130,52126,443,21159,443,allow,1672,1149,523,13,37,8,5
131,52144,80,16896,80,allow,366,240,126,7,33,5,2
132,50816,443,50681,443,allow,134,60,74,3,6,2,1
133,50057,80,26007,80,allow,1570,754,816,10,16,6,4
134,52146,80,44068,80,allow,366,240,126,7,33,5,2
135,54139,53,64934,53,allow,168,78,90,2,31,1,1
136,49410,53,29049,53,allow,177,94,83,2,31,1,1
137,53994,16605,15809,16605,allow,70,70,0,2,8,2,0
138,35242,8635,35242,8635,allow,138,78,60,2,6,1,1
139,52148,80,27900,80,allow,366,240,126,7,33,5,2
140,49900,443,28761,443,allow,1820,1101,719,18,73,10,8
141,43931,53,36161,53,allow,168,78,90,2,31,1,1
142,51048,445,0,0,drop,70,70,0,1,0,1,0
143,51045,445,0,0,drop,70,70,0,1,0,1,0
144,13394,23,0,0,deny,60,60,0,1,0,1,0
145,61078,57470,0,0,deny,62,62,0,1,0,1,0
146,55725,445,0,0,drop,70,70,0,1,0,1,0
147,55723,445,0,0,drop,70,70,0,1,0,1,0
148,55724,445,0,0,drop,70,70,0,1,0,1,0
149,51125,445,0,0,drop,66,66,0,1,0,1,0
150,51123,445,0,0,drop,66,66,0,1,0,1,0
151,51122,445,0,0,drop,66,66,0,1,0,1,0
152,51121,445,0,0,drop,66,66,0,1,0,1,0
153,51126,445,0,0,drop,66,66,0,1,0,1,0
154,51124,445,0,0,drop,66,66,0,1,0,1,0
155,51120,445,0,0,drop,66,66,0,1,0,1,0
156,51119,445,0,0,drop,66,66,0,1,0,1,0
157,62776,62413,0,0,deny,146,146,0,1,0,1,0
158,51041,445,0,0,drop,70,70,0,1,0,1,0
159,46448,30170,0,0,deny,159,159,0,1,0,1,0
160,10688,25174,0,0,deny,146,146,0,1,0,1,0
161,34086,25174,0,0,deny,62,62,0,1,0,1,0
162,64605,25174,0,0,deny,62,62,0,1,0,1,0
163,51039,445,0,0,drop,70,70,0,1,0,1,0
164,56688,25174,0,0,deny,62,62,0,1,0,1,0
165,57015,42707,0,0,deny,62,62,0,1,0,1,0
166,41213,25174,0,0,deny,62,62,0,1,0,1,0
167,57131,8055,0,0,deny,145,145,0,1,0,1,0
168,45855,25174,0,0,deny,62,62,0,1,0,1,0
169,54483,25174,0,0,deny,66,66,0,1,0,1,0
170,45855,25174,0,0,deny,146,146,0,1,0,1,0
171,49990,62413,0,0,deny,66,66,0,1,0,1,0
172,1582,56205,0,0,deny,62,62,0,1,0,1,0
173,65003,57470,0,0,deny,78,78,0,1,0,1,0
174,55718,445,0,0,drop,70,70,0,1,0,1,0
175,55717,445,0,0,drop,70,70,0,1,0,1,0
176,55713,445,0,0,drop,70,70,0,1,0,1,0
177,55708,445,0,0,drop,70,70,0,1,0,1,0
178,63486,51505,0,0,deny,66,66,0,1,0,1,0
179,54100,37965,0,0,deny,62,62,0,1,0,1,0
180,51034,445,0,0,drop,70,70,0,1,0,1,0
181,51107,445,0,0,drop,66,66,0,1,0,1,0
182,51105,445,0,0,drop,66,66,0,1,0,1,0
183,51104,445,0,0,drop,66,66,0,1,0,1,0
184,1815,22114,0,0,deny,66,66,0,1,0,1,0
185,443,47582,0,0,deny,60,60,0,1,0,1,0
186,443,47582,0,0,deny,85,85,0,1,0,1,0
187,443,47582,0,0,deny,100,100,0,1,0,1,0
188,59126,57470,0,0,deny,66,66,0,1,0,1,0
189,27621,50584,0,0,deny,62,62,0,1,0,1,0
190,52266,50038,0,0,deny,66,66,0,1,0,1,0
191,56456,1433,0,0,deny,60,60,0,1,0,1,0
192,43537,2323,0,0,deny,60,60,0,1,0,1,0
193,40772,15503,0,0,deny,74,74,0,1,0,1,0
194,50594,25174,0,0,deny,66,66,0,1,0,1,0
195,4323,64147,0,0,deny,62,62,0,1,0,1,0
196,55703,445,0,0,drop,70,70,0,1,0,1,0
197,55701,445,0,0,drop,70,70,0,1,0,1,0
198,55696,445,0,0,drop,70,70,0,1,0,1,0
199,55698,445,0,0,drop,70,70,0,1,0,1,0
200,34349,25174,0,0,deny,146,146,0,1,0,1,0
201,39587,22114,0,0,deny,62,62,0,1,0,1,0
202,42542,25174,0,0,deny,62,62,0,1,0,1,0
203,49529,21247,0,0,deny,62,62,0,1,0,1,0
204,64579,37965,0,0,deny,66,66,0,1,0,1,0
205,51021,445,0,0,drop,70,70,0,1,0,1,0
206,53771,57470,0,0,deny,66,66,0,1,0,1,0
207,15701,37965,0,0,deny,146,146,0,1,0,1,0
208,4529,56205,0,0,deny,62,62,0,1,0,1,0
209,45060,37965,0,0,deny,62,62,0,1,0,1,0
210,32554,34729,0,0,deny,62,62,0,1,0,1,0
211,51018,445,0,0,drop,70,70,0,1,0,1,0
212,47913,25174,0,0,deny,146,146,0,1,0,1,0
213,55686,445,0,0,drop,70,70,0,1,0,1,0
214,55683,445,0,0,drop,70,70,0,1,0,1,0
215,55679,445,0,0,drop,70,70,0,1,0,1,0
216,2206,25174,0,0,deny,62,62,0,1,0,1,0
217,64808,62413,0,0,deny,62,62,0,1,0,1,0
218,17244,22114,0,0,deny,62,62,0,1,0,1,0
219,51095,445,0,0,drop,66,66,0,1,0,1,0
220,51014,445,0,0,drop,70,70,0,1,0,1,0
221,58925,25174,0,0,deny,66,66,0,1,0,1,0
222,32549,37807,0,0,deny,146,146,0,1,0,1,0
223,51012,445,0,0,drop,70,70,0,1,0,1,0
224,52838,37965,0,0,deny,66,66,0,1,0,1,0
225,34217,23,0,0,deny,60,60,0,1,0,1,0
226,52459,33890,0,0,deny,60,60,0,1,0,1,0
227,51010,445,0,0,drop,70,70,0,1,0,1,0
228,55678,445,0,0,drop,70,70,0,1,0,1,0
229,6666,3389,0,0,deny,60,60,0,1,0,1,0
230,1024,21854,0,0,reset-both,157,157,0,1,0,1,0
231,55677,445,0,0,drop,70,70,0,1,0,1,0
232,25533,22114,0,0,deny,62,62,0,1,0,1,0
233,47132,1433,0,0,deny,60,60,0,1,0,1,0
234,56119,37965,0,0,deny,62,62,0,1,0,1,0
235,51080,445,0,0,drop,66,66,0,1,0,1,0
236,51076,445,0,0,drop,66,66,0,1,0,1,0
237,51003,445,0,0,drop,70,70,0,1,0,1,0
238,54502,34729,0,0,deny,66,66,0,1,0,1,0
239,53626,30317,0,0,deny,66,66,0,1,0,1,0
240,53712,25174,0,0,deny,66,66,0,1,0,1,0
241,51001,445,0,0,drop,70,70,0,1,0,1,0
242,33726,44847,0,0,deny,62,62,0,1,0,1,0
243,22568,37965,0,0,deny,66,66,0,1,0,1,0
244,443,49988,0,0,deny,82,82,0,1,0,1,0
245,55667,445,0,0,drop,70,70,0,1,0,1,0
246,55665,445,0,0,drop,70,70,0,1,0,1,0
247,55660,445,0,0,drop,70,70,0,1,0,1,0
248,55658,445,0,0,drop,70,70,0,1,0,1,0
249,53985,30188,0,0,deny,62,62,0,1,0,1,0
250,57613,42707,0,0,deny,62,62,0,1,0,1,0
251,6666,6001,0,0,deny,60,60,0,1,0,1,0
252,45941,23386,0,0,deny,60,60,0,1,0,1,0
253,51000,445,0,0,drop,70,70,0,1,0,1,0
254,51071,445,0,0,drop,66,66,0,1,0,1,0
255,50999,445,0,0,drop,70,70,0,1,0,1,0
256,50998,445,0,0,drop,70,70,0,1,0,1,0
257,55759,5900,0,0,deny,60,60,0,1,0,1,0
258,50995,445,0,0,drop,70,70,0,1,0,1,0
259,50992,445,0,0,drop,70,70,0,1,0,1,0
260,51067,445,0,0,drop,66,66,0,1,0,1,0
261,51066,445,0,0,drop,66,66,0,1,0,1,0
262,51065,445,0,0,drop,66,66,0,1,0,1,0
263,51062,445,0,0,drop,66,66,0,1,0,1,0
264,51057,445,0,0,drop,66,66,0,1,0,1,0
265,51063,445,0,0,drop,66,66,0,1,0,1,0
266,51059,445,0,0,drop,66,66,0,1,0,1,0
267,55651,445,0,0,drop,70,70,0,1,0,1,0
268,21268,62609,0,0,deny,146,146,0,1,0,1,0
269,21268,62609,0,0,deny,146,146,0,1,0,1,0
270,55648,445,0,0,drop,70,70,0,1,0,1,0
271,55646,445,0,0,drop,70,70,0,1,0,1,0
272,55644,445,0,0,drop,70,70,0,1,0,1,0
273,50980,445,0,0,drop,70,70,0,1,0,1,0
274,50979,445,0,0,drop,70,70,0,1,0,1,0
275,23758,44847,0,0,deny,62,62,0,1,0,1,0
276,50975,445,0,0,drop,70,70,0,1,0,1,0
277,53324,44847,0,0,deny,66,66,0,1,0,1,0
278,50970,445,0,0,drop,70,70,0,1,0,1,0
279,50969,445,0,0,drop,70,70,0,1,0,1,0
280,53243,57470,0,0,deny,74,74,0,1,0,1,0
281,64776,25174,0,0,deny,66,66,0,1,0,1,0
282,50547,22197,0,0,deny,66,66,0,1,0,1,0
283,64298,50584,0,0,deny,66,66,0,1,0,1,0
284,30456,36237,0,0,deny,62,62,0,1,0,1,0
285,56816,443,16188,443,allow,7956,1967,5989,20,15,11,9
286,52011,80,26180,80,allow,23580,10536,13044,36,39,18,18
287,50198,3389,50198,3389,allow,3343,1454,1889,15,16,8,7
288,56624,53,45708,53,allow,170,87,83,2,30,1,1
289,56813,443,32005,443,allow,8021,2001,6020,20,16,11,9
290,52007,443,2667,443,allow,10217,8266,1951,33,39,20,13
291,64092,14447,29856,14447,allow,66,66,0,1,5,1,0
292,64270,443,64270,443,allow,4747,1840,2907,19,27,11,8
293,51163,443,48007,443,allow,9466,2602,6864,41,185,20,21
294,52469,443,22069,443,allow,29896,14149,15747,61,209,35,26
295,46898,53,46898,53,allow,194,87,107,2,30,1,1
296,53198,443,53198,443,allow,4591,1684,2907,19,28,11,8
297,5886,80,5886,80,allow,138678,5557,133121,152,16,58,94
298,56815,443,53722,443,allow,7903,1914,5989,20,15,11,9
299,52270,3708,62556,3708,allow,316,136,180,6,6,3,3
300,52264,43015,38341,43015,allow,70,70,0,2,7,2,0
301,62685,443,28394,443,allow,7023,2352,4671,18,75,10,8
302,49333,443,8337,443,allow,50226,4284,45942,76,75,31,45
303,62892,443,62892,443,allow,4377,1470,2907,19,30,11,8
304,50487,3389,50487,3389,allow,6312,2620,3692,25,24,12,13
305,39430,443,21846,443,allow,506,292,214,8,50,5,3
306,45232,80,45232,80,allow,2895,1484,1411,10,15,6,4
307,51164,443,28609,443,allow,5040,2743,2297,34,185,18,16
308,64099,55470,50878,55470,allow,66,66,0,1,5,1,0
309,52240,52893,2825,52893,allow,66,66,0,1,5,1,0
310,48550,443,45303,443,allow,778,358,420,12,43,6,6
311,47845,53,47845,53,allow,243,94,149,2,32,1,1
312,52263,16350,50284,16350,allow,70,70,0,2,8,2,0
313,53177,8595,28264,8595,allow,70,70,0,2,9,2,0
314,53984,57077,2292,57077,allow,70,70,0,1,5,1,0
315,56674,443,44964,443,allow,237,177,60,3,5,2,1
316,34440,53,34440,53,allow,235,90,145,2,32,1,1
317,44389,443,27883,443,allow,3067,1817,1250,18,16,8,10
318,52265,32078,35097,32078,allow,70,70,0,2,7,2,0
319,54996,53,39612,53,allow,168,86,82,2,35,1,1
320,35609,443,35165,443,allow,237,177,60,3,5,2,1
321,55727,43736,19578,43736,allow,70,70,0,1,5,1,0
322,56911,53,21649,53,allow,170,87,83,2,30,1,1
323,50193,3389,50193,3389,allow,3409,1454,1955,16,16,8,8
324,49935,53,10954,53,allow,75,75,0,1,30,1,0
325,52852,53,0,0,allow,82,82,0,1,30,1,0
326,59226,53,59226,53,allow,194,87,107,2,30,1,1
327,60286,443,29238,443,allow,7576,1897,5679,23,136,13,10
328,27313,53,27313,53,allow,194,87,107,2,31,1,1
329,55674,53,14625,53,allow,744,89,655,2,31,1,1
330,40814,53,40814,53,allow,213,87,126,2,31,1,1
331,53067,4040,59736,4040,allow,115,115,0,1,31,1,0
332,56730,53,30044,53,allow,170,87,83,2,31,1,1
333,46713,53,46713,53,allow,217,87,130,2,31,1,1
334,32806,53,32806,53,allow,194,87,107,2,31,1,1
335,56434,53,6758,53,allow,701,88,613,2,31,1,1
336,51221,64767,41578,64767,allow,330,330,0,6,1200,6,0
337,19502,53,19502,53,allow,198,89,109,2,31,1,1
338,53151,53,29237,53,allow,168,78,90,2,31,1,1
339,56086,443,31892,443,allow,6817,3598,3219,32,143,15,17
340,27839,53,27839,53,allow,213,87,126,2,31,1,1
341,22835,51221,0,0,deny,62,62,0,1,0,1,0
342,65305,51221,0,0,deny,66,66,0,1,0,1,0
343,23001,64147,0,0,deny,62,62,0,1,0,1,0
344,52128,37807,0,0,deny,62,62,0,1,0,1,0
345,23632,64147,0,0,deny,66,66,0,1,0,1,0
346,48706,23393,0,0,deny,60,60,0,1,0,1,0
347,64288,53,54415,53,allow,398,103,295,4,41,2,2
348,52041,80,18599,80,allow,2901,1407,1494,15,38,9,6
349,64087,80,46757,80,allow,314,192,122,6,15,4,2
350,56052,53,22562,53,allow,177,94,83,2,30,1,1
351,52150,80,40663,80,allow,546,300,246,10,32,6,4
352,48706,23393,0,0,deny,60,60,0,1,0,1,0
353,55641,445,0,0,drop,70,70,0,1,0,1,0
354,55642,445,0,0,drop,70,70,0,1,0,1,0
355,55640,445,0,0,drop,70,70,0,1,0,1,0
356,51050,445,0,0,drop,66,66,0,1,0,1,0
357,35207,22114,0,0,deny,62,62,0,1,0,1,0
358,55635,445,0,0,drop,70,70,0,1,0,1,0
359,50957,445,0,0,drop,70,70,0,1,0,1,0
360,51432,25174,0,0,deny,146,146,0,1,0,1,0
361,51047,445,0,0,drop,66,66,0,1,0,1,0
362,51046,445,0,0,drop,66,66,0,1,0,1,0
363,51045,445,0,0,drop,66,66,0,1,0,1,0
364,17925,26467,0,0,deny,66,66,0,1,0,1,0
365,34993,15503,0,0,deny,62,62,0,1,0,1,0
366,8040,44847,0,0,deny,66,66,0,1,0,1,0
367,39588,25174,0,0,deny,66,66,0,1,0,1,0
368,51042,445,0,0,drop,66,66,0,1,0,1,0
369,2978,48817,0,0,deny,66,66,0,1,0,1,0
370,1536,48817,0,0,deny,62,62,0,1,0,1,0
371,43269,50584,0,0,deny,66,66,0,1,0,1,0
372,33453,64147,0,0,deny,62,62,0,1,0,1,0
373,51414,22,0,0,deny,60,60,0,1,0,1,0
374,34810,25174,0,0,deny,62,62,0,1,0,1,0
375,50951,445,0,0,drop,70,70,0,1,0,1,0
376,5685,35440,0,0,deny,62,62,0,1,0,1,0
377,55633,445,0,0,drop,70,70,0,1,0,1,0
378,51598,56079,0,0,deny,66,66,0,1,0,1,0
379,40239,22114,0,0,deny,146,146,0,1,0,1,0
380,443,18368,0,0,deny,60,60,0,1,0,1,0
381,55622,445,0,0,drop,70,70,0,1,0,1,0
382,52145,80,50375,80,allow,366,240,126,7,32,5,2
383,50039,7000,50039,7000,allow,3050,1659,1391,16,15,9,7
384,56717,80,40230,80,allow,3894448,104279,3790169,4041,97,1411,2630
385,52162,443,20113,443,allow,1461,924,537,13,31,7,6
386,52272,37105,49502,37105,allow,316,136,180,6,6,3,3
387,56504,53,24881,53,allow,198,102,96,2,32,1,1
388,64098,10096,50669,10096,allow,70,70,0,1,4,1,0
389,52241,51717,19106,51717,allow,70,70,0,1,4,1,0
390,52143,80,6472,80,allow,366,240,126,7,32,5,2
391,50050,443,8381,443,allow,7912,3269,4643,23,95,12,11
392,52164,443,54936,443,allow,4187,773,3414,16,30,9,7
393,52115,443,22081,443,allow,11551,3870,7681,29,37,16,13
394,52147,80,1117,80,allow,366,240,126,7,32,5,2
395,52157,80,19874,80,allow,366,240,126,7,32,5,2
396,55526,80,37218,80,allow,78,78,0,2,8,2,0
397,52151,80,38473,80,allow,546,300,246,10,32,6,4
398,49359,443,64650,443,allow,63494,7222,56272,107,81,49,58
399,60512,6881,33887,6881,allow,320,140,180,6,6,3,3
400,53982,24226,55007,24226,allow,70,70,0,1,4,1,0
401,53985,26515,42482,26515,allow,70,70,0,1,4,1,0
402,16965,3389,16965,3389,allow,4085,1916,2169,21,18,12,9
403,52000,80,35679,80,allow,3604,2064,1540,15,40,10,5
404,38717,443,31292,443,allow,958865,18695,940170,908,16,266,642
405,56624,53,34436,53,allow,177,94,83,2,30,1,1
406,49795,53,44891,53,allow,263,94,169,2,30,1,1
407,50057,53,37422,53,allow,177,94,83,2,30,1,1
408,55306,53,39881,53,allow,177,94,83,2,30,1,1
409,52159,80,23650,80,allow,502,310,192,9,31,6,3
410,52153,80,26645,80,allow,366,240,126,7,32,5,2
411,55725,14704,64431,14704,allow,70,70,0,1,5,1,0
412,50711,80,19117,80,allow,1658,1247,411,8,15,5,3
413,58304,443,13109,443,allow,13442,1200,12242,26,29,11,15
414,58305,443,38970,443,allow,11659,1027,10632,25,29,11,14
415,60291,53,5136,53,allow,78,78,0,1,30,1,0
416,56555,53,42493,53,allow,348,94,254,2,30,1,1
417,49436,53,61599,53,allow,718,94,624,2,30,1,1
418,64226,53,54672,53,allow,245,94,151,2,30,1,1
419,55379,443,27244,443,allow,13679,7277,6402,35,262,15,20
420,33825,443,41237,443,allow,9407,2233,7174,38,96,16,22
421,19763,53,19763,53,allow,216,82,134,2,32,1,1
422,56741,53,5499,53,allow,370,94,276,2,30,1,1
423,51041,80,59300,80,allow,1514,480,1034,11,15,6,5
424,56663,53,41717,53,allow,181,94,87,2,33,1,1
425,56440,53,62063,53,allow,212,102,110,2,30,1,1
426,49961,443,64983,443,allow,16890,7125,9765,33,98,19,14
427,52236,15313,26526,15313,allow,70,70,0,1,5,1,0
428,56052,53,19569,53,allow,177,94,83,2,30,1,1
429,53971,80,16324,80,allow,662,448,214,10,15,7,3
430,64196,53,65372,53,allow,262,94,168,2,30,1,1
431,38330,123,58815,123,allow,184,94,90,2,30,1,1
432,49935,53,45170,53,allow,168,86,82,2,30,1,1
433,55639,53,27613,53,allow,244,94,150,2,30,1,1
434,53470,53,29709,53,allow,168,78,90,2,30,1,1
435,51986,80,28001,80,allow,1420,888,532,11,49,7,4
436,40831,80,63406,80,allow,1614,1300,314,10,15,5,5
437,36138,443,58693,443,allow,50384,5218,45166,76,99,26,50
438,33151,53,41502,53,allow,168,78,90,2,30,1,1
439,50563,53,11644,53,allow,718,94,624,2,30,1,1
440,50480,443,25461,443,allow,57535,3735,53800,70,122,26,44
441,57138,443,59763,443,allow,70379,4205,66174,101,403,51,50
442,52152,80,10469,80,allow,366,240,126,7,32,5,2
443,55724,45682,6518,45682,allow,70,70,0,1,5,1,0
444,51999,80,34655,80,allow,20433,10970,9463,34,42,19,15
445,51934,443,39970,443,allow,9735,2891,6844,36,82,17,19
446,56521,53,35277,53,allow,305,86,219,2,30,1,1
447,50056,27018,7128,27018,allow,468,390,78,5,30,4,1
448,65078,53,19268,53,allow,177,94,83,2,30,1,1
449,55999,443,53262,443,allow,45632,2078,43554,58,120,22,36
450,43088,5228,50878,5228,allow,4708,1753,2955,27,4133,12,15
451,37647,443,55661,443,allow,697381,19797,677584,725,106,247,478
452,58424,443,8670,443,allow,81295,4140,77155,114,117,42,72
453,52142,80,50942,80,allow,246,120,126,5,32,3,2
454,52155,80,52769,80,allow,366,240,126,7,32,5,2
455,65524,443,51488,443,allow,282968,9210,273758,296,15,106,190
456,52163,443,4704,443,allow,4187,773,3414,16,30,9,7
457,52161,443,17095,443,allow,1461,924,537,13,31,7,6
458,53995,41985,42236,41985,allow,70,70,0,2,7,2,0
459,51221,51413,17316,51413,allow,460,150,310,2,1200,1,1
460,65525,443,9387,443,allow,92247,4799,87448,107,15,43,64
461,52080,80,40918,80,allow,27100,21684,5416,39,38,25,14
462,52158,80,31502,80,allow,502,310,192,9,31,6,3
463,10151,11888,57602,11888,allow,491,150,341,2,1200,1,1
464,52154,80,54882,80,allow,366,240,126,7,32,5,2
465,49899,443,6307,443,allow,1820,1101,719,18,72,10,8
466,53983,40500,9041,40500,allow,70,70,0,1,4,1,0
467,49668,443,64842,443,allow,1288,754,534,13,50,5,8
468,64093,64828,53558,64828,allow,70,70,0,1,4,1,0
469,52237,16801,7817,16801,allow,70,70,0,1,5,1,0
470,57242,53,53275,53,allow,184,86,98,2,29,1,1
471,60833,443,43148,443,allow,1157,817,340,10,26,5,5
472,32971,443,57614,443,allow,300,180,120,4,15,2,2
473,52027,80,10157,80,allow,9732,8170,1562,18,38,10,8
474,56172,53,12622,53,allow,253,87,166,4,29,2,2
475,56663,53,55920,53,allow,181,94,87,2,30,1,1
476,56773,80,16432,80,allow,1462,703,759,8,16,5,3
477,44421,443,9990,443,allow,2548,1565,983,20,330,11,9
478,55806,53,2252,53,allow,200,102,98,2,30,1,1
479,17129,53,49932,53,allow,225,78,147,2,31,1,1
480,51404,443,29692,443,allow,9076,2650,6426,35,247,15,20
481,36503,443,18047,443,allow,3549,899,2650,13,120,6,7
482,53660,443,62189,443,allow,2955,864,2091,11,119,5,6
483,54401,443,33851,443,allow,11527127,373718,11153409,12286,144,4090,8196
484,52018,80,60048,80,allow,4988,2667,2321,15,38,10,5
485,55726,32463,19971,32463,allow,70,70,0,1,5,1,0
486,50054,443,33481,443,allow,7630,839,6791,20,79,9,11
487,56624,53,60055,53,allow,328,87,241,4,52,2,2
488,56667,53,36173,53,allow,232,94,138,2,30,1,1
489,56684,53,5087,53,allow,194,94,100,2,30,1,1
490,65001,53,27011,53,allow,200,78,122,2,30,1,1
491,56751,53,35800,53,allow,177,94,83,2,30,1,1
492,52127,80,9783,80,allow,2412,1750,662,13,36,9,4
493,12939,53,12939,53,allow,216,82,134,2,32,1,1
494,52486,443,26318,443,allow,57366,41661,15705,111,440,66,45
495,52238,48996,43886,48996,allow,70,70,0,1,5,1,0
496,55848,53,3289,53,allow,387,134,253,2,30,1,1
497,65484,53,10578,53,allow,195,86,109,2,30,1,1
498,49695,53,29724,53,allow,240,102,138,2,30,1,1
499,64877,53,41929,53,allow,209,110,99,2,30,1,1
500,43516,53,56876,53,allow,168,78,90,2,30,1,1
501,52865,443,19165,443,allow,13139,6481,6658,36,262,16,20
502,50684,443,36548,443,allow,6909,2495,4414,20,15,11,9
503,52013,80,47338,80,allow,27271,12050,15221,45,38,24,21
504,51946,80,42668,80,allow,1716,952,764,13,69,8,5
505,52160,80,10438,80,allow,502,310,192,9,31,6,3
506,52267,55982,31620,55982,allow,70,70,0,2,6,2,0
507,24965,53,24965,53,allow,247,98,149,2,32,1,1
508,52266,31225,1238,31225,allow,70,70,0,1,5,1,0
509,51930,443,10848,443,allow,9114,2713,6401,33,82,15,18
510,38999,443,34634,443,allow,12742,1983,10759,47,123,14,33
511,57986,80,48652,80,allow,1056,682,374,10,15,6,4
512,49410,53,59985,53,allow,324,87,237,4,55,2,2
513,54877,53,59244,53,allow,199,94,105,2,30,1,1
514,49432,53,21540,53,allow,199,94,105,2,30,1,1
515,49743,53,1715,53,allow,210,94,116,2,30,1,1
516,49913,53,15271,53,allow,177,94,83,2,30,1,1
517,39311,443,39728,443,allow,12825,8114,4711,63,269,25,38
518,42046,443,15950,443,allow,10195,2175,8020,25,187,14,11
519,44323,5228,8392,5228,allow,7292,4509,2783,50,6392,25,25
520,55072,53,55776,53,allow,177,94,83,2,30,1,1
521,49980,53,9358,53,allow,168,94,74,2,31,1,1
522,55306,53,44864,53,allow,177,94,83,2,31,1,1
523,47739,5228,19332,5228,allow,2852,2143,709,16,121,8,8
524,6881,6881,13981,6881,allow,150,150,0,1,1200,1,0
525,65078,53,50659,53,allow,177,94,83,2,30,1,1
526,49980,53,26131,53,allow,152,78,74,2,30,1,1
527,55065,53,9474,53,allow,168,78,90,2,30,1,1
528,45151,53,40658,53,allow,168,78,90,2,30,1,1
529,55072,53,50967,53,allow,177,94,83,2,31,1,1
530,57470,13613,53702,13613,allow,1577,594,983,20,1638,10,10
531,53637,443,7341,443,allow,8473,1099,7374,20,119,9,11
532,50064,80,16215,80,allow,186,64,122,4,25,2,2
533,50065,80,29478,80,allow,4709,4006,703,11,25,6,5
534,58964,80,7375,80,allow,5541,4758,783,16,16,8,8
535,57262,53,45135,53,allow,94,94,0,1,30,1,0
536,53638,443,29587,443,allow,2090,1100,990,17,119,9,8
537,28007,443,40494,443,allow,31586,15587,15999,213,884,105,108
538,49964,53,64934,53,allow,749,94,655,2,30,1,1
539,49854,443,20438,443,allow,5578,2780,2798,14,120,7,7
540,64112,24707,56635,24707,allow,66,66,0,2,8,2,0
541,53895,443,16317,443,allow,375374,160846,214528,633,1412,294,339
542,56751,53,10691,53,allow,177,94,83,2,30,1,1
543,55563,53,42353,53,allow,177,94,83,2,30,1,1
544,55619,445,0,0,drop,70,70,0,1,0,1,0
545,3456,11392,0,0,deny,62,62,0,1,0,1,0
546,50942,445,0,0,drop,70,70,0,1,0,1,0
547,50939,445,0,0,drop,70,70,0,1,0,1,0
548,50941,445,0,0,drop,70,70,0,1,0,1,0
549,443,34920,0,0,deny,60,60,0,1,0,1,0
550,15774,56205,0,0,deny,66,66,0,1,0,1,0
551,50937,445,0,0,drop,70,70,0,1,0,1,0
552,443,14591,0,0,deny,131,131,0,1,0,1,0
553,63421,44847,0,0,deny,66,66,0,1,0,1,0
554,62949,37965,0,0,deny,62,62,0,1,0,1,0
555,55517,25174,0,0,deny,66,66,0,1,0,1,0
556,50935,445,0,0,drop,70,70,0,1,0,1,0
557,63346,37965,0,0,deny,66,66,0,1,0,1,0
558,42564,50584,0,0,deny,62,62,0,1,0,1,0
559,51032,445,0,0,drop,66,66,0,1,0,1,0
560,45652,10214,0,0,deny,62,62,0,1,0,1,0
561,33314,44847,0,0,deny,62,62,0,1,0,1,0
562,52470,14037,0,0,deny,66,66,0,1,0,1,0
563,1024,35894,0,0,deny,62,62,0,1,0,1,0
564,43704,37965,0,0,deny,66,66,0,1,0,1,0
565,48830,5900,0,0,deny,60,60,0,1,0,1,0
566,51024,445,0,0,drop,66,66,0,1,0,1,0
567,55608,445,0,0,drop,70,70,0,1,0,1,0
568,56039,50584,0,0,deny,62,62,0,1,0,1,0
569,50928,445,0,0,drop,70,70,0,1,0,1,0
570,59977,30188,0,0,deny,66,66,0,1,0,1,0
571,26884,57866,0,0,deny,74,74,0,1,0,1,0
572,61624,30317,0,0,deny,66,66,0,1,0,1,0
573,51021,445,0,0,drop,66,66,0,1,0,1,0
574,60141,30188,0,0,deny,66,66,0,1,0,1,0
575,52812,25174,0,0,deny,62,62,0,1,0,1,0
576,11643,81,0,0,deny,60,60,0,1,0,1,0
577,52769,51221,0,0,deny,62,62,0,1,0,1,0
578,50920,445,0,0,drop,70,70,0,1,0,1,0
579,11056,6881,0,0,deny,62,62,0,1,0,1,0
580,50917,445,0,0,drop,70,70,0,1,0,1,0
581,51014,445,0,0,drop,66,66,0,1,0,1,0
582,6666,62078,0,0,deny,60,60,0,1,0,1,0
583,39213,25174,0,0,deny,62,62,0,1,0,1,0
584,47063,15503,0,0,deny,146,146,0,1,0,1,0
585,56428,30317,0,0,deny,66,66,0,1,0,1,0
586,51007,445,0,0,drop,66,66,0,1,0,1,0
587,24534,50584,0,0,deny,62,62,0,1,0,1,0
588,50913,445,0,0,drop,70,70,0,1,0,1,0
589,50912,445,0,0,drop,70,70,0,1,0,1,0
590,42981,44847,0,0,deny,146,146,0,1,0,1,0
591,7151,37965,0,0,deny,66,66,0,1,0,1,0
592,60722,37965,0,0,deny,62,62,0,1,0,1,0
593,56940,5900,0,0,deny,60,60,0,1,0,1,0
594,65003,57470,0,0,deny,78,78,0,1,0,1,0
595,56366,51221,0,0,deny,66,66,0,1,0,1,0
596,3945,35440,0,0,deny,66,66,0,1,0,1,0
597,55597,445,0,0,drop,70,70,0,1,0,1,0
598,55595,445,0,0,drop,70,70,0,1,0,1,0
599,55596,445,0,0,drop,70,70,0,1,0,1,0
600,50996,445,0,0,drop,66,66,0,1,0,1,0
601,50997,445,0,0,drop,66,66,0,1,0,1,0
602,50998,445,0,0,drop,66,66,0,1,0,1,0
603,50991,445,0,0,drop,66,66,0,1,0,1,0
604,50995,445,0,0,drop,66,66,0,1,0,1,0
605,50994,445,0,0,drop,66,66,0,1,0,1,0
606,50993,445,0,0,drop,66,66,0,1,0,1,0
607,50990,445,0,0,drop,66,66,0,1,0,1,0
608,50908,445,0,0,drop,70,70,0,1,0,1,0
609,36357,25174,0,0,deny,62,62,0,1,0,1,0
610,64333,57470,0,0,deny,78,78,0,1,0,1,0
611,35319,51505,0,0,deny,62,62,0,1,0,1,0
612,56876,11392,0,0,deny,66,66,0,1,0,1,0
613,50907,445,0,0,drop,70,70,0,1,0,1,0
614,47141,50584,0,0,deny,62,62,0,1,0,1,0
615,52340,22114,0,0,deny,62,62,0,1,0,1,0
616,6889,5529,0,0,deny,143,143,0,1,0,1,0
617,5151,50584,0,0,deny,62,62,0,1,0,1,0
618,40988,60043,0,0,deny,146,146,0,1,0,1,0
619,50902,445,0,0,drop,70,70,0,1,0,1,0
620,55593,445,0,0,drop,70,70,0,1,0,1,0
621,55592,445,0,0,drop,70,70,0,1,0,1,0
622,55582,445,0,0,drop,70,70,0,1,0,1,0
623,55580,445,0,0,drop,70,70,0,1,0,1,0
624,20012,8443,0,0,deny,60,60,0,1,0,1,0
625,50978,445,0,0,drop,66,66,0,1,0,1,0
626,50976,445,0,0,drop,66,66,0,1,0,1,0
627,50975,445,0,0,drop,66,66,0,1,0,1,0
628,59610,51505,0,0,deny,66,66,0,1,0,1,0
629,64406,25174,0,0,deny,62,62,0,1,0,1,0
630,50506,10214,0,0,deny,66,66,0,1,0,1,0
631,7110,25174,0,0,deny,66,66,0,1,0,1,0
632,55575,445,0,0,drop,70,70,0,1,0,1,0
633,443,49988,0,0,deny,82,82,0,1,0,1,0
634,62111,35440,0,0,deny,66,66,0,1,0,1,0
635,60799,25174,0,0,deny,66,66,0,1,0,1,0
636,6666,5000,0,0,deny,60,60,0,1,0,1,0
637,1116,44847,0,0,deny,66,66,0,1,0,1,0
638,61202,35894,0,0,deny,66,66,0,1,0,1,0
639,55569,445,0,0,drop,70,70,0,1,0,1,0
640,55568,445,0,0,drop,70,70,0,1,0,1,0
641,55567,445,0,0,drop,70,70,0,1,0,1,0
642,50889,445,0,0,drop,70,70,0,1,0,1,0
643,35744,64147,0,0,deny,66,66,0,1,0,1,0
644,26424,27189,0,0,deny,66,66,0,1,0,1,0
645,1038,37965,0,0,deny,62,62,0,1,0,1,0
646,50886,445,0,0,drop,70,70,0,1,0,1,0
647,50127,64147,0,0,deny,62,62,0,1,0,1,0
648,61183,25174,0,0,deny,62,62,0,1,0,1,0
649,59972,25174,0,0,deny,62,62,0,1,0,1,0
650,55558,445,0,0,drop,70,70,0,1,0,1,0
651,55555,445,0,0,drop,70,70,0,1,0,1,0
652,55551,445,0,0,drop,70,70,0,1,0,1,0
653,55043,57470,0,0,deny,78,78,0,1,0,1,0
654,60128,22114,0,0,deny,62,62,0,1,0,1,0
655,14263,22114,0,0,deny,66,66,0,1,0,1,0
656,7521,20234,0,0,deny,157,157,0,1,0,1,0
657,27153,50584,0,0,deny,146,146,0,1,0,1,0
658,50963,445,0,0,drop,66,66,0,1,0,1,0
659,50882,445,0,0,drop,70,70,0,1,0,1,0
660,50880,445,0,0,drop,70,70,0,1,0,1,0
661,10669,49756,0,0,deny,60,60,0,1,0,1,0
662,10669,49756,0,0,deny,60,60,0,1,0,1,0
663,10669,49756,0,0,deny,60,60,0,1,0,1,0
664,10669,49756,0,0,deny,60,60,0,1,0,1,0
665,10669,49756,0,0,deny,60,60,0,1,0,1,0
666,10594,25174,0,0,deny,146,146,0,1,0,1,0
667,50878,445,0,0,drop,70,70,0,1,0,1,0
668,49001,48817,0,0,deny,160,160,0,1,0,1,0
669,56432,35253,0,0,deny,66,66,0,1,0,1,0
670,55550,445,0,0,drop,70,70,0,1,0,1,0
671,63321,37807,0,0,deny,66,66,0,1,0,1,0
672,55512,23718,0,0,deny,66,66,0,1,0,1,0
673,55547,445,0,0,drop,70,70,0,1,0,1,0
674,19875,30170,0,0,deny,145,145,0,1,0,1,0
675,43671,17372,0,0,deny,62,62,0,1,0,1,0
676,45941,23386,0,0,deny,60,60,0,1,0,1,0
677,50871,445,0,0,drop,70,70,0,1,0,1,0
678,48071,25174,0,0,deny,62,62,0,1,0,1,0
679,50950,445,0,0,drop,66,66,0,1,0,1,0
680,50947,445,0,0,drop,66,66,0,1,0,1,0
681,54280,3385,0,0,deny,60,60,0,1,0,1,0
682,47266,25174,0,0,deny,146,146,0,1,0,1,0
683,50869,445,0,0,drop,70,70,0,1,0,1,0
684,28875,51505,0,0,deny,62,62,0,1,0,1,0
685,36229,62413,0,0,deny,62,62,0,1,0,1,0
686,52225,31985,35881,31985,allow,66,66,0,1,5,1,0
687,52234,64624,43132,64624,allow,136,136,0,3,14,3,0
688,57575,443,57575,443,allow,206737,25710,181027,212,180,75,137
689,57573,443,57573,443,allow,775362,32338,743024,683,180,169,514
690,55410,53,27764,53,allow,711,87,624,2,30,1,1
691,55059,53,53925,53,allow,711,87,624,2,30,1,1
692,2182,53,2182,53,allow,643,88,555,2,30,1,1
693,55613,53,34338,53,allow,170,87,83,2,30,1,1
694,64775,443,64775,443,allow,4559,1652,2907,19,27,11,8
695,52277,443,52277,443,allow,1880,941,939,17,21,7,10
696,51493,80,21444,80,allow,9524,736,8788,18,131,9,9
697,57570,443,57570,443,allow,175212,28668,146544,186,180,69,117
698,52224,37178,41727,37178,allow,136,136,0,3,14,3,0
699,56434,53,56434,53,allow,243,94,149,2,32,1,1
700,52259,25011,50909,25011,allow,70,70,0,2,8,2,0
701,55589,443,3953,443,allow,7894,1557,6337,20,150,9,11
702,53527,443,25088,443,allow,127391,26326,101065,179,172,76,103
703,55893,53,56779,53,allow,711,87,624,2,30,1,1
704,55836,53,8077,53,allow,170,87,83,2,31,1,1
705,64928,53,11072,53,allow,762,98,664,2,30,1,1
706,56752,53,39858,53,allow,701,88,613,2,30,1,1
707,49241,443,49241,443,allow,31778,6075,25703,54,49,28,26
708,60443,443,1656,443,allow,10961,4286,6675,53,320,21,32
709,52235,48910,47820,48910,allow,136,136,0,3,14,3,0
710,53993,6881,30701,6881,allow,70,70,0,2,8,2,0
711,52221,33166,38901,33166,allow,66,66,0,1,5,1,0
712,56597,443,50431,443,allow,10135129,248530,9886599,9808,64,3124,6684
713,64089,20260,49392,20260,allow,66,66,0,1,5,1,0
714,50895,443,61149,443,allow,130,70,60,3,5,2,1
715,64114,64126,30827,64126,allow,66,66,0,2,8,2,0
716,59937,443,15432,443,allow,7701,3981,3720,27,70,12,15
717,55592,443,17919,443,allow,8049,1560,6489,19,150,9,10
718,55591,443,37425,443,allow,7902,1565,6337,20,150,9,11
719,56811,443,16024,443,allow,8020,2000,6020,20,15,11,9
720,49336,80,14005,80,allow,3060,1219,1841,11,19,7,4
721,53527,5228,55667,5228,allow,9674,1776,7898,29,3764,11,18
722,51152,443,11725,443,allow,44048,4441,39607,97,317,43,54
723,64111,1830,17922,1830,allow,66,66,0,2,8,2,0
724,52230,47803,46448,47803,allow,136,136,0,3,14,3,0
725,56812,443,34534,443,allow,8073,2053,6020,20,15,11,9
726,55590,443,56220,443,allow,7906,1569,6337,20,150,9,11
727,52260,52142,32000,52142,allow,70,70,0,2,8,2,0
728,55100,53,57209,53,allow,711,87,624,2,30,1,1
729,56810,443,52495,443,allow,8072,2052,6020,20,16,11,9
730,59895,53,59895,53,allow,643,88,555,2,30,1,1
731,42625,443,18977,443,allow,218298,5904,212394,220,120,63,157
732,46422,80,48489,80,allow,1447,468,979,9,181,5,4
733,44847,18659,47289,18659,allow,150,150,0,1,1200,1,0
734,54153,443,43773,443,allow,5008,2097,2911,13,121,6,7
735,3376,35440,0,0,deny,66,66,0,1,0,1,0
736,50868,445,0,0,drop,70,70,0,1,0,1,0
737,55538,445,0,0,drop,70,70,0,1,0,1,0
738,55532,445,0,0,drop,70,70,0,1,0,1,0
739,55530,445,0,0,drop,70,70,0,1,0,1,0
740,55529,445,0,0,drop,70,70,0,1,0,1,0
741,50867,445,0,0,drop,70,70,0,1,0,1,0
742,53243,57470,0,0,deny,74,74,0,1,0,1,0
743,50866,445,0,0,drop,70,70,0,1,0,1,0
744,50862,445,0,0,drop,70,70,0,1,0,1,0
745,50861,445,0,0,drop,70,70,0,1,0,1,0
746,2815,62413,0,0,deny,66,66,0,1,0,1,0
747,41477,50584,0,0,deny,66,66,0,1,0,1,0
748,59393,25174,0,0,deny,66,66,0,1,0,1,0
749,50945,445,0,0,drop,66,66,0,1,0,1,0
750,53089,24211,0,0,deny,62,62,0,1,0,1,0
751,55206,22114,0,0,deny,66,66,0,1,0,1,0
752,13406,22114,0,0,deny,62,62,0,1,0,1,0
753,18745,64147,0,0,deny,62,62,0,1,0,1,0
754,53189,62413,0,0,deny,62,62,0,1,0,1,0
755,50934,445,0,0,drop,66,66,0,1,0,1,0
756,50936,445,0,0,drop,66,66,0,1,0,1,0
757,50938,445,0,0,drop,66,66,0,1,0,1,0
758,50932,445,0,0,drop,66,66,0,1,0,1,0
759,55590,53,20424,53,allow,177,94,83,2,30,1,1
760,50929,445,0,0,drop,66,66,0,1,0,1,0
761,50927,445,0,0,drop,66,66,0,1,0,1,0
762,50928,445,0,0,drop,66,66,0,1,0,1,0
763,50848,445,0,0,drop,70,70,0,1,0,1,0
764,50847,445,0,0,drop,70,70,0,1,0,1,0
765,443,49988,0,0,deny,82,82,0,1,0,1,0
766,443,41237,0,0,deny,89,89,0,1,0,1,0
767,50843,445,0,0,drop,70,70,0,1,0,1,0
768,55523,445,0,0,drop,70,70,0,1,0,1,0
769,50838,445,0,0,drop,70,70,0,1,0,1,0
770,50837,445,0,0,drop,70,70,0,1,0,1,0
771,45964,2777,0,0,deny,60,60,0,1,0,1,0
772,55520,445,0,0,drop,70,70,0,1,0,1,0
773,55518,445,0,0,drop,70,70,0,1,0,1,0
774,55516,445,0,0,drop,70,70,0,1,0,1,0
775,53275,21247,0,0,deny,62,62,0,1,0,1,0
776,53750,25174,0,0,deny,62,62,0,1,0,1,0
777,65288,44847,0,0,deny,66,66,0,1,0,1,0
778,60003,36829,0,0,deny,66,66,0,1,0,1,0
779,53667,22114,0,0,deny,62,62,0,1,0,1,0
780,65270,3855,0,0,deny,78,78,0,1,0,1,0
781,51827,56205,0,0,deny,66,66,0,1,0,1,0
782,58835,17372,0,0,deny,66,66,0,1,0,1,0
783,42674,22114,0,0,deny,62,62,0,1,0,1,0
784,49587,35776,0,0,deny,157,157,0,1,0,1,0
785,50826,445,0,0,drop,70,70,0,1,0,1,0
786,12655,30627,0,0,deny,62,62,0,1,0,1,0
787,55514,445,0,0,drop,70,70,0,1,0,1,0
788,55515,445,0,0,drop,70,70,0,1,0,1,0
789,55509,445,0,0,drop,70,70,0,1,0,1,0
790,52102,443,62995,443,allow,343074,14649,328425,390,41,159,231
791,52262,14418,18744,14418,allow,70,70,0,2,8,2,0
792,52231,1026,54310,1026,allow,136,136,0,3,14,3,0
793,42873,443,33511,443,allow,3379,2111,1268,19,15,10,9
794,57441,53,7425,53,allow,177,94,83,2,30,1,1
795,54571,443,54134,443,allow,10546,2453,8093,28,15,16,12
796,51502,80,42285,80,allow,1515,481,1034,11,15,6,5
797,64581,53,7849,53,allow,514,88,426,4,42,2,2
798,34220,443,12969,443,allow,7946,2731,5215,27,18,15,12
799,50008,53,2633,53,allow,232,94,138,2,29,1,1
800,57470,21158,39017,21158,allow,2182,798,1384,19,1199,10,9
801,52211,80,22459,80,allow,8559,5109,3450,23,160,12,11
802,47159,443,53350,443,allow,777,432,345,10,15,5,5
803,49291,443,62267,443,allow,18607,4906,13701,47,255,20,27
804,49255,80,49255,80,allow,8453,961,7492,18,20,9,9
805,49300,443,26110,443,allow,8282,3240,5042,40,255,20,20
806,46452,53,46452,53,allow,247,98,149,2,32,1,1
807,21018,53,21018,53,allow,235,90,145,2,31,1,1
808,49913,53,61333,53,allow,177,94,83,2,29,1,1
809,55563,53,47396,53,allow,177,94,83,2,29,1,1
810,55135,53,55135,53,allow,220,90,130,2,29,1,1
811,50705,80,25198,80,allow,499,192,307,6,26,4,2
812,50697,80,65344,80,allow,318,192,126,6,27,4,2
813,35671,443,43722,443,allow,6824,1142,5682,24,134,13,11
814,52228,49974,17167,49974,allow,230,136,94,4,14,3,1
815,50746,443,34629,443,allow,8422,1676,6746,25,16,13,12
816,49486,7000,49486,7000,allow,3370,1595,1775,16,15,9,7
817,59877,443,61626,443,allow,9024,1533,7491,25,110,11,14
818,60526,443,60526,443,allow,1462,863,599,15,37,9,6
819,47009,53,0,0,allow,86,86,0,1,30,1,0
820,55067,443,5248,443,allow,17968,12031,5937,38,63,21,17
821,65077,53,33139,53,allow,734,86,648,2,30,1,1
822,52258,58792,14441,58792,allow,316,136,180,6,8,3,3
823,41431,443,64563,443,allow,190,70,120,4,15,2,2
824,49508,443,20014,443,allow,13719,5017,8702,40,283,20,20
825,52256,41337,31273,41337,allow,316,136,180,6,8,3,3
826,37419,443,55901,443,allow,558,210,348,9,28,4,5
827,51817,443,24496,443,allow,2811130,115323,2695807,3382,206,1445,1937
828,52232,35126,13178,35126,allow,70,70,0,1,5,1,0
829,60372,53,60372,53,allow,222,90,132,2,30,1,1
830,52220,65128,1362,65128,allow,70,70,0,1,5,1,0
831,52223,11979,45106,11979,allow,70,70,0,1,5,1,0
832,40189,443,26952,443,allow,7221,2940,4281,30,23,16,14
833,55836,53,20362,53,allow,177,94,83,2,30,1,1
834,52802,443,30052,443,allow,4202,1924,2278,27,80,13,14
835,55613,53,57785,53,allow,177,94,83,2,30,1,1
836,35216,123,45101,123,allow,184,94,90,2,30,1,1
837,51221,49857,1668,49857,allow,791,266,525,8,1200,4,4
838,65139,53,12315,53,allow,210,102,108,2,30,1,1
839,52101,80,34628,80,allow,55117,3792,51325,69,36,29,40
840,49474,7000,49474,7000,allow,2990,1599,1391,15,15,8,7
841,37466,443,58228,443,allow,13829,1724,12105,28,516,13,15
842,50700,80,14024,80,allow,648,256,392,8,27,5,3
843,50704,80,8069,80,allow,499,192,307,6,26,4,2
844,43744,53,43744,53,allow,235,90,145,2,32,1,1
845,50226,80,13987,80,allow,1746,780,966,19,102,7,12
846,50665,443,2947,443,allow,2626,1638,988,19,83,11,8
847,56441,80,54346,80,allow,17008,1379,15629,22,25,7,15
848,57441,53,33174,53,allow,177,94,83,2,30,1,1
849,1935,53,17873,53,allow,260,86,174,2,30,1,1
850,56022,53,29566,53,allow,728,102,626,2,30,1,1
851,50265,17555,24395,17555,allow,1488,930,558,21,1200,12,9
852,53973,50546,28275,50546,allow,2069,1081,988,12,16,7,5
853,57913,80,64220,80,allow,6515,1210,5305,15,23,8,7
854,49240,443,49240,443,allow,8448,3368,5080,25,48,15,10
855,53705,443,25596,443,allow,1579,988,591,13,44,7,6
856,64110,51617,13818,51617,allow,66,66,0,2,7,2,0
857,52233,42673,65112,42673,allow,136,136,0,3,14,3,0
858,56275,53,54180,53,allow,177,94,83,2,30,1,1
859,52222,11516,7975,11516,allow,70,70,0,1,5,1,0
860,60474,443,49891,443,allow,5888,1175,4713,19,76,11,8
861,35922,443,6231,443,allow,6997,1773,5224,27,17,15,12
862,50433,443,11749,443,allow,134,60,74,3,10,2,1
863,33042,443,32323,443,allow,130,70,60,2,14,1,1
864,59833,443,63196,443,allow,15252,5376,9876,35,154,16,19
865,52257,6712,42589,6712,allow,70,70,0,2,8,2,0
866,38716,443,32682,443,allow,90273,3481,86792,96,15,31,65
867,52226,48784,61623,48784,allow,70,70,0,1,5,1,0
868,52645,6881,55258,6881,allow,841,535,306,10,14,5,5
869,64081,59517,43134,59517,allow,504,382,122,8,16,6,2
870,55806,53,43969,53,allow,200,102,98,2,32,1,1
871,50057,53,42578,53,allow,177,94,83,2,29,1,1
872,52149,80,41444,80,allow,1638,1324,314,10,15,5,5
873,56730,53,39267,53,allow,177,94,83,2,29,1,1
874,52015,80,59849,80,allow,14830,11044,3786,27,37,15,12
875,53024,123,1742,123,allow,184,94,90,2,30,1,1
876,50366,80,48017,80,allow,23852,1662,22190,36,15,19,17
877,56730,53,28037,53,allow,177,94,83,2,30,1,1
878,55306,53,18601,53,allow,177,94,83,2,29,1,1
879,55354,53,28658,53,allow,168,94,74,2,30,1,1
880,54351,53,59901,53,allow,168,78,90,2,29,1,1
881,55613,53,25861,53,allow,177,94,83,2,30,1,1
882,55613,53,1186,53,allow,177,94,83,2,30,1,1
883,1937,53,32884,53,allow,210,78,132,2,30,1,1
884,51406,443,19359,443,allow,5360,3775,1585,22,35,13,9
885,55354,53,24160,53,allow,168,94,74,2,30,1,1
886,43625,53,13195,53,allow,86,86,0,1,30,1,0
887,56730,53,28651,53,allow,177,94,83,2,30,1,1
888,56962,53,33318,53,allow,210,102,108,2,30,1,1
889,50171,53,22623,53,allow,211,78,133,2,30,1,1
890,57470,8999,23972,8999,allow,1577,594,983,20,1616,10,10
891,65062,53,47695,53,allow,229,110,119,2,30,1,1
892,33065,443,50330,443,allow,6746,2826,3920,19,399,11,8
893,56528,443,54144,443,allow,8313,3597,4716,16,119,8,8
894,54391,80,1850,80,allow,1378,808,570,13,361,7,6
895,50698,80,39680,80,allow,318,192,126,6,27,4,2
896,60809,40010,63910,40010,allow,316,136,180,6,6,3,3
897,52255,16087,20036,16087,allow,70,70,0,2,8,2,0
898,55723,80,48588,80,allow,70,70,0,1,5,1,0
899,52229,54711,46262,54711,allow,136,136,0,3,14,3,0
900,45839,80,2983,80,allow,1638,1324,314,10,15,5,5
901,52048,80,14488,80,allow,41486,20844,20642,64,37,32,32
902,50961,5222,36046,5222,allow,8318,2850,5468,54,255,27,27
903,37426,443,35217,443,allow,7477,3305,4172,21,400,12,9
904,53176,58851,59130,58851,allow,70,70,0,2,8,2,0
905,59949,80,40471,80,allow,730296,15564,714732,723,57,218,505
906,41314,80,2894,80,allow,1723,438,1285,10,136,6,4
907,43225,443,17321,443,allow,3831584,85342,3746242,3246,110,597,2649
908,55836,53,51304,53,allow,177,94,83,2,30,1,1
909,39097,443,24428,443,allow,6747,2827,3920,19,399,11,8
910,46295,443,39789,443,allow,178,118,60,2,15,1,1
911,54343,443,5667,443,allow,7990,2701,5289,30,61,17,13
912,50707,80,44331,80,allow,16427,3830,12597,28,25,12,16
913,52261,48208,15422,48208,allow,70,70,0,2,8,2,0
914,49335,80,26214,80,allow,1193,703,490,8,18,5,3
915,43227,443,35933,443,allow,1139403,49178,1090225,1155,108,353,802
916,123,123,15177,123,allow,184,94,90,2,30,1,1
917,1938,53,25817,53,allow,210,78,132,2,30,1,1
918,37427,443,48428,443,allow,10281,4850,5431,23,400,13,10
919,50584,51413,16088,51413,allow,475,150,325,2,1200,1,1
920,51221,40624,20030,40624,allow,594,594,0,10,1200,10,0
921,57470,8999,31471,8999,allow,1577,594,983,20,1614,10,10
922,55387,443,54944,443,allow,3997,1374,2623,14,136,7,7
923,19473,45556,7986,45556,allow,469,150,319,2,1200,1,1
924,30188,12494,61043,12494,allow,502,150,352,2,1200,1,1
925,57470,24276,41676,24276,allow,132,132,0,3,1200,3,0
926,21133,51413,43233,51413,allow,460,150,310,2,1200,1,1
927,55650,53,22960,53,allow,179,94,85,2,31,1,1
928,53126,53,53126,53,allow,247,98,149,2,32,1,1
929,58990,53,6423,53,allow,168,78,90,2,30,1,1
930,21846,53,21846,53,allow,247,98,149,2,33,1,1
931,5111,53,5111,53,allow,235,90,145,2,33,1,1
932,53980,36153,43274,36153,allow,164,70,94,2,5,1,1
933,40785,443,32724,443,allow,646,292,354,10,41,5,5
934,46271,7700,56460,7700,allow,1440,956,484,15,36,8,7
935,50253,53,23205,53,allow,167,86,81,2,31,1,1
936,57449,80,1245,80,allow,4508,2978,1530,13,15,6,7
937,52194,443,33437,443,allow,9075,3727,5348,38,50,18,20
938,56841,53,62125,53,allow,177,94,83,2,30,1,1
939,55494,53,4891,53,allow,255,102,153,2,30,1,1
940,50920,445,0,0,drop,66,66,0,1,0,1,0
941,55507,445,0,0,drop,70,70,0,1,0,1,0
942,53305,50584,0,0,deny,62,62,0,1,0,1,0
943,50919,445,0,0,drop,66,66,0,1,0,1,0
944,63495,50584,0,0,deny,66,66,0,1,0,1,0
945,50915,445,0,0,drop,66,66,0,1,0,1,0
946,50917,445,0,0,drop,66,66,0,1,0,1,0
947,50913,445,0,0,drop,66,66,0,1,0,1,0
948,51114,25174,0,0,deny,66,66,0,1,0,1,0
949,59549,50584,0,0,deny,66,66,0,1,0,1,0
950,50822,445,0,0,drop,70,70,0,1,0,1,0
951,59107,25174,0,0,deny,66,66,0,1,0,1,0
952,443,49988,0,0,deny,82,82,0,1,0,1,0
953,45941,23388,0,0,deny,60,60,0,1,0,1,0
954,55504,445,0,0,drop,70,70,0,1,0,1,0
955,55310,50584,0,0,deny,66,66,0,1,0,1,0
956,50813,445,0,0,drop,70,70,0,1,0,1,0
957,50811,445,0,0,drop,70,70,0,1,0,1,0
958,50810,445,0,0,drop,70,70,0,1,0,1,0
959,36992,25174,0,0,deny,62,62,0,1,0,1,0
960,55498,445,0,0,drop,70,70,0,1,0,1,0
961,55491,445,0,0,drop,70,70,0,1,0,1,0
962,993,34205,0,0,deny,66,66,0,1,0,1,0
963,50807,445,0,0,drop,70,70,0,1,0,1,0
964,50806,445,0,0,drop,70,70,0,1,0,1,0
965,50903,445,0,0,drop,66,66,0,1,0,1,0
966,20112,64147,0,0,deny,62,62,0,1,0,1,0
967,27507,25174,0,0,deny,62,62,0,1,0,1,0
968,54539,26467,0,0,deny,62,62,0,1,0,1,0
969,61583,64147,0,0,deny,66,66,0,1,0,1,0
970,26420,25174,0,0,deny,66,66,0,1,0,1,0
971,443,49988,0,0,deny,82,82,0,1,0,1,0
972,57325,60043,0,0,deny,62,62,0,1,0,1,0
973,50800,445,0,0,drop,70,70,0,1,0,1,0
974,50895,445,0,0,drop,66,66,0,1,0,1,0
975,59497,64097,0,0,deny,66,66,0,1,0,1,0
976,56576,9000,0,0,deny,60,60,0,1,0,1,0
977,61932,25174,0,0,deny,66,66,0,1,0,1,0
978,22029,50584,0,0,deny,66,66,0,1,0,1,0
979,55481,445,0,0,drop,70,70,0,1,0,1,0
980,58460,36237,0,0,deny,66,66,0,1,0,1,0
981,65003,57470,0,0,deny,78,78,0,1,0,1,0
982,51348,25174,0,0,deny,66,66,0,1,0,1,0
983,63409,50265,0,0,deny,66,66,0,1,0,1,0
984,50893,445,0,0,drop,66,66,0,1,0,1,0
985,443,35385,0,0,deny,161,161,0,1,0,1,0
986,50792,445,0,0,drop,70,70,0,1,0,1,0
987,3914,37965,0,0,deny,62,62,0,1,0,1,0
988,3911,37965,0,0,deny,66,66,0,1,0,1,0
989,50789,445,0,0,drop,70,70,0,1,0,1,0
990,32722,25174,0,0,deny,62,62,0,1,0,1,0
991,50885,445,0,0,drop,66,66,0,1,0,1,0
992,53353,26467,0,0,deny,62,62,0,1,0,1,0
993,35616,21247,0,0,deny,146,146,0,1,0,1,0
994,50882,445,0,0,drop,66,66,0,1,0,1,0
995,3093,62413,0,0,deny,62,62,0,1,0,1,0
996,31410,25174,0,0,deny,62,62,0,1,0,1,0
997,50785,445,0,0,drop,70,70,0,1,0,1,0
998,50784,445,0,0,drop,70,70,0,1,0,1,0
999,53194,35440,0,0,deny,66,66,0,1,0,1,0
1000,10652,57470,0,0,deny,66,66,0,1,0,1,0
1001,62838,44847,0,0,deny,66,66,0,1,0,1,0
1002,14578,50584,0,0,deny,66,66,0,1,0,1,0
1003,6546,37965,0,0,deny,62,62,0,1,0,1,0
1004,3667,56205,0,0,deny,146,146,0,1,0,1,0
1005,50780,445,0,0,drop,70,70,0,1,0,1,0
1006,40418,25174,0,0,deny,62,62,0,1,0,1,0
1007,64333,57470,0,0,deny,78,78,0,1,0,1,0
1008,443,49988,0,0,deny,82,82,0,1,0,1,0
1009,55468,445,0,0,drop,70,70,0,1,0,1,0
1010,55469,445,0,0,drop,70,70,0,1,0,1,0
1011,55467,445,0,0,drop,70,70,0,1,0,1,0
1012,50867,445,0,0,drop,66,66,0,1,0,1,0
1013,50863,445,0,0,drop,66,66,0,1,0,1,0
1014,50869,445,0,0,drop,66,66,0,1,0,1,0
1015,50865,445,0,0,drop,66,66,0,1,0,1,0
1016,50870,445,0,0,drop,66,66,0,1,0,1,0
1017,50868,445,0,0,drop,66,66,0,1,0,1,0
1018,50866,445,0,0,drop,66,66,0,1,0,1,0
1019,50864,445,0,0,drop,66,66,0,1,0,1,0
1020,50779,445,0,0,drop,70,70,0,1,0,1,0
1021,58229,50584,0,0,deny,66,66,0,1,0,1,0
1022,60058,11392,0,0,deny,66,66,0,1,0,1,0
1023,8889,63001,0,0,deny,60,60,0,1,0,1,0
1024,11317,61248,0,0,reset-both,143,143,0,1,0,1,0
1025,52044,44847,0,0,deny,146,146,0,1,0,1,0
1026,56075,23,0,0,deny,60,60,0,1,0,1,0
1027,25565,47158,0,0,deny,60,60,0,1,0,1,0
1028,50774,445,0,0,drop,70,70,0,1,0,1,0
1029,55463,445,0,0,drop,70,70,0,1,0,1,0
1030,55567,53,51894,53,allow,184,80,104,2,0,1,1
1031,55458,445,0,0,drop,70,70,0,1,0,1,0
1032,55460,445,0,0,drop,70,70,0,1,0,1,0
1033,55452,445,0,0,drop,70,70,0,1,0,1,0
1034,56098,64147,0,0,deny,66,66,0,1,0,1,0
1035,53120,25174,0,0,deny,146,146,0,1,0,1,0
1036,57607,21247,0,0,deny,66,66,0,1,0,1,0
1037,13168,35440,0,0,deny,62,62,0,1,0,1,0
1038,50850,445,0,0,drop,66,66,0,1,0,1,0
1039,50848,445,0,0,drop,66,66,0,1,0,1,0
1040,50847,445,0,0,drop,66,66,0,1,0,1,0
1041,58463,11392,0,0,deny,66,66,0,1,0,1,0
1042,22981,15503,0,0,deny,62,62,0,1,0,1,0
1043,0,0,0,0,deny,98,98,0,1,0,1,0
1044,0,0,0,0,deny,98,98,0,1,0,1,0
1045,0,0,0,0,deny,98,98,0,1,0,1,0
1046,0,0,0,0,allow,244,244,0,2,0,2,0
1047,0,0,0,0,deny,98,98,0,1,0,1,0
1048,0,0,0,0,deny,82,82,0,1,0,1,0
1049,0,0,0,0,deny,98,98,0,1,0,1,0
1050,0,0,0,0,deny,98,98,0,1,0,1,0
1051,62971,44847,0,0,deny,62,62,0,1,0,1,0
1052,443,9863,0,0,deny,60,60,0,1,0,1,0
1053,55448,445,0,0,drop,70,70,0,1,0,1,0
1054,48706,23393,0,0,deny,60,60,0,1,0,1,0
1055,32983,51221,0,0,deny,66,66,0,1,0,1,0
1056,443,48056,0,0,deny,135,135,0,1,0,1,0
1057,55043,57470,0,0,deny,78,78,0,1,0,1,0
1058,55443,445,0,0,drop,70,70,0,1,0,1,0
1059,55441,445,0,0,drop,70,70,0,1,0,1,0
1060,55440,445,0,0,drop,70,70,0,1,0,1,0
1061,50761,445,0,0,drop,70,70,0,1,0,1,0
1062,5223,32965,0,0,deny,220,220,0,1,0,1,0
1063,23031,22114,0,0,deny,146,146,0,1,0,1,0
1064,53544,21247,0,0,deny,66,66,0,1,0,1,0
1065,58758,22114,0,0,deny,66,66,0,1,0,1,0
1066,26821,57866,0,0,deny,62,62,0,1,0,1,0
1067,38565,51505,0,0,deny,62,62,0,1,0,1,0
1068,50758,445,0,0,drop,70,70,0,1,0,1,0
1069,45064,25174,0,0,deny,62,62,0,1,0,1,0
1070,57793,37807,0,0,deny,66,66,0,1,0,1,0
1071,1730,37965,0,0,deny,145,145,0,1,0,1,0
1072,54131,57866,0,0,deny,66,66,0,1,0,1,0
1073,57779,22114,0,0,deny,146,146,0,1,0,1,0
1074,55430,445,0,0,drop,70,70,0,1,0,1,0
1075,55427,445,0,0,drop,70,70,0,1,0,1,0
1076,55423,445,0,0,drop,70,70,0,1,0,1,0
1077,50754,445,0,0,drop,70,70,0,1,0,1,0
1078,43571,26467,0,0,deny,62,62,0,1,0,1,0
1079,58861,26467,0,0,deny,66,66,0,1,0,1,0
1080,50752,445,0,0,drop,70,70,0,1,0,1,0
1081,993,58185,0,0,deny,129,129,0,1,0,1,0
1082,50837,445,0,0,drop,66,66,0,1,0,1,0
1083,50750,445,0,0,drop,70,70,0,1,0,1,0
1084,10467,25174,0,0,deny,146,146,0,1,0,1,0
1085,7105,25174,0,0,deny,66,66,0,1,0,1,0
1086,10430,22114,0,0,deny,146,146,0,1,0,1,0
1087,18986,44847,0,0,deny,66,66,0,1,0,1,0
1088,63765,51221,0,0,deny,62,62,0,1,0,1,0
1089,39393,22114,0,0,deny,62,62,0,1,0,1,0
1090,443,45788,0,0,deny,332,332,0,1,0,1,0
1091,61637,25174,0,0,deny,66,66,0,1,0,1,0
1092,55422,445,0,0,drop,70,70,0,1,0,1,0
1093,64431,53,52524,53,allow,170,87,83,2,31,1,1
1094,40932,8434,40932,8434,allow,156,156,0,3,8,3,0
1095,49564,443,50036,443,allow,180388,3938,176450,145,161,20,125
1096,64715,53,13561,53,allow,770,102,668,2,30,1,1
1097,53276,80,53276,80,allow,42664,1998,40666,53,27,20,33
1098,36712,53,0,0,allow,138,69,69,2,30,1,1
1099,57171,3389,57171,3389,allow,3428,1714,1714,16,33,8,8
1100,26249,7000,26249,7000,allow,2269,815,1454,14,16,7,7
1101,49484,7000,49484,7000,allow,2958,1567,1391,15,15,8,7
1102,51432,80,51432,80,allow,42247,4067,38180,58,25,23,35
1103,64113,22211,60375,22211,allow,312,132,180,6,7,3,3
1104,52274,443,52274,443,allow,6679,2408,4271,23,20,10,13
1105,61443,443,44561,443,allow,7832,1143,6689,19,26,9,10
1106,56807,443,49269,443,allow,8020,2000,6020,20,16,11,9
1107,45315,80,28283,80,allow,6087687,127446,5960241,5920,28,1981,3939
1108,62333,443,8530,443,allow,4019,2219,1800,33,186,17,16
1109,38400,53,0,0,allow,82,82,0,1,30,1,0
1110,56659,53,59706,53,allow,711,87,624,2,30,1,1
1111,63738,443,63738,443,allow,4349,1442,2907,19,27,11,8
1112,57424,53,35431,53,allow,711,87,624,2,30,1,1
1113,56809,443,9000,443,allow,7929,1909,6020,20,15,11,9
1114,56808,443,31717,443,allow,7981,1961,6020,20,15,11,9
1115,49483,7000,49483,7000,allow,755531,16955,738576,785,16,265,520
1116,8416,8416,61571,8416,allow,66,66,0,1,30,1,0
1117,56838,53,49360,53,allow,170,87,83,2,30,1,1
1118,57436,53,43639,53,allow,733,85,648,2,30,1,1
1119,52246,52840,54967,52840,allow,258,70,188,4,9,2,2
1120,56343,53,26546,53,allow,170,87,83,2,30,1,1
1121,8415,8415,47085,8415,allow,66,66,0,1,30,1,0
1122,52025,80,59666,80,allow,87927,9680,78247,101,37,40,61
1123,52280,443,52280,443,allow,1615,941,674,15,20,7,8
1124,17052,53,17052,53,allow,235,90,145,2,32,1,1
1125,56275,53,11893,53,allow,170,87,83,2,30,1,1
1126,41774,53,0,0,allow,82,82,0,1,30,1,0
1127,8414,8414,6179,8414,allow,66,66,0,1,30,1,0
1128,50190,53,51481,53,allow,754,94,660,2,30,1,1
1129,55650,53,47564,53,allow,174,89,85,2,30,1,1
1130,55797,53,58319,53,allow,170,87,83,2,31,1,1
1131,50972,3544,45034,3544,allow,258,107,151,2,31,1,1
1132,51443,53,51443,53,allow,217,87,130,2,31,1,1
1133,55325,53,64305,53,allow,711,87,624,2,31,1,1
1134,56663,53,34654,53,allow,178,91,87,2,31,1,1
1135,56882,53,4292,53,allow,87,87,0,2,61,2,0
1136,6881,64422,29110,64422,allow,219,111,108,2,1201,1,1
1137,65284,53,18214,53,allow,758,96,662,2,31,1,1
1138,26458,44847,0,0,deny,146,146,0,1,0,1,0
1139,55420,445,0,0,drop,70,70,0,1,0,1,0
1140,23383,64147,0,0,deny,62,62,0,1,0,1,0
1141,50415,64147,0,0,deny,66,66,0,1,0,1,0
1142,50743,445,0,0,drop,70,70,0,1,0,1,0
1143,26906,22114,0,0,deny,62,62,0,1,0,1,0
1144,65507,53,7082,53,allow,229,102,127,2,30,1,1
1145,50822,443,34134,443,allow,89322,8569,80753,102,316,31,71
1146,53197,80,29002,80,allow,748,459,289,8,254,5,3
1147,53195,443,44058,443,allow,2016,1160,856,17,46,9,8
1148,50183,443,52770,443,allow,6348,1071,5277,18,42,10,8
1149,56841,53,54383,53,allow,177,94,83,2,29,1,1
1150,50253,53,52044,53,allow,167,86,81,2,29,1,1
1151,56838,53,18546,53,allow,177,94,83,2,29,1,1
1152,64431,53,6973,53,allow,177,94,83,2,30,1,1
1153,39636,80,39636,80,allow,4774,553,4221,13,20,6,7
1154,62069,443,28586,443,allow,38455,5252,33203,71,60,41,30
1155,51263,443,47905,443,allow,143597,6963,136634,206,439,103,103
1156,55650,53,39411,53,allow,179,94,85,2,29,1,1
1157,38280,80,34023,80,allow,748,459,289,8,254,5,3
1158,50170,53,38281,53,allow,260,86,174,2,29,1,1
1159,56755,443,63082,443,allow,1327,918,409,10,26,6,4
1160,42441,123,34753,123,allow,184,94,90,2,30,1,1
1161,50744,443,51827,443,allow,6811,1923,4888,21,15,11,10
1162,56838,53,39774,53,allow,177,94,83,2,30,1,1
1163,55590,53,49633,53,allow,177,94,83,2,29,1,1
1164,50078,53,55714,53,allow,177,94,83,2,29,1,1
1165,60017,443,62960,443,allow,5291,2624,2667,28,145,15,13
1166,48783,53,0,0,allow,86,86,0,1,30,1,0
1167,56285,443,32543,443,allow,185763,7360,178403,201,120,68,133
1168,37786,443,52361,443,allow,5544,2626,2918,28,145,15,13
1169,40074,443,9837,443,allow,412322,17503,394819,466,140,167,299
1170,64431,53,36891,53,allow,177,94,83,2,30,1,1
1171,51982,80,16574,80,allow,2776,2091,685,9,47,5,4
1172,57038,53,18909,53,allow,194,102,92,2,33,1,1
1173,45315,443,19700,443,allow,56118,3429,52689,77,26,35,42
1174,50187,443,52959,443,allow,6363,1073,5290,18,38,10,8
1175,50186,443,57350,443,allow,6363,1073,5290,18,38,10,8
1176,61361,443,58250,443,allow,7653,1226,6427,24,18,14,10
1177,52053,80,43263,80,allow,27839,14036,13803,46,36,24,22
1178,56092,53,34391,53,allow,177,94,83,2,30,1,1
1179,55594,53,43491,53,allow,167,86,81,2,30,1,1
1180,56343,53,46504,53,allow,177,94,83,2,30,1,1
1181,51684,80,23150,80,allow,1515,481,1034,11,15,6,5
1182,55059,443,19056,443,allow,32852,17447,15405,61,64,32,29
1183,50188,443,57063,443,allow,6357,1079,5278,18,32,10,8
1184,50185,443,5992,443,allow,6350,1071,5279,18,42,10,8
1185,50184,443,37537,443,allow,6349,1071,5278,18,42,10,8
1186,35519,80,60080,80,allow,841,715,126,5,15,3,2
1187,46587,443,46587,443,allow,30701,1538,29163,40,16,14,26
1188,58589,80,4699,80,allow,1360,900,460,10,515,6,4
1189,36535,443,34984,443,allow,3319,2176,1143,21,15,11,10
1190,61362,443,23026,443,allow,7653,1226,6427,24,18,14,10
1191,42117,443,44867,443,allow,9999,4008,5991,33,345,18,15
1192,61364,443,17656,443,allow,7653,1226,6427,24,18,14,10
1193,53168,23074,22420,23074,allow,958,454,504,14,21,8,6
1194,56092,53,54654,53,allow,177,94,83,2,30,1,1
1195,55915,53,47313,53,allow,86,86,0,1,30,1,0
1196,55226,443,25011,443,allow,711879,19394,692485,724,98,238,486
1197,65330,53,32414,53,allow,733,94,639,2,30,1,1
1198,56343,53,54537,53,allow,177,94,83,2,30,1,1
1199,55867,53,45353,53,allow,178,94,84,2,30,1,1
1200,55963,53,19959,53,allow,316,94,222,2,30,1,1
1201,57038,53,31637,53,allow,194,102,92,2,30,1,1
1202,65520,53,2299,53,allow,379,94,285,2,30,1,1
1203,64439,53,36419,53,allow,359,134,225,2,30,1,1
1204,50698,5900,50698,5900,allow,130,66,64,2,5,1,1
1205,8204,53,48850,53,allow,86,86,0,1,30,1,0
1206,60376,443,40016,443,allow,6608,1843,4765,44,120,23,21
1207,52101,443,56883,443,allow,5706850,104758,5602092,5170,41,1379,3791
1208,60407,443,48240,443,allow,308771,8699,300072,322,30,112,210
1209,56757,443,47194,443,allow,6205,986,5219,16,25,10,6
1210,44250,443,49251,443,allow,3374,2106,1268,19,15,10,9
1211,33119,80,62481,80,allow,1638,1324,314,10,14,5,5
1212,32895,443,18670,443,allow,76969,3534,73435,97,34,40,57
1213,53169,44707,23330,44707,allow,1078,518,560,16,21,9,7
1214,53975,40978,50066,40978,allow,1946,1019,927,10,15,6,4
1215,51120,587,51120,587,allow,320,128,192,6,6,3,3
1216,43129,443,48108,443,allow,4579,580,3999,13,22,5,8
1217,64996,53,37849,53,allow,547,91,456,4,35,2,2
1218,52609,18081,52609,18081,allow,66,66,0,1,5,1,0
1219,49250,80,27382,80,allow,1623,629,994,8,75,5,3
1220,51324,465,51324,465,allow,320,128,192,6,5,3,3
1221,50406,443,46416,443,allow,6470,897,5573,24,55,9,15
1222,49485,7080,49485,7080,allow,2960,432,2528,11,15,6,5
1223,50182,443,53780,443,allow,6349,1071,5278,18,42,10,8
1224,52195,443,42007,443,allow,3470,1776,1694,20,48,10,10
1225,55729,63805,38910,63805,allow,70,70,0,2,8,2,0
1226,50181,443,22681,443,allow,6350,1071,5279,18,42,10,8
1227,56407,53,58288,53,allow,216,102,114,2,29,1,1
1228,33539,443,27903,443,allow,3244,2042,1202,17,16,9,8
1229,56275,53,62167,53,allow,177,94,83,2,29,1,1
1230,58174,443,55907,443,allow,11141,2777,8364,33,58,14,19
1231,50078,53,19314,53,allow,185,102,83,2,29,1,1
1232,55329,443,60850,443,allow,18284,2468,15816,42,26,22,20
1233,49778,53,15143,53,allow,255,102,153,2,29,1,1
1234,64067,53,52701,53,allow,329,94,235,2,29,1,1
1235,59343,80,59343,80,allow,32527,13068,19459,56,15,21,35
1236,49674,53,9150,53,allow,211,102,109,2,29,1,1
1237,56343,53,52506,53,allow,177,94,83,2,29,1,1
1238,61363,443,19587,443,allow,7653,1226,6427,24,18,14,10
1239,61360,443,42103,443,allow,7653,1226,6427,24,18,14,10
1240,26900,27017,38585,27017,allow,6466,3520,2946,38,46,21,17
1241,49458,53,15275,53,allow,280,94,186,2,30,1,1
1242,55745,443,5170,443,allow,11503,3691,7812,30,240,14,16
1243,49364,53,17404,53,allow,307,307,0,4,60,4,0
1244,59847,443,26253,443,allow,11950,1590,10360,33,90,16,17
1245,55836,53,33356,53,allow,177,94,83,2,30,1,1
1246,60590,443,17721,443,allow,41114,1554,39560,49,120,18,31
1247,52100,80,3260,80,allow,30068,3203,26865,43,35,19,24
1248,55732,45682,36442,45682,allow,70,70,0,2,8,2,0
1249,49201,80,60094,80,allow,2986,825,2161,10,135,6,4
1250,56492,53,4383,53,allow,212,102,110,2,30,1,1
1251,34750,80,47643,80,allow,111678,5254,106424,150,240,71,79
1252,50180,443,51713,443,allow,6349,1071,5278,18,42,10,8
1253,55542,443,51637,443,allow,58975,3359,55616,78,26,34,44
1254,56905,80,13949,80,allow,78,78,0,2,8,2,0
1255,55731,36432,38455,36432,allow,70,70,0,2,8,2,0
1256,37335,443,14228,443,allow,130,70,60,3,5,2,1
1257,54104,443,3216,443,allow,190,70,120,4,15,2,2
1258,56838,53,31421,53,allow,327,87,240,4,50,2,2
1259,64709,53,11434,53,allow,821,102,719,2,30,1,1
1260,55154,443,34870,443,allow,2251,1098,1153,25,120,12,13
1261,50179,443,33699,443,allow,5419,1080,4339,17,42,10,7
1262,62232,80,47630,80,allow,1511,517,994,8,15,5,3
1263,62918,993,34205,993,allow,8324,3635,4689,76,53,35,41
1264,9521,443,4635,443,allow,7231,1442,5789,21,30,10,11
1265,52107,80,35011,80,allow,9902,8772,1130,18,35,10,8
1266,55594,53,22728,53,allow,167,86,81,2,30,1,1
1267,55066,443,25317,443,allow,12715,3716,8999,28,62,16,12
1268,56515,53,36823,53,allow,177,94,83,2,30,1,1
1269,49988,443,49988,443,allow,2123,1050,1073,23,120,11,12
1270,55420,53,38783,53,allow,177,94,83,2,30,1,1
1271,55053,53,47870,53,allow,216,102,114,2,30,1,1
1272,55867,53,60176,53,allow,178,94,84,2,31,1,1
1273,50641,443,27533,443,allow,1473,890,583,13,140,7,6
1274,43199,5228,42030,5228,allow,10588,2455,8133,46,5724,19,27
1275,56431,53,28557,53,allow,177,94,83,2,31,1,1
1276,56586,53,32780,53,allow,177,94,83,2,31,1,1
1277,64796,53,3205,53,allow,184,94,90,2,31,1,1
1278,64431,53,35945,53,allow,177,94,83,2,31,1,1
1279,64124,443,56676,443,allow,1411,852,559,13,25,7,6
1280,55869,53,8327,53,allow,196,102,94,2,31,1,1
1281,53251,53,53251,53,allow,247,98,149,2,34,1,1
1282,31994,53,31994,53,allow,244,98,146,2,33,1,1
1283,2099,53,2099,53,allow,217,82,135,2,33,1,1
1284,49857,53,15096,53,allow,173,94,79,2,30,1,1
1285,57840,53,57840,53,allow,183,82,101,2,30,1,1
1286,55869,53,64090,53,allow,196,102,94,2,30,1,1
1287,49396,53,60623,53,allow,216,102,114,2,30,1,1
1288,55732,53,29178,53,allow,177,94,83,2,30,1,1
1289,55797,53,36305,53,allow,177,94,83,2,31,1,1
1290,34920,53,40562,53,allow,168,78,90,2,31,1,1
1291,65289,53,7871,53,allow,179,94,85,2,31,1,1
1292,56906,53,55216,53,allow,167,86,81,2,31,1,1
1293,50741,445,0,0,drop,70,70,0,1,0,1,0
1294,50821,445,0,0,drop,66,66,0,1,0,1,0
1295,50818,445,0,0,drop,66,66,0,1,0,1,0
1296,50740,445,0,0,drop,70,70,0,1,0,1,0
1297,17408,8497,0,0,deny,148,148,0,1,0,1,0
1298,57015,25174,0,0,deny,66,66,0,1,0,1,0
1299,50739,445,0,0,drop,70,70,0,1,0,1,0
1300,50738,445,0,0,drop,70,70,0,1,0,1,0
1301,50735,445,0,0,drop,70,70,0,1,0,1,0
1302,50732,445,0,0,drop,70,70,0,1,0,1,0
1303,17002,22114,0,0,deny,62,62,0,1,0,1,0
1304,63677,15503,0,0,deny,66,66,0,1,0,1,0
1305,63508,62413,0,0,deny,66,66,0,1,0,1,0
1306,55409,445,0,0,drop,70,70,0,1,0,1,0
1307,55408,445,0,0,drop,70,70,0,1,0,1,0
1308,55404,445,0,0,drop,70,70,0,1,0,1,0
1309,55402,445,0,0,drop,70,70,0,1,0,1,0
1310,10833,23,0,0,deny,60,60,0,1,0,1,0
1311,50816,445,0,0,drop,66,66,0,1,0,1,0
1312,56679,51505,0,0,deny,62,62,0,1,0,1,0
1313,12645,22114,0,0,deny,146,146,0,1,0,1,0
1314,50720,445,0,0,drop,70,70,0,1,0,1,0
1315,50719,445,0,0,drop,70,70,0,1,0,1,0
1316,18771,35440,0,0,deny,62,62,0,1,0,1,0
1317,50717,445,0,0,drop,70,70,0,1,0,1,0
1318,3976,25174,0,0,deny,62,62,0,1,0,1,0
1319,50809,445,0,0,drop,66,66,0,1,0,1,0
1320,50799,445,0,0,drop,66,66,0,1,0,1,0
1321,50807,445,0,0,drop,66,66,0,1,0,1,0
1322,50800,445,0,0,drop,66,66,0,1,0,1,0
1323,50803,445,0,0,drop,66,66,0,1,0,1,0
1324,50808,445,0,0,drop,66,66,0,1,0,1,0
1325,50801,445,0,0,drop,66,66,0,1,0,1,0
1326,50709,445,0,0,drop,70,70,0,1,0,1,0
1327,50710,445,0,0,drop,70,70,0,1,0,1,0
1328,68,67,0,0,deny,346,346,0,1,0,1,0
1329,57297,51221,0,0,deny,66,66,0,1,0,1,0
1330,10874,25174,0,0,deny,62,62,0,1,0,1,0
1331,55395,445,0,0,drop,70,70,0,1,0,1,0
1332,55392,445,0,0,drop,70,70,0,1,0,1,0
1333,55389,445,0,0,drop,70,70,0,1,0,1,0
1334,55388,445,0,0,drop,70,70,0,1,0,1,0
1335,38959,25174,0,0,deny,62,62,0,1,0,1,0
1336,50698,445,0,0,drop,70,70,0,1,0,1,0
1337,1030,35776,0,0,deny,139,139,0,1,0,1,0
1338,62952,35440,0,0,deny,66,66,0,1,0,1,0
1339,55386,445,0,0,drop,70,70,0,1,0,1,0
1340,55385,445,0,0,drop,70,70,0,1,0,1,0
1341,55384,445,0,0,drop,70,70,0,1,0,1,0
1342,50793,445,0,0,drop,66,66,0,1,0,1,0
1343,55379,445,0,0,drop,70,70,0,1,0,1,0
1344,14263,22114,0,0,deny,62,62,0,1,0,1,0
1345,50790,445,0,0,drop,66,66,0,1,0,1,0
1346,17146,57470,0,0,deny,62,62,0,1,0,1,0
1347,1582,56205,0,0,deny,62,62,0,1,0,1,0
1348,50789,445,0,0,drop,66,66,0,1,0,1,0
1349,80,13987,0,0,deny,66,66,0,1,0,1,0
1350,50787,445,0,0,drop,66,66,0,1,0,1,0
1351,50694,445,0,0,drop,70,70,0,1,0,1,0
1352,50786,445,0,0,drop,66,66,0,1,0,1,0
1353,29719,22114,0,0,deny,146,146,0,1,0,1,0
1354,20457,51185,0,0,deny,72,72,0,1,0,1,0
1355,38852,37965,0,0,deny,62,62,0,1,0,1,0
1356,50683,445,0,0,drop,70,70,0,1,0,1,0
1357,50682,445,0,0,drop,70,70,0,1,0,1,0
1358,50684,445,0,0,drop,70,70,0,1,0,1,0
1359,50681,445,0,0,drop,70,70,0,1,0,1,0
1360,55374,445,0,0,drop,70,70,0,1,0,1,0
1361,50677,445,0,0,drop,70,70,0,1,0,1,0
1362,60714,50584,0,0,deny,66,66,0,1,0,1,0
1363,55370,445,0,0,drop,70,70,0,1,0,1,0
1364,55363,445,0,0,drop,70,70,0,1,0,1,0
1365,41213,25174,0,0,deny,62,62,0,1,0,1,0
1366,28579,64147,0,0,deny,62,62,0,1,0,1,0
1367,63988,22114,0,0,deny,66,66,0,1,0,1,0
1368,57643,28189,0,0,deny,60,60,0,1,0,1,0
1369,62080,54532,0,0,deny,60,60,0,1,0,1,0
1370,50775,445,0,0,drop,66,66,0,1,0,1,0
1371,48706,23393,0,0,deny,60,60,0,1,0,1,0
1372,5610,37965,0,0,deny,66,66,0,1,0,1,0
1373,15635,41182,0,0,deny,66,66,0,1,0,1,0
1374,27419,23,0,0,deny,60,60,0,1,0,1,0
1375,59088,57470,0,0,deny,62,62,0,1,0,1,0
1376,59126,57470,0,0,deny,66,66,0,1,0,1,0
1377,60193,53,20927,53,allow,214,85,129,2,0,1,1
1378,54025,53,41690,53,allow,578,286,292,9,0,5,4
1379,50672,445,0,0,drop,70,70,0,1,0,1,0
1380,6796,50584,0,0,deny,62,62,0,1,0,1,0
1381,45013,50584,0,0,deny,62,62,0,1,0,1,0
1382,46760,50584,0,0,deny,146,146,0,1,0,1,0
1383,25565,2216,0,0,deny,60,60,0,1,0,1,0
1384,33912,25174,0,0,deny,62,62,0,1,0,1,0
1385,993,49276,0,0,deny,129,129,0,1,0,1,0
1386,50767,445,0,0,drop,66,66,0,1,0,1,0
1387,29576,37807,0,0,deny,66,66,0,1,0,1,0
1388,55351,445,0,0,drop,70,70,0,1,0,1,0
1389,50594,25174,0,0,deny,66,66,0,1,0,1,0
1390,6712,123,0,0,deny,90,90,0,1,0,1,0
1391,61288,23,0,0,deny,60,60,0,1,0,1,0
1392,443,35385,0,0,deny,161,161,0,1,0,1,0
1393,50664,445,0,0,drop,70,70,0,1,0,1,0
1394,27621,50584,0,0,deny,62,62,0,1,0,1,0
1395,50661,445,0,0,drop,70,70,0,1,0,1,0
1396,50764,445,0,0,drop,66,66,0,1,0,1,0
1397,40394,67,0,0,deny,60,60,0,1,0,1,0
1398,58593,57470,0,0,deny,62,62,0,1,0,1,0
1399,50756,445,0,0,drop,66,66,0,1,0,1,0
1400,50657,445,0,0,drop,70,70,0,1,0,1,0
1401,50656,445,0,0,drop,70,70,0,1,0,1,0
1402,50749,445,0,0,drop,66,66,0,1,0,1,0
1403,50652,445,0,0,drop,70,70,0,1,0,1,0
1404,28139,22114,0,0,deny,62,62,0,1,0,1,0
1405,58440,22114,0,0,deny,146,146,0,1,0,1,0
1406,5683,44847,0,0,deny,66,66,0,1,0,1,0
1407,54051,28793,0,0,deny,66,66,0,1,0,1,0
1408,64333,57470,0,0,deny,78,78,0,1,0,1,0
1409,50650,445,0,0,drop,70,70,0,1,0,1,0
1410,55341,445,0,0,drop,70,70,0,1,0,1,0
1411,55340,445,0,0,drop,70,70,0,1,0,1,0
1412,55339,445,0,0,drop,70,70,0,1,0,1,0
1413,50738,445,0,0,drop,66,66,0,1,0,1,0
1414,50735,445,0,0,drop,66,66,0,1,0,1,0
1415,50741,445,0,0,drop,66,66,0,1,0,1,0
1416,50742,445,0,0,drop,66,66,0,1,0,1,0
1417,50737,445,0,0,drop,66,66,0,1,0,1,0
1418,50740,445,0,0,drop,66,66,0,1,0,1,0
1419,50736,445,0,0,drop,66,66,0,1,0,1,0
1420,50734,445,0,0,drop,66,66,0,1,0,1,0
1421,0,0,0,0,deny,60,60,0,1,0,1,0
1422,0,0,0,0,deny,98,98,0,1,0,1,0
1423,0,0,0,0,deny,60,60,0,1,0,1,0
1424,0,0,0,0,deny,60,60,0,1,0,1,0
1425,11775,25174,0,0,deny,62,62,0,1,0,1,0
1426,64150,22114,0,0,deny,66,66,0,1,0,1,0
1427,37959,3855,0,0,deny,72,72,0,1,0,1,0
1428,51146,23117,0,0,deny,66,66,0,1,0,1,0
1429,50646,445,0,0,drop,70,70,0,1,0,1,0
1430,55043,57470,0,0,deny,78,78,0,1,0,1,0
1431,14360,64147,0,0,deny,62,62,0,1,0,1,0
1432,55427,64147,0,0,deny,66,66,0,1,0,1,0
1433,55338,445,0,0,drop,70,70,0,1,0,1,0
1434,55335,445,0,0,drop,70,70,0,1,0,1,0
1435,55333,445,0,0,drop,70,70,0,1,0,1,0
1436,55321,445,0,0,drop,70,70,0,1,0,1,0
1437,50721,445,0,0,drop,66,66,0,1,0,1,0
1438,50720,445,0,0,drop,66,66,0,1,0,1,0
1439,50719,445,0,0,deny,66,66,0,1,0,1,0
1440,57546,25174,0,0,deny,66,66,0,1,0,1,0
1441,54502,34729,0,0,deny,66,66,0,1,0,1,0
1442,32554,34729,0,0,deny,62,62,0,1,0,1,0
1443,53626,30317,0,0,deny,66,66,0,1,0,1,0
1444,7539,30317,0,0,deny,62,62,0,1,0,1,0
1445,63640,57866,0,0,deny,66,66,0,1,0,1,0
1446,50633,445,0,0,drop,70,70,0,1,0,1,0
1447,55319,445,0,0,drop,70,70,0,1,0,1,0
1448,58836,51505,0,0,deny,66,66,0,1,0,1,0
1449,44710,25174,0,0,deny,62,62,0,1,0,1,0
1450,55317,445,0,0,drop,70,70,0,1,0,1,0
1451,55314,445,0,0,drop,70,70,0,1,0,1,0
1452,55308,445,0,0,drop,70,70,0,1,0,1,0
1453,50052,65008,0,0,deny,60,60,0,1,0,1,0
1454,50630,445,0,0,drop,70,70,0,1,0,1,0
1455,53260,36237,0,0,deny,62,62,0,1,0,1,0
1456,53324,44847,0,0,deny,66,66,0,1,0,1,0
1457,52564,15503,0,0,deny,74,74,0,1,0,1,0
1458,58638,5900,58638,5900,allow,156,62,94,2,10,1,1
1459,50147,443,13714,443,allow,9915,1833,8082,22,46,13,9
1460,55109,53,12323,53,allow,711,87,624,2,30,1,1
1461,23332,80,23332,80,allow,490,264,226,8,26,5,3
1462,58638,5900,58638,5900,allow,156,62,94,2,10,1,1
1463,59342,80,59342,80,allow,107768,4073,103695,177,15,58,119
1464,8411,8411,36899,8411,allow,66,66,0,1,30,1,0
1465,55869,53,59798,53,allow,192,98,94,2,30,1,1
1466,27302,443,50050,443,allow,9046,1414,7632,25,84,10,15
1467,22321,80,22321,80,allow,490,264,226,8,26,5,3
1468,58957,80,23483,80,allow,13330975,109486,13221489,10177,23,1394,8783
1469,56804,443,56989,443,allow,8074,2054,6020,20,15,11,9
1470,55457,443,34189,443,allow,130,70,60,3,5,2,1
1471,56083,53,60591,53,allow,711,87,624,2,30,1,1
1472,56431,53,62997,53,allow,170,87,83,2,30,1,1
1473,56806,443,15010,443,allow,8072,2052,6020,20,15,11,9
1474,61054,53,61054,53,allow,237,91,146,2,33,1,1
1475,54076,53,54076,53,allow,243,94,149,2,32,1,1
1476,6527,53,6527,53,allow,235,90,145,2,32,1,1
1477,52248,9323,44483,9323,allow,210,70,140,4,8,2,2
1478,52270,443,52270,443,allow,1615,941,674,15,20,7,8
1479,55867,53,58666,53,allow,172,88,84,2,30,1,1
1480,56586,53,6320,53,allow,170,87,83,2,30,1,1
1481,54898,443,54771,443,allow,78537,4022,74515,120,386,55,65
1482,50823,443,50823,443,allow,1210,637,573,14,25,7,7
1483,64796,53,48263,53,allow,184,94,90,2,31,1,1
1484,58638,5900,58638,5900,allow,156,62,94,2,10,1,1
1485,9519,443,34920,443,allow,3910,370,3540,16,34,5,11
1486,9522,443,6233,443,allow,6146,709,5437,18,29,8,10
1487,58638,5900,58638,5900,allow,156,62,94,2,10,1,1
1488,52269,443,52269,443,allow,1615,941,674,15,20,7,8
1489,58638,5900,58638,5900,allow,156,62,94,2,10,1,1
1490,56805,443,33799,443,allow,8022,2002,6020,20,15,11,9
1491,58638,5900,58638,5900,allow,156,62,94,2,10,1,1
1492,65359,53,51803,53,allow,731,91,640,2,30,1,1
1493,8413,8413,11663,8413,allow,66,66,0,1,30,1,0
1494,56504,53,4684,53,allow,196,100,96,2,30,1,1
1495,56919,53,26686,53,allow,170,87,83,2,30,1,1
1496,8412,8412,23033,8412,allow,66,66,0,1,30,1,0
1497,55491,443,47772,443,allow,5123,2651,2472,15,123,8,7
1498,49506,53,26702,53,allow,200,102,98,2,31,1,1
1499,65289,53,55084,53,allow,174,89,85,2,31,1,1
1500,64722,53,22432,53,allow,184,94,90,2,31,1,1
1501,50031,53,53719,53,allow,178,91,87,2,31,1,1
1502,59086,53,59086,53,allow,235,90,145,2,32,1,1
1503,50944,443,50944,443,allow,1210,637,573,14,25,7,7
1504,51073,443,51073,443,allow,1210,637,573,14,25,7,7
1505,64103,38976,24644,38976,allow,66,66,0,2,8,2,0
1506,64105,6363,30786,6363,allow,66,66,0,2,8,2,0
1507,40175,53,40175,53,allow,235,90,145,2,32,1,1
1508,53976,52534,6002,52534,allow,70,70,0,1,5,1,0
1509,28236,53,28236,53,allow,235,90,145,2,32,1,1
1510,58638,5900,58638,5900,allow,156,62,94,2,10,1,1
1511,64729,80,64729,80,allow,40906,1105,39801,45,142,13,32
1512,9516,443,9863,443,allow,3909,369,3540,16,35,5,11
1513,56733,53,47115,53,allow,187,98,89,3,52,2,1
1514,37350,53,37350,53,allow,213,87,126,2,30,1,1
1515,38104,443,51062,443,allow,8884,4067,4817,24,19,11,13
1516,58254,80,49705,80,allow,1151,711,440,10,15,5,5
1517,62160,53,62160,53,allow,205,81,124,2,30,1,1
1518,5588,5588,0,0,allow,3354,1792,1562,46,194,23,23
1519,55735,53,59032,53,allow,256,93,163,2,30,1,1
1520,64171,53,19883,53,allow,174,89,85,2,30,1,1
1521,53338,53,53532,53,allow,168,78,90,2,30,1,1
1522,56262,53,64499,53,allow,170,87,83,2,31,1,1
1523,56906,53,50869,53,allow,166,85,81,2,31,1,1
1524,56322,53,0,0,allow,166,73,93,2,31,1,1
1525,37965,56605,48626,56605,allow,847,152,695,4,1201,2,2
1526,62825,443,8189,443,allow,17772,2595,15177,25,122,12,13
1527,57033,53,60387,53,allow,754,94,660,2,31,1,1
1528,56720,53,57762,53,allow,916,86,830,2,31,1,1
1529,49321,53,16825,53,allow,184,94,90,2,31,1,1
1530,27677,22114,0,0,deny,146,146,0,1,0,1,0
1531,50547,22197,0,0,deny,66,66,0,1,0,1,0
1532,51052,50584,0,0,deny,66,66,0,1,0,1,0
1533,58230,64147,0,0,deny,66,66,0,1,0,1,0
1534,30456,36237,0,0,deny,62,62,0,1,0,1,0
1535,50625,445,0,0,drop,70,70,0,1,0,1,0
1536,50624,445,0,0,drop,70,70,0,1,0,1,0
1537,45269,50584,0,0,deny,62,62,0,1,0,1,0
1538,55300,445,0,0,drop,70,70,0,1,0,1,0
1539,55295,445,0,0,drop,70,70,0,1,0,1,0
1540,35207,22114,0,0,deny,62,62,0,1,0,1,0
1541,50622,445,0,0,drop,70,70,0,1,0,1,0
1542,53127,443,41153,443,allow,13914,7812,6102,52,69,28,24
1543,46568,443,33630,443,allow,6407,984,5423,21,360,11,10
1544,42356,443,3759,443,allow,276,70,206,5,26,2,3
1545,43900,443,13168,443,allow,442,250,192,8,25,5,3
1546,56479,443,37707,443,allow,3041,1995,1046,17,16,8,9
1547,52047,80,55413,80,allow,27784,13980,13804,44,35,22,22
1548,53957,29970,1762,29970,allow,552,366,186,9,17,6,3
1549,53951,80,8930,80,allow,78,78,0,2,7,2,0
1550,38602,80,59364,80,allow,2586,832,1754,14,16,7,7
1551,57410,443,21541,443,allow,7435,2697,4738,23,30,13,10
1552,51136,443,51136,443,allow,1210,637,573,14,25,7,7
1553,65131,53,28562,53,allow,443,98,345,4,57,2,2
1554,4782,443,2792,443,allow,1191,692,499,12,39,7,5
1555,49670,443,5760,443,allow,886,541,345,11,15,6,5
1556,64082,43786,41878,43786,allow,504,382,122,8,14,6,2
1557,21944,53,21944,53,allow,217,82,135,2,32,1,1
1558,65053,53,65053,53,allow,235,90,145,2,31,1,1
1559,53979,26308,29256,26308,allow,70,70,0,1,4,1,0
1560,49188,53,58733,53,allow,621,111,510,4,35,2,2
1561,52272,443,52272,443,allow,1615,941,674,15,20,7,8
1562,39994,80,41282,80,allow,2387,930,1457,14,16,7,7
1563,56515,53,8193,53,allow,177,94,83,2,29,1,1
1564,57448,53,27842,53,allow,177,94,83,2,29,1,1
1565,56906,53,48411,53,allow,167,86,81,2,29,1,1
1566,50063,53,17752,53,allow,173,94,79,2,29,1,1
1567,55650,53,4298,53,allow,179,94,85,2,29,1,1
1568,61119,53,61119,53,allow,217,90,127,2,29,1,1
1569,50063,53,53923,53,allow,173,94,79,2,30,1,1
1570,55732,53,41995,53,allow,177,94,83,2,29,1,1
1571,56176,53,13645,53,allow,177,94,83,2,30,1,1
1572,51606,443,25122,443,allow,5188,1096,4092,21,95,12,9
1573,48285,8080,0,0,allow,184,78,106,3,10,2,1
1574,58638,5900,58638,5900,allow,160,66,94,2,9,1,1
1575,62910,993,51747,993,allow,9108,4045,5063,84,72,39,45
1576,63954,53,6162,53,allow,289,102,187,2,30,1,1
1577,57152,53,57152,53,allow,241,98,143,2,30,1,1
1578,49481,53,5935,53,allow,232,102,130,2,30,1,1
1579,55061,443,38247,443,allow,18682,8068,10614,42,62,22,20
1580,49482,7000,49482,7000,allow,3098,1611,1487,16,15,9,7
1581,49364,443,26461,443,allow,8376,2198,6178,25,81,14,11
1582,50972,3544,40157,3544,allow,409,107,302,4,30,2,2
1583,56504,53,22416,53,allow,198,102,96,2,33,1,1
1584,57035,80,15633,80,allow,953,524,429,11,256,6,5
1585,51605,443,55829,443,allow,8095,3030,5065,27,95,14,13
1586,65094,53,59382,53,allow,630,204,426,6,64,3,3
1587,39892,443,8583,443,allow,2186,1319,867,23,20,13,10
1588,51252,443,8705,443,allow,9600,4628,4972,41,16,24,17
1589,64051,53,63556,53,allow,275,102,173,2,30,1,1
1590,49837,53,3661,53,allow,183,102,81,2,30,1,1
1591,65028,53,37363,53,allow,79,79,0,2,33,2,0
1592,61544,53,18551,53,allow,325,86,239,2,30,1,1
1593,64876,53,58020,53,allow,737,94,643,2,30,1,1
1594,53500,443,64344,443,allow,558,210,348,9,29,4,5
1595,64722,53,7575,53,allow,184,94,90,2,30,1,1
1596,56262,53,63670,53,allow,177,94,83,2,30,1,1
1597,45608,443,58506,443,allow,8487,2231,6256,26,350,12,14
1598,56563,53,53188,53,allow,292,126,166,2,30,1,1
1599,50031,53,15521,53,allow,181,94,87,2,30,1,1
1600,64122,443,27502,443,allow,5121090,119252,5001838,5000,55,1680,3320
1601,56431,53,59476,53,allow,177,94,83,2,30,1,1
1602,21526,53,21526,53,allow,230,90,140,2,30,1,1
1603,64796,53,58063,53,allow,184,94,90,2,30,1,1
1604,49340,53,57846,53,allow,387,134,253,2,30,1,1
1605,44839,443,42515,443,allow,308,84,224,4,120,2,2
1606,40401,80,34965,80,allow,1603,1179,424,10,124,6,4
1607,38135,80,24108,80,allow,111328,4904,106424,145,240,66,79
1608,51377,443,25439,443,allow,2838,944,1894,12,135,7,5
1609,57176,53,43366,53,allow,178,94,84,2,30,1,1
1610,58991,443,64156,443,allow,972647,20727,951920,916,263,245,671
1611,28441,23,28441,23,allow,152,66,86,2,7,1,1
1612,60506,56243,34455,56243,allow,70,70,0,2,8,2,0
1613,52569,80,52569,80,allow,93783,3885,89898,105,167,37,68
1614,54388,53,31456,53,allow,168,78,90,2,30,1,1
1615,64371,443,25379,443,allow,5925,3462,2463,13,120,7,6
1616,51704,443,61850,443,allow,7117,619,6498,19,34,6,13
1617,58975,80,4684,80,allow,214,140,74,4,15,3,1
1618,53956,41578,43631,41578,allow,492,306,186,8,17,5,3
1619,51251,443,24124,443,allow,7950,2502,5448,38,16,22,16
1620,58855,80,59829,80,allow,1601,902,699,8,387,5,3
1621,46201,443,55008,443,allow,16666,4851,11815,58,150,27,31
1622,41249,443,56931,443,allow,2080,1126,954,17,150,10,7
1623,59912,53,38804,53,allow,168,78,90,2,30,1,1
1624,64926,53,0,0,allow,371,77,294,2,30,1,1
1625,64171,53,47261,53,allow,179,94,85,2,30,1,1
1626,46567,443,52746,443,allow,6407,984,5423,21,360,11,10
1627,17750,6992,50842,6992,allow,150,150,0,1,1200,1,0
1628,41325,443,55609,443,allow,6015,4418,1597,38,246,22,16
1629,57356,443,8609,443,allow,7644,3087,4557,26,46,15,11
1630,54030,443,52354,443,allow,249900,26024,223876,450,167,183,267
1631,47152,443,10144,443,allow,11278,2044,9234,32,178,17,15
1632,58856,443,60071,443,allow,2694,1614,1080,14,386,8,6
1633,49224,53,4375,53,allow,199,102,97,2,32,1,1
1634,52218,62004,11964,62004,allow,136,136,0,3,12,3,0
1635,34331,443,11872,443,allow,120,60,60,3,4,2,1
1636,43026,443,33561,443,allow,138,78,60,2,4,1,1
1637,58638,5900,58638,5900,allow,160,66,94,2,9,1,1
1638,58638,5900,58638,5900,allow,160,66,94,2,9,1,1
1639,32515,443,32515,443,allow,34885,6636,28249,74,51,38,36
1640,46822,3389,46822,3389,allow,3457,1568,1889,17,21,10,7
1641,55867,53,49859,53,allow,178,94,84,2,29,1,1
1642,36873,80,37820,80,allow,1115,534,581,12,16,7,5
1643,60502,61473,62296,61473,allow,1628,1037,591,14,16,8,6
1644,56919,53,21784,53,allow,177,94,83,2,29,1,1
1645,50388,53,43330,53,allow,94,94,0,1,29,1,0
1646,55797,53,20315,53,allow,177,94,83,2,29,1,1
1647,56269,53,56636,53,allow,326,126,200,2,30,1,1
1648,43830,443,46012,443,allow,2257,461,1796,9,39,4,5
1649,55420,53,27651,53,allow,177,94,83,2,29,1,1
1650,65290,53,22798,53,allow,181,94,87,2,29,1,1
1651,40204,40017,36316,40017,allow,156,94,62,2,30,1,1
1652,49506,53,12143,53,allow,200,102,98,2,30,1,1
1653,65229,53,65530,53,allow,443,182,261,6,30,3,3
1654,49837,53,9778,53,allow,167,86,81,2,30,1,1
1655,65239,53,57855,53,allow,489,185,304,6,73,3,3
1656,56586,53,54269,53,allow,177,94,83,2,30,1,1
1657,64376,53,21911,53,allow,210,94,116,2,30,1,1
1658,57448,53,10658,53,allow,177,94,83,2,29,1,1
1659,56037,53,8318,53,allow,246,102,144,2,30,1,1
1660,55797,53,21762,53,allow,177,94,83,2,30,1,1
1661,56977,53,6420,53,allow,322,102,220,2,30,1,1
1662,65290,53,6842,53,allow,181,94,87,2,29,1,1
1663,49857,53,44627,53,allow,165,86,79,2,29,1,1
1664,56919,53,40423,53,allow,177,94,83,2,29,1,1
1665,56906,53,34993,53,allow,167,86,81,2,31,1,1
1666,56307,53,55446,53,allow,185,102,83,2,31,1,1
1667,56257,53,40578,53,allow,177,94,83,2,31,1,1
1668,55605,53,12415,53,allow,300,88,212,4,51,2,2
1669,49745,53,63902,53,allow,1472,98,1374,4,54,2,2
1670,49603,53,34411,53,allow,326,126,200,2,30,1,1
1671,55025,53,42219,53,allow,183,94,89,2,30,1,1
1672,50031,53,40045,53,allow,181,94,87,2,30,1,1
1673,56322,53,0,0,allow,629,73,556,2,30,1,1
1674,58839,443,35385,443,allow,8595,2118,6477,40,179,22,18
1675,49669,443,57280,443,allow,6911,897,6014,22,28,10,12
1676,44246,5228,57956,5228,allow,19678,4762,14916,98,9851,54,44
1677,62913,993,11946,993,allow,9122,4055,5067,84,67,39,45
1678,45105,443,12616,443,allow,3607,2257,1350,22,19,12,10
1679,33818,53,62977,53,allow,168,78,90,2,30,1,1
1680,56176,53,54476,53,allow,177,94,83,2,30,1,1
1681,55065,443,23726,443,allow,13236,4421,8815,28,61,16,12
1682,64171,53,17588,53,allow,179,94,85,2,30,1,1
1683,46569,443,56973,443,allow,6409,984,5425,21,360,11,10
1684,59685,443,5373,443,allow,2316,1353,963,17,276,9,8
1685,60508,55998,14688,55998,allow,70,70,0,2,8,2,0
1686,52297,80,4278,80,allow,1061,574,487,13,256,7,6
1687,49462,53,10345,53,allow,86,86,0,1,30,1,0
1688,34484,53,27104,53,allow,86,86,0,1,30,1,0
1689,65402,53,33102,53,allow,297,110,187,2,30,1,1
1690,32185,53,63584,53,allow,86,86,0,1,30,1,0
1691,49506,53,23058,53,allow,200,102,98,2,30,1,1
1692,64722,53,27260,53,allow,184,94,90,2,30,1,1
1693,56262,53,55550,53,allow,177,94,83,2,31,1,1
1694,44191,443,19988,443,allow,7151,1943,5208,30,25,17,13
1695,49231,443,44532,443,allow,474745,13542,461203,502,17,189,313
1696,56663,53,10723,53,allow,181,94,87,2,33,1,1
1697,58176,5223,41893,5223,allow,15152,5747,9405,46,56,20,26
1698,53174,41442,13286,41442,allow,70,70,0,1,5,1,0
1699,39538,80,23642,80,allow,2191,1142,1049,21,370,9,12
1700,58974,80,55839,80,allow,214,140,74,4,15,3,1
1701,65522,443,46739,443,allow,399281,11940,387341,412,16,145,267
1702,45545,53,45545,53,allow,178,82,96,2,30,1,1
1703,49293,53,22414,53,allow,811,94,717,2,30,1,1
1704,64511,53,2785,53,allow,305,102,203,2,30,1,1
1705,55025,53,22515,53,allow,183,94,89,2,30,1,1
1706,65289,53,55210,53,allow,179,94,85,2,30,1,1
1707,56919,53,56265,53,allow,177,94,83,2,30,1,1
1708,56431,53,39797,53,allow,177,94,83,2,30,1,1
1709,56572,53,63633,53,allow,177,94,83,2,31,1,1
1710,56262,53,24636,53,allow,177,94,83,2,30,1,1
1711,64917,53,41071,53,allow,194,94,100,2,30,1,1
1712,51442,443,50943,443,allow,15321,3760,11561,56,170,23,33
1713,49321,53,55835,53,allow,184,94,90,2,31,1,1
1714,64370,443,23826,443,allow,2783,692,2091,10,120,5,5
1715,49126,443,33194,443,allow,3800867,77753,3723114,3263,625,478,2785
1716,60774,443,14767,443,allow,29739,1164,28575,40,120,15,25
1717,49591,5228,57295,5228,allow,18548,2772,15776,41,3957,17,24
1718,47963,443,46762,443,allow,8903,3095,5808,31,121,16,15
1719,61445,443,34767,443,allow,97211,3043,94168,109,121,37,72
1720,37142,443,20503,443,allow,17201,10578,6623,57,145,27,30
1721,49160,33586,34033,33586,allow,1377,300,1077,6,1200,3,3
1722,49506,53,52835,53,allow,200,102,98,2,31,1,1
1723,64722,53,18980,53,allow,384,94,290,4,42,2,2
1724,50740,443,2714,443,allow,3108,1730,1378,16,16,9,7
1725,65066,80,65066,80,allow,874843,22526,852317,878,44,304,574
1726,55053,443,17178,443,allow,6906,1283,5623,29,248,14,15
1727,14446,443,21708,443,allow,2616,1470,1146,18,16,8,10
1728,55869,53,49767,53,allow,196,102,94,2,30,1,1
1729,64694,53,22388,53,allow,289,82,207,4,46,2,2
1730,62922,993,33264,993,allow,9484,4222,5262,86,45,40,46
1731,42354,443,60503,443,allow,4181,998,3183,14,27,7,7
1732,59875,443,3172,443,allow,12357,5182,7175,30,108,13,17
1733,54927,443,30686,443,allow,7148,1924,5224,35,364,19,16
1734,42096,80,4456,80,allow,1711,698,1013,14,17,6,8
1735,60503,53425,43534,53425,allow,504,318,186,8,16,5,3
1736,54892,443,40724,443,allow,602278,26008,576270,748,396,317,431
1737,33041,443,60563,443,allow,12375,6777,5598,28,49,13,15
1738,65200,51050,0,0,deny,62,62,0,1,0,1,0
1739,42417,22114,0,0,deny,62,62,0,1,0,1,0
1740,50708,445,0,0,drop,66,66,0,1,0,1,0
1741,55710,5555,0,0,deny,60,60,0,1,0,1,0
1742,18652,64147,0,0,deny,62,62,0,1,0,1,0
1743,11983,57470,0,0,deny,62,62,0,1,0,1,0
1744,39588,25174,0,0,deny,66,66,0,1,0,1,0
1745,443,35385,0,0,deny,161,161,0,1,0,1,0
1746,55294,445,0,0,drop,70,70,0,1,0,1,0
1747,43269,50584,0,0,deny,66,66,0,1,0,1,0
1748,50615,445,0,0,drop,70,70,0,1,0,1,0
1749,30966,44847,0,0,deny,146,146,0,1,0,1,0
1750,61550,5529,0,0,deny,145,145,0,1,0,1,0
1751,55293,445,0,0,drop,70,70,0,1,0,1,0
1752,9518,1,0,0,deny,100,100,0,1,0,1,0
1753,50613,445,0,0,drop,70,70,0,1,0,1,0
1754,51598,56079,0,0,deny,66,66,0,1,0,1,0
1755,47342,36237,0,0,deny,62,62,0,1,0,1,0
1756,60676,57866,0,0,deny,66,66,0,1,0,1,0
1757,50692,445,0,0,drop,66,66,0,1,0,1,0
1758,50691,445,0,0,drop,66,66,0,1,0,1,0
1759,50612,445,0,0,drop,70,70,0,1,0,1,0
1760,26287,56205,0,0,deny,62,62,0,1,0,1,0
1761,50611,445,0,0,drop,70,70,0,1,0,1,0
1762,50610,445,0,0,drop,70,70,0,1,0,1,0
1763,50606,445,0,0,drop,70,70,0,1,0,1,0
1764,50604,445,0,0,drop,70,70,0,1,0,1,0
1765,63421,44847,0,0,deny,66,66,0,1,0,1,0
1766,58365,5900,0,0,deny,60,60,0,1,0,1,0
1767,12909,47807,0,0,deny,148,148,0,1,0,1,0
1768,6881,6881,0,0,deny,62,62,0,1,0,1,0
1769,55283,445,0,0,drop,70,70,0,1,0,1,0
1770,55280,445,0,0,drop,70,70,0,1,0,1,0
1771,55277,445,0,0,drop,70,70,0,1,0,1,0
1772,55275,445,0,0,drop,70,70,0,1,0,1,0
1773,57539,44847,0,0,deny,62,62,0,1,0,1,0
1774,40847,25174,0,0,deny,146,146,0,1,0,1,0
1775,63346,37965,0,0,deny,66,66,0,1,0,1,0
1776,56119,37965,0,0,deny,62,62,0,1,0,1,0
1777,50592,445,0,0,drop,70,70,0,1,0,1,0
1778,62949,37965,0,0,deny,62,62,0,1,0,1,0
1779,43704,37965,0,0,deny,66,66,0,1,0,1,0
1780,50591,445,0,0,drop,70,70,0,1,0,1,0
1781,50689,445,0,0,drop,66,66,0,1,0,1,0
1782,63050,57470,0,0,deny,74,74,0,1,0,1,0
1783,50586,445,0,0,drop,70,70,0,1,0,1,0
1784,50582,445,0,0,drop,70,70,0,1,0,1,0
1785,50581,445,0,0,drop,70,70,0,1,0,1,0
1786,50680,445,0,0,drop,66,66,0,1,0,1,0
1787,50682,445,0,0,drop,66,66,0,1,0,1,0
1788,50671,445,0,0,drop,66,66,0,1,0,1,0
1789,50676,445,0,0,drop,66,66,0,1,0,1,0
1790,50677,445,0,0,drop,66,66,0,1,0,1,0
1791,50674,445,0,0,drop,66,66,0,1,0,1,0
1792,50675,445,0,0,drop,66,66,0,1,0,1,0
1793,55266,445,0,0,drop,70,70,0,1,0,1,0
1794,48706,23393,0,0,deny,60,60,0,1,0,1,0
1795,49786,25174,0,0,deny,66,66,0,1,0,1,0
1796,55264,445,0,0,drop,70,70,0,1,0,1,0
1797,55262,445,0,0,drop,70,70,0,1,0,1,0
1798,55261,445,0,0,drop,70,70,0,1,0,1,0
1799,36005,22,0,0,deny,60,60,0,1,0,1,0
1800,65417,44847,0,0,deny,66,66,0,1,0,1,0
1801,9231,3389,0,0,deny,66,66,0,1,0,1,0
1802,39213,25174,0,0,deny,62,62,0,1,0,1,0
1803,50570,445,0,0,drop,70,70,0,1,0,1,0
1804,59096,8604,0,0,deny,66,66,0,1,0,1,0
1805,57846,57866,0,0,deny,66,66,0,1,0,1,0
1806,443,35385,0,0,deny,66,66,0,1,0,1,0
1807,443,58101,0,0,deny,60,60,0,1,0,1,0
1808,993,51747,0,0,deny,66,66,0,1,0,1,0
1809,55259,445,0,0,drop,70,70,0,1,0,1,0
1810,55256,445,0,0,drop,70,70,0,1,0,1,0
1811,55253,445,0,0,drop,70,70,0,1,0,1,0
1812,63002,22114,0,0,deny,66,66,0,1,0,1,0
1813,50665,445,0,0,drop,66,66,0,1,0,1,0
1814,55251,445,0,0,drop,70,70,0,1,0,1,0
1815,57643,28189,0,0,deny,60,60,0,1,0,1,0
1816,62080,54532,0,0,deny,60,60,0,1,0,1,0
1817,50662,445,0,0,drop,66,66,0,1,0,1,0
1818,50566,445,0,0,drop,70,70,0,1,0,1,0
1819,443,50238,0,0,deny,331,331,0,1,0,1,0
1820,10754,28793,0,0,deny,62,62,0,1,0,1,0
1821,42973,57470,0,0,deny,62,62,0,1,0,1,0
1822,50660,445,0,0,drop,66,66,0,1,0,1,0
1823,50659,445,0,0,drop,66,66,0,1,0,1,0
1824,3945,35440,0,0,deny,66,66,0,1,0,1,0
1825,56428,30317,0,0,deny,66,66,0,1,0,1,0
1826,50658,445,0,0,drop,66,66,0,1,0,1,0
1827,58511,50584,0,0,deny,146,146,0,1,0,1,0
1828,50557,445,0,0,drop,70,70,0,1,0,1,0
1829,50556,445,0,0,drop,70,70,0,1,0,1,0
1830,50555,445,0,0,drop,70,70,0,1,0,1,0
1831,443,44683,0,0,deny,83,83,0,1,0,1,0
1832,50552,445,0,0,drop,70,70,0,1,0,1,0
1833,50550,445,0,0,drop,70,70,0,1,0,1,0
1834,60861,25174,0,0,deny,66,66,0,1,0,1,0
1835,60883,64147,0,0,deny,70,70,0,1,0,1,0
1836,55246,445,0,0,drop,70,70,0,1,0,1,0
1837,993,11946,0,0,deny,66,66,0,1,0,1,0
1838,40772,15503,0,0,deny,74,74,0,1,0,1,0
1839,443,35385,0,0,deny,66,66,0,1,0,1,0
1840,443,35385,0,0,deny,97,97,0,1,0,1,0
1841,443,35385,0,0,deny,130,130,0,1,0,1,0
1842,55240,445,0,0,drop,70,70,0,1,0,1,0
1843,55233,445,0,0,drop,70,70,0,1,0,1,0
1844,47141,50584,0,0,deny,62,62,0,1,0,1,0
1845,5151,50584,0,0,deny,62,62,0,1,0,1,0
1846,50647,445,0,0,drop,66,66,0,1,0,1,0
1847,50544,445,0,0,drop,70,70,0,1,0,1,0
1848,34212,11392,0,0,deny,62,62,0,1,0,1,0
1849,24127,23,0,0,deny,60,60,0,1,0,1,0
1850,50506,10214,0,0,deny,66,66,0,1,0,1,0
1851,45652,10214,0,0,deny,62,62,0,1,0,1,0
1852,35610,37965,0,0,deny,62,62,0,1,0,1,0
1853,57325,37965,0,0,deny,62,62,0,1,0,1,0
1854,50639,445,0,0,drop,66,66,0,1,0,1,0
1855,55223,445,0,0,drop,70,70,0,1,0,1,0
1856,8889,3808,0,0,deny,60,60,0,1,0,1,0
1857,50536,445,0,0,drop,70,70,0,1,0,1,0
1858,55306,53,23236,53,allow,170,87,83,2,0,1,1
1859,993,33264,0,0,deny,66,66,0,1,0,1,0
1860,6666,2001,0,0,deny,60,60,0,1,0,1,0
1861,50535,445,0,0,drop,70,70,0,1,0,1,0
1862,50637,445,0,0,drop,66,66,0,1,0,1,0
1863,61202,35894,0,0,deny,66,66,0,1,0,1,0
1864,1024,35894,0,0,deny,62,62,0,1,0,1,0
1865,13027,64147,0,0,deny,62,62,0,1,0,1,0
1866,50530,445,0,0,drop,70,70,0,1,0,1,0
1867,26424,27189,0,0,deny,66,66,0,1,0,1,0
1868,53466,25174,0,0,deny,146,146,0,1,0,1,0
1869,50528,445,0,0,drop,70,70,0,1,0,1,0
1870,50360,37965,0,0,deny,62,62,0,1,0,1,0
1871,50629,445,0,0,drop,66,66,0,1,0,1,0
1872,6889,55108,0,0,deny,143,143,0,1,0,1,0
1873,3117,37965,0,0,deny,62,62,0,1,0,1,0
1874,50622,445,0,0,drop,66,66,0,1,0,1,0
1875,50524,445,0,0,drop,70,70,0,1,0,1,0
1876,53318,22114,0,0,deny,66,66,0,1,0,1,0
1877,52033,50584,0,0,deny,66,66,0,1,0,1,0
1878,31675,19473,0,0,deny,62,62,0,1,0,1,0
1879,55043,57470,0,0,deny,78,78,0,1,0,1,0
1880,45144,25174,0,0,deny,146,146,0,1,0,1,0
1881,50523,445,0,0,drop,70,70,0,1,0,1,0
1882,60453,22114,0,0,deny,146,146,0,1,0,1,0
1883,20804,64147,0,0,deny,145,145,0,1,0,1,0
1884,55216,445,0,0,drop,70,70,0,1,0,1,0
1885,55212,445,0,0,drop,70,70,0,1,0,1,0
1886,55211,445,0,0,drop,70,70,0,1,0,1,0
1887,49677,25174,0,0,deny,62,62,0,1,0,1,0
1888,55994,22114,0,0,deny,66,66,0,1,0,1,0
1889,50607,445,0,0,drop,66,66,0,1,0,1,0
1890,50614,445,0,0,drop,66,66,0,1,0,1,0
1891,50609,445,0,0,drop,66,66,0,1,0,1,0
1892,50610,445,0,0,drop,66,66,0,1,0,1,0
1893,50613,445,0,0,drop,66,66,0,1,0,1,0
1894,50608,445,0,0,drop,66,66,0,1,0,1,0
1895,50606,445,0,0,drop,66,66,0,1,0,1,0
1896,50612,445,0,0,drop,66,66,0,1,0,1,0
1897,58055,56205,0,0,deny,146,146,0,1,0,1,0
1898,50518,445,0,0,drop,70,70,0,1,0,1,0
1899,45375,1900,0,0,deny,139,139,0,1,0,1,0
1900,19136,64147,0,0,deny,62,62,0,1,0,1,0
1901,63321,37807,0,0,deny,66,66,0,1,0,1,0
1902,46417,22114,0,0,deny,146,146,0,1,0,1,0
1903,41677,57470,0,0,deny,62,62,0,1,0,1,0
1904,30303,56301,0,0,deny,169,169,0,1,0,1,0
1905,49594,22114,0,0,deny,66,66,0,1,0,1,0
1906,50655,26467,0,0,deny,66,66,0,1,0,1,0
1907,2850,64147,0,0,deny,62,62,0,1,0,1,0
1908,48071,25174,0,0,deny,62,62,0,1,0,1,0
1909,6666,62078,0,0,deny,60,60,0,1,0,1,0
1910,55209,445,0,0,drop,70,70,0,1,0,1,0
1911,55204,445,0,0,drop,70,70,0,1,0,1,0
1912,55203,445,0,0,drop,70,70,0,1,0,1,0
1913,55199,445,0,0,drop,70,70,0,1,0,1,0
1914,50594,445,0,0,drop,66,66,0,1,0,1,0
1915,50593,445,0,0,drop,66,66,0,1,0,1,0
1916,50591,445,0,0,drop,66,66,0,1,0,1,0
1917,28875,51505,0,0,deny,62,62,0,1,0,1,0
1918,50505,445,0,0,drop,70,70,0,1,0,1,0
1919,55903,53,1701,53,allow,170,87,83,2,30,1,1
1920,40204,40018,64999,40018,allow,150,88,62,2,30,1,1
1921,52213,56682,55020,56682,allow,66,66,0,1,5,1,0
1922,9515,443,54612,443,allow,318,192,126,6,34,4,2
1923,55115,53,54899,53,allow,758,96,662,2,31,1,1
1924,50687,443,7518,443,allow,1199,618,581,13,29,6,7
1925,49476,7010,49476,7010,allow,4215,2090,2125,15,16,8,7
1926,56803,443,62661,443,allow,8020,2000,6020,20,15,11,9
1927,53971,18810,57788,18810,allow,70,70,0,1,5,1,0
1928,64080,11801,41031,11801,allow,66,66,0,1,5,1,0
1929,49722,443,18328,443,allow,9698,3026,6672,54,618,27,27
1930,64681,53,5691,53,allow,86,86,0,1,60,1,0
1931,56122,53,50294,53,allow,731,91,640,2,30,1,1
1932,39023,443,14196,443,allow,1017,705,312,9,20,4,5
1933,50686,443,4744,443,allow,1199,618,581,13,29,6,7
1934,65130,80,61798,80,allow,2500,531,1969,11,76,6,5
1935,50722,80,21337,80,allow,3235,555,2680,13,20,6,7
1936,53171,11820,1212,11820,allow,698,320,378,10,16,6,4
1937,50730,53,50730,53,allow,228,97,131,2,30,1,1
1938,57047,53,47290,53,allow,1426,98,1328,4,53,2,2
1939,49315,443,55462,443,allow,160961,7302,153659,171,87,49,122
1940,29979,53,29979,53,allow,215,80,135,2,33,1,1
1941,56801,443,16437,443,allow,8022,2002,6020,20,15,11,9
1942,59799,443,59799,443,allow,4666,1759,2907,19,28,11,8
1943,63431,443,3951,443,allow,3182,1568,1614,8,120,4,4
1944,63217,443,63217,443,allow,11907,1406,10501,25,22,11,14
1945,53964,24389,41775,24389,allow,1473,842,631,12,15,7,5
1946,36103,443,46915,443,allow,130,70,60,2,15,1,1
1947,53998,443,53998,443,allow,4613,1706,2907,19,30,11,8
1948,56802,443,7219,443,allow,8072,2052,6020,20,15,11,9
1949,52215,16937,53036,16937,allow,136,136,0,3,12,3,0
1950,53967,54589,61471,54589,allow,70,70,0,1,5,1,0
1951,9511,443,26929,443,allow,318,192,126,6,34,4,2
1952,49477,7000,49477,7000,allow,5910,4455,1455,19,15,11,8
1953,44884,443,1595,443,allow,309,309,0,1,5,1,0
1954,56756,443,1855,443,allow,7565,2187,5378,27,24,15,12
1955,54973,53,61675,53,allow,711,87,624,2,30,1,1
1956,56265,53,18284,53,allow,733,85,648,2,30,1,1
1957,55897,53,23504,53,allow,770,102,668,2,30,1,1
1958,55975,53,49618,53,allow,711,87,624,2,30,1,1
1959,56257,53,60774,53,allow,170,87,83,2,31,1,1
1960,50134,53,40420,53,allow,733,86,647,2,31,1,1
1961,56216,53,5035,53,allow,170,87,83,2,31,1,1
1962,56272,443,56272,443,allow,4550,1643,2907,19,28,11,8
1963,9514,443,6699,443,allow,318,192,126,6,34,4,2
1964,49480,7000,49480,7000,allow,3050,1659,1391,16,15,9,7
1965,46774,53,46774,53,allow,235,90,145,2,33,1,1
1966,41614,5222,29157,5222,allow,768,510,258,9,21,5,4
1967,59442,53,59442,53,allow,235,90,145,2,33,1,1
1968,38698,443,26967,443,allow,628,250,378,11,39,5,6
1969,56476,443,56476,443,allow,4624,1717,2907,19,30,11,8
1970,54939,443,24418,443,allow,13018,3066,9952,65,361,33,32
1971,55370,53,23288,53,allow,711,87,624,2,30,1,1
1972,56800,443,17462,443,allow,8074,2054,6020,20,16,11,9
1973,57176,53,30899,53,allow,172,88,84,2,30,1,1
1974,55219,53,47738,53,allow,91,91,0,1,30,1,0
1975,55806,53,53227,53,allow,200,102,98,2,30,1,1
1976,55564,53,55564,53,allow,215,88,127,2,30,1,1
1977,55349,53,28852,53,allow,744,89,655,2,30,1,1
1978,55224,53,26209,53,allow,711,87,624,2,31,1,1
1979,45205,443,55089,443,allow,7221,3151,4070,20,162,9,11
1980,61077,443,19799,443,allow,4970,2272,2698,12,121,6,6
1981,56255,53,37256,53,allow,701,88,613,2,31,1,1
1982,49762,53,56822,53,allow,184,94,90,2,31,1,1
1983,59513,53,0,0,allow,82,82,0,1,31,1,0
1984,57237,443,44952,443,allow,3283,1030,2253,16,136,8,8
1985,55647,53,53361,53,allow,250,86,164,4,31,2,2
1986,56480,53,53765,53,allow,755,94,661,2,31,1,1
1987,64124,53,26589,53,allow,182,93,89,2,31,1,1
1988,57052,53,31599,53,allow,711,87,624,2,31,1,1
1989,45154,53,45154,53,allow,236,108,128,2,31,1,1
1990,55288,53,47176,53,allow,192,98,94,2,31,1,1
1991,57374,53,45450,53,allow,733,86,647,2,31,1,1
1992,56397,53,29734,53,allow,174,89,85,2,31,1,1
1993,55082,53,13671,53,allow,755,93,662,2,31,1,1
1994,5578,53,5578,53,allow,288,83,205,2,31,1,1
1995,43056,443,9640,443,allow,31297,21354,9943,55,363,28,27
1996,6881,16869,32052,16869,allow,509,150,359,2,1200,1,1
1997,48706,23393,0,0,deny,60,60,0,1,0,1,0
1998,18204,55160,0,0,deny,146,146,0,1,0,1,0
1999,53189,62413,0,0,deny,62,62,0,1,0,1,0
2000,13406,22114,0,0,deny,62,62,0,1,0,1,0
2001,54256,123,0,0,deny,234,234,0,1,0,1,0
2002,52863,50584,0,0,deny,66,66,0,1,0,1,0
2003,55206,22114,0,0,deny,66,66,0,1,0,1,0
2004,2075,19473,0,0,deny,62,62,0,1,0,1,0
2005,55191,445,0,0,drop,70,70,0,1,0,1,0
2006,23846,22114,0,0,deny,146,146,0,1,0,1,0
2007,64878,26467,0,0,deny,62,62,0,1,0,1,0
2008,50367,37965,0,0,deny,66,66,0,1,0,1,0
2009,50502,445,0,0,drop,70,70,0,1,0,1,0
2010,55190,445,0,0,drop,70,70,0,1,0,1,0
2011,55183,445,0,0,drop,70,70,0,1,0,1,0
2012,55180,445,0,0,drop,70,70,0,1,0,1,0
2013,1638,25174,0,0,deny,146,146,0,1,0,1,0
2014,46619,57470,0,0,deny,62,62,0,1,0,1,0
2015,23353,25174,0,0,deny,62,62,0,1,0,1,0
2016,50498,445,0,0,drop,70,70,0,1,0,1,0
2017,9687,35440,0,0,deny,66,66,0,1,0,1,0
2018,48144,21247,0,0,deny,66,66,0,1,0,1,0
2019,50496,445,0,0,drop,70,70,0,1,0,1,0
2020,43260,41615,0,0,deny,145,145,0,1,0,1,0
2021,43260,41615,0,0,deny,145,145,0,1,0,1,0
2022,51827,56205,0,0,deny,66,66,0,1,0,1,0
2023,16425,15503,0,0,deny,62,62,0,1,0,1,0
2024,25565,28739,0,0,deny,60,60,0,1,0,1,0
2025,50494,445,0,0,drop,70,70,0,1,0,1,0
2026,52819,15503,0,0,deny,66,66,0,1,0,1,0
2027,55172,445,0,0,drop,70,70,0,1,0,1,0
2028,30046,15503,0,0,deny,62,62,0,1,0,1,0
2029,55168,445,0,0,drop,70,70,0,1,0,1,0
2030,55167,445,0,0,drop,70,70,0,1,0,1,0
2031,51954,57470,0,0,deny,66,66,0,1,0,1,0
2032,33351,43890,0,0,deny,146,146,0,1,0,1,0
2033,4862,37965,0,0,deny,66,66,0,1,0,1,0
2034,50581,445,0,0,drop,66,66,0,1,0,1,0
2035,7844,22114,0,0,deny,66,66,0,1,0,1,0
2036,34500,23,0,0,deny,60,60,0,1,0,1,0
2037,61701,15503,0,0,deny,62,62,0,1,0,1,0
2038,993,4264,0,0,deny,66,66,0,1,0,1,0
2039,61455,64147,0,0,deny,66,66,0,1,0,1,0
2040,52745,25174,0,0,deny,66,66,0,1,0,1,0
2041,26623,22114,0,0,deny,146,146,0,1,0,1,0
2042,62721,56205,0,0,deny,66,66,0,1,0,1,0
2043,1025,46776,0,0,deny,62,62,0,1,0,1,0
2044,50487,445,0,0,drop,70,70,0,1,0,1,0
2045,57348,25174,0,0,deny,146,146,0,1,0,1,0
2046,24073,22114,0,0,deny,62,62,0,1,0,1,0
2047,59107,25174,0,0,deny,66,66,0,1,0,1,0
2048,55166,445,0,0,drop,70,70,0,1,0,1,0
2049,59549,50584,0,0,deny,66,66,0,1,0,1,0
2050,62183,57470,0,0,deny,74,74,0,1,0,1,0
2051,34993,15503,0,0,deny,62,62,0,1,0,1,0
2052,993,3979,0,0,deny,129,129,0,1,0,1,0
2053,50485,445,0,0,drop,70,70,0,1,0,1,0
2054,31859,33909,0,0,deny,62,62,0,1,0,1,0
2055,55164,445,0,0,drop,70,70,0,1,0,1,0
2056,60428,25174,0,0,deny,66,66,0,1,0,1,0
2057,63190,35440,0,0,deny,62,62,0,1,0,1,0
2058,50484,445,0,0,drop,70,70,0,1,0,1,0
2059,55310,50584,0,0,deny,66,66,0,1,0,1,0
2060,50483,445,0,0,drop,70,70,0,1,0,1,0
2061,50482,445,0,0,drop,70,70,0,1,0,1,0
2062,50476,445,0,0,drop,70,70,0,1,0,1,0
2063,65216,53,28628,53,allow,218,94,124,2,30,1,1
2064,56216,53,58788,53,allow,177,94,83,2,30,1,1
2065,64592,443,64064,443,allow,24682,1935,22747,36,17,17,19
2066,57607,443,42010,443,allow,2614,1689,925,18,20,10,8
2067,37110,53,37110,53,allow,247,98,149,2,33,1,1
2068,50674,80,2786,80,allow,3325,598,2727,12,15,6,6
2069,55066,443,16494,443,allow,39091,9981,29110,93,208,42,51
2070,53972,59089,19075,59089,allow,70,70,0,1,4,1,0
2071,64078,54561,14823,54561,allow,70,70,0,1,4,1,0
2072,56604,3389,56604,3389,allow,3424,1710,1714,16,31,8,8
2073,42355,443,21738,443,allow,4181,998,3183,14,26,7,7
2074,39890,443,4730,443,allow,21106,2445,18661,45,20,24,21
2075,55051,443,30290,443,allow,6975,1243,5732,29,254,14,15
2076,65523,443,11792,443,allow,92518,4869,87649,109,15,44,65
2077,38783,443,19297,443,allow,584,370,214,9,25,6,3
2078,53969,13156,32626,13156,allow,70,70,0,1,4,1,0
2079,55806,53,52811,53,allow,200,102,98,2,33,1,1
2080,53974,26108,47325,26108,allow,70,70,0,1,4,1,0
2081,64079,20233,52835,20233,allow,70,70,0,1,4,1,0
2082,64083,63666,39336,63666,allow,70,70,0,1,4,1,0
2083,53173,25067,40514,25067,allow,70,70,0,1,5,1,0
2084,56586,53,50469,53,allow,177,94,83,2,29,1,1
2085,64618,53,13340,53,allow,410,102,308,2,29,1,1
2086,49787,53,40556,53,allow,258,110,148,2,29,1,1
2087,65289,53,50124,53,allow,564,193,371,6,51,3,3
2088,56439,53,20721,53,allow,177,94,83,2,29,1,1
2089,57176,53,54360,53,allow,178,94,84,2,29,1,1
2090,64365,53,27467,53,allow,341,110,231,2,29,1,1
2091,65511,53,46791,53,allow,214,102,112,2,30,1,1
2092,50175,53,51711,53,allow,819,102,717,2,30,1,1
2093,53461,443,61462,443,allow,52988,3128,49860,67,48,26,41
2094,49344,53,20668,53,allow,458,188,270,6,29,3,3
2095,57176,53,50437,53,allow,178,94,84,2,29,1,1
2096,55339,53,49453,53,allow,194,94,100,2,30,1,1
2097,55903,53,28482,53,allow,177,94,83,2,30,1,1
2098,64009,53,32252,53,allow,209,110,99,2,30,1,1
2099,40204,40003,21367,40003,allow,156,94,62,2,30,1,1
2100,52212,51343,7428,51343,allow,70,70,0,1,5,1,0
2101,49566,443,65424,443,allow,1394,540,854,24,36,10,14
2102,9323,443,4707,443,allow,26959,1764,25195,42,48,18,24
2103,49550,443,28578,443,allow,2338,1407,931,18,200,10,8
2104,56068,53,60568,53,allow,168,94,74,2,30,1,1
2105,14032,53,14032,53,allow,235,90,145,2,32,1,1
2106,53194,443,6156,443,allow,1478,918,560,12,44,6,6
2107,38002,49152,2185,49152,allow,156,156,0,3,8,3,0
2108,9524,443,1427,443,allow,1313,876,437,11,26,6,5
2109,46486,53,46486,53,allow,414,268,146,3,34,2,1
2110,38785,443,33251,443,allow,5206,3832,1374,23,25,13,10
2111,59131,53,59747,53,allow,70,70,0,1,30,1,0
2112,55015,53,27863,53,allow,733,94,639,2,30,1,1
2113,59899,3389,59899,3389,allow,3624,1910,1714,19,32,11,8
2114,56892,53,40383,53,allow,210,102,108,2,30,1,1
2115,61827,5223,22031,5223,allow,10784,5831,4953,33,521,15,18
2116,55561,53,57871,53,allow,313,102,211,2,30,1,1
2117,52111,53162,33838,53162,allow,1330,706,624,10,33,6,4
2118,52124,443,40698,443,allow,78269,5330,72939,127,313,57,70
2119,57284,53,57366,53,allow,165,86,79,2,30,1,1
2120,58877,443,35023,443,allow,183394,7389,176005,219,108,87,132
2121,49103,443,44063,443,allow,6725,505,6220,20,181,5,15
2122,54658,443,29655,443,allow,40096,3155,36941,50,135,19,31
2123,55288,53,5668,53,allow,196,102,94,2,30,1,1
2124,46310,443,45813,443,allow,10106,2096,8010,24,186,13,11
2125,56939,53,41233,53,allow,322,134,188,2,30,1,1
2126,55845,443,55416,443,allow,505207,16025,489182,464,139,97,367
2127,55138,53,34483,53,allow,173,94,79,2,30,1,1
2128,56257,53,40161,53,allow,177,94,83,2,30,1,1
2129,55219,53,51728,53,allow,181,94,87,2,32,1,1
2130,25778,53,25778,53,allow,235,90,145,2,33,1,1
2131,55774,8060,21425,8060,allow,70,70,0,1,5,1,0
2132,52718,53,15399,53,allow,164,78,86,2,30,1,1
2133,49321,53,46028,53,allow,184,94,90,2,30,1,1
2134,56068,53,7794,53,allow,152,78,74,2,30,1,1
2135,55070,53,15674,53,allow,195,94,101,2,30,1,1
2136,40204,40018,24038,40018,allow,566,86,480,2,30,1,1
2137,52214,27480,63759,27480,allow,70,70,0,1,5,1,0
2138,62506,443,7984,443,allow,1326,876,450,11,32,6,5
2139,40689,443,13371,443,allow,4203,1564,2639,26,470,14,12
2140,35921,443,5709,443,allow,5207,1058,4149,21,150,12,9
2141,55903,53,48648,53,allow,177,94,83,2,30,1,1
2142,40204,40031,12730,40031,allow,245,182,63,2,30,1,1
2143,43568,443,63608,443,allow,9445,6593,2852,43,96,25,18
2144,56743,443,40694,443,allow,7789,2275,5514,30,47,16,14
2145,54934,443,9475,443,allow,11700,3386,8314,63,362,33,30
2146,34752,3389,34752,3389,allow,3910,1805,2105,20,18,12,8
2147,49481,7000,49481,7000,allow,3066,1675,1391,16,14,9,7
2148,57382,443,54714,443,allow,5619,927,4692,17,15,10,7
2149,52046,80,15183,80,allow,27904,14100,13804,46,34,24,22
2150,52113,443,33178,443,allow,17710,1892,15818,37,24,17,20
2151,52216,8848,22408,8848,allow,136,136,0,3,11,3,0
2152,14259,53,14259,53,allow,247,98,149,2,33,1,1
2153,53304,80,56632,80,allow,130,64,66,3,4,2,1
2154,60707,80,12418,80,allow,144,78,66,2,5,1,1
2155,64077,20208,51700,20208,allow,70,70,0,1,4,1,0
2156,62923,993,4264,993,allow,9848,4639,5209,83,41,42,41
2157,37636,443,48056,443,allow,9658,2602,7056,32,66,14,18
2158,36542,443,35325,443,allow,31814,26657,5157,52,212,32,20
2159,56904,80,52022,80,allow,25125,2681,22444,36,318,19,17
2160,123,123,26903,123,allow,826,376,450,10,34,5,5
2161,58730,443,58122,443,allow,5110,950,4160,21,48,10,11
2162,57923,443,34874,443,allow,13736,1702,12034,26,15,12,14
2163,49573,443,25314,443,allow,1820,1101,719,18,16,10,8
2164,56572,53,22035,53,allow,177,94,83,2,29,1,1
2165,56307,53,24670,53,allow,185,102,83,2,29,1,1
2166,50175,53,55281,53,allow,196,102,94,2,30,1,1
2167,64425,53,6282,53,allow,182,86,96,2,29,1,1
2168,64588,443,57526,443,allow,9156,2109,7047,27,32,15,12
2169,56439,53,22707,53,allow,177,94,83,2,29,1,1
2170,55795,53,50908,53,allow,177,94,83,2,30,1,1
2171,40204,40035,37692,40035,allow,156,94,62,2,30,1,1
2172,63847,443,1340,443,allow,1786,172,1614,7,120,3,4
2173,64560,53,45431,53,allow,807,94,713,2,30,1,1
2174,56397,53,62027,53,allow,179,94,85,2,30,1,1
2175,64698,53,15508,53,allow,763,102,661,2,30,1,1
2176,56143,53,11476,53,allow,214,94,120,2,30,1,1
2177,36687,53,34461,53,allow,168,78,90,2,31,1,1
2178,48731,443,18575,443,allow,5959,1709,4250,27,1211,15,12
2179,56991,443,28802,443,allow,20986,10828,10158,35,95,20,15
2180,49479,7000,49479,7000,allow,5200,3745,1455,18,15,10,8
2181,62504,443,1666,443,allow,10385,7051,3334,27,33,15,12
2182,56620,53,8741,53,allow,214,102,112,2,30,1,1
2183,54020,443,45905,443,allow,17529,8138,9391,39,31,17,22
2184,55871,53,54072,53,allow,189,102,87,2,30,1,1
2185,55382,53,39381,53,allow,226,110,116,2,30,1,1
2186,38001,49152,63633,49152,allow,156,156,0,3,8,3,0
2187,62505,443,46992,443,allow,14891,3970,10921,32,33,15,17
2188,60991,443,12084,443,allow,15561,8186,7375,44,47,26,18
2189,56594,53,16703,53,allow,167,86,81,2,30,1,1
2190,50031,53,6210,53,allow,181,94,87,2,30,1,1
2191,56216,53,54561,53,allow,177,94,83,2,30,1,1
2192,30434,53,30434,53,allow,197,90,107,2,30,1,1
2193,56594,53,29488,53,allow,167,86,81,2,30,1,1
2194,37052,53,37052,53,allow,178,82,96,2,30,1,1
2195,56746,80,35139,80,allow,876072,26350,849722,935,27,335,600
2196,50826,443,11870,443,allow,6601,1120,5481,17,115,9,8
2197,60992,443,15020,443,allow,3465,2532,933,20,47,12,8
2198,55795,53,49814,53,allow,177,94,83,2,30,1,1
2199,55064,443,12029,443,allow,12611,3681,8930,26,61,15,11
2200,55138,53,34113,53,allow,165,86,79,2,30,1,1
2201,50478,445,0,0,drop,70,70,0,1,0,1,0
2202,50564,445,0,0,drop,66,66,0,1,0,1,0
2203,50562,445,0,0,drop,66,66,0,1,0,1,0
2204,16518,64147,0,0,deny,145,145,0,1,0,1,0
2205,1865,25174,0,0,deny,146,146,0,1,0,1,0
2206,56152,56205,0,0,deny,62,62,0,1,0,1,0
2207,63848,443,19599,443,allow,3182,1568,1614,8,120,4,4
2208,6881,51413,34368,51413,allow,207,118,89,2,1199,1,1
2209,49762,53,16917,53,allow,184,94,90,2,30,1,1
2210,55107,53,13262,53,allow,184,94,90,2,30,1,1
2211,55647,53,13562,53,allow,168,86,82,2,31,1,1
2212,37322,53,64245,53,allow,168,78,90,2,31,1,1
2213,49369,53,12483,53,allow,168,86,82,2,31,1,1
2214,57470,31566,19027,31566,allow,481,150,331,2,1199,1,1
2215,49369,53,65002,53,allow,168,86,82,2,30,1,1
2216,49383,53,39251,53,allow,758,102,656,2,30,1,1
2217,57431,53,3019,53,allow,181,94,87,2,31,1,1
2218,57470,15564,5143,15564,allow,1577,594,983,20,1624,10,10
2219,57169,53,55765,53,allow,458,188,270,6,31,3,3
2220,56397,53,56445,53,allow,179,94,85,2,31,1,1
2221,52245,53652,1791,53652,allow,70,70,0,2,7,2,0
2222,55288,53,4599,53,allow,196,102,94,2,30,1,1
2223,49760,53,59419,53,allow,183,94,89,2,30,1,1
2224,57006,53,15142,53,allow,819,102,717,2,30,1,1
2225,52210,15604,53741,15604,allow,70,70,0,1,5,1,0
2226,62065,443,18237,443,allow,21959,8954,13005,65,63,33,32
2227,49633,53,11968,53,allow,168,86,82,2,30,1,1
2228,49590,53,5842,53,allow,458,188,270,6,30,3,3
2229,55318,53,12855,53,allow,167,86,81,2,30,1,1
2230,56442,53,53594,53,allow,167,86,81,2,30,1,1
2231,19651,53,19651,53,allow,216,90,126,2,30,1,1
2232,49225,80,23885,80,allow,15343,3240,12103,23,81,9,14
2233,57355,443,46923,443,allow,36265,3519,32746,55,46,27,28
2234,57304,53,49312,53,allow,228,110,118,2,31,1,1
2235,55318,53,32183,53,allow,167,86,81,2,31,1,1
2236,49946,443,3936,443,allow,8725,3341,5384,25,136,12,13
2237,58535,30317,0,0,deny,62,62,0,1,0,1,0
2238,54912,64147,0,0,deny,66,66,0,1,0,1,0
2239,27507,25174,0,0,deny,62,62,0,1,0,1,0
2240,25565,27942,0,0,deny,60,60,0,1,0,1,0
2241,55155,445,0,0,drop,70,70,0,1,0,1,0
2242,55154,445,0,0,drop,70,70,0,1,0,1,0
2243,55151,445,0,0,drop,70,70,0,1,0,1,0
2244,55146,445,0,0,drop,70,70,0,1,0,1,0
2245,50464,445,0,0,drop,70,70,0,1,0,1,0
2246,50463,445,0,0,drop,70,70,0,1,0,1,0
2247,64199,50584,0,0,deny,146,146,0,1,0,1,0
2248,50460,445,0,0,drop,70,70,0,1,0,1,0
2249,26420,25174,0,0,deny,66,66,0,1,0,1,0
2250,61583,64147,0,0,deny,66,66,0,1,0,1,0
2251,20112,64147,0,0,deny,62,62,0,1,0,1,0
2252,50453,445,0,0,drop,70,70,0,1,0,1,0
2253,50454,445,0,0,drop,70,70,0,1,0,1,0
2254,50561,445,0,0,drop,66,66,0,1,0,1,0
2255,4328,7302,0,0,deny,66,66,0,1,0,1,0
2256,50553,445,0,0,drop,66,66,0,1,0,1,0
2257,50552,445,0,0,drop,66,66,0,1,0,1,0
2258,50549,445,0,0,drop,66,66,0,1,0,1,0
2259,50548,445,0,0,drop,66,66,0,1,0,1,0
2260,50545,445,0,0,drop,66,66,0,1,0,1,0
2261,50546,445,0,0,drop,66,66,0,1,0,1,0
2262,50543,445,0,0,drop,66,66,0,1,0,1,0
2263,57239,123,0,0,deny,90,90,0,1,0,1,0
2264,52427,42873,0,0,deny,66,66,0,1,0,1,0
2265,55140,445,0,0,drop,70,70,0,1,0,1,0
2266,51348,25174,0,0,deny,66,66,0,1,0,1,0
2267,57643,28189,0,0,deny,60,60,0,1,0,1,0
2268,51550,11392,0,0,deny,66,66,0,1,0,1,0
2269,62080,54532,0,0,deny,60,60,0,1,0,1,0
2270,55136,445,0,0,drop,70,70,0,1,0,1,0
2271,55133,445,0,0,drop,70,70,0,1,0,1,0
2272,55132,445,0,0,drop,70,70,0,1,0,1,0
2273,60248,46776,0,0,deny,66,66,0,1,0,1,0
2274,53730,37965,0,0,deny,66,66,0,1,0,1,0
2275,14717,64147,0,0,deny,66,66,0,1,0,1,0
2276,50442,445,0,0,drop,70,70,0,1,0,1,0
2277,42030,25,0,0,deny,74,74,0,1,0,1,0
2278,2572,17546,0,0,deny,62,62,0,1,0,1,0
2279,30784,30975,0,0,deny,159,159,0,1,0,1,0
2280,55201,26467,0,0,deny,62,62,0,1,0,1,0
2281,8102,57470,0,0,deny,62,62,0,1,0,1,0
2282,18653,42707,0,0,deny,66,66,0,1,0,1,0
2283,3093,62413,0,0,deny,62,62,0,1,0,1,0
2284,42608,1,0,0,deny,62,62,0,1,0,1,0
2285,62744,62413,0,0,deny,66,66,0,1,0,1,0
2286,55130,445,0,0,drop,70,70,0,1,0,1,0
2287,55131,445,0,0,drop,70,70,0,1,0,1,0
2288,55128,445,0,0,drop,70,70,0,1,0,1,0
2289,53194,35440,0,0,deny,66,66,0,1,0,1,0
2290,50438,445,0,0,drop,70,70,0,1,0,1,0
2291,50537,445,0,0,drop,66,66,0,1,0,1,0
2292,55123,445,0,0,drop,70,70,0,1,0,1,0
2293,50535,445,0,0,drop,66,66,0,1,0,1,0
2294,50532,445,0,0,drop,66,66,0,1,0,1,0
2295,50533,445,0,0,drop,66,66,0,1,0,1,0
2296,50427,445,0,0,drop,70,70,0,1,0,1,0
2297,50429,445,0,0,drop,70,70,0,1,0,1,0
2298,50426,445,0,0,drop,70,70,0,1,0,1,0
2299,8734,56205,0,0,deny,66,66,0,1,0,1,0
2300,50530,445,0,0,drop,66,66,0,1,0,1,0
2301,50423,445,0,0,drop,70,70,0,1,0,1,0
2302,58229,50584,0,0,deny,66,66,0,1,0,1,0
2303,40254,25174,0,0,deny,62,62,0,1,0,1,0
2304,50421,445,0,0,drop,70,70,0,1,0,1,0
2305,6546,37965,0,0,deny,62,62,0,1,0,1,0
2306,44207,44847,0,0,deny,62,62,0,1,0,1,0
2307,58799,30188,0,0,deny,62,62,0,1,0,1,0
2308,35760,11392,0,0,deny,146,146,0,1,0,1,0
2309,56182,53,55538,53,allow,762,98,664,2,0,1,1
2310,22029,50584,0,0,deny,66,66,0,1,0,1,0
2311,55118,445,0,0,drop,70,70,0,1,0,1,0
2312,57762,25174,0,0,deny,146,146,0,1,0,1,0
2313,26566,44847,0,0,deny,66,66,0,1,0,1,0
2314,55817,36829,0,0,deny,66,66,0,1,0,1,0
2315,55114,445,0,0,drop,70,70,0,1,0,1,0
2316,55105,445,0,0,drop,70,70,0,1,0,1,0
2317,26629,56079,0,0,deny,62,62,0,1,0,1,0
2318,50415,445,0,0,drop,70,70,0,1,0,1,0
2319,48025,44847,0,0,deny,62,62,0,1,0,1,0
2320,11317,53563,0,0,reset-both,143,143,0,1,0,1,0
2321,50518,445,0,0,drop,66,66,0,1,0,1,0
2322,50408,445,0,0,drop,70,70,0,1,0,1,0
2323,50511,445,0,0,drop,66,66,0,1,0,1,0
2324,50406,445,0,0,drop,70,70,0,1,0,1,0
2325,49380,21247,0,0,deny,66,66,0,1,0,1,0
2326,55666,35440,0,0,deny,60,60,0,1,0,1,0
2327,55095,445,0,0,drop,70,70,0,1,0,1,0
2328,51575,9694,0,0,deny,62,62,0,1,0,1,0
2329,9748,21247,0,0,deny,66,66,0,1,0,1,0
2330,32983,51221,0,0,deny,66,66,0,1,0,1,0
2331,61916,64097,0,0,deny,62,62,0,1,0,1,0
2332,55043,57470,0,0,deny,78,78,0,1,0,1,0
2333,50508,445,0,0,drop,66,66,0,1,0,1,0
2334,58758,22114,0,0,deny,66,66,0,1,0,1,0
2335,50402,445,0,0,drop,70,70,0,1,0,1,0
2336,44079,10387,0,0,deny,145,145,0,1,0,1,0
2337,50400,445,0,0,drop,70,70,0,1,0,1,0
2338,53995,25174,0,0,deny,66,66,0,1,0,1,0
2339,50502,445,0,0,drop,66,66,0,1,0,1,0
2340,53928,15503,0,0,deny,62,62,0,1,0,1,0
2341,50499,445,0,0,drop,66,66,0,1,0,1,0
2342,50396,445,0,0,drop,70,70,0,1,0,1,0
2343,6881,45378,0,0,deny,146,146,0,1,0,1,0
2344,19875,30170,0,0,deny,145,145,0,1,0,1,0
2345,50394,445,0,0,drop,70,70,0,1,0,1,0
2346,44891,23,0,0,deny,60,60,0,1,0,1,0
2347,52336,64097,0,0,deny,62,62,0,1,0,1,0
2348,3730,17372,0,0,deny,62,62,0,1,0,1,0
2349,55088,445,0,0,drop,70,70,0,1,0,1,0
2350,55084,445,0,0,drop,70,70,0,1,0,1,0
2351,55083,445,0,0,drop,70,70,0,1,0,1,0
2352,36685,35440,0,0,deny,62,62,0,1,0,1,0
2353,58453,50584,0,0,deny,66,66,0,1,0,1,0
2354,36933,23117,0,0,deny,62,62,0,1,0,1,0
2355,50485,445,0,0,drop,66,66,0,1,0,1,0
2356,50486,445,0,0,drop,66,66,0,1,0,1,0
2357,50481,445,0,0,drop,66,66,0,1,0,1,0
2358,49828,53,40540,53,allow,578,286,292,9,15,5,4
2359,45316,80,11125,80,allow,3044854,64416,2980438,2968,19,997,1971
2360,53172,56013,23634,56013,allow,70,70,0,1,5,1,0
2361,52247,49278,31090,49278,allow,316,136,180,6,6,3,3
2362,55318,53,35151,53,allow,166,85,81,2,30,1,1
2363,49552,53,59587,53,allow,188,96,92,2,30,1,1
2364,56797,443,58873,443,allow,8022,2002,6020,20,16,11,9
2365,49475,7000,49475,7000,allow,3546,2043,1503,16,15,9,7
2366,48985,15000,20199,15000,allow,130,70,60,2,5,1,1
2367,55445,53,56296,53,allow,711,87,624,2,30,1,1
2368,49369,53,21699,53,allow,168,86,82,2,30,1,1
2369,56748,53,43623,53,allow,184,94,90,2,31,1,1
2370,56204,53,48985,53,allow,168,86,82,2,30,1,1
2371,45017,443,13860,443,allow,11771,2624,9147,50,20,25,25
2372,56799,443,47229,443,allow,8021,2001,6020,20,15,11,9
2373,63459,443,63459,443,allow,4506,1599,2907,19,28,11,8
2374,56822,53,60516,53,allow,184,94,90,2,30,1,1
2375,53963,6882,6880,6882,allow,70,70,0,1,5,1,0
2376,50295,3389,50295,3389,allow,5936,2690,3246,25,20,15,10
2377,43906,443,43906,443,allow,4792,2767,2025,38,255,20,18
2378,57896,7635,57896,7635,allow,138,78,60,2,5,1,1
2379,56798,443,60246,443,allow,8073,2053,6020,20,15,11,9
2380,64801,53,33594,53,allow,728,96,632,2,30,1,1
2381,49474,7000,49474,7000,allow,3100,783,2317,14,15,7,7
2382,6194,80,6194,80,allow,3058,774,2284,11,16,6,5
2383,55638,53,11091,53,allow,168,86,82,2,30,1,1
2384,49482,80,49482,80,allow,2444,1148,1296,14,48,7,7
2385,42780,53,61676,53,allow,198,93,105,2,30,1,1
2386,55774,53,26343,53,allow,701,88,613,2,30,1,1
2387,57431,53,32621,53,allow,178,91,87,2,31,1,1
2388,55088,53,52692,53,allow,170,87,83,2,31,1,1
2389,57418,443,57418,443,allow,4736,1759,2977,20,26,11,9
2390,56732,53,32710,53,allow,701,88,613,2,30,1,1
2391,52242,3749,25339,3749,allow,70,70,0,2,7,2,0
2392,37905,443,37905,443,allow,4707,1800,2907,19,26,11,8
2393,57038,53,16760,53,allow,188,96,92,2,30,1,1
2394,45287,53,10390,53,allow,198,93,105,2,30,1,1
2395,49633,53,21391,53,allow,168,86,82,2,30,1,1
2396,41317,53,41317,53,allow,217,87,130,2,30,1,1
2397,48906,53,48906,53,allow,217,87,130,2,30,1,1
2398,65336,53,30958,53,allow,771,101,670,2,31,1,1
2399,55702,53,21809,53,allow,761,100,661,2,31,1,1
2400,55469,53,16063,53,allow,817,98,719,2,31,1,1
2401,37510,443,18789,443,allow,8619,2288,6331,41,361,16,25
2402,55107,53,40259,53,allow,184,94,90,2,30,1,1
2403,56677,53,20003,53,allow,200,102,98,2,31,1,1
2404,56765,53,1940,53,allow,188,96,92,2,31,1,1
2405,49332,53,39051,53,allow,740,93,647,2,31,1,1
2406,35141,53,35141,53,allow,288,83,205,2,31,1,1
2407,50793,443,16791,443,allow,9721,3096,6625,30,122,13,17
2408,49870,53,21637,53,allow,188,96,92,2,31,1,1
2409,55317,53,36634,53,allow,711,87,624,2,31,1,1
2410,56439,53,38034,53,allow,196,100,96,2,31,1,1
2411,56942,53,26338,53,allow,170,87,83,2,31,1,1
2412,57269,53,41250,53,allow,182,93,89,2,31,1,1
2413,56030,53,56239,53,allow,815,95,720,2,31,1,1
2414,55478,53,12055,53,allow,170,87,83,2,31,1,1
2415,56079,53,34259,53,allow,740,93,647,2,31,1,1
2416,49480,53,59035,53,allow,184,94,90,2,31,1,1
2417,65442,53,27260,53,allow,760,97,663,2,31,1,1
2418,49540,53,42804,53,allow,754,94,660,2,31,1,1
2419,55752,443,54224,443,allow,11823,4029,7794,25,143,12,13
2420,50285,53,26837,53,allow,760,97,663,2,31,1,1
2421,64941,53,34820,53,allow,295,101,194,4,31,2,2
2422,54887,443,19441,443,allow,4364,2141,2223,15,137,7,8
2423,64763,53,55818,53,allow,212,108,104,2,31,1,1
2424,55877,54210,39473,54210,allow,490,149,341,2,1200,1,1
2425,50479,445,0,0,drop,66,66,0,1,0,1,0
2426,50480,445,0,0,drop,66,66,0,1,0,1,0
2427,50482,445,0,0,drop,66,66,0,1,0,1,0
2428,50484,445,0,0,drop,66,66,0,1,0,1,0
2429,50478,445,0,0,drop,66,66,0,1,0,1,0
2430,32722,25174,0,0,deny,62,62,0,1,0,1,0
2431,28830,37965,0,0,deny,62,62,0,1,0,1,0
2432,44044,23,0,0,deny,60,60,0,1,0,1,0
2433,61250,42873,0,0,deny,66,66,0,1,0,1,0
2434,61637,25174,0,0,deny,66,66,0,1,0,1,0
2435,11112,43890,0,0,deny,66,66,0,1,0,1,0
2436,59883,17637,0,0,deny,66,66,0,1,0,1,0
2437,52363,123,30662,123,allow,184,94,90,2,30,1,1
2438,55288,53,34566,53,allow,196,102,94,2,30,1,1
2439,54996,53,14810,53,allow,168,86,82,2,31,1,1
2440,64709,53,54232,53,allow,338,110,228,2,29,1,1
2441,64683,53,62247,53,allow,198,102,96,2,29,1,1
2442,64124,53,35184,53,allow,183,94,89,2,30,1,1
2443,56442,53,30750,53,allow,167,86,81,2,30,1,1
2444,55183,53,52172,53,allow,177,94,83,2,30,1,1
2445,55107,53,25498,53,allow,184,94,90,2,30,1,1
2446,56658,53,34980,53,allow,458,188,270,6,30,3,3
2447,58036,443,9162,443,allow,12752,5123,7629,39,90,18,21
2448,48935,443,24879,443,allow,12753,6074,6679,44,88,23,21
2449,54136,80,25504,80,allow,1585,863,722,12,15,6,6
2450,60498,55100,54000,55100,allow,164,70,94,2,5,1,1
2451,35104,53,13881,53,allow,168,78,90,2,29,1,1
2452,55903,53,64113,53,allow,177,94,83,2,29,1,1
2453,50210,53,56208,53,allow,756,94,662,2,29,1,1
2454,49321,53,38287,53,allow,184,94,90,2,29,1,1
2455,64683,53,49305,53,allow,821,102,719,2,29,1,1
2456,58961,80,48953,80,allow,5412,4758,654,14,14,8,6
2457,55647,53,31412,53,allow,168,86,82,2,29,1,1
2458,50524,53,52843,53,allow,816,102,714,2,29,1,1
2459,52211,56648,11346,56648,allow,70,70,0,1,4,1,0
2460,56677,53,7912,53,allow,200,102,98,2,30,1,1
2461,49762,53,33292,53,allow,184,94,90,2,30,1,1
2462,57297,53,52793,53,allow,242,102,140,2,30,1,1
2463,49989,53,64218,53,allow,755,94,661,2,29,1,1
2464,57284,53,33476,53,allow,173,94,79,2,29,1,1
2465,54973,53,49914,53,allow,811,94,717,2,29,1,1
2466,56204,53,61458,53,allow,168,86,82,2,30,1,1
2467,57006,53,13462,53,allow,196,102,94,2,29,1,1
2468,50524,53,62327,53,allow,193,102,91,2,30,1,1
2469,63012,443,56934,443,allow,3707,1245,2462,11,119,6,5
2470,64560,53,36010,53,allow,184,94,90,2,29,1,1
2471,56688,53,13604,53,allow,196,102,94,2,29,1,1
2472,49948,53,30662,53,allow,214,94,120,2,30,1,1
2473,56041,53,5205,53,allow,183,94,89,2,30,1,1
2474,55233,53,15536,53,allow,215,102,113,2,30,1,1
2475,60499,51413,63354,51413,allow,70,70,0,1,5,1,0
2476,36515,80,38433,80,allow,51571,48786,2785,74,19,38,36
2477,56822,53,28434,53,allow,184,94,90,2,30,1,1
2478,43564,53,37702,53,allow,199,94,105,2,30,1,1
2479,56041,53,23370,53,allow,183,94,89,2,30,1,1
2480,49368,443,53544,443,allow,14412,3279,11133,33,19,17,16
2481,54382,53,54382,53,allow,414,268,146,3,33,2,1
2482,35699,443,53038,443,allow,2060,1106,954,17,150,10,7
2483,57228,53,50397,53,allow,344,94,250,2,30,1,1
2484,56677,53,47518,53,allow,200,102,98,2,30,1,1
2485,49552,53,25565,53,allow,194,102,92,2,30,1,1
2486,56942,53,38411,53,allow,177,94,83,2,30,1,1
2487,57431,53,54427,53,allow,181,94,87,2,30,1,1
2488,55088,53,34841,53,allow,177,94,83,2,30,1,1
2489,48095,53,40439,53,allow,199,94,105,2,30,1,1
2490,56942,53,55677,53,allow,177,94,83,2,30,1,1
2491,55823,53,52028,53,allow,210,102,108,2,30,1,1
2492,52948,48482,33406,48482,allow,5180,2470,2710,49,339,25,24
2493,60501,40829,17093,40829,allow,70,70,0,1,5,1,0
2494,52209,37241,61696,37241,allow,136,136,0,3,14,3,0
2495,56191,53,1757,53,allow,177,94,83,2,30,1,1
2496,60863,53,60863,53,allow,298,114,184,2,30,1,1
2497,55075,443,61643,443,allow,2459,1608,851,17,25,9,8
2498,64122,53,46704,53,allow,255,102,153,2,30,1,1
2499,56531,53,17376,53,allow,309,94,215,2,30,1,1
2500,10963,53,10963,53,allow,216,90,126,2,30,1,1
2501,56205,53,15763,53,allow,240,110,130,2,30,1,1
2502,10061,443,5696,443,allow,4984,892,4092,18,185,9,9
2503,58330,443,54762,443,allow,7353,2840,4513,33,107,18,15
2504,52207,4637,29875,4637,allow,136,136,0,3,14,3,0
2505,52208,47300,63479,47300,allow,70,70,0,1,5,1,0
2506,55753,53,0,0,allow,82,82,0,2,40,2,0
2507,49563,80,54340,80,allow,1515,481,1034,11,15,6,5
2508,49762,53,65280,53,allow,184,94,90,2,30,1,1
2509,49552,53,34956,53,allow,194,102,92,2,30,1,1
2510,56617,53,38232,53,allow,228,110,118,2,30,1,1
2511,57432,443,22941,443,allow,26468,3325,23143,41,147,16,25
2512,51116,80,26188,80,allow,14873,8100,6773,36,32,19,17
2513,51117,80,26474,80,allow,5040,3914,1126,19,32,12,7
2514,50421,443,23778,443,allow,562,222,340,9,26,4,5
2515,49369,53,34405,53,allow,324,86,238,4,47,2,2
2516,55647,53,8145,53,allow,168,86,82,2,30,1,1
2517,64124,53,4238,53,allow,183,94,89,2,30,1,1
2518,63948,53,52448,53,allow,366,102,264,4,60,2,2
2519,55638,53,63082,53,allow,168,86,82,2,30,1,1
2520,56204,53,36998,53,allow,168,86,82,2,30,1,1
2521,57122,53,58221,53,allow,198,94,104,2,30,1,1
2522,56111,53,27769,53,allow,227,110,117,2,30,1,1
2523,49480,53,58009,53,allow,184,94,90,2,31,1,1
2524,55062,443,36502,443,allow,14701,3640,11061,29,60,16,13
2525,49671,53,50695,53,allow,335,117,218,4,36,2,2
2526,57288,443,50391,443,allow,840,420,420,14,39,7,7
2527,55089,80,46073,80,allow,1558,452,1106,11,15,6,5
2528,14445,443,55284,443,allow,2589,1443,1146,18,15,8,10
2529,58061,80,39603,80,allow,5571,2637,2934,23,75,12,11
2530,44155,53,24482,53,allow,168,78,90,2,29,1,1
2531,43552,443,10231,443,allow,4680,2873,1807,26,53,15,11
2532,56872,53,25005,53,allow,443,182,261,6,29,3,3
2533,52049,80,61901,80,allow,34695,17472,17223,55,33,28,27
2534,56688,53,52079,53,allow,196,102,94,2,31,1,1
2535,60808,40010,35600,40010,allow,316,136,180,6,6,3,3
2536,50672,80,28058,80,allow,1515,481,1034,11,16,6,5
2537,60507,53830,57450,53830,allow,320,140,180,6,6,3,3
2538,56748,53,55168,53,allow,184,94,90,2,30,1,1
2539,52244,58774,22208,58774,allow,70,70,0,2,6,2,0
2540,55056,443,30880,443,allow,5233,3384,1849,21,62,11,10
2541,60213,80,45825,80,allow,70,70,0,1,4,1,0
2542,55088,53,21749,53,allow,177,94,83,2,30,1,1
2543,64124,53,27285,53,allow,294,93,201,4,42,2,2
2544,49272,53,53692,53,allow,198,102,96,2,30,1,1
2545,49366,443,23124,443,allow,14668,3601,11067,34,19,19,15
2546,53959,39097,20337,39097,allow,1450,761,689,14,15,8,6
2547,38715,443,52129,443,allow,403299,12717,390582,439,16,171,268
2548,49743,443,50508,443,allow,2372,1143,1229,21,82,10,11
2549,55871,53,26416,53,allow,181,94,87,2,29,1,1
2550,62170,53,16163,53,allow,234,94,140,2,29,1,1
2551,50279,53,54207,53,allow,749,94,655,2,29,1,1
2552,56216,53,35008,53,allow,177,94,83,2,29,1,1
2553,49760,53,45249,53,allow,183,94,89,2,29,1,1
2554,55183,53,35427,53,allow,177,94,83,2,29,1,1
2555,56257,53,40398,53,allow,177,94,83,2,29,1,1
2556,39556,443,12327,443,allow,7469,2547,4922,18,135,8,10
2557,55836,53,17348,53,allow,177,94,83,2,30,1,1
2558,19366,53,39850,53,allow,300,209,91,3,30,2,1
2559,57422,53,31757,53,allow,821,102,719,2,30,1,1
2560,30188,56962,59522,56962,allow,2746,1487,1259,21,2495,14,7
2561,49272,53,44204,53,allow,198,102,96,2,30,1,1
2562,64072,80,14418,80,allow,314,192,122,6,15,4,2
2563,56252,53,39340,53,allow,228,110,118,2,30,1,1
2564,48443,53,3585,53,allow,168,78,90,2,30,1,1
2565,56191,53,27279,53,allow,177,94,83,2,30,1,1
2566,56748,53,15879,53,allow,184,94,90,2,30,1,1
2567,56765,53,6433,53,allow,194,102,92,2,30,1,1
2568,65240,53,35636,53,allow,755,102,653,2,30,1,1
2569,32871,53,29403,53,allow,199,94,105,2,30,1,1
2570,55556,53,41769,53,allow,224,94,130,2,30,1,1
2571,52071,80,35224,80,allow,1284,780,504,12,360,7,5
2572,43439,443,4737,443,allow,13482,3731,9751,40,500,17,23
2573,49495,53,39798,53,allow,758,102,656,2,31,1,1
2574,55053,80,18063,80,allow,162010,4343,157667,170,98,61,109
2575,20727,53,20727,53,allow,217,82,135,2,32,1,1
2576,49724,53,30037,53,allow,470,131,339,4,32,2,2
2577,60500,44739,7471,44739,allow,70,70,0,1,5,1,0
2578,55097,53,3886,53,allow,324,102,222,4,42,2,2
2579,42947,443,14067,443,allow,11377,7703,3674,26,161,19,7
2580,50548,443,50022,443,allow,9277,2865,6412,31,200,18,13
2581,61920,53,61920,53,allow,298,114,184,2,30,1,1
2582,52686,53,56390,53,allow,199,94,105,2,30,1,1
2583,57409,53,41368,53,allow,232,94,138,2,30,1,1
2584,56982,53,26329,53,allow,193,94,99,2,30,1,1
2585,49264,443,65214,443,allow,2424,258,2166,9,120,4,5
2586,58955,80,51848,80,allow,3037,2276,761,12,28,7,5
2587,39994,80,39994,80,allow,2919,1492,1427,10,15,6,4
2588,51129,80,6520,80,allow,2794,2075,719,15,30,9,6
2589,52243,35643,17676,35643,allow,70,70,0,2,6,2,0
2590,57038,53,63930,53,allow,194,102,92,2,33,1,1
2591,9337,443,53921,443,allow,428,128,300,8,47,3,5
2592,49216,53,56828,53,allow,274,94,180,2,30,1,1
2593,55836,53,6468,53,allow,177,94,83,2,30,1,1
2594,56678,53,49059,53,allow,240,110,130,2,30,1,1
2595,55478,53,56587,53,allow,177,94,83,2,30,1,1
2596,56822,53,60070,53,allow,184,94,90,2,30,1,1
2597,57384,53,57923,53,allow,228,110,118,2,30,1,1
2598,49821,53,3854,53,allow,265,94,171,2,30,1,1
2599,56147,53,61785,53,allow,258,110,148,2,30,1,1
2600,57422,53,42352,53,allow,198,102,96,2,30,1,1
2601,49356,53,31993,53,allow,763,102,661,2,31,1,1
2602,42727,443,63558,443,allow,4813,970,3843,12,135,6,6
2603,57575,443,3355,443,allow,707158,36853,670305,902,148,310,592
2604,57269,53,5905,53,allow,183,94,89,2,30,1,1
2605,64128,53,31311,53,allow,193,102,91,2,31,1,1
2606,49710,443,63933,443,allow,7691,1797,5894,22,137,12,10
2607,56020,53,55046,53,allow,168,86,82,2,30,1,1
2608,56506,53,36137,53,allow,227,102,125,2,30,1,1
2609,55478,53,54641,53,allow,177,94,83,2,30,1,1
2610,49969,53,53673,53,allow,789,102,687,2,30,1,1
2611,56863,53,12002,53,allow,177,94,83,2,31,1,1
2612,56397,53,11047,53,allow,179,94,85,2,30,1,1
2613,51173,443,28678,443,allow,13341,4805,8536,88,378,42,46
2614,6881,6881,38605,6881,allow,502,150,352,2,1199,1,1
2615,48817,27294,48817,27294,allow,150,150,0,1,1200,1,0
2616,56942,53,10682,53,allow,177,94,83,2,31,1,1
2617,34014,80,56105,80,allow,1951,731,1220,11,150,6,5
2618,57470,36670,48397,36670,allow,3570,1126,2444,28,1465,16,12
2619,56020,53,24675,53,allow,168,86,82,2,31,1,1
2620,56439,53,35642,53,allow,198,102,96,2,31,1,1
2621,49224,53,51489,53,allow,199,102,97,2,34,1,1
2622,37672,5223,15708,5223,allow,110,110,0,1,5,1,0
2623,57269,53,43829,53,allow,183,94,89,2,30,1,1
2624,64095,1976,59947,1976,allow,66,66,0,2,8,2,0
2625,64098,10096,39565,10096,allow,66,66,0,2,8,2,0
2626,55058,443,16741,443,allow,12435,4022,8413,27,62,15,12
2627,49245,80,49245,80,allow,378,180,198,7,54,4,3
2628,64094,1024,11634,1024,allow,66,66,0,2,8,2,0
2629,57426,443,14949,443,allow,832,268,564,14,37,5,9
2630,59845,15503,0,0,deny,66,66,0,1,0,1,0
2631,45964,2225,0,0,deny,60,60,0,1,0,1,0
2632,3986,17372,0,0,deny,66,66,0,1,0,1,0
2633,61963,6881,0,0,deny,146,146,0,1,0,1,0
2634,55082,445,0,0,drop,70,70,0,1,0,1,0
2635,55081,445,0,0,drop,70,70,0,1,0,1,0
2636,55075,445,0,0,drop,70,70,0,1,0,1,0
2637,55067,445,0,0,drop,70,70,0,1,0,1,0
2638,25565,1726,0,0,deny,60,60,0,1,0,1,0
2639,45064,25174,0,0,deny,62,62,0,1,0,1,0
2640,443,44683,0,0,deny,83,83,0,1,0,1,0
2641,51922,44847,0,0,deny,62,62,0,1,0,1,0
2642,50466,445,0,0,drop,66,66,0,1,0,1,0
2643,50465,445,0,0,drop,66,66,0,1,0,1,0
2644,50463,445,0,0,drop,66,66,0,1,0,1,0
2645,50377,445,0,0,drop,70,70,0,1,0,1,0
2646,63508,62413,0,0,deny,66,66,0,1,0,1,0
2647,59068,49813,0,0,deny,70,70,0,1,0,1,0
2648,55393,44512,0,0,deny,66,66,0,1,0,1,0
2649,50354,56205,0,0,deny,66,66,0,1,0,1,0
2650,63677,15503,0,0,deny,66,66,0,1,0,1,0
2651,22981,15503,0,0,deny,62,62,0,1,0,1,0
2652,50372,445,0,0,drop,70,70,0,1,0,1,0
2653,55063,445,0,0,drop,70,70,0,1,0,1,0
2654,19718,37965,0,0,deny,66,66,0,1,0,1,0
2655,55059,445,0,0,drop,70,70,0,1,0,1,0
2656,55055,445,0,0,drop,70,70,0,1,0,1,0
2657,55056,445,0,0,drop,70,70,0,1,0,1,0
2658,10874,25174,0,0,deny,62,62,0,1,0,1,0
2659,57297,51221,0,0,deny,66,66,0,1,0,1,0
2660,63765,51221,0,0,deny,62,62,0,1,0,1,0
2661,49220,22,0,0,deny,60,60,0,1,0,1,0
2662,26124,56205,0,0,deny,146,146,0,1,0,1,0
2663,50367,445,0,0,drop,70,70,0,1,0,1,0
2664,65287,36829,0,0,deny,146,146,0,1,0,1,0
2665,1025,57470,0,0,deny,62,62,0,1,0,1,0
2666,50366,445,0,0,drop,70,70,0,1,0,1,0
2667,47632,25174,0,0,deny,146,146,0,1,0,1,0
2668,25679,27189,0,0,deny,62,62,0,1,0,1,0
2669,50364,445,0,0,drop,70,70,0,1,0,1,0
2670,38959,25174,0,0,deny,62,62,0,1,0,1,0
2671,10306,44847,0,0,deny,62,62,0,1,0,1,0
2672,55045,445,0,0,drop,70,70,0,1,0,1,0
2673,55044,445,0,0,drop,70,70,0,1,0,1,0
2674,55039,445,0,0,drop,70,70,0,1,0,1,0
2675,54280,3398,0,0,deny,60,60,0,1,0,1,0
2676,34086,25174,0,0,deny,66,66,0,1,0,1,0
2677,40086,22114,0,0,deny,146,146,0,1,0,1,0
2678,3576,8305,0,0,deny,145,145,0,1,0,1,0
2679,50453,445,0,0,drop,66,66,0,1,0,1,0
2680,1814,62413,0,0,deny,66,66,0,1,0,1,0
2681,26821,57866,0,0,deny,62,62,0,1,0,1,0
2682,48258,37965,0,0,deny,62,62,0,1,0,1,0
2683,51356,22114,0,0,deny,62,62,0,1,0,1,0
2684,45908,33330,0,0,deny,60,60,0,1,0,1,0
2685,50357,445,0,0,drop,70,70,0,1,0,1,0
2686,14263,22114,0,0,deny,62,62,0,1,0,1,0
2687,50355,445,0,0,drop,70,70,0,1,0,1,0
2688,65270,3855,0,0,deny,78,78,0,1,0,1,0
2689,55038,445,0,0,drop,70,70,0,1,0,1,0
2690,50354,445,0,0,drop,70,70,0,1,0,1,0
2691,55037,445,0,0,drop,70,70,0,1,0,1,0
2692,50353,445,0,0,drop,70,70,0,1,0,1,0
2693,50352,445,0,0,drop,70,70,0,1,0,1,0
2694,64605,25174,0,0,deny,66,66,0,1,0,1,0
2695,50346,445,0,0,drop,70,70,0,1,0,1,0
2696,50347,445,0,0,drop,70,70,0,1,0,1,0
2697,57726,37965,0,0,deny,62,62,0,1,0,1,0
2698,60714,50584,0,0,deny,66,66,0,1,0,1,0
2699,61085,37965,0,0,deny,62,62,0,1,0,1,0
2700,56688,25174,0,0,deny,66,66,0,1,0,1,0
2701,50436,445,0,0,drop,66,66,0,1,0,1,0
2702,50437,445,0,0,drop,66,66,0,1,0,1,0
2703,63988,22114,0,0,deny,66,66,0,1,0,1,0
2704,57643,28189,0,0,deny,60,60,0,1,0,1,0
2705,62080,54532,0,0,deny,60,60,0,1,0,1,0
2706,3410,17372,0,0,deny,62,62,0,1,0,1,0
2707,58724,43890,0,0,deny,66,66,0,1,0,1,0
2708,50334,445,0,0,drop,70,70,0,1,0,1,0
2709,59965,36237,0,0,deny,62,62,0,1,0,1,0
2710,50333,445,0,0,drop,70,70,0,1,0,1,0
2711,5610,37965,0,0,deny,66,66,0,1,0,1,0
2712,50331,445,0,0,drop,70,70,0,1,0,1,0
2713,49529,21247,0,0,deny,62,62,0,1,0,1,0
2714,57015,42707,0,0,deny,62,62,0,1,0,1,0
2715,46842,25174,0,0,deny,146,146,0,1,0,1,0
2716,50324,445,0,0,drop,70,70,0,1,0,1,0
2717,50323,445,0,0,drop,70,70,0,1,0,1,0
2718,15635,41182,0,0,deny,66,66,0,1,0,1,0
2719,55027,445,0,0,drop,70,70,0,1,0,1,0
2720,55026,445,0,0,drop,70,70,0,1,0,1,0
2721,55024,445,0,0,drop,70,70,0,1,0,1,0
2722,55020,445,0,0,drop,70,70,0,1,0,1,0
2723,3406,17372,0,0,deny,62,62,0,1,0,1,0
2724,31410,25174,0,0,deny,146,146,0,1,0,1,0
2725,4545,1900,0,0,deny,136,136,0,1,0,1,0
2726,45013,50584,0,0,deny,62,62,0,1,0,1,0
2727,44774,22114,0,0,deny,146,146,0,1,0,1,0
2728,50432,445,0,0,drop,66,66,0,1,0,1,0
2729,44774,22114,0,0,deny,62,62,0,1,0,1,0
2730,39586,22114,0,0,deny,66,66,0,1,0,1,0
2731,29576,37807,0,0,deny,66,66,0,1,0,1,0
2732,4323,64147,0,0,deny,66,66,0,1,0,1,0
2733,50426,445,0,0,drop,66,66,0,1,0,1,0
2734,50427,445,0,0,drop,66,66,0,1,0,1,0
2735,50425,445,0,0,drop,66,66,0,1,0,1,0
2736,50422,445,0,0,drop,66,66,0,1,0,1,0
2737,50421,445,0,0,drop,66,66,0,1,0,1,0
2738,50418,445,0,0,drop,66,66,0,1,0,1,0
2739,50415,445,0,0,drop,66,66,0,1,0,1,0
2740,40772,15503,0,0,deny,74,74,0,1,0,1,0
2741,63593,22114,0,0,deny,62,62,0,1,0,1,0
2742,58129,26467,0,0,deny,62,62,0,1,0,1,0
2743,55010,445,0,0,drop,70,70,0,1,0,1,0
2744,50312,445,0,0,drop,70,70,0,1,0,1,0
2745,55008,445,0,0,drop,70,70,0,1,0,1,0
2746,55006,445,0,0,drop,70,70,0,1,0,1,0
2747,55004,445,0,0,drop,70,70,0,1,0,1,0
2748,53771,57470,0,0,deny,66,66,0,1,0,1,0
2749,56679,51505,0,0,deny,62,62,0,1,0,1,0
2750,50308,445,0,0,drop,70,70,0,1,0,1,0
2751,60416,37965,0,0,deny,66,66,0,1,0,1,0
2752,45941,23386,0,0,deny,60,60,0,1,0,1,0
2753,3976,25174,0,0,deny,62,62,0,1,0,1,0
2754,55003,445,0,0,drop,70,70,0,1,0,1,0
2755,54997,445,0,0,drop,70,70,0,1,0,1,0
2756,54996,445,0,0,drop,70,70,0,1,0,1,0
2757,64808,62413,0,0,deny,66,66,0,1,0,1,0
2758,61802,23,0,0,deny,60,60,0,1,0,1,0
2759,50409,445,0,0,drop,66,66,0,1,0,1,0
2760,43155,35440,0,0,deny,62,62,0,1,0,1,0
2761,54995,445,0,0,drop,70,70,0,1,0,1,0
2762,34335,23,0,0,deny,60,60,0,1,0,1,0
2763,17171,22114,0,0,deny,66,66,0,1,0,1,0
2764,50298,445,0,0,drop,70,70,0,1,0,1,0
2765,50297,445,0,0,drop,70,70,0,1,0,1,0
2766,50299,445,0,0,drop,70,70,0,1,0,1,0
2767,50407,445,0,0,drop,66,66,0,1,0,1,0
2768,5683,44847,0,0,deny,66,66,0,1,0,1,0
2769,50293,445,0,0,drop,70,70,0,1,0,1,0
2770,64150,22114,0,0,deny,66,66,0,1,0,1,0
2771,24160,37807,0,0,deny,62,62,0,1,0,1,0
2772,50405,445,0,0,drop,66,66,0,1,0,1,0
2773,50403,445,0,0,drop,66,66,0,1,0,1,0
2774,64737,53,51522,53,allow,757,98,659,2,0,1,1
2775,50291,445,0,0,drop,70,70,0,1,0,1,0
2776,11101,22114,0,0,deny,146,146,0,1,0,1,0
2777,44528,5900,0,0,deny,60,60,0,1,0,1,0
2778,58925,25174,0,0,deny,66,66,0,1,0,1,0
2779,50402,445,0,0,drop,66,66,0,1,0,1,0
2780,30129,37965,0,0,deny,72,72,0,1,0,1,0
2781,0,0,0,0,allow,124,64,60,2,0,1,1
2782,11775,25174,0,0,deny,62,62,0,1,0,1,0
2783,56906,50584,0,0,deny,62,62,0,1,0,1,0
2784,59031,25174,0,0,deny,62,62,0,1,0,1,0
2785,51146,23117,0,0,deny,66,66,0,1,0,1,0
2786,6778,50584,0,0,deny,66,66,0,1,0,1,0
2787,12632,25174,0,0,deny,146,146,0,1,0,1,0
2788,54990,445,0,0,drop,70,70,0,1,0,1,0
2789,35507,15503,0,0,deny,62,62,0,1,0,1,0
2790,25363,22114,0,0,deny,66,66,0,1,0,1,0
2791,54981,445,0,0,drop,70,70,0,1,0,1,0
2792,54977,445,0,0,drop,70,70,0,1,0,1,0
2793,28579,64147,0,0,deny,62,62,0,1,0,1,0
2794,50285,445,0,0,drop,70,70,0,1,0,1,0
2795,8040,44847,0,0,deny,66,66,0,1,0,1,0
2796,55427,64147,0,0,deny,66,66,0,1,0,1,0
2797,52838,37965,0,0,deny,66,66,0,1,0,1,0
2798,17146,57470,0,0,deny,62,62,0,1,0,1,0
2799,55043,57470,0,0,deny,78,78,0,1,0,1,0
2800,50391,445,0,0,drop,66,66,0,1,0,1,0
2801,45269,50584,0,0,deny,62,62,0,1,0,1,0
2802,57546,25174,0,0,deny,66,66,0,1,0,1,0
2803,50277,445,0,0,drop,70,70,0,1,0,1,0
2804,50407,62413,0,0,deny,62,62,0,1,0,1,0
2805,59822,56205,0,0,deny,62,62,0,1,0,1,0
2806,50274,445,0,0,drop,70,70,0,1,0,1,0
2807,57613,42707,0,0,deny,66,66,0,1,0,1,0
2808,53985,30188,0,0,deny,66,66,0,1,0,1,0
2809,59345,25174,0,0,deny,62,62,0,1,0,1,0
2810,58836,51505,0,0,deny,66,66,0,1,0,1,0
2811,63640,57866,0,0,deny,66,66,0,1,0,1,0
2812,50383,445,0,0,drop,66,66,0,1,0,1,0
2813,7539,30317,0,0,deny,62,62,0,1,0,1,0
2814,443,44683,0,0,deny,83,83,0,1,0,1,0
2815,54967,445,0,0,drop,70,70,0,1,0,1,0
2816,8080,37965,0,0,deny,62,62,0,1,0,1,0
2817,44710,25174,0,0,deny,62,62,0,1,0,1,0
2818,50270,445,0,0,drop,70,70,0,1,0,1,0
2819,6999,2310,0,0,deny,143,143,0,1,0,1,0
2820,50269,445,0,0,drop,70,70,0,1,0,1,0
2821,59076,25174,0,0,deny,62,62,0,1,0,1,0
2822,50381,445,0,0,drop,66,66,0,1,0,1,0
2823,18398,21247,0,0,deny,66,66,0,1,0,1,0
2824,23310,22114,0,0,deny,62,62,0,1,0,1,0
2825,52564,15503,0,0,deny,74,74,0,1,0,1,0
2826,7561,43890,0,0,deny,62,62,0,1,0,1,0
2827,50265,445,0,0,drop,70,70,0,1,0,1,0
2828,50372,445,0,0,drop,66,66,0,1,0,1,0
2829,51052,50584,0,0,deny,66,66,0,1,0,1,0
2830,58230,64147,0,0,deny,66,66,0,1,0,1,0
2831,64797,53,54337,53,allow,182,93,89,2,30,1,1
2832,52892,443,17240,443,allow,41925,30922,11003,68,186,38,30
2833,49685,80,12171,80,allow,1548,847,701,10,16,5,5
2834,49240,8080,49240,8080,allow,22799,6835,15964,35,56,20,15
2835,57571,443,57571,443,allow,881747,19604,862143,728,175,144,584
2836,55727,43736,4643,43736,allow,70,70,0,2,8,2,0
2837,49243,80,49243,80,allow,378,180,198,7,53,4,3
2838,49238,8080,49238,8080,allow,378,180,198,7,53,4,3
2839,49242,80,49242,80,allow,378,180,198,7,53,4,3
2840,57572,443,57572,443,allow,181333,21870,159463,187,175,65,122
2841,49272,53,7753,53,allow,196,100,96,2,30,1,1
2842,55095,53,54084,53,allow,783,96,687,2,30,1,1
2843,50630,53,37346,53,allow,754,94,660,2,30,1,1
2844,56368,53,19580,53,allow,711,87,624,2,30,1,1
2845,60494,33709,52651,33709,allow,504,318,186,8,16,5,3
2846,52240,52893,59916,52893,allow,70,70,0,2,6,2,0
2847,52194,22674,61715,22674,allow,66,66,0,1,5,1,0
2848,1380,53,1380,53,allow,235,90,145,2,32,1,1
2849,64099,55470,5838,55470,allow,66,66,0,2,8,2,0
2850,27296,443,26053,443,allow,10243,1659,8584,29,83,13,16
2851,56795,443,62237,443,allow,8021,2001,6020,20,15,11,9
2852,55893,53,33227,53,allow,267,94,173,4,56,2,2
2853,55072,53,45639,53,allow,170,87,83,2,31,1,1
2854,57134,53,30351,53,allow,190,97,93,2,30,1,1
2855,3755,443,3755,443,allow,12079,1344,10735,24,17,10,14
2856,31925,53,31925,53,allow,237,91,146,2,33,1,1
2857,56794,443,16368,443,allow,8073,2053,6020,20,15,11,9
2858,55526,53,26801,53,allow,749,94,655,2,30,1,1
2859,64128,53,32109,53,allow,186,95,91,2,30,1,1
2860,43212,443,25002,443,allow,7476,2192,5284,27,316,13,14
2861,26831,443,14363,443,allow,7283,2586,4697,22,19,11,11
2862,49239,8080,49239,8080,allow,378,180,198,7,53,4,3
2863,53984,57077,13402,57077,allow,70,70,0,2,8,2,0
2864,57436,53,31842,53,allow,182,93,89,2,30,1,1
2865,50600,53,50600,53,allow,257,101,156,2,34,1,1
2866,26742,53,26742,53,allow,237,91,146,2,33,1,1
2867,57120,53,16635,53,allow,761,100,661,2,30,1,1
2868,5643,53,5643,53,allow,237,91,146,2,33,1,1
2869,47042,443,19544,443,allow,2809,1884,925,19,25,11,8
2870,57139,53,57139,53,allow,235,90,145,2,32,1,1
2871,55642,53,4187,53,allow,711,87,624,2,30,1,1
2872,55633,53,54670,53,allow,816,97,719,2,30,1,1
2873,60860,443,28548,443,allow,11687,2565,9122,46,66,25,21
2874,49686,80,54142,80,allow,2611,1811,800,13,15,7,6
2875,56688,53,38230,53,allow,192,98,94,2,30,1,1
2876,56796,443,60351,443,allow,8074,2054,6020,20,15,11,9
2877,58035,53,58035,53,allow,237,91,146,2,32,1,1
2878,64092,14447,3904,14447,allow,66,66,0,2,8,2,0
2879,50819,443,24202,443,allow,11217,3882,7335,42,164,19,23
2880,52203,1024,52908,1024,allow,136,136,0,3,14,3,0
2881,43032,443,42506,443,allow,2940,1721,1219,17,361,9,8
2882,64779,53,1103,53,allow,810,108,702,2,30,1,1
2883,56793,443,4192,443,allow,8022,2002,6020,20,16,11,9
2884,39683,443,12229,443,allow,101895,6430,95465,152,175,66,86
2885,56487,53,25181,53,allow,788,108,680,2,31,1,1
2886,32299,40019,6627,40019,allow,261,175,86,2,31,1,1
2887,49364,53,25963,53,allow,307,307,0,4,61,4,0
2888,51848,443,16596,443,allow,5788,3446,2342,22,135,11,11
2889,57470,1500,26703,1500,allow,528,528,0,9,1200,9,0
2890,55025,53,8549,53,allow,93,93,0,1,31,1,0
2891,56424,53,11596,53,allow,170,87,83,2,31,1,1
2892,56163,53,27486,53,allow,188,96,92,2,31,1,1
2893,56020,53,48606,53,allow,168,86,82,2,31,1,1
2894,55617,53,30754,53,allow,212,108,104,2,31,1,1
2895,49929,53,57396,53,allow,212,108,104,2,31,1,1
2896,6882,30499,61301,30499,allow,150,150,0,1,1200,1,0
2897,64712,53,32542,53,allow,181,98,83,2,31,1,1
2898,123,123,4169,123,allow,184,94,90,2,31,1,1
2899,57144,53,3454,53,allow,172,88,84,2,31,1,1
2900,54998,53,2972,53,allow,196,100,96,2,31,1,1
2901,50375,1,0,0,allow,74,74,0,1,91,1,0
2902,56603,53,10898,53,allow,174,89,85,2,31,1,1
2903,53124,443,9153,443,allow,64407,55712,8695,92,364,58,34
2904,51414,22,0,0,deny,60,60,0,1,0,1,0
2905,51414,22,0,0,deny,60,60,0,1,0,1,0
2906,4162,21532,0,0,deny,146,146,0,1,0,1,0
2907,52128,37807,0,0,deny,66,66,0,1,0,1,0
2908,50367,445,0,0,drop,66,66,0,1,0,1,0
2909,33912,25174,0,0,deny,62,62,0,1,0,1,0
2910,50264,445,0,0,drop,70,70,0,1,0,1,0
2911,65228,53,0,0,deny,88,88,0,1,0,1,0
2912,62208,37965,0,0,deny,66,66,0,1,0,1,0
2913,42417,22114,0,0,deny,62,62,0,1,0,1,0
2914,45964,2225,0,0,deny,60,60,0,1,0,1,0
2915,50259,445,0,0,drop,70,70,0,1,0,1,0
2916,55725,14704,2998,14704,allow,70,70,0,2,8,2,0
2917,35422,443,43455,443,allow,154,94,60,2,5,1,1
2918,9487,443,35248,443,allow,5179,2934,2245,25,32,13,12
2919,53496,443,54389,443,allow,3155,2234,921,15,16,8,7
2920,58481,15503,0,0,deny,146,146,0,1,0,1,0
2921,54955,445,0,0,drop,70,70,0,1,0,1,0
2922,54957,445,0,0,drop,70,70,0,1,0,1,0
2923,54956,445,0,0,drop,70,70,0,1,0,1,0
2924,1025,50584,0,0,deny,62,62,0,1,0,1,0
2925,50350,445,0,0,drop,66,66,0,1,0,1,0
2926,50357,445,0,0,drop,66,66,0,1,0,1,0
2927,50352,445,0,0,drop,66,66,0,1,0,1,0
2928,50356,445,0,0,drop,66,66,0,1,0,1,0
2929,50354,445,0,0,drop,66,66,0,1,0,1,0
2930,50358,445,0,0,drop,66,66,0,1,0,1,0
2931,50353,445,0,0,drop,66,66,0,1,0,1,0
2932,50351,445,0,0,drop,66,66,0,1,0,1,0
2933,443,4512,0,0,deny,60,60,0,1,0,1,0
2934,11337,25773,0,0,reset-both,159,159,0,1,0,1,0
2935,60676,57866,0,0,deny,66,66,0,1,0,1,0
2936,5685,35440,0,0,deny,66,66,0,1,0,1,0
2937,29742,50584,0,0,deny,62,62,0,1,0,1,0
2938,63627,26296,0,0,deny,159,159,0,1,0,1,0
2939,19427,23,0,0,deny,60,60,0,1,0,1,0
2940,49607,25174,0,0,deny,62,62,0,1,0,1,0
2941,3456,11392,0,0,deny,66,66,0,1,0,1,0
2942,54951,445,0,0,drop,70,70,0,1,0,1,0
2943,54947,445,0,0,drop,70,70,0,1,0,1,0
2944,54942,445,0,0,drop,70,70,0,1,0,1,0
2945,54940,445,0,0,drop,70,70,0,1,0,1,0
2946,51993,25174,0,0,deny,62,62,0,1,0,1,0
2947,50246,445,0,0,drop,70,70,0,1,0,1,0
2948,37609,15503,0,0,deny,146,146,0,1,0,1,0
2949,14656,36237,0,0,deny,62,62,0,1,0,1,0
2950,50337,445,0,0,drop,66,66,0,1,0,1,0
2951,50338,445,0,0,drop,66,66,0,1,0,1,0
2952,50335,445,0,0,drop,66,66,0,1,0,1,0
2953,61273,25174,0,0,deny,146,146,0,1,0,1,0
2954,50243,445,0,0,drop,70,70,0,1,0,1,0
2955,6892,36949,0,0,deny,159,159,0,1,0,1,0
2956,62183,57470,0,0,deny,74,74,0,1,0,1,0
2957,56039,50584,0,0,deny,66,66,0,1,0,1,0
2958,58357,62413,0,0,deny,146,146,0,1,0,1,0
2959,54936,445,0,0,drop,70,70,0,1,0,1,0
2960,57236,53733,0,0,deny,62,62,0,1,0,1,0
2961,54934,445,0,0,drop,70,70,0,1,0,1,0
2962,54930,445,0,0,drop,70,70,0,1,0,1,0
2963,54926,445,0,0,drop,70,70,0,1,0,1,0
2964,33453,64147,0,0,deny,62,62,0,1,0,1,0
2965,443,44683,0,0,deny,83,83,0,1,0,1,0
2966,59977,30188,0,0,deny,66,66,0,1,0,1,0
2967,50238,445,0,0,drop,70,70,0,1,0,1,0
2968,58873,443,27496,443,allow,1855088,42017,1813071,1821,49,531,1290
2969,49323,53,12095,53,allow,790,110,680,2,30,1,1
2970,56652,53,23903,53,allow,821,102,719,2,30,1,1
2971,64941,53,8617,53,allow,199,102,97,2,30,1,1
2972,64797,53,56821,53,allow,183,94,89,2,30,1,1
2973,49742,53,44369,53,allow,199,94,105,2,30,1,1
2974,64763,53,53321,53,allow,214,110,104,2,30,1,1
2975,56526,443,31407,443,allow,5082,973,4109,18,60,9,9
2976,49247,80,49247,80,allow,378,180,198,7,53,4,3
2977,64075,1026,24378,1026,allow,70,70,0,1,4,1,0
2978,55893,53,24260,53,allow,267,94,173,4,55,2,2
2979,55318,53,26417,53,allow,167,86,81,2,29,1,1
2980,55465,443,38707,443,allow,12399,3942,8457,83,615,42,41
2981,63433,443,29608,443,allow,1950,1231,719,20,15,12,8
2982,51433,80,51433,80,allow,12796,1635,11161,21,15,8,13
2983,56525,443,34500,443,allow,5022,973,4049,17,60,9,8
2984,65234,53,35438,53,allow,193,102,91,2,30,1,1
2985,38714,443,54689,443,allow,90043,3609,86434,97,15,33,64
2986,50080,443,5025,443,allow,15595,3264,12331,26,35,14,12
2987,49272,53,2689,53,allow,198,102,96,2,29,1,1
2988,53960,61038,13704,61038,allow,552,306,246,9,14,5,4
2989,53985,26515,51989,26515,allow,70,70,0,2,7,2,0
2990,57431,53,12541,53,allow,181,94,87,2,29,1,1
2991,46719,443,39379,443,allow,7261,3272,3989,22,45,13,9
2992,52227,27904,24192,27904,allow,316,136,180,6,9,3,3
2993,56971,53,24481,53,allow,195,102,93,2,30,1,1
2994,53983,40500,52248,40500,allow,70,70,0,2,7,2,0
2995,52205,24416,50314,24416,allow,136,136,0,3,13,3,0
2996,49714,53,19961,53,allow,490,101,389,4,45,2,2
2997,58785,53,54759,53,allow,211,86,125,2,30,1,1
2998,50332,53,15195,53,allow,193,102,91,2,29,1,1
2999,49402,53,62978,53,allow,214,110,104,2,30,1,1
3000,52200,42430,15926,42430,allow,66,66,0,2,10,2,0
3001,57631,443,64255,443,allow,154,94,60,2,5,1,1
3002,53273,443,62514,443,allow,17169,6566,10603,52,37,24,28
3003,43829,443,59022,443,allow,368,160,208,6,33,3,3
3004,50544,53,6922,53,allow,193,102,91,2,30,1,1
3005,57269,53,63044,53,allow,183,94,89,2,30,1,1
3006,49480,53,47457,53,allow,184,94,90,2,30,1,1
3007,64750,53,43856,53,allow,193,102,91,2,30,1,1
3008,49003,53,49003,53,allow,262,106,156,2,32,1,1
3009,56750,80,10595,80,allow,194,128,66,4,25,3,1
3010,65294,53,7465,53,allow,184,102,82,2,30,1,1
3011,44724,443,7111,443,allow,4383,2829,1554,27,80,14,13
3012,55049,443,10286,443,allow,12851,3808,9043,30,61,16,14
3013,9463,443,40374,443,allow,8952,5576,3376,35,38,21,14
3014,39915,443,9924,443,allow,15058,8409,6649,40,271,21,19
3015,50544,53,48893,53,allow,816,102,714,2,30,1,1
3016,42947,53,42947,53,allow,260,106,154,2,33,1,1
3017,64640,53,17711,53,allow,249,94,155,2,30,1,1
3018,37653,5223,53311,5223,allow,70,70,0,1,5,1,0
3019,55726,32463,13679,32463,allow,70,70,0,2,8,2,0
3020,52050,80,59091,80,allow,20868,10484,10384,34,32,17,17
3021,65389,53,2887,53,allow,215,102,113,2,30,1,1
3022,9334,443,58101,443,allow,674,128,546,12,46,3,9
3023,51506,443,39609,443,allow,4869,699,4170,14,15,8,6
3024,56652,53,12784,53,allow,198,102,96,2,30,1,1
3025,55053,443,38835,443,allow,23234,3906,19328,40,61,19,21
3026,65294,53,37568,53,allow,168,86,82,2,30,1,1
3027,64268,53,55887,53,allow,679,179,500,6,69,3,3
3028,65461,53,60419,53,allow,226,94,132,2,30,1,1
3029,56688,53,20462,53,allow,196,102,94,2,30,1,1
3030,64685,53,55702,53,allow,193,102,91,2,30,1,1
3031,55490,443,55467,443,allow,3080,1018,2062,10,120,5,5
3032,50241,53,51739,53,allow,184,102,82,2,30,1,1
3033,52204,36387,46788,36387,allow,136,136,0,3,13,3,0
3034,51995,443,36323,443,allow,9966,5049,4917,41,15,25,16
3035,51121,443,8150,443,allow,5553,2844,2709,21,30,11,10
3036,57134,53,41374,53,allow,195,102,93,2,30,1,1
3037,55478,53,55747,53,allow,177,94,83,2,30,1,1
3038,55072,53,59629,53,allow,177,94,83,2,30,1,1
3039,19573,53,49198,53,allow,183,78,105,2,30,1,1
3040,49480,53,12824,53,allow,184,94,90,2,30,1,1
3041,57436,53,46375,53,allow,183,94,89,2,30,1,1
3042,55958,53,32998,53,allow,177,94,83,2,30,1,1
3043,64128,53,26433,53,allow,193,102,91,2,30,1,1
3044,57436,53,1607,53,allow,183,94,89,2,30,1,1
3045,49402,53,18505,53,allow,214,110,104,2,30,1,1
3046,57063,53,34748,53,allow,177,94,83,2,30,1,1
3047,52202,64241,19062,64241,allow,250,66,184,4,9,2,2
3048,52195,50930,54222,50930,allow,70,70,0,1,5,1,0
3049,57512,443,32314,443,allow,4265,2639,1626,34,31,16,18
3050,9464,443,61543,443,allow,9340,5582,3758,36,38,21,15
3051,9477,443,41654,443,allow,7461,1448,6013,22,35,11,11
3052,52930,443,25439,443,allow,4596,1029,3567,15,26,9,6
3053,49701,53,45217,53,allow,523,92,431,4,48,2,2
3054,55050,443,4346,443,allow,7372,2875,4497,23,61,13,10
3055,55958,53,17152,53,allow,177,94,83,2,30,1,1
3056,58306,443,35402,443,allow,5995,3536,2459,31,20,17,14
3057,52432,443,37828,443,allow,330,190,140,6,15,4,2
3058,36433,80,4245,80,allow,1585,863,722,12,15,6,6
3059,49237,8080,49237,8080,allow,4451,1329,3122,13,53,7,6
3060,55062,53,27959,53,allow,194,94,100,2,31,1,1
3061,57574,443,57574,443,allow,164451,18310,146141,163,175,52,111
3062,50425,443,27749,443,allow,4600,667,3933,14,17,7,7
3063,39550,80,36745,80,allow,1598,731,867,17,362,8,9
3064,56747,80,7383,80,allow,194,128,66,4,25,3,1
3065,53953,34661,36111,34661,allow,552,306,246,9,15,5,4
3066,56748,80,43315,80,allow,194,128,66,4,25,3,1
3067,53986,54070,21018,54070,allow,70,70,0,2,7,2,0
3068,50420,443,27192,443,allow,648,210,438,10,27,4,6
3069,49236,8080,49236,8080,allow,4458,1336,3122,13,53,7,6
3070,49246,80,49246,80,allow,378,180,198,7,53,4,3
3071,52241,51717,30281,51717,allow,70,70,0,2,5,2,0
3072,49241,8080,49241,8080,allow,12477,3635,8842,23,55,13,10
3073,55893,53,45153,53,allow,267,94,173,4,56,2,2
3074,52239,1172,16970,1172,allow,256,136,120,5,5,3,2
3075,56204,53,64652,53,allow,168,86,82,2,29,1,1
3076,64093,64828,28561,64828,allow,66,66,0,2,7,2,0
3077,3470,53,3470,53,allow,217,82,135,2,32,1,1
3078,56822,53,57328,53,allow,184,94,90,2,29,1,1
3079,52160,443,26040,443,allow,956,420,536,15,26,7,8
3080,53982,24226,50334,24226,allow,70,70,0,2,7,2,0
3081,55107,53,60741,53,allow,184,94,90,2,29,1,1
3082,52198,12727,50505,12727,allow,66,66,0,2,10,2,0
3083,55724,45682,40719,45682,allow,70,70,0,2,8,2,0
3084,65070,53,12563,53,allow,198,102,96,2,30,1,1
3085,64044,21989,15782,21989,allow,816,508,308,12,27,7,5
3086,53987,16571,41017,16571,allow,70,70,0,2,7,2,0
3087,52398,443,30861,443,allow,323437,18923,304514,544,252,276,268
3088,58755,53,43262,53,allow,277,102,175,2,30,1,1
3089,64815,53,31191,53,allow,214,110,104,2,30,1,1
3090,52199,35549,28334,35549,allow,66,66,0,2,10,2,0
3091,56765,53,25229,53,allow,194,102,92,2,29,1,1
3092,59897,443,39118,443,allow,9919,4495,5424,53,118,30,23
3093,55088,53,51001,53,allow,177,94,83,2,29,1,1
3094,52931,443,64191,443,allow,416,210,206,7,26,4,3
3095,50332,53,12740,53,allow,193,102,91,2,29,1,1
3096,56748,53,37401,53,allow,184,94,90,2,30,1,1
3097,49775,80,50741,80,allow,254,128,126,5,16,3,2
3098,56439,53,49648,53,allow,198,102,96,2,29,1,1
3099,65258,53,18646,53,allow,763,102,661,2,30,1,1
3100,56677,53,61027,53,allow,200,102,98,2,30,1,1
3101,56863,53,37391,53,allow,177,94,83,2,30,1,1
3102,64797,53,6795,53,allow,183,94,89,2,30,1,1
3103,49870,53,17515,53,allow,194,102,92,2,30,1,1
3104,57436,53,48007,53,allow,183,94,89,2,30,1,1
3105,49418,53,2882,53,allow,165,86,79,2,30,1,1
3106,65229,53,28081,53,allow,195,102,93,2,30,1,1
3107,50369,53,47601,53,allow,166,86,80,2,30,1,1
3108,37574,123,51434,123,allow,184,94,90,2,30,1,1
3109,49308,53,30302,53,allow,195,102,93,2,31,1,1
3110,64941,53,17276,53,allow,199,102,97,2,30,1,1
3111,55072,53,7801,53,allow,177,94,83,2,30,1,1
3112,49254,53,47857,53,allow,173,94,79,2,30,1,1
3113,55072,53,28531,53,allow,177,94,83,2,30,1,1
3114,57398,53,40796,53,allow,196,94,102,2,31,1,1
3115,32299,40021,3069,40021,allow,148,86,62,2,31,1,1
3116,53259,443,6892,443,allow,5513,929,4584,20,360,10,10
3117,52434,80,48898,80,allow,1647,481,1166,13,15,6,7
3118,52193,33027,51097,33027,allow,70,70,0,1,5,1,0
3119,56971,53,47465,53,allow,195,102,93,2,30,1,1
3120,64763,53,14685,53,allow,214,110,104,2,30,1,1
3121,56765,53,28041,53,allow,194,102,92,2,30,1,1
3122,64797,53,38007,53,allow,183,94,89,2,30,1,1
3123,65465,53,62433,53,allow,372,126,246,2,30,1,1
3124,57063,53,54503,53,allow,177,94,83,2,30,1,1
3125,57134,53,42837,53,allow,195,102,93,2,30,1,1
3126,49402,53,34826,53,allow,214,110,104,2,30,1,1
3127,57396,53,7718,53,allow,184,94,90,2,30,1,1
3128,51714,123,49877,123,allow,184,94,90,2,30,1,1
3129,55879,53,59038,53,allow,184,94,90,2,30,1,1
3130,51391,443,62057,443,allow,9973,1941,8032,38,121,19,19
3131,15503,63093,6070,63093,allow,481,150,331,2,1200,1,1
3132,56163,53,47774,53,allow,194,102,92,2,30,1,1
3133,57588,443,14769,443,allow,7629,3270,4359,34,337,17,17
3134,56749,80,24129,80,allow,194,128,66,4,25,3,1
3135,52201,44054,12966,44054,allow,66,66,0,2,9,2,0
3136,55722,26192,51333,26192,allow,70,70,0,1,5,1,0
3137,35516,80,25484,80,allow,841,715,126,5,15,3,2
3138,64815,53,51366,53,allow,214,110,104,2,30,1,1
3139,49870,53,59356,53,allow,194,102,92,2,30,1,1
3140,64599,53,27573,53,allow,398,102,296,2,30,1,1
3141,56439,53,18376,53,allow,198,102,96,2,30,1,1
3142,34107,443,34100,443,allow,11976,5066,6910,83,2475,43,40
3143,65181,53,41975,53,allow,421,96,325,4,42,2,2
3144,9444,443,26906,443,allow,7353,1570,5783,22,39,11,11
3145,9443,443,55182,443,allow,7398,1480,5918,24,39,12,12
3146,60990,443,42071,443,allow,212824,12881,199943,244,49,101,143
3147,52425,443,14303,443,allow,64135,3588,60547,88,40,38,50
3148,65070,53,45301,53,allow,821,102,719,2,30,1,1
3149,64748,53,54658,53,allow,212,102,110,2,30,1,1
3150,64941,53,15219,53,allow,199,102,97,2,30,1,1
3151,50241,53,32622,53,allow,184,102,82,2,30,1,1
3152,56341,53,11727,53,allow,243,94,149,2,30,1,1
3153,65229,53,50271,53,allow,195,102,93,2,30,1,1
3154,57396,53,20662,53,allow,807,94,713,2,30,1,1
3155,64685,53,47182,53,allow,193,102,91,2,30,1,1
3156,49308,53,4514,53,allow,195,102,93,2,30,1,1
3157,49703,53,62145,53,allow,228,110,118,2,30,1,1
3158,64980,53,1256,53,allow,199,102,97,2,31,1,1
3159,54998,53,21655,53,allow,198,102,96,2,31,1,1
3160,44889,443,7395,443,allow,9982,2062,7920,37,120,19,18
3161,49499,443,1804,443,allow,5541,2623,2918,28,144,15,13
3162,57470,40794,36042,40794,allow,132,132,0,3,1199,3,0
3163,57072,53,34434,53,allow,193,102,91,2,30,1,1
3164,56332,53,17265,53,allow,193,102,91,2,30,1,1
3165,55025,53,14358,53,allow,183,94,89,2,31,1,1
3166,56332,53,36197,53,allow,193,102,91,2,31,1,1
3167,65234,53,58797,53,allow,193,102,91,2,31,1,1
3168,64710,53,45310,53,allow,195,102,93,2,31,1,1
3169,37334,443,47156,443,allow,6592,1735,4857,23,360,11,12
3170,44847,37005,6154,37005,allow,150,150,0,1,1200,1,0
3171,50584,6881,26330,6881,allow,502,150,352,2,1200,1,1
3172,56226,53,55576,53,allow,512,187,325,6,58,3,3
3173,52189,24190,59596,24190,allow,70,70,0,1,5,1,0
3174,52236,15313,56383,15313,allow,70,70,0,2,5,2,0
3175,37673,443,65454,443,allow,3226,2225,1001,18,47,11,7
3176,52217,36746,31872,36746,allow,316,136,180,6,9,3,3
3177,53955,3290,25446,3290,allow,70,70,0,1,5,1,0
3178,52054,80,38291,80,allow,41406,4176,37230,57,32,25,32
3179,51992,443,50696,443,allow,1083,596,487,11,16,7,4
3180,57914,80,49885,80,allow,6527,1210,5317,15,18,8,7
3181,49998,443,24613,443,allow,24410,6698,17712,32,16,13,19
3182,52223,11979,36766,11979,allow,70,70,0,2,9,2,0
3183,51993,443,1370,443,allow,1209,656,553,13,16,8,5
3184,6897,48817,0,0,deny,139,139,0,1,0,1,0
3185,50237,445,0,0,drop,70,70,0,1,0,1,0
3186,32424,25174,0,0,deny,146,146,0,1,0,1,0
3187,26762,22114,0,0,deny,62,62,0,1,0,1,0
3188,60141,30188,0,0,deny,66,66,0,1,0,1,0
3189,65417,44847,0,0,deny,66,66,0,1,0,1,0
3190,50235,445,0,0,drop,70,70,0,1,0,1,0
3191,52812,25174,0,0,deny,66,66,0,1,0,1,0
3192,63050,57470,0,0,deny,74,74,0,1,0,1,0
3193,11983,57470,0,0,deny,62,62,0,1,0,1,0
3194,59096,8604,0,0,deny,66,66,0,1,0,1,0
3195,57846,57866,0,0,deny,66,66,0,1,0,1,0
3196,32484,2323,0,0,deny,60,60,0,1,0,1,0
3197,54916,445,0,0,drop,70,70,0,1,0,1,0
3198,54913,445,0,0,drop,70,70,0,1,0,1,0
3199,54911,445,0,0,drop,70,70,0,1,0,1,0
3200,50325,445,0,0,drop,66,66,0,1,0,1,0
3201,50228,445,0,0,drop,70,70,0,1,0,1,0
3202,53260,36237,0,0,deny,62,62,0,1,0,1,0
3203,50226,445,0,0,drop,70,70,0,1,0,1,0
3204,58148,43890,0,0,deny,62,62,0,1,0,1,0
3205,50225,445,0,0,drop,70,70,0,1,0,1,0
3206,36357,25174,0,0,deny,66,66,0,1,0,1,0
3207,50224,445,0,0,drop,70,70,0,1,0,1,0
3208,54910,445,0,0,drop,70,70,0,1,0,1,0
3209,50223,445,0,0,drop,70,70,0,1,0,1,0
3210,443,44683,0,0,deny,83,83,0,1,0,1,0
3211,50219,445,0,0,drop,70,70,0,1,0,1,0
3212,50217,445,0,0,drop,70,70,0,1,0,1,0
3213,60861,25174,0,0,deny,66,66,0,1,0,1,0
3214,56876,11392,0,0,deny,66,66,0,1,0,1,0
3215,54909,445,0,0,drop,70,70,0,1,0,1,0
3216,40772,15503,0,0,deny,74,74,0,1,0,1,0
3217,52340,22114,0,0,deny,66,66,0,1,0,1,0
3218,50310,445,0,0,drop,66,66,0,1,0,1,0
3219,50308,445,0,0,drop,66,66,0,1,0,1,0
3220,62919,9694,0,0,deny,146,146,0,1,0,1,0
3221,50198,445,0,0,drop,70,70,0,1,0,1,0
3222,50205,445,0,0,drop,70,70,0,1,0,1,0
3223,50204,445,0,0,drop,70,70,0,1,0,1,0
3224,30303,22530,0,0,deny,169,169,0,1,0,1,0
3225,50195,445,0,0,drop,70,70,0,1,0,1,0
3226,50194,445,0,0,drop,70,70,0,1,0,1,0
3227,52518,35440,0,0,deny,62,62,0,1,0,1,0
3228,54898,445,0,0,drop,70,70,0,1,0,1,0
3229,54899,445,0,0,drop,70,70,0,1,0,1,0
3230,54895,445,0,0,drop,70,70,0,1,0,1,0
3231,54892,445,0,0,drop,70,70,0,1,0,1,0
3232,53721,62413,0,0,deny,62,62,0,1,0,1,0
3233,6889,34962,0,0,deny,143,143,0,1,0,1,0
3234,52969,44847,0,0,deny,62,62,0,1,0,1,0
3235,50303,445,0,0,drop,66,66,0,1,0,1,0
3236,11494,51505,0,0,deny,146,146,0,1,0,1,0
3237,443,44683,0,0,deny,83,83,0,1,0,1,0
3238,64406,25174,0,0,deny,66,66,0,1,0,1,0
3239,50291,445,0,0,drop,66,66,0,1,0,1,0
3240,50296,445,0,0,drop,66,66,0,1,0,1,0
3241,50293,445,0,0,drop,66,66,0,1,0,1,0
3242,50288,445,0,0,drop,66,66,0,1,0,1,0
3243,50295,445,0,0,drop,66,66,0,1,0,1,0
3244,50297,445,0,0,drop,66,66,0,1,0,1,0
3245,50287,445,0,0,drop,66,66,0,1,0,1,0
3246,50183,445,0,0,drop,70,70,0,1,0,1,0
3247,443,62514,0,0,deny,66,66,0,1,0,1,0
3248,54882,445,0,0,drop,70,70,0,1,0,1,0
3249,54598,37965,0,0,deny,62,62,0,1,0,1,0
3250,54880,445,0,0,drop,70,70,0,1,0,1,0
3251,54879,445,0,0,drop,70,70,0,1,0,1,0
3252,54876,445,0,0,drop,70,70,0,1,0,1,0
3253,56067,25174,0,0,deny,62,62,0,1,0,1,0
3254,50990,23884,0,0,deny,62,62,0,1,0,1,0
3255,50127,64147,0,0,deny,66,66,0,1,0,1,0
3256,0,0,0,0,allow,480,244,236,4,0,2,2
3257,62902,32468,0,0,deny,66,66,0,1,0,1,0
3258,50179,445,0,0,drop,70,70,0,1,0,1,0
3259,54874,445,0,0,drop,70,70,0,1,0,1,0
3260,54869,445,0,0,drop,70,70,0,1,0,1,0
3261,54868,445,0,0,drop,70,70,0,1,0,1,0
3262,443,50238,0,0,deny,331,331,0,1,0,1,0
3263,50169,445,0,0,drop,70,70,0,1,0,1,0
3264,50167,445,0,0,drop,70,70,0,1,0,1,0
3265,50170,445,0,0,drop,70,70,0,1,0,1,0
3266,50280,445,0,0,drop,66,66,0,1,0,1,0
3267,50164,445,0,0,drop,70,70,0,1,0,1,0
3268,54867,445,0,0,drop,70,70,0,1,0,1,0
3269,52033,50584,0,0,deny,66,66,0,1,0,1,0
3270,443,45788,0,0,deny,332,332,0,1,0,1,0
3271,50162,445,0,0,drop,70,70,0,1,0,1,0
3272,50279,445,0,0,drop,66,66,0,1,0,1,0
3273,58253,25174,0,0,deny,146,146,0,1,0,1,0
3274,7701,23,0,0,deny,60,60,0,1,0,1,0
3275,50277,445,0,0,drop,66,66,0,1,0,1,0
3276,50276,445,0,0,drop,66,66,0,1,0,1,0
3277,35610,37965,0,0,deny,62,62,0,1,0,1,0
3278,443,44683,0,0,deny,83,83,0,1,0,1,0
3279,50274,445,0,0,drop,66,66,0,1,0,1,0
3280,53318,22114,0,0,deny,66,66,0,1,0,1,0
3281,33132,123,0,0,deny,234,234,0,1,0,1,0
3282,34993,15503,0,0,deny,62,62,0,1,0,1,0
3283,43671,17372,0,0,deny,62,62,0,1,0,1,0
3284,50156,445,0,0,drop,70,70,0,1,0,1,0
3285,49594,22114,0,0,deny,66,66,0,1,0,1,0
3286,54857,445,0,0,drop,70,70,0,1,0,1,0
3287,27745,50584,0,0,deny,62,62,0,1,0,1,0
3288,54849,445,0,0,drop,70,70,0,1,0,1,0
3289,27448,22114,0,0,deny,62,62,0,1,0,1,0
3290,443,9986,0,0,deny,669,669,0,1,0,1,0
3291,50263,445,0,0,drop,66,66,0,1,0,1,0
3292,50149,445,0,0,drop,70,70,0,1,0,1,0
3293,30270,37965,0,0,deny,62,62,0,1,0,1,0
3294,50146,445,0,0,drop,70,70,0,1,0,1,0
3295,44784,443,49876,443,allow,12834,7868,4966,60,463,38,22
3296,56790,443,12015,443,allow,8073,2053,6020,20,16,11,9
3297,52221,33166,34754,33166,allow,70,70,0,2,8,2,0
3298,57468,2258,57468,2258,allow,156,156,0,3,8,3,0
3299,53961,13067,4497,13067,allow,70,70,0,1,5,1,0
3300,59339,80,59339,80,allow,107838,4143,103695,178,15,59,119
3301,50337,53,56473,53,allow,762,97,665,2,30,1,1
3302,64710,53,31226,53,allow,190,97,93,2,30,1,1
3303,47598,443,10751,443,allow,22048,16451,5597,47,18,21,26
3304,38537,443,38537,443,allow,4662,1755,2907,19,30,11,8
3305,60884,443,1605,443,allow,6505,2038,4467,26,46,15,11
3306,5588,5588,0,0,allow,3354,1792,1562,46,194,23,23
3307,65234,53,64779,53,allow,186,95,91,2,31,1,1
3308,49459,53,24594,53,allow,198,101,97,2,30,1,1
3309,49308,53,20210,53,allow,190,97,93,2,30,1,1
3310,7968,53,7968,53,allow,407,261,146,3,32,2,1
3311,8082,53,8082,53,allow,237,91,146,2,33,1,1
3312,64883,53,13274,53,allow,184,94,90,2,31,1,1
3313,59340,80,59340,80,allow,24437,12718,11719,41,15,16,25
3314,52186,57609,42161,57609,allow,66,66,0,1,5,1,0
3315,56792,443,43093,443,allow,8074,2054,6020,20,15,11,9
3316,56791,443,55063,443,allow,8021,2001,6020,20,15,11,9
3317,36551,443,34195,443,allow,8674,2101,6573,25,15,13,12
3318,51754,7000,51754,7000,allow,4727,2346,2381,19,16,12,7
3319,10436,53,10436,53,allow,237,91,146,2,32,1,1
3320,56247,53,34021,53,allow,751,95,656,2,30,1,1
3321,64089,20260,49240,20260,allow,66,66,0,2,8,2,0
3322,52225,31985,22878,31985,allow,70,70,0,2,8,2,0
3323,55879,53,40028,53,allow,184,94,90,2,30,1,1
3324,48471,443,48471,443,allow,4381,1474,2907,19,26,11,8
3325,5588,5588,0,0,allow,3354,1792,1562,46,193,23,23
3326,57115,53,47701,53,allow,172,88,84,2,30,1,1
3327,36499,53,58408,53,allow,302,208,94,3,30,2,1
3328,42982,443,14998,443,allow,7467,1522,5945,26,16,14,12
3329,49941,53,34590,53,allow,186,95,91,2,31,1,1
3330,64242,53,44715,53,allow,176,90,86,2,31,1,1
3331,43718,53,43718,53,allow,209,77,132,2,34,1,1
3332,7975,53,7975,53,allow,237,91,146,2,33,1,1
3333,64684,53,19854,53,allow,184,94,90,2,31,1,1
3334,58077,36653,28921,36653,allow,268,128,140,5,10,3,2
3335,52184,57262,17429,57262,allow,66,66,0,1,5,1,0
3336,64685,53,52958,53,allow,186,95,91,2,30,1,1
3337,58653,53,0,0,allow,82,82,0,1,30,1,0
3338,57288,53,62463,53,allow,770,101,669,2,30,1,1
3339,56332,53,50254,53,allow,186,95,91,2,30,1,1
3340,65408,53,61605,53,allow,764,99,665,2,30,1,1
3341,56606,53,17065,53,allow,762,97,665,2,31,1,1
3342,49370,443,17640,443,allow,350,210,140,6,16,4,2
3343,65206,53,9006,53,allow,762,98,664,2,30,1,1
3344,55161,53,9497,53,allow,732,89,643,2,30,1,1
3345,55579,53,14828,53,allow,172,88,84,2,30,1,1
3346,51808,443,64378,443,allow,3871,1166,2705,13,136,6,7
3347,39895,443,43258,443,allow,10727,3308,7419,33,503,15,18
3348,53625,53,53625,53,allow,643,88,555,2,31,1,1
3349,55273,53,3281,53,allow,764,99,665,2,31,1,1
3350,64770,53,63194,53,allow,93,93,0,1,31,1,0
3351,64639,53,5053,53,allow,198,101,97,2,31,1,1
3352,57181,53,16955,53,allow,753,96,657,2,31,1,1
3353,50334,443,29587,443,allow,3193,346,2847,12,121,5,7
3354,5588,5588,0,0,allow,3354,1792,1562,46,194,23,23
3355,50455,53,22933,53,allow,756,95,661,2,30,1,1
3356,57378,53,2616,53,allow,756,95,661,2,31,1,1
3357,55799,53,31223,53,allow,752,93,659,2,31,1,1
3358,64283,53,28343,53,allow,186,95,91,2,31,1,1
3359,59777,443,22920,443,allow,19311,2432,16879,55,417,24,31
3360,56864,53,65006,53,allow,200,102,98,2,31,1,1
3361,55265,53,47317,53,allow,198,101,97,2,31,1,1
3362,10151,27949,13472,27949,allow,469,149,320,2,1200,1,1
3363,54596,443,49824,443,allow,4510,2210,2300,14,136,7,7
3364,59537,443,51089,443,allow,3351,841,2510,13,136,6,7
3365,56622,53,51149,53,allow,757,98,659,2,31,1,1
3366,56446,443,1598,443,allow,16401,10833,5568,32,362,18,14
3367,53125,443,24442,443,allow,3358,1952,1406,16,360,8,8
3368,18574,56205,0,0,deny,62,62,0,1,0,1,0
3369,53089,24211,0,0,deny,66,66,0,1,0,1,0
3370,50255,445,0,0,drop,66,66,0,1,0,1,0
3371,52863,50584,0,0,deny,66,66,0,1,0,1,0
3372,50143,445,0,0,drop,70,70,0,1,0,1,0
3373,54839,445,0,0,drop,70,70,0,1,0,1,0
3374,50141,445,0,0,drop,70,70,0,1,0,1,0
3375,57325,37965,0,0,deny,62,62,0,1,0,1,0
3376,50367,37965,0,0,deny,66,66,0,1,0,1,0
3377,18745,64147,0,0,deny,66,66,0,1,0,1,0
3378,28999,37807,0,0,deny,62,62,0,1,0,1,0
3379,64949,44847,0,0,deny,62,62,0,1,0,1,0
3380,56775,9200,31796,9200,allow,8223,3066,5157,30,33,15,15
3381,55879,53,11765,53,allow,184,94,90,2,30,1,1
3382,38690,443,27226,443,allow,8871,3470,5401,24,123,13,11
3383,56603,53,24241,53,allow,179,94,85,2,30,1,1
3384,51848,443,58021,443,allow,68198,5503,62695,102,40,43,59
3385,51596,443,63040,443,allow,4638384,61757,4576627,3641,280,309,3332
3386,52190,29765,59554,29765,allow,70,70,0,1,4,1,0
3387,52187,38153,27552,38153,allow,70,70,0,1,4,1,0
3388,64041,53,28808,53,allow,380,92,288,4,37,2,2
3389,57354,53,64428,53,allow,198,94,104,2,29,1,1
3390,49929,53,44359,53,allow,214,110,104,2,29,1,1
3391,57134,53,24003,53,allow,195,102,93,2,29,1,1
3392,60473,22170,57823,22170,allow,1599,743,856,13,36,7,6
3393,53944,23280,32203,23280,allow,1740,834,906,16,16,10,6
3394,52188,13182,17024,13182,allow,70,70,0,1,4,1,0
3395,51994,443,26093,443,allow,330,190,140,6,15,4,2
3396,64685,53,12212,53,allow,534,193,341,6,78,3,3
3397,64997,53,32660,53,allow,771,102,669,2,29,1,1
3398,64856,53,25050,53,allow,451,124,327,4,45,2,2
3399,49459,53,5838,53,allow,199,102,97,2,29,1,1
3400,49254,53,63665,53,allow,173,94,79,2,29,1,1
3401,60914,53,60914,53,allow,180,82,98,2,29,1,1
3402,52219,37398,8768,37398,allow,316,136,180,6,8,3,3
3403,52185,13269,13389,13269,allow,70,70,0,1,4,1,0
3404,57072,53,31261,53,allow,816,102,714,2,29,1,1
3405,53962,16251,51780,16251,allow,70,70,0,1,4,1,0
3406,49586,53,25001,53,allow,212,94,118,2,29,1,1
3407,52226,48784,24421,48784,allow,70,70,0,2,8,2,0
3408,54998,53,23774,53,allow,198,102,96,2,29,1,1
3409,64088,39650,57206,39650,allow,66,66,0,2,7,2,0
3410,52237,16801,36529,16801,allow,70,70,0,2,4,2,0
3411,64883,53,48996,53,allow,184,94,90,2,30,1,1
3412,55255,53,4437,53,allow,282,94,188,2,29,1,1
3413,50369,53,17923,53,allow,166,86,80,2,29,1,1
3414,56424,53,45965,53,allow,177,94,83,2,29,1,1
3415,64885,53,14280,53,allow,261,102,159,2,29,1,1
3416,48982,53,28037,53,allow,306,212,94,3,29,2,1
3417,55462,53,64670,53,allow,214,110,104,2,29,1,1
3418,64980,53,27979,53,allow,199,102,97,2,29,1,1
3419,123,123,40397,123,allow,184,94,90,2,30,1,1
3420,44945,80,24197,80,allow,1729,1287,442,7,15,5,2
3421,51911,443,51829,443,allow,4456,2972,1484,38,211,20,18
3422,47831,443,18559,443,allow,180582,6020,174562,196,200,70,126
3423,64641,53,5011,53,allow,260,102,158,2,30,1,1
3424,64968,53,62769,53,allow,767,102,665,2,30,1,1
3425,55372,53,44494,53,allow,199,102,97,2,30,1,1
3426,49907,53,22787,53,allow,199,102,97,2,30,1,1
3427,49342,53,2621,53,allow,200,102,98,2,30,1,1
3428,47665,443,4370,443,allow,214,140,74,4,15,3,1
3429,64490,53,23595,53,allow,280,118,162,2,30,1,1
3430,64175,53,22231,53,allow,453,100,353,4,57,2,2
3431,50700,80,7989,80,allow,142,142,0,1,5,1,0
3432,64495,53,28201,53,allow,243,94,149,2,30,1,1
3433,64988,53,6131,53,allow,360,110,250,2,30,1,1
3434,55723,80,12672,80,allow,70,70,0,2,8,2,0
3435,50709,80,40115,80,allow,1658,1247,411,8,15,5,3
3436,65344,53,6284,53,allow,211,102,109,2,30,1,1
3437,57381,443,25601,443,allow,4645,700,3945,12,15,8,4
3438,65366,53,65366,53,allow,244,98,146,2,33,1,1
3439,49853,53,4793,53,allow,291,102,189,2,30,1,1
3440,41741,443,63716,443,allow,20594,4629,15965,46,317,29,17
3441,50755,80,64278,80,allow,1783,1346,437,7,15,5,2
3442,56424,53,21857,53,allow,177,94,83,2,30,1,1
3443,62054,443,20146,443,allow,10596,3874,6722,30,62,17,13
3444,56163,53,9366,53,allow,194,102,92,2,30,1,1
3445,55617,53,46139,53,allow,214,110,104,2,30,1,1
3446,64883,53,2709,53,allow,184,94,90,2,30,1,1
3447,49437,53,49111,53,allow,498,204,294,6,30,3,3
3448,64712,53,1546,53,allow,177,94,83,2,30,1,1
3449,51812,443,55280,443,allow,10741,7368,3373,32,135,16,16
3450,57144,53,45834,53,allow,178,94,84,2,30,1,1
3451,57411,443,31872,443,allow,214,140,74,4,15,3,1
3452,64096,1127,15786,1127,allow,312,132,180,6,6,3,3
3453,47832,443,4961,443,allow,130090,7064,123026,184,200,92,92
3454,41298,443,14805,443,allow,2974,1378,1596,28,34,15,13
3455,49764,443,46462,443,allow,114197,7285,106912,177,77,85,92
3456,55516,53,62536,53,allow,211,102,109,2,30,1,1
3457,28280,53,52004,53,allow,168,78,90,2,30,1,1
3458,50079,443,34341,443,allow,7274,2208,5066,26,255,14,12
3459,49326,53,31358,53,allow,193,102,91,2,31,1,1
3460,60805,20010,5973,20010,allow,70,70,0,1,5,1,0
3461,39537,8245,49028,8245,allow,280,214,66,2,30,1,1
3462,55579,53,62219,53,allow,178,94,84,2,30,1,1
3463,49941,53,13341,53,allow,193,102,91,2,30,1,1
3464,48994,443,64205,443,allow,46452,6817,39635,103,299,45,58
3465,51001,443,45191,443,allow,5841,1986,3855,19,18,11,8
3466,53949,42301,56593,42301,allow,1396,719,677,15,15,8,7
3467,52222,11516,64024,11516,allow,70,70,0,2,8,2,0
3468,60496,56871,22838,56871,allow,504,318,186,8,15,5,3
3469,52191,32843,31336,32843,allow,70,70,0,1,4,1,0
3470,50699,80,24288,80,allow,7292,3171,4121,19,21,11,8
3471,37694,80,28033,80,allow,1190,591,599,8,15,5,3
3472,52220,65128,43562,65128,allow,70,70,0,2,8,2,0
3473,52238,48996,6858,48996,allow,70,70,0,2,4,2,0
3474,43586,443,62166,443,allow,2328,1429,899,18,33,10,8
3475,43701,3389,43701,3389,allow,3910,1805,2105,20,19,12,8
3476,55893,53,44273,53,allow,267,94,173,4,55,2,2
3477,44320,443,32394,443,allow,154,94,60,2,4,1,1
3478,64750,53,24687,53,allow,193,102,91,2,29,1,1
3479,52701,443,13239,443,allow,130,70,60,3,5,2,1
3480,49352,53,51513,53,allow,216,102,114,2,29,1,1
3481,55071,53,30463,53,allow,356,118,238,2,29,1,1
3482,46593,28678,34181,28678,allow,1806,1806,0,22,224,22,0
3483,56424,53,8677,53,allow,177,94,83,2,29,1,1
3484,57409,443,54706,443,allow,1054,567,487,10,15,6,4
3485,55462,53,19938,53,allow,214,110,104,2,29,1,1
3486,51688,123,9497,123,allow,184,94,90,2,29,1,1
3487,64242,53,3579,53,allow,180,94,86,2,30,1,1
3488,55144,53,13694,53,allow,316,94,222,2,29,1,1
3489,57115,53,18402,53,allow,178,94,84,2,30,1,1
3490,44517,53,22276,53,allow,306,212,94,3,29,2,1
3491,55879,53,9895,53,allow,184,94,90,2,29,1,1
3492,49418,53,32330,53,allow,165,86,79,2,29,1,1
3493,57115,53,57243,53,allow,178,94,84,2,29,1,1
3494,32299,40019,4671,40019,allow,148,86,62,2,30,1,1
3495,49929,53,53934,53,allow,214,110,104,2,30,1,1
3496,64710,53,1727,53,allow,195,102,93,2,29,1,1
3497,64684,53,47246,53,allow,184,94,90,2,30,1,1
3498,55617,53,20605,53,allow,214,110,104,2,30,1,1
3499,64684,53,48311,53,allow,184,94,90,2,30,1,1
3500,64171,53,30410,53,allow,94,94,0,1,30,1,0
3501,49459,53,33594,53,allow,199,102,97,2,30,1,1
3502,123,123,12424,123,allow,184,94,90,2,30,1,1
3503,57144,53,55905,53,allow,178,94,84,2,30,1,1
3504,65236,53,5620,53,allow,758,102,656,2,30,1,1
3505,55372,53,36344,53,allow,199,102,97,2,30,1,1
3506,49342,53,62127,53,allow,200,102,98,2,30,1,1
3507,64522,53,42718,53,allow,230,102,128,2,31,1,1
3508,55786,53,43858,53,allow,177,94,83,2,31,1,1
3509,37965,48167,49022,48167,allow,490,149,341,3,1199,2,1
3510,49941,53,58431,53,allow,193,102,91,2,30,1,1
3511,49469,53,2393,53,allow,185,102,83,2,30,1,1
3512,56603,53,17293,53,allow,179,94,85,2,30,1,1
3513,65075,53,5602,53,allow,164,86,78,2,31,1,1
3514,49459,53,35212,53,allow,199,102,97,2,31,1,1
3515,53723,443,51817,443,allow,70,70,0,1,5,1,0
3516,51910,443,32865,443,allow,308,188,120,4,15,2,2
3517,45109,443,9498,443,allow,190,70,120,4,15,2,2
3518,51051,443,1978,443,allow,7712,2203,5509,24,516,14,10
3519,50627,443,54044,443,allow,5427,3497,1930,23,141,13,10
3520,64568,53,24682,53,allow,388,134,254,2,30,1,1
3521,54815,3389,54815,3389,allow,3424,1710,1714,16,31,8,8
3522,50316,53,18070,53,allow,816,102,714,2,30,1,1
3523,65518,53,59686,53,allow,211,102,109,2,30,1,1
3524,49277,53,14856,53,allow,230,102,128,2,30,1,1
3525,32914,80,9670,80,allow,1542,831,711,7,15,5,2
3526,47663,443,61725,443,allow,214,140,74,4,15,3,1
3527,44228,443,32223,443,allow,7352,1790,5562,24,263,12,12
3528,49374,53,26527,53,allow,199,94,105,2,30,1,1
3529,55617,53,11638,53,allow,214,110,104,2,30,1,1
3530,64242,53,41761,53,allow,180,94,86,2,30,1,1
3531,65028,53,13338,53,allow,763,102,661,2,30,1,1
3532,55579,53,12007,53,allow,178,94,84,2,30,1,1
3533,50316,53,39379,53,allow,193,102,91,2,30,1,1
3534,56008,53,22150,53,allow,230,86,144,2,30,1,1
3535,56603,53,28698,53,allow,179,94,85,2,30,1,1
3536,49342,53,56835,53,allow,200,102,98,2,30,1,1
3537,51913,443,51764,443,allow,190,70,120,4,15,2,2
3538,58959,80,58892,80,allow,5481,4758,723,15,15,8,7
3539,52174,43106,3385,43106,allow,160,70,90,2,8,1,1
3540,9335,443,4512,443,allow,674,128,546,12,45,3,9
3541,64046,18318,32519,18318,allow,3197,1526,1671,19,26,12,7
3542,37952,80,16690,80,allow,1372,868,504,13,35,8,5
3543,63464,443,19526,443,allow,8543,1114,7429,26,93,11,15
3544,44227,443,19248,443,allow,7491,1930,5561,26,263,14,12
3545,57115,53,1229,53,allow,178,94,84,2,30,1,1
3546,65154,53,12899,53,allow,196,94,102,2,30,1,1
3547,42315,443,13240,443,allow,13090,9437,3653,43,188,14,29
3548,55820,53,19644,53,allow,194,102,92,2,30,1,1
3549,49941,53,57941,53,allow,193,102,91,2,31,1,1
3550,64283,53,30888,53,allow,193,102,91,2,31,1,1
3551,40672,443,9807,443,allow,9150,2155,6995,38,295,15,23
3552,56882,53,12251,53,allow,87,87,0,2,60,2,0
3553,50992,443,14898,443,allow,49212,42366,6846,109,147,59,50
3554,54526,443,1853,443,allow,33625519,489773,33135746,29877,243,6803,23074
3555,65322,53,59723,53,allow,235,94,141,2,30,1,1
3556,55866,443,45291,443,allow,53845,7300,46545,80,31,38,42
3557,42121,53,52822,53,allow,199,94,105,2,31,1,1
3558,65090,53,63161,53,allow,230,102,128,2,31,1,1
3559,50294,53,23372,53,allow,178,94,84,2,30,1,1
3560,65515,53,18245,53,allow,195,102,93,2,31,1,1
3561,49469,53,45496,53,allow,177,94,83,2,30,1,1
3562,64639,53,49663,53,allow,199,102,97,2,31,1,1
3563,58381,53,27908,53,allow,199,94,105,2,31,1,1
3564,57793,53,34542,53,allow,168,78,90,2,31,1,1
3565,64684,53,15819,53,allow,184,94,90,2,31,1,1
3566,64724,53,50975,53,allow,195,102,93,2,31,1,1
3567,56332,53,61425,53,allow,193,102,91,2,31,1,1
3568,54998,53,27657,53,allow,198,102,96,2,31,1,1
3569,46899,443,58934,443,allow,9085,2222,6863,39,125,19,20
3570,65234,53,47492,53,allow,193,102,91,2,31,1,1
3571,51638,443,56586,443,allow,8176,2082,6094,26,360,12,14
3572,56079,53,14640,53,allow,199,102,97,2,31,1,1
3573,52334,443,32129,443,allow,96091,8340,87751,159,205,75,84
3574,62241,443,33164,443,allow,7205,2250,4955,16,120,7,9
3575,50191,53,52829,53,allow,182,102,80,2,30,1,1
3576,54889,443,50379,443,allow,4600,2214,2386,13,134,7,6
3577,30188,33365,39784,33365,allow,42329,18517,23812,241,2378,116,125
3578,51221,51413,53021,51413,allow,460,150,310,2,1200,1,1
3579,49512,53,60222,53,allow,195,102,93,2,31,1,1
3580,37912,443,31339,443,allow,130,70,60,3,5,2,1
3581,49913,53,48535,53,allow,493,94,399,4,40,2,2
3582,38914,443,38914,443,allow,4644,1737,2907,19,28,11,8
3583,49982,53,15818,53,allow,322,94,228,4,49,2,2
3584,55820,53,60004,53,allow,194,102,92,2,31,1,1
3585,51880,8000,15502,8000,allow,750,360,390,10,60,5,5
3586,53122,443,25117,443,allow,23067,5901,17166,43,73,21,22
3587,58638,5900,58638,5900,allow,130,66,64,2,5,1,1
3588,58638,5900,58638,5900,allow,66,66,0,1,5,1,0
3589,58638,5900,58638,5900,allow,130,66,64,2,5,1,1
3590,58638,5900,58638,5900,allow,130,66,64,2,5,1,1
3591,45732,443,54582,443,allow,6558,2131,4427,26,262,10,16
3592,50730,443,7850,443,allow,1323,738,585,10,16,6,4
3593,50252,445,0,0,drop,66,66,0,1,0,1,0
3594,50137,445,0,0,drop,70,70,0,1,0,1,0
3595,53750,25174,0,0,deny,66,66,0,1,0,1,0
3596,53275,21247,0,0,deny,66,66,0,1,0,1,0
3597,58835,17372,0,0,deny,66,66,0,1,0,1,0
3598,64622,36829,0,0,deny,62,62,0,1,0,1,0
3599,53667,22114,0,0,deny,66,66,0,1,0,1,0
3600,50246,445,0,0,drop,66,66,0,1,0,1,0
3601,50136,445,0,0,drop,70,70,0,1,0,1,0
3602,48144,21247,0,0,deny,66,66,0,1,0,1,0
3603,5223,32965,0,0,deny,220,220,0,1,0,1,0
3604,21294,21247,0,0,deny,146,146,0,1,0,1,0
3605,50239,445,0,0,drop,66,66,0,1,0,1,0
3606,53376,22114,0,0,deny,146,146,0,1,0,1,0
3607,46619,57470,0,0,deny,62,62,0,1,0,1,0
3608,51954,57470,0,0,deny,66,66,0,1,0,1,0
3609,11585,56205,0,0,deny,62,62,0,1,0,1,0
3610,54633,36237,0,0,deny,66,66,0,1,0,1,0
3611,32679,37965,0,0,deny,62,62,0,1,0,1,0
3612,3117,37965,0,0,deny,62,62,0,1,0,1,0
3613,4862,37965,0,0,deny,66,66,0,1,0,1,0
3614,18739,23,0,0,deny,60,60,0,1,0,1,0
3615,56818,60043,0,0,deny,66,66,0,1,0,1,0
3616,50131,445,0,0,drop,70,70,0,1,0,1,0
3617,7844,22114,0,0,deny,66,66,0,1,0,1,0
3618,61455,64147,0,0,deny,66,66,0,1,0,1,0
3619,13027,64147,0,0,deny,62,62,0,1,0,1,0
3620,53305,50584,0,0,deny,66,66,0,1,0,1,0
3621,63495,50584,0,0,deny,66,66,0,1,0,1,0
3622,52745,25174,0,0,deny,66,66,0,1,0,1,0
3623,54830,445,0,0,drop,70,70,0,1,0,1,0
3624,54828,445,0,0,drop,70,70,0,1,0,1,0
3625,54827,445,0,0,drop,70,70,0,1,0,1,0
3626,62721,56205,0,0,deny,66,66,0,1,0,1,0
3627,48706,23393,0,0,deny,60,60,0,1,0,1,0
3628,49590,57470,0,0,deny,78,78,0,1,0,1,0
3629,50229,445,0,0,drop,66,66,0,1,0,1,0
3630,50230,445,0,0,drop,66,66,0,1,0,1,0
3631,50226,445,0,0,drop,66,66,0,1,0,1,0
3632,50225,445,0,0,drop,66,66,0,1,0,1,0
3633,50228,445,0,0,drop,66,66,0,1,0,1,0
3634,50222,445,0,0,drop,66,66,0,1,0,1,0
3635,50224,445,0,0,drop,66,66,0,1,0,1,0
3636,50223,445,0,0,drop,66,66,0,1,0,1,0
3637,24073,22114,0,0,deny,62,62,0,1,0,1,0
3638,61550,5529,0,0,deny,145,145,0,1,0,1,0
3639,62183,57470,0,0,deny,74,74,0,1,0,1,0
3640,60428,25174,0,0,deny,66,66,0,1,0,1,0
3641,12531,22114,0,0,deny,146,146,0,1,0,1,0
3642,50828,23,0,0,deny,60,60,0,1,0,1,0
3643,63488,22114,0,0,deny,62,62,0,1,0,1,0
3644,50118,445,0,0,drop,70,70,0,1,0,1,0
3645,52018,22114,0,0,deny,146,146,0,1,0,1,0
3646,54821,445,0,0,drop,70,70,0,1,0,1,0
3647,54816,445,0,0,drop,70,70,0,1,0,1,0
3648,54814,445,0,0,drop,70,70,0,1,0,1,0
3649,54811,445,0,0,drop,70,70,0,1,0,1,0
3650,4752,30188,0,0,deny,62,62,0,1,0,1,0
3651,32796,37965,0,0,deny,62,62,0,1,0,1,0
3652,51474,14914,0,0,deny,139,139,0,1,0,1,0
3653,58535,30317,0,0,deny,62,62,0,1,0,1,0
3654,54912,64147,0,0,deny,66,66,0,1,0,1,0
3655,19136,64147,0,0,deny,62,62,0,1,0,1,0
3656,50115,445,0,0,drop,70,70,0,1,0,1,0
3657,50210,445,0,0,drop,66,66,0,1,0,1,0
3658,50208,445,0,0,drop,66,66,0,1,0,1,0
3659,50207,445,0,0,drop,66,66,0,1,0,1,0
3660,19623,25174,0,0,deny,62,62,0,1,0,1,0
3661,20741,64147,0,0,deny,62,62,0,1,0,1,0
3662,1027,57866,0,0,deny,62,62,0,1,0,1,0
3663,57523,25174,0,0,deny,146,146,0,1,0,1,0
3664,54808,445,0,0,drop,70,70,0,1,0,1,0
3665,443,4205,0,0,deny,320,320,0,1,0,1,0
3666,57325,60043,0,0,deny,66,66,0,1,0,1,0
3667,59497,64097,0,0,deny,66,66,0,1,0,1,0
3668,50111,445,0,0,drop,70,70,0,1,0,1,0
3669,54803,445,0,0,drop,70,70,0,1,0,1,0
3670,54797,445,0,0,drop,70,70,0,1,0,1,0
3671,54795,445,0,0,drop,70,70,0,1,0,1,0
3672,29177,44847,0,0,deny,62,62,0,1,0,1,0
3673,50109,445,0,0,drop,70,70,0,1,0,1,0
3674,61711,35440,0,0,deny,62,62,0,1,0,1,0
3675,16979,56205,0,0,deny,62,62,0,1,0,1,0
3676,36419,50584,0,0,deny,146,146,0,1,0,1,0
3677,36120,57470,0,0,deny,145,145,0,1,0,1,0
3678,50107,445,0,0,drop,70,70,0,1,0,1,0
3679,19068,37965,0,0,deny,62,62,0,1,0,1,0
3680,51550,11392,0,0,deny,66,66,0,1,0,1,0
3681,4328,7302,0,0,deny,66,66,0,1,0,1,0
3682,65270,3855,0,0,deny,78,78,0,1,0,1,0
3683,17038,36829,0,0,deny,146,146,0,1,0,1,0
3684,52459,33890,0,0,deny,60,60,0,1,0,1,0
3685,56719,37807,0,0,deny,62,62,0,1,0,1,0
3686,43747,22114,0,0,deny,62,62,0,1,0,1,0
3687,62838,44847,0,0,deny,66,66,0,1,0,1,0
3688,12503,25174,0,0,deny,146,146,0,1,0,1,0
3689,56102,53,3387,53,allow,757,98,659,2,0,1,1
3690,54788,445,0,0,drop,70,70,0,1,0,1,0
3691,54787,445,0,0,drop,70,70,0,1,0,1,0
3692,54783,445,0,0,drop,70,70,0,1,0,1,0
3693,8889,2117,0,0,deny,60,60,0,1,0,1,0
3694,50100,445,0,0,drop,70,70,0,1,0,1,0
3695,62744,62413,0,0,deny,66,66,0,1,0,1,0
3696,24560,51050,0,0,deny,146,146,0,1,0,1,0
3697,24376,50584,0,0,deny,62,62,0,1,0,1,0
3698,50198,445,0,0,drop,66,66,0,1,0,1,0
3699,50098,445,0,0,drop,70,70,0,1,0,1,0
3700,23353,25174,0,0,deny,62,62,0,1,0,1,0
3701,8734,56205,0,0,deny,66,66,0,1,0,1,0
3702,23353,25174,0,0,deny,146,146,0,1,0,1,0
3703,31660,35440,0,0,deny,62,62,0,1,0,1,0
3704,50097,445,0,0,drop,70,70,0,1,0,1,0
3705,50096,445,0,0,drop,70,70,0,1,0,1,0
3706,11692,25174,0,0,deny,62,62,0,1,0,1,0
3707,50095,445,0,0,drop,70,70,0,1,0,1,0
3708,50089,445,0,0,drop,70,70,0,1,0,1,0
3709,50092,445,0,0,drop,70,70,0,1,0,1,0
3710,40254,25174,0,0,deny,62,62,0,1,0,1,0
3711,54782,445,0,0,drop,70,70,0,1,0,1,0
3712,54781,445,0,0,drop,70,70,0,1,0,1,0
3713,55817,36829,0,0,deny,66,66,0,1,0,1,0
3714,52596,17372,0,0,deny,62,62,0,1,0,1,0
3715,26566,44847,0,0,deny,66,66,0,1,0,1,0
3716,50076,445,0,0,drop,70,70,0,1,0,1,0
3717,50075,445,0,0,drop,70,70,0,1,0,1,0
3718,40418,25174,0,0,deny,66,66,0,1,0,1,0
3719,50070,445,0,0,drop,70,70,0,1,0,1,0
3720,50065,445,0,0,drop,70,70,0,1,0,1,0
3721,50066,445,0,0,drop,70,70,0,1,0,1,0
3722,50182,445,0,0,drop,66,66,0,1,0,1,0
3723,50180,445,0,0,drop,66,66,0,1,0,1,0
3724,52745,57866,0,0,deny,62,62,0,1,0,1,0
3725,30181,61689,0,0,deny,62,62,0,1,0,1,0
3726,64923,25174,0,0,deny,66,66,0,1,0,1,0
3727,48025,44847,0,0,deny,62,62,0,1,0,1,0
3728,56098,64147,0,0,deny,66,66,0,1,0,1,0
3729,57607,21247,0,0,deny,66,66,0,1,0,1,0
3730,42542,25174,0,0,deny,146,146,0,1,0,1,0
3731,54768,445,0,0,deny,70,70,0,1,0,1,0
3732,54767,445,0,0,drop,70,70,0,1,0,1,0
3733,54766,445,0,0,drop,70,70,0,1,0,1,0
3734,54760,445,0,0,drop,70,70,0,1,0,1,0
3735,53844,22114,0,0,deny,62,62,0,1,0,1,0
3736,47179,53733,0,0,deny,146,146,0,1,0,1,0
3737,58463,11392,0,0,deny,66,66,0,1,0,1,0
3738,0,0,0,0,allow,134,64,70,2,0,1,1
3739,58543,6881,0,0,deny,146,146,0,1,0,1,0
3740,50174,445,0,0,drop,66,66,0,1,0,1,0
3741,50054,445,0,0,drop,70,70,0,1,0,1,0
3742,54539,26467,0,0,deny,62,62,0,1,0,1,0
3743,49380,21247,0,0,deny,66,66,0,1,0,1,0
3744,46640,9002,0,0,deny,60,60,0,1,0,1,0
3745,50164,445,0,0,drop,66,66,0,1,0,1,0
3746,50169,445,0,0,drop,66,66,0,1,0,1,0
3747,50171,445,0,0,drop,66,66,0,1,0,1,0
3748,50168,445,0,0,drop,66,66,0,1,0,1,0
3749,50162,445,0,0,drop,66,66,0,1,0,1,0
3750,50161,445,0,0,drop,66,66,0,1,0,1,0
3751,50159,445,0,0,drop,66,66,0,1,0,1,0
3752,62971,44847,0,0,deny,66,66,0,1,0,1,0
3753,53353,26467,0,0,deny,62,62,0,1,0,1,0
3754,443,14315,0,0,deny,158,158,0,1,0,1,0
3755,54757,445,0,0,drop,70,70,0,1,0,1,0
3756,13168,35440,0,0,deny,66,66,0,1,0,1,0
3757,443,59890,0,0,deny,60,60,0,1,0,1,0
3758,54752,445,0,0,drop,70,70,0,1,0,1,0
3759,54749,445,0,0,drop,70,70,0,1,0,1,0
3760,54748,445,0,0,drop,70,70,0,1,0,1,0
3761,38565,51505,0,0,deny,66,66,0,1,0,1,0
3762,46180,1433,0,0,deny,60,60,0,1,0,1,0
3763,50050,445,0,0,drop,70,70,0,1,0,1,0
3764,53995,25174,0,0,deny,66,66,0,1,0,1,0
3765,57793,37807,0,0,deny,66,66,0,1,0,1,0
3766,50041,445,0,0,drop,70,70,0,1,0,1,0
3767,50040,445,0,0,drop,70,70,0,1,0,1,0
3768,50039,445,0,0,drop,70,70,0,1,0,1,0
3769,23379,57866,0,0,deny,62,62,0,1,0,1,0
3770,50035,445,0,0,drop,70,70,0,1,0,1,0
3771,28064,36237,0,0,deny,62,62,0,1,0,1,0
3772,54740,445,0,0,drop,70,70,0,1,0,1,0
3773,54745,445,0,0,drop,70,70,0,1,0,1,0
3774,54743,445,0,0,drop,70,70,0,1,0,1,0
3775,50033,445,0,0,drop,70,70,0,1,0,1,0
3776,50153,445,0,0,drop,66,66,0,1,0,1,0
3777,54739,445,0,0,drop,70,70,0,1,0,1,0
3778,50151,445,0,0,drop,66,66,0,1,0,1,0
3779,7105,25174,0,0,deny,66,66,0,1,0,1,0
3780,50149,445,0,0,drop,66,66,0,1,0,1,0
3781,50148,445,0,0,drop,66,66,0,1,0,1,0
3782,50146,445,0,0,drop,66,66,0,1,0,1,0
3783,59845,15503,0,0,deny,66,66,0,1,0,1,0
3784,3381,44847,0,0,deny,78,78,0,1,0,1,0
3785,56258,53,45112,53,allow,166,85,81,2,31,1,1
3786,37669,443,48889,443,allow,24415,3924,20491,45,48,22,23
3787,37152,443,20347,443,allow,7794,2670,5124,27,316,14,13
3788,58638,5900,58638,5900,allow,126,62,64,2,5,1,1
3789,58638,5900,58638,5900,allow,126,62,64,2,5,1,1
3790,58638,5900,58638,5900,allow,126,62,64,2,5,1,1
3791,58638,5900,58638,5900,allow,62,62,0,1,5,1,0
3792,58638,5900,58638,5900,allow,62,62,0,1,5,1,0
3793,58638,5900,58638,5900,allow,62,62,0,1,5,1,0
3794,57002,53,38861,53,allow,731,85,646,2,30,1,1
3795,47643,443,8942,443,allow,11108,3774,7334,28,230,13,15
3796,58638,5900,58638,5900,allow,62,62,0,1,5,1,0
3797,53954,57868,29520,57868,allow,70,70,0,1,5,1,0
3798,49514,53,50895,53,allow,780,93,687,2,30,1,1
3799,40159,443,53282,443,allow,5360,4048,1312,22,265,11,11
3800,50624,443,1028,443,allow,12712,3662,9050,32,140,17,15
3801,30945,53,30945,53,allow,237,91,146,2,32,1,1
3802,55325,53,12048,53,allow,762,101,661,2,30,1,1
3803,57265,53,26246,53,allow,762,98,664,2,30,1,1
3804,48171,443,3704,443,allow,10420,3506,6914,33,274,18,15
3805,47276,443,9154,443,allow,9503,5267,4236,56,218,31,25
3806,56079,53,63600,53,allow,198,101,97,2,31,1,1
3807,64724,53,10875,53,allow,190,97,93,2,31,1,1
3808,64789,53,3910,53,allow,198,101,97,2,30,1,1
3809,64454,3389,64454,3389,allow,4350,2261,2089,21,18,11,10
3810,9189,80,9189,80,allow,13456,880,12576,21,16,9,12
3811,56786,443,23041,443,allow,7929,1940,5989,20,16,11,9
3812,51969,443,9113,443,allow,15609,5649,9960,58,76,31,27
3813,53134,443,53110,443,allow,8361,2182,6179,26,40,15,11
3814,58638,5900,58638,5900,allow,62,62,0,1,5,1,0
3815,58638,5900,58638,5900,allow,62,62,0,1,5,1,0
3816,58638,5900,58638,5900,allow,126,62,64,2,5,1,1
3817,51880,8000,29097,8000,allow,270,270,0,4,33,4,0
3818,58638,5900,58638,5900,allow,126,62,64,2,5,1,1
3819,49882,80,49056,80,allow,2560,599,1961,13,75,7,6
3820,58638,5900,58638,5900,allow,62,62,0,1,5,1,0
3821,58638,5900,58638,5900,allow,62,62,0,1,5,1,0
3822,55048,443,61796,443,allow,12799,3662,9137,40,50,22,18
3823,65006,53,31072,53,allow,793,101,692,2,30,1,1
3824,39462,80,39462,80,allow,1058,497,561,10,16,6,4
3825,50935,80,12497,80,allow,40645,6133,34512,66,274,33,33
3826,58638,5900,58638,5900,allow,62,62,0,1,5,1,0
3827,56788,443,39724,443,allow,7929,1940,5989,20,15,11,9
3828,58638,5900,58638,5900,allow,62,62,0,1,5,1,0
3829,58638,5900,58638,5900,allow,62,62,0,1,5,1,0
3830,54234,53,54234,53,allow,237,91,146,2,33,1,1
3831,58638,5900,58638,5900,allow,126,62,64,2,5,1,1
3832,49512,53,53127,53,allow,190,97,93,2,31,1,1
3833,58638,5900,58638,5900,allow,126,62,64,2,5,1,1
3834,38520,53,38520,53,allow,231,88,143,2,34,1,1
3835,64149,53,35596,53,allow,301,108,193,4,50,2,2
3836,56789,443,8502,443,allow,7877,1888,5989,20,15,11,9
3837,63607,53,63607,53,allow,643,88,555,2,30,1,1
3838,56787,443,7195,443,allow,7877,1888,5989,20,15,11,9
3839,60495,6882,21325,6882,allow,70,70,0,1,5,1,0
3840,49342,53,37970,53,allow,200,102,98,2,30,1,1
3841,56812,53,46886,53,allow,767,102,665,2,30,1,1
3842,58725,443,25110,443,allow,9279,5062,4217,56,259,25,31
3843,51179,443,22561,443,allow,13708,1734,11974,25,31,12,13
3844,64937,53,10087,53,allow,182,93,89,2,31,1,1
3845,64937,53,22410,53,allow,182,93,89,2,31,1,1
3846,64332,53,28123,53,allow,166,85,81,2,31,1,1
3847,57470,867,17411,867,allow,330,330,0,6,1200,6,0
3848,57470,1024,34451,1024,allow,132,132,0,3,1200,3,0
3849,49160,6881,22368,6881,allow,490,150,340,2,1200,1,1
3850,55711,53,33941,53,allow,733,93,640,2,31,1,1
3851,64217,53,58721,53,allow,186,95,91,2,31,1,1
3852,57411,53,22912,53,allow,192,98,94,2,31,1,1
3853,48229,53,48229,53,allow,213,87,126,2,31,1,1
3854,57470,53380,4441,53380,allow,330,330,0,6,1200,6,0
3855,55820,53,24388,53,allow,188,96,92,2,31,1,1
3856,64815,123,8798,123,allow,184,94,90,2,31,1,1
3857,50636,53,31294,53,allow,772,100,672,2,31,1,1
3858,49907,53,44048,53,allow,198,101,97,2,31,1,1
3859,55646,53,23408,53,allow,182,93,89,2,31,1,1
3860,56724,53,16788,53,allow,190,97,93,2,31,1,1
3861,64723,443,61032,443,allow,7978900,79979,7898921,6464,210,644,5820
3862,55615,53,23565,53,allow,772,100,672,2,31,1,1
3863,19473,51413,49212,51413,allow,459,149,310,2,1200,1,1
3864,57131,35776,0,0,deny,145,145,0,1,0,1,0
3865,16490,25174,0,0,deny,62,62,0,1,0,1,0
3866,50591,22114,0,0,deny,146,146,0,1,0,1,0
3867,55973,25174,0,0,deny,62,62,0,1,0,1,0
3868,50027,445,0,0,drop,70,70,0,1,0,1,0
3869,443,56513,0,0,deny,78,78,0,1,0,1,0
3870,18130,25174,0,0,deny,62,62,0,1,0,1,0
3871,63136,42873,0,0,deny,66,66,0,1,0,1,0
3872,61250,42873,0,0,deny,66,66,0,1,0,1,0
3873,49308,22114,0,0,deny,62,62,0,1,0,1,0
3874,54735,445,0,0,drop,70,70,0,1,0,1,0
3875,54727,445,0,0,drop,70,70,0,1,0,1,0
3876,54721,445,0,0,drop,70,70,0,1,0,1,0
3877,13718,23,0,0,deny,60,60,0,1,0,1,0
3878,26906,22114,0,0,deny,66,66,0,1,0,1,0
3879,50020,445,0,0,drop,70,70,0,1,0,1,0
3880,11112,43890,0,0,deny,66,66,0,1,0,1,0
3881,50018,445,0,0,drop,70,70,0,1,0,1,0
3882,56258,53,19240,53,allow,167,86,81,2,30,1,1
3883,56745,80,35194,80,allow,214,140,74,4,25,3,1
3884,58769,22114,0,0,deny,146,146,0,1,0,1,0
3885,50135,445,0,0,drop,66,66,0,1,0,1,0
3886,25565,50263,0,0,deny,60,60,0,1,0,1,0
3887,63469,64147,0,0,deny,62,62,0,1,0,1,0
3888,57015,25174,0,0,deny,66,66,0,1,0,1,0
3889,50014,445,0,0,drop,70,70,0,1,0,1,0
3890,50012,445,0,0,drop,70,70,0,1,0,1,0
3891,50354,56205,0,0,deny,66,66,0,1,0,1,0
3892,50127,445,0,0,drop,66,66,0,1,0,1,0
3893,54711,445,0,0,drop,70,70,0,1,0,1,0
3894,10425,23,0,0,deny,60,60,0,1,0,1,0
3895,18771,35440,0,0,deny,66,66,0,1,0,1,0
3896,26629,56079,0,0,deny,62,62,0,1,0,1,0
3897,50008,445,0,0,drop,70,70,0,1,0,1,0
3898,33352,50584,0,0,deny,146,146,0,1,0,1,0
3899,51865,61689,0,0,deny,62,62,0,1,0,1,0
3900,50125,445,0,0,drop,66,66,0,1,0,1,0
3901,50007,445,0,0,drop,70,70,0,1,0,1,0
3902,64322,53,60744,53,allow,273,90,183,4,33,2,2
3903,46987,443,53868,443,allow,8688,3211,5477,24,343,11,13
3904,64307,53,35303,53,allow,241,94,147,2,30,1,1
3905,49880,53,5726,53,allow,194,102,92,2,30,1,1
3906,55265,53,4151,53,allow,199,102,97,2,30,1,1
3907,56115,53,60323,53,allow,167,86,81,2,30,1,1
3908,56115,53,18486,53,allow,167,86,81,2,30,1,1
3909,65452,53,19191,53,allow,196,102,94,2,30,1,1
3910,34732,53,8209,53,allow,86,86,0,1,30,1,0
3911,64789,53,27915,53,allow,199,102,97,2,30,1,1
3912,63773,443,33011,443,allow,9693,2010,7683,18,130,9,9
3913,64116,443,49764,443,allow,7439,1156,6283,19,75,11,8
3914,51880,8000,24485,8000,allow,582,270,312,8,32,4,4
3915,123,123,14772,123,allow,184,94,90,2,29,1,1
3916,65515,53,18334,53,allow,195,102,93,2,29,1,1
3917,64882,53,29551,53,allow,230,102,128,2,29,1,1
3918,65076,53,51472,53,allow,215,94,121,2,29,1,1
3919,57054,53,52774,53,allow,241,94,147,2,29,1,1
3920,56131,53,35553,53,allow,199,94,105,2,29,1,1
3921,49939,53,35198,53,allow,231,102,129,2,29,1,1
3922,49166,53,17612,53,allow,322,102,220,2,30,1,1
3923,64789,53,49397,53,allow,199,102,97,2,30,1,1
3924,57884,443,11734,443,allow,7668,2540,5128,22,155,12,10
3925,56400,53,1687,53,allow,196,102,94,2,30,1,1
3926,56538,53,20855,53,allow,401,95,306,4,57,2,2
3927,64149,53,6477,53,allow,301,108,193,4,49,2,2
3928,36660,443,25642,443,allow,25051,3368,21683,50,313,26,24
3929,53136,80,42745,80,allow,23974,12718,11256,37,36,19,18
3930,64930,53,11667,53,allow,317,96,221,4,32,2,2
3931,58638,5900,58638,5900,allow,130,66,64,2,4,1,1
3932,49279,53,50429,53,allow,199,102,97,2,29,1,1
3933,53951,8999,52530,8999,allow,70,70,0,1,4,1,0
3934,58638,5900,58638,5900,allow,66,66,0,1,4,1,0
3935,49929,53,22603,53,allow,214,110,104,2,29,1,1
3936,64283,53,44589,53,allow,193,102,91,2,29,1,1
3937,49177,443,40595,443,allow,840,700,140,13,59,11,2
3938,64710,53,5594,53,allow,195,102,93,2,29,1,1
3939,49836,53,26222,53,allow,889,404,485,10,29,5,5
3940,64935,53,15324,53,allow,193,102,91,2,31,1,1
3941,65199,53,15810,53,allow,215,94,121,2,30,1,1
3942,64606,53,12951,53,allow,290,102,188,2,30,1,1
3943,37672,443,48728,443,allow,3338,2337,1001,18,45,11,7
3944,38320,53,38320,53,allow,260,106,154,2,32,1,1
3945,61343,443,57856,443,allow,1784740,34746,1749994,1769,331,357,1412
3946,55598,53,62889,53,allow,186,102,84,2,30,1,1
3947,65220,53,21177,53,allow,184,94,90,2,30,1,1
3948,57137,53,46999,53,allow,279,96,183,4,32,2,2
3949,52101,64162,42746,64162,allow,1200,576,624,8,31,4,4
3950,64404,53,7876,53,allow,251,110,141,2,30,1,1
3951,49965,53,10762,53,allow,226,110,116,2,30,1,1
3952,49280,53,63122,53,allow,167,86,81,2,30,1,1
3953,55273,53,48247,53,allow,197,94,103,2,30,1,1
3954,55265,53,44071,53,allow,199,102,97,2,30,1,1
3955,49448,53,38995,53,allow,195,94,101,2,30,1,1
3956,64789,53,51641,53,allow,199,102,97,2,30,1,1
3957,49280,53,8666,53,allow,167,86,81,2,30,1,1
3958,50011,53,47474,53,allow,1398,98,1300,4,31,2,2
3959,49291,53,30701,53,allow,759,102,657,2,30,1,1
3960,64217,53,23995,53,allow,193,102,91,2,30,1,1
3961,50622,443,10440,443,allow,9215,1795,7420,32,140,16,16
3962,37586,443,60764,443,allow,19675,10416,9259,53,81,30,23
3963,64283,53,27743,53,allow,193,102,91,2,30,1,1
3964,55040,443,51805,443,allow,36648,3634,33014,51,62,23,28
3965,52075,443,32298,443,allow,18579,9266,9313,49,198,25,24
3966,50681,80,59849,80,allow,318,192,126,6,26,4,2
3967,64639,53,21872,53,allow,199,102,97,2,30,1,1
3968,64719,53,55102,53,allow,263,118,145,2,30,1,1
3969,64149,53,17311,53,allow,301,108,193,4,49,2,2
3970,55797,53,43104,53,allow,194,102,92,2,30,1,1
3971,64724,53,43750,53,allow,195,102,93,2,30,1,1
3972,33892,53,0,0,allow,86,86,0,1,30,1,0
3973,55797,53,58246,53,allow,817,102,715,2,30,1,1
3974,56258,53,24780,53,allow,167,86,81,2,30,1,1
3975,57255,443,53541,443,allow,4769,2622,2147,14,135,7,7
3976,57309,53,4070,53,allow,197,102,95,2,30,1,1
3977,64603,53,49089,53,allow,269,110,159,2,30,1,1
3978,49228,443,55799,443,allow,842887,22143,820744,866,19,314,552
3979,53101,443,16538,443,allow,27964,15805,12159,204,904,120,84
3980,42686,53,42686,53,allow,262,106,156,2,32,1,1
3981,40826,443,36041,443,allow,4125,2847,1278,18,255,10,8
3982,64854,53,54158,53,allow,260,102,158,2,30,1,1
3983,63965,53,1139,53,allow,214,102,112,2,30,1,1
3984,55100,53,15692,53,allow,182,102,80,2,30,1,1
3985,55094,53,35029,53,allow,244,94,150,2,30,1,1
3986,65452,53,12771,53,allow,819,102,717,2,30,1,1
3987,56864,53,28207,53,allow,200,102,98,2,30,1,1
3988,65260,53,63253,53,allow,184,94,90,2,30,1,1
3989,49512,53,36100,53,allow,195,102,93,2,30,1,1
3990,53028,443,47549,443,allow,12081,2070,10011,33,620,12,21
3991,49326,53,56607,53,allow,193,102,91,2,31,1,1
3992,57883,443,38550,443,allow,5932,1264,4668,21,155,11,10
3993,38639,443,56279,443,allow,10556,3559,6997,38,82,21,17
3994,49554,53,46723,53,allow,541,201,340,6,64,3,3
3995,50682,80,30834,80,allow,5036,4332,704,11,25,6,5
3996,56754,443,40687,443,allow,9868,2027,7841,24,20,12,12
3997,63985,53,11526,53,allow,351,103,248,4,46,2,2
3998,55044,443,65434,443,allow,14427,4574,9853,34,61,18,16
3999,55254,53,23493,53,allow,195,102,93,2,30,1,1
4000,65075,53,61185,53,allow,172,94,78,2,30,1,1
4001,7536,53,7536,53,allow,198,90,108,2,30,1,1
4002,55254,53,12306,53,allow,195,102,93,2,30,1,1
4003,55026,53,51536,53,allow,164,86,78,2,30,1,1
4004,53946,27426,37838,27426,allow,612,306,306,10,14,5,5
4005,51880,8000,42444,8000,allow,582,270,312,8,32,4,4
4006,51880,4000,30933,4000,allow,270,270,0,4,32,4,0
4007,58020,80,26488,80,allow,2312,1094,1218,25,89,13,12
4008,51880,51880,39901,51880,allow,582,270,312,8,32,4,4
4009,53980,36153,5182,36153,allow,258,70,188,4,7,2,2
4010,48495,443,14805,443,allow,3108,1711,1397,24,813,11,13
4011,53950,32057,54034,32057,allow,70,70,0,1,4,1,0
4012,65176,53,19712,53,allow,299,99,200,4,45,2,2
4013,58638,5900,58638,5900,allow,130,66,64,2,4,1,1
4014,58638,5900,58638,5900,allow,66,66,0,1,4,1,0
4015,58638,5900,58638,5900,allow,66,66,0,1,4,1,0
4016,58638,5900,58638,5900,allow,66,66,0,1,4,1,0
4017,58638,5900,58638,5900,allow,66,66,0,1,4,1,0
4018,58638,5900,58638,5900,allow,130,66,64,2,4,1,1
4019,58638,5900,58638,5900,allow,66,66,0,1,4,1,0
4020,64883,53,45539,53,allow,292,94,198,4,57,2,2
4021,58638,5900,58638,5900,allow,66,66,0,1,4,1,0
4022,58638,5900,58638,5900,allow,66,66,0,1,4,1,0
4023,58638,5900,58638,5900,allow,66,66,0,1,4,1,0
4024,58638,5900,58638,5900,allow,130,66,64,2,4,1,1
4025,58638,5900,58638,5900,allow,130,66,64,2,4,1,1
4026,58638,5900,58638,5900,allow,66,66,0,1,4,1,0
4027,58638,5900,58638,5900,allow,66,66,0,1,4,1,0
4028,55579,53,24866,53,allow,178,94,84,2,29,1,1
4029,58638,5900,58638,5900,allow,130,66,64,2,4,1,1
4030,10059,443,58839,443,allow,70553,6471,64082,141,182,69,72
4031,58638,5900,58638,5900,allow,66,66,0,1,4,1,0
4032,49308,53,35422,53,allow,320,97,223,4,50,2,2
4033,53952,26973,7961,26973,allow,70,70,0,1,4,1,0
4034,50191,53,41237,53,allow,182,102,80,2,29,1,1
4035,56775,53,62594,53,allow,200,94,106,2,29,1,1
4036,64550,53,62266,53,allow,221,94,127,2,29,1,1
4037,33161,80,27979,80,allow,604,530,74,7,15,6,1
4038,47935,443,5335,443,allow,12403,2139,10264,38,22,19,19
4039,50294,53,34116,53,allow,178,94,84,2,29,1,1
4040,55754,53,55090,53,allow,199,102,97,2,30,1,1
4041,56079,53,40631,53,allow,199,102,97,2,29,1,1
4042,56864,53,5721,53,allow,200,102,98,2,30,1,1
4043,57144,53,1605,53,allow,178,94,84,2,29,1,1
4044,55348,53,24176,53,allow,498,204,294,6,30,3,3
4045,56864,53,8861,53,allow,200,102,98,2,30,1,1
4046,56020,53,56318,53,allow,168,86,82,2,29,1,1
4047,55598,53,46757,53,allow,186,102,84,2,30,1,1
4048,56332,53,33283,53,allow,199,102,97,2,29,1,1
4049,50316,53,38175,53,allow,753,94,659,2,29,1,1
4050,64895,53,61625,53,allow,199,102,97,2,30,1,1
4051,49407,53,19099,53,allow,209,102,107,2,30,1,1
4052,49248,53,8891,53,allow,211,102,109,2,30,1,1
4053,65063,53,59913,53,allow,340,94,246,2,30,1,1
4054,49697,53,43942,53,allow,195,94,101,2,30,1,1
4055,55087,53,1147,53,allow,183,94,89,2,31,1,1
4056,49337,443,47623,443,allow,5483,2770,2713,30,361,15,15
4057,59103,443,44683,443,allow,2192,1049,1143,24,119,11,13
4058,56127,443,17365,443,allow,6103,2710,3393,58,212,28,30
4059,57262,443,38202,443,allow,43771,18333,25438,105,126,49,56
4060,42484,443,62904,443,allow,79507,72433,7074,96,415,60,36
4061,65377,53,44573,53,allow,193,102,91,2,31,1,1
4062,49223,2710,26016,2710,allow,3492,3432,60,12,36,11,1
4063,35515,80,62151,80,allow,841,715,126,5,15,3,2
4064,49880,53,16831,53,allow,817,102,715,2,30,1,1
4065,59119,53,4964,53,allow,168,78,90,2,30,1,1
4066,57411,53,7355,53,allow,196,102,94,2,30,1,1
4067,37833,53,37833,53,allow,222,90,132,2,30,1,1
4068,38633,443,28633,443,allow,4393,1151,3242,22,165,13,9
4069,38640,443,50053,443,allow,6171,1091,5080,22,82,12,10
4070,36841,443,46092,443,allow,7293,1544,5749,22,256,11,11
4071,49585,53,39603,53,allow,732,86,646,2,30,1,1
4072,64639,53,46471,53,allow,199,102,97,2,30,1,1
4073,55786,53,44397,53,allow,177,94,83,2,30,1,1
4074,45899,53,19119,53,allow,168,78,90,2,30,1,1
4075,65201,53,5254,53,allow,288,94,194,2,30,1,1
4076,49974,53,0,0,allow,86,86,0,1,30,1,0
4077,49907,53,32516,53,allow,199,102,97,2,30,1,1
4078,55265,53,65356,53,allow,199,102,97,2,30,1,1
4079,55044,53,38715,53,allow,196,102,94,2,30,1,1
4080,38634,443,59310,443,allow,9741,4687,5054,36,165,21,15
4081,53170,20259,55641,20259,allow,70,70,0,1,5,1,0
4082,53165,18504,40263,18504,allow,444,192,252,8,17,4,4
4083,49840,443,49840,443,allow,4645,1738,2907,19,30,11,8
4084,49314,53,60410,53,allow,214,94,120,2,30,1,1
4085,54816,53,4342,53,allow,168,78,90,2,30,1,1
4086,36245,53,44289,53,allow,168,78,90,2,30,1,1
4087,55100,53,34612,53,allow,182,102,80,2,30,1,1
4088,44505,53,44505,53,allow,216,90,126,2,30,1,1
4089,56400,53,12520,53,allow,819,102,717,2,30,1,1
4090,65377,53,29691,53,allow,193,102,91,2,30,1,1
4091,45676,123,45676,123,allow,184,94,90,2,30,1,1
4092,50290,443,41228,443,allow,6662,3336,3326,37,142,17,20
4093,56660,53,55953,53,allow,183,94,89,2,31,1,1
4094,49198,53,18910,53,allow,164,78,86,2,31,1,1
4095,55044,53,10792,53,allow,196,102,94,2,31,1,1
4096,43463,443,25009,443,allow,6919,1449,5470,21,186,12,9
4097,6881,56867,6114,56867,allow,150,150,0,1,1199,1,0
4098,53497,443,53212,443,allow,17187157,553524,16633633,18453,352,6098,12355
4099,52160,443,34670,443,allow,6679,3424,3255,19,138,10,9
4100,57470,80,24424,80,allow,230,82,148,4,1199,2,2
4101,64724,53,63918,53,allow,319,97,222,4,31,2,2
4102,56079,53,1064,53,allow,199,102,97,2,31,1,1
4103,57137,53,9212,53,allow,279,96,183,4,32,2,2
4104,53281,80,26227,80,allow,124,64,60,3,5,2,1
4105,49217,53,30696,53,allow,282,93,189,4,45,2,2
4106,49260,53,23458,53,allow,199,86,113,2,30,1,1
4107,65496,53,1852,53,allow,198,94,104,2,31,1,1
4108,61829,443,61829,443,allow,280243,73972,206271,309,206,142,167
4109,40072,80,29014,80,allow,1298,370,928,12,15,6,6
4110,49217,53,45409,53,allow,282,93,189,4,45,2,2
4111,49217,53,50933,53,allow,282,93,189,4,45,2,2
4112,49420,80,13977,80,allow,1985,657,1328,11,21,6,5
4113,64149,53,19971,53,allow,301,108,193,4,49,2,2
4114,64961,53,7551,53,allow,243,110,133,2,30,1,1
4115,64758,53,8387,53,allow,734,94,640,2,30,1,1
4116,65260,53,12231,53,allow,184,94,90,2,30,1,1
4117,64332,53,6045,53,allow,167,86,81,2,30,1,1
4118,59883,17637,0,0,deny,66,66,0,1,0,1,0
4119,25679,27189,0,0,deny,62,62,0,1,0,1,0
4120,10333,22114,0,0,deny,146,146,0,1,0,1,0
4121,50116,445,0,0,drop,66,66,0,1,0,1,0
4122,52791,25174,0,0,deny,66,66,0,1,0,1,0
4123,50113,445,0,0,drop,66,66,0,1,0,1,0
4124,54280,3398,0,0,deny,60,60,0,1,0,1,0
4125,56381,51505,0,0,deny,146,146,0,1,0,1,0
4126,50002,445,0,0,drop,70,70,0,1,0,1,0
4127,54976,10387,0,0,deny,159,159,0,1,0,1,0
4128,1814,62413,0,0,deny,66,66,0,1,0,1,0
4129,25583,2323,0,0,deny,60,60,0,1,0,1,0
4130,54701,445,0,0,drop,70,70,0,1,0,1,0
4131,54702,445,0,0,drop,70,70,0,1,0,1,0
4132,54699,445,0,0,drop,70,70,0,1,0,1,0
4133,50102,445,0,0,drop,66,66,0,1,0,1,0
4134,50098,445,0,0,drop,66,66,0,1,0,1,0
4135,50101,445,0,0,drop,66,66,0,1,0,1,0
4136,50100,445,0,0,drop,66,66,0,1,0,1,0
4137,50095,445,0,0,drop,66,66,0,1,0,1,0
4138,50099,445,0,0,drop,66,66,0,1,0,1,0
4139,50097,445,0,0,drop,66,66,0,1,0,1,0
4140,50094,445,0,0,drop,66,66,0,1,0,1,0
4141,20706,23718,0,0,deny,62,62,0,1,0,1,0
4142,9696,16010,0,0,deny,60,60,0,1,0,1,0
4143,50326,46824,0,0,deny,66,66,0,1,0,1,0
4144,34086,25174,0,0,deny,66,66,0,1,0,1,0
4145,64605,25174,0,0,deny,66,66,0,1,0,1,0
4146,45952,22114,0,0,deny,62,62,0,1,0,1,0
4147,49989,445,0,0,drop,70,70,0,1,0,1,0
4148,55666,35440,0,0,deny,66,66,0,1,0,1,0
4149,38852,37965,0,0,deny,62,62,0,1,0,1,0
4150,12980,26296,0,0,deny,145,145,0,1,0,1,0
4151,63690,64147,0,0,deny,62,62,0,1,0,1,0
4152,20487,50584,0,0,deny,62,62,0,1,0,1,0
4153,32381,50584,0,0,deny,66,66,0,1,0,1,0
4154,49986,445,0,0,drop,70,70,0,1,0,1,0
4155,54695,445,0,0,drop,70,70,0,1,0,1,0
4156,54689,445,0,0,drop,70,70,0,1,0,1,0
4157,54688,445,0,0,drop,70,70,0,1,0,1,0
4158,54683,445,0,0,drop,70,70,0,1,0,1,0
4159,59326,57470,0,0,deny,74,74,0,1,0,1,0
4160,56688,25174,0,0,deny,66,66,0,1,0,1,0
4161,36685,35440,0,0,deny,62,62,0,1,0,1,0
4162,50080,445,0,0,drop,66,66,0,1,0,1,0
4163,50082,445,0,0,drop,66,66,0,1,0,1,0
4164,50079,445,0,0,drop,66,66,0,1,0,1,0
4165,65216,35440,0,0,deny,66,66,0,1,0,1,0
4166,65270,3855,0,0,deny,78,78,0,1,0,1,0
4167,44913,36866,0,0,deny,148,148,0,1,0,1,0
4168,49981,445,0,0,drop,70,70,0,1,0,1,0
4169,44774,22114,0,0,deny,62,62,0,1,0,1,0
4170,35974,23,0,0,deny,60,60,0,1,0,1,0
4171,39586,22114,0,0,deny,66,66,0,1,0,1,0
4172,54679,445,0,0,drop,70,70,0,1,0,1,0
4173,49980,445,0,0,drop,70,70,0,1,0,1,0
4174,1687,25174,0,0,deny,146,146,0,1,0,1,0
4175,4323,64147,0,0,deny,66,66,0,1,0,1,0
4176,54678,445,0,0,drop,70,70,0,1,0,1,0
4177,54675,445,0,0,drop,70,70,0,1,0,1,0
4178,54667,445,0,0,drop,70,70,0,1,0,1,0
4179,49978,445,0,0,drop,70,70,0,1,0,1,0
4180,443,50238,0,0,deny,331,331,0,1,0,1,0
4181,41653,21247,0,0,deny,62,62,0,1,0,1,0
4182,49590,57470,0,0,deny,78,78,0,1,0,1,0
4183,49971,445,0,0,drop,70,70,0,1,0,1,0
4184,63010,57470,0,0,deny,145,145,0,1,0,1,0
4185,56039,50584,0,0,deny,66,66,0,1,0,1,0
4186,54660,445,0,0,drop,70,70,0,1,0,1,0
4187,54657,445,0,0,drop,70,70,0,1,0,1,0
4188,54655,445,0,0,drop,70,70,0,1,0,1,0
4189,49969,445,0,0,drop,70,70,0,1,0,1,0
4190,58593,57470,0,0,deny,62,62,0,1,0,1,0
4191,29009,25174,0,0,deny,146,146,0,1,0,1,0
4192,59223,17500,0,0,deny,66,66,0,1,0,1,0
4193,64808,62413,0,0,deny,66,66,0,1,0,1,0
4194,61280,26467,0,0,deny,62,62,0,1,0,1,0
4195,50068,445,0,0,drop,66,66,0,1,0,1,0
4196,59225,57587,0,0,deny,66,66,0,1,0,1,0
4197,8889,29421,0,0,deny,60,60,0,1,0,1,0
4198,54555,25174,0,0,deny,62,62,0,1,0,1,0
4199,2064,22114,0,0,deny,62,62,0,1,0,1,0
4200,49968,445,0,0,drop,70,70,0,1,0,1,0
4201,17171,22114,0,0,deny,66,66,0,1,0,1,0
4202,49967,445,0,0,drop,70,70,0,1,0,1,0
4203,49966,445,0,0,drop,70,70,0,1,0,1,0
4204,54051,28793,0,0,deny,66,66,0,1,0,1,0
4205,49961,445,0,0,drop,70,70,0,1,0,1,0
4206,49960,445,0,0,drop,70,70,0,1,0,1,0
4207,9327,57470,0,0,deny,62,62,0,1,0,1,0
4208,49908,56205,0,0,deny,62,62,0,1,0,1,0
4209,56713,25174,0,0,deny,62,62,0,1,0,1,0
4210,56909,50584,0,0,deny,62,62,0,1,0,1,0
4211,10004,57470,0,0,deny,145,145,0,1,0,1,0
4212,58925,25174,0,0,deny,66,66,0,1,0,1,0
4213,30129,37965,0,0,deny,72,72,0,1,0,1,0
4214,54654,445,0,0,drop,70,70,0,1,0,1,0
4215,59031,25174,0,0,deny,62,62,0,1,0,1,0
4216,54650,445,0,0,drop,70,70,0,1,0,1,0
4217,56906,50584,0,0,deny,62,62,0,1,0,1,0
4218,27321,25174,0,0,deny,62,62,0,1,0,1,0
4219,49948,445,0,0,drop,70,70,0,1,0,1,0
4220,25363,22114,0,0,deny,66,66,0,1,0,1,0
4221,49945,445,0,0,drop,70,70,0,1,0,1,0
4222,1024,48817,0,0,deny,145,145,0,1,0,1,0
4223,49938,445,0,0,drop,70,70,0,1,0,1,0
4224,49937,445,0,0,drop,70,70,0,1,0,1,0
4225,6778,50584,0,0,deny,66,66,0,1,0,1,0
4226,49529,21247,0,0,deny,62,62,0,1,0,1,0
4227,5787,44847,0,0,deny,66,66,0,1,0,1,0
4228,50055,445,0,0,drop,66,66,0,1,0,1,0
4229,50050,445,0,0,drop,66,66,0,1,0,1,0
4230,9745,26467,0,0,deny,62,62,0,1,0,1,0
4231,52838,37965,0,0,deny,66,66,0,1,0,1,0
4232,52929,43890,0,0,deny,62,62,0,1,0,1,0
4233,64882,43890,0,0,deny,66,66,0,1,0,1,0
4234,49531,26467,0,0,deny,62,62,0,1,0,1,0
4235,52604,25174,0,0,deny,62,62,0,1,0,1,0
4236,50974,11392,0,0,deny,66,66,0,1,0,1,0
4237,52318,22114,0,0,deny,146,146,0,1,0,1,0
4238,54642,445,0,0,drop,70,70,0,1,0,1,0
4239,54640,445,0,0,drop,70,70,0,1,0,1,0
4240,54639,445,0,0,drop,70,70,0,1,0,1,0
4241,54633,445,0,0,drop,70,70,0,1,0,1,0
4242,51414,22,0,0,deny,60,60,0,1,0,1,0
4243,49926,445,0,0,drop,70,70,0,1,0,1,0
4244,50047,445,0,0,drop,66,66,0,1,0,1,0
4245,53985,30188,0,0,deny,66,66,0,1,0,1,0
4246,57015,42707,0,0,deny,62,62,0,1,0,1,0
4247,57613,42707,0,0,deny,66,66,0,1,0,1,0
4248,50033,445,0,0,drop,66,66,0,1,0,1,0
4249,50043,445,0,0,drop,66,66,0,1,0,1,0
4250,50031,445,0,0,drop,66,66,0,1,0,1,0
4251,50036,445,0,0,drop,66,66,0,1,0,1,0
4252,50040,445,0,0,drop,66,66,0,1,0,1,0
4253,50038,445,0,0,drop,66,66,0,1,0,1,0
4254,50035,445,0,0,drop,66,66,0,1,0,1,0
4255,51544,44847,0,0,deny,146,146,0,1,0,1,0
4256,58129,26467,0,0,deny,62,62,0,1,0,1,0
4257,44414,23718,0,0,deny,62,62,0,1,0,1,0
4258,54629,445,0,0,drop,70,70,0,1,0,1,0
4259,19875,30170,0,0,deny,145,145,0,1,0,1,0
4260,24160,37807,0,0,deny,62,62,0,1,0,1,0
4261,54624,445,0,0,drop,70,70,0,1,0,1,0
4262,54621,445,0,0,drop,70,70,0,1,0,1,0
4263,54620,445,0,0,deny,70,70,0,1,0,1,0
4264,59076,25174,0,0,deny,62,62,0,1,0,1,0
4265,23122,26296,0,0,deny,159,159,0,1,0,1,0
4266,49922,445,0,0,drop,70,70,0,1,0,1,0
4267,45461,25174,0,0,deny,146,146,0,1,0,1,0
4268,47063,15503,0,0,deny,62,62,0,1,0,1,0
4269,49911,445,0,0,drop,70,70,0,1,0,1,0
4270,49910,445,0,0,drop,70,70,0,1,0,1,0
4271,49913,445,0,0,drop,70,70,0,1,0,1,0
4272,32496,48817,0,0,deny,148,148,0,1,0,1,0
4273,49476,443,31371,443,allow,7254,1183,6071,19,152,9,10
4274,59336,80,59336,80,allow,24437,12718,11719,41,15,16,25
4275,53981,29500,46111,29500,allow,320,140,180,6,7,3,3
4276,58932,80,50607,80,allow,2424,529,1895,11,75,6,5
4277,56785,443,49634,443,allow,7905,1916,5989,20,15,11,9
4278,49774,80,42910,80,allow,254,128,126,5,15,3,2
4279,64818,53,5282,53,allow,174,89,85,2,30,1,1
4280,57309,53,11380,53,allow,194,99,95,2,30,1,1
4281,59335,80,59335,80,allow,107776,4213,103563,177,16,60,117
4282,26882,443,64713,443,allow,10633,2672,7961,31,20,16,15
4283,55646,53,12583,53,allow,780,93,687,2,30,1,1
4284,52025,443,47252,443,allow,8034,2692,5342,15,16,8,7
4285,64322,53,46348,53,allow,273,90,183,4,32,2,2
4286,54610,443,15531,443,allow,19810,7047,12763,54,438,28,26
4287,56664,80,24275,80,allow,1056,682,374,10,15,6,4
4288,43518,443,43518,443,allow,4691,1784,2907,19,29,11,8
4289,64944,53,44996,53,allow,749,89,660,2,30,1,1
4290,54601,443,45945,443,allow,28386,15864,12522,59,471,31,28
4291,53976,52534,48449,52534,allow,70,70,0,2,7,2,0
4292,44503,1433,44503,1433,allow,150,60,90,2,9,1,1
4293,64701,53,64701,53,allow,265,111,154,2,30,1,1
4294,53978,27091,3798,27091,allow,320,140,180,6,7,3,3
4295,47904,443,37875,443,allow,2766,1907,859,17,24,10,7
4296,53948,7370,62549,7370,allow,70,70,0,1,5,1,0
4297,55856,53,9134,53,allow,1410,93,1317,4,59,2,2
4298,49477,443,62857,443,allow,8416,1247,7169,21,152,10,11
4299,61401,443,65147,443,allow,33774,1880,31894,58,195,19,39
4300,49326,53,16602,53,allow,186,95,91,2,30,1,1
4301,49224,53,33872,53,allow,198,101,97,2,30,1,1
4302,55564,53,50276,53,allow,775,103,672,2,30,1,1
4303,49582,53,42965,53,allow,775,103,672,2,30,1,1
4304,60247,443,21929,443,allow,12256,5443,6813,33,437,18,15
4305,56784,443,32848,443,allow,7957,1968,5989,20,15,11,9
4306,62218,53,62218,53,allow,253,99,154,2,33,1,1
4307,63855,80,40243,80,allow,4529,1221,3308,14,75,8,6
4308,53947,867,6908,867,allow,70,70,0,1,5,1,0
4309,56783,443,28364,443,allow,7904,1915,5989,20,16,11,9
4310,49478,443,45550,443,allow,4241,1161,3080,17,152,9,8
4311,5588,5588,0,0,allow,3354,1792,1562,46,195,23,23
4312,48204,443,48204,443,allow,4743,1836,2907,19,26,11,8
4313,41803,53,41803,53,allow,243,104,139,2,30,1,1
4314,50497,53,25431,53,allow,747,93,654,2,30,1,1
4315,55044,53,9273,53,allow,192,98,94,2,30,1,1
4316,44125,53,44125,53,allow,209,79,130,2,30,1,1
4317,64895,53,11867,53,allow,198,101,97,2,30,1,1
4318,65220,53,41846,53,allow,184,94,90,2,30,1,1
4319,63560,53,63560,53,allow,209,79,130,2,30,1,1
4320,52487,443,29392,443,allow,13734,3206,10528,26,150,13,13
4321,55257,53,9976,53,allow,749,89,660,2,30,1,1
4322,65260,53,38236,53,allow,184,94,90,2,30,1,1
4323,49901,53,54026,53,allow,776,102,674,2,30,1,1
4324,65224,53,48832,53,allow,758,93,665,2,30,1,1
4325,55087,53,55975,53,allow,182,93,89,2,31,1,1
4326,64935,53,11961,53,allow,186,95,91,2,31,1,1
4327,17119,53,17119,53,allow,217,87,130,2,30,1,1
4328,55646,53,54569,53,allow,182,93,89,2,30,1,1
4329,57188,53,44023,53,allow,186,95,91,2,30,1,1
4330,57130,53,10466,53,allow,778,103,675,2,31,1,1
4331,55530,53,3862,53,allow,758,93,665,2,31,1,1
4332,36017,53,46700,53,allow,198,93,105,2,31,1,1
4333,45459,53,25942,53,allow,198,93,105,2,31,1,1
4334,54994,53,24459,53,allow,202,103,99,2,31,1,1
4335,57956,443,29445,443,allow,7842,2164,5678,48,5441,20,28
4336,21133,11342,54289,11342,allow,478,149,329,2,1200,1,1
4337,55627,53,20054,53,allow,174,89,85,2,31,1,1
4338,64930,53,64696,53,allow,186,95,91,2,31,1,1
4339,65377,53,42499,53,allow,186,95,91,2,31,1,1
4340,55377,53,47893,53,allow,190,97,93,2,31,1,1
4341,55654,53,20360,53,allow,726,85,641,2,31,1,1
4342,55932,53,16236,53,allow,202,103,99,2,31,1,1
4343,56389,53,11725,53,allow,774,101,673,2,31,1,1
4344,49237,53,49766,53,allow,735,88,647,2,31,1,1
4345,49629,53,36000,53,allow,196,100,96,2,31,1,1
4346,51444,443,39755,443,allow,3283,951,2332,13,135,6,7
4347,56790,53,5516,53,allow,747,92,655,2,31,1,1
4348,57577,443,27380,443,allow,39421,4980,34441,57,144,23,34
4349,35722,443,40129,443,allow,13035,2590,10445,27,125,14,13
4350,56180,53,32734,53,allow,200,102,98,2,31,1,1
4351,49343,53,32839,53,allow,202,103,99,2,31,1,1
4352,6881,6882,26617,6882,allow,231,111,120,2,1200,1,1
4353,44290,53,27070,53,allow,240,76,164,2,31,1,1
4354,19037,53,19037,53,allow,227,89,138,2,31,1,1
4355,55005,53,54882,53,allow,182,93,89,2,31,1,1
4356,55637,53,24847,53,allow,202,103,99,2,31,1,1
4357,55675,53,42703,53,allow,196,100,96,2,31,1,1
4358,56002,53,4276,53,allow,771,101,670,2,31,1,1
4359,55014,53,9068,53,allow,716,95,621,2,31,1,1
4360,57051,53,27315,53,allow,170,87,83,2,31,1,1
4361,64752,53,55237,53,allow,190,97,93,2,31,1,1
4362,56317,53,55686,53,allow,182,93,89,2,31,1,1
4363,56569,53,23106,53,allow,182,93,89,2,31,1,1
4364,57137,53,2649,53,allow,279,96,183,4,31,2,2
4365,65373,53,60314,53,allow,194,99,95,2,31,1,1
4366,57401,53,41706,53,allow,174,89,85,2,31,1,1
4367,65257,443,11599,443,allow,4019,708,3311,16,137,7,9
4368,49909,445,0,0,deny,70,70,0,1,0,1,0
4369,52128,37807,0,0,deny,66,66,0,1,0,1,0
4370,48016,57470,0,0,deny,62,62,0,1,0,1,0
4371,49905,445,0,0,drop,70,70,0,1,0,1,0
4372,60645,35440,0,0,deny,62,62,0,1,0,1,0
4373,1712,23,0,0,deny,60,60,0,1,0,1,0
4374,4545,1900,0,0,deny,136,136,0,1,0,1,0
4375,4545,1900,0,0,deny,136,136,0,1,0,1,0
4376,14360,64147,0,0,deny,62,62,0,1,0,1,0
4377,9226,57470,0,0,deny,66,66,0,1,0,1,0
4378,54619,445,0,0,drop,70,70,0,1,0,1,0
4379,54615,445,0,0,drop,70,70,0,1,0,1,0
4380,54612,445,0,0,drop,70,70,0,1,0,1,0
4381,65200,51050,0,0,deny,66,66,0,1,0,1,0
4382,54611,445,0,0,drop,70,70,0,1,0,1,0
4383,13020,26467,0,0,deny,62,62,0,1,0,1,0
4384,59347,57470,0,0,deny,62,62,0,1,0,1,0
4385,50023,445,0,0,drop,66,66,0,1,0,1,0
4386,65530,53,49295,53,allow,381,88,293,4,31,2,2
4387,42753,443,38036,443,allow,10114,3154,6960,27,20,16,11
4388,56660,53,34940,53,allow,183,94,89,2,30,1,1
4389,64712,53,32713,53,allow,210,102,108,2,30,1,1
4390,53871,443,15841,443,allow,7797,1807,5990,15,135,7,8
4391,64469,53,32950,53,allow,342,97,245,4,42,2,2
4392,53935,42874,31408,42874,allow,1973,1021,952,10,15,6,4
4393,49907,53,54297,53,allow,199,102,97,2,29,1,1
4394,55044,53,52145,53,allow,196,102,94,2,29,1,1
4395,64146,53,19064,53,allow,212,102,110,2,29,1,1
4396,57188,53,20332,53,allow,193,102,91,2,30,1,1
4397,64332,53,46508,53,allow,167,86,81,2,30,1,1
4398,56724,53,52473,53,allow,195,102,93,2,30,1,1
4399,53938,15926,50841,15926,allow,492,306,186,8,15,5,3
4400,34687,443,63653,443,allow,3120,1862,1258,18,15,11,7
4401,49504,7275,25597,7275,allow,8962,1625,7337,28,16,15,13
4402,45195,80,65375,80,allow,1115,534,581,12,15,7,5
4403,64322,53,46298,53,allow,273,90,183,4,32,2,2
4404,49430,53,28668,53,allow,332,99,233,4,45,2,2
4405,49548,443,63354,443,allow,8912,2297,6615,43,255,20,23
4406,65186,53,51165,53,allow,521,90,431,4,43,2,2
4407,57188,53,35661,53,allow,193,102,91,2,29,1,1
4408,60807,40010,25177,40010,allow,316,136,180,6,5,3,3
4409,64217,53,31853,53,allow,193,102,91,2,29,1,1
4410,51418,443,51418,443,allow,4742,1835,2907,19,30,11,8
4411,63957,53,44993,53,allow,214,94,120,2,29,1,1
4412,56258,53,14638,53,allow,167,86,81,2,29,1,1
4413,123,123,46819,123,allow,184,94,90,2,29,1,1
4414,64930,53,29648,53,allow,193,102,91,2,29,1,1
4415,57411,53,32246,53,allow,196,102,94,2,29,1,1
4416,49512,53,26273,53,allow,195,102,93,2,30,1,1
4417,56724,53,34585,53,allow,308,97,211,4,45,2,2
4418,36897,443,23482,443,allow,6351,4202,2149,35,94,18,17
4419,49472,443,5541,443,allow,3897,1306,2591,17,158,9,8
4420,55122,443,57128,443,allow,17936,14273,3663,59,122,33,26
4421,17824,53,17824,53,allow,244,98,146,2,32,1,1
4422,46102,80,6915,80,allow,70,70,0,2,5,2,0
4423,38524,443,15396,443,allow,5846879,177697,5669182,6043,41,2261,3782
4424,64846,53,55957,53,allow,785,110,675,2,30,1,1
4425,64895,53,65185,53,allow,199,102,97,2,30,1,1
4426,49475,443,44120,443,allow,10402,1945,8457,24,158,11,13
4427,49655,53,33441,53,allow,209,110,99,2,30,1,1
4428,51443,443,11818,443,allow,4773,2454,2319,14,135,7,7
4429,55005,53,64520,53,allow,183,94,89,2,30,1,1
4430,43357,443,61952,443,allow,146374,13143,133231,238,131,116,122
4431,38143,443,25496,443,allow,84884,5896,78988,128,36,66,62
4432,49256,443,30277,443,allow,10619,3257,7362,29,361,13,16
4433,64978,53,11316,53,allow,198,102,96,2,30,1,1
4434,36022,443,7743,443,allow,7257,1619,5638,22,275,11,11
4435,64816,123,36690,123,allow,184,94,90,2,30,1,1
4436,57309,53,8457,53,allow,197,102,95,2,30,1,1
4437,9166,53,9166,53,allow,244,98,146,2,32,1,1
4438,65220,53,17734,53,allow,303,94,209,4,32,2,2
4439,52165,80,35107,80,allow,1945,1002,943,11,19,7,4
4440,10014,40026,21058,40026,allow,156,94,62,2,30,1,1
4441,55087,53,26632,53,allow,183,94,89,2,30,1,1
4442,64685,53,47486,53,allow,785,110,675,2,30,1,1
4443,52082,80,6337,80,allow,4560,3934,626,11,29,6,5
4444,53931,55300,33330,55300,allow,492,306,186,8,15,5,3
4445,51651,80,41220,80,allow,8100,4781,3319,23,166,12,11
4446,49872,443,65245,443,allow,3120,1862,1258,18,15,11,7
4447,49950,443,56465,443,allow,6770,2219,4551,21,89,11,10
4448,10008,40004,11500,40004,allow,156,94,62,2,30,1,1
4449,64978,53,20864,53,allow,198,102,96,2,30,1,1
4450,64818,53,60686,53,allow,179,94,85,2,30,1,1
4451,49520,53,1147,53,allow,209,110,99,2,30,1,1
4452,55043,443,10001,443,allow,36707,3750,32957,54,60,24,30
4453,53937,28506,44986,28506,allow,492,306,186,8,15,5,3
4454,65144,53,32702,53,allow,653,86,567,4,46,2,2
4455,51329,443,55771,443,allow,2019,1219,800,15,17,8,7
4456,65521,443,8234,443,allow,92427,4519,87908,105,15,39,66
4457,57137,53,36481,53,allow,279,96,183,4,31,2,2
4458,60803,80,16464,80,allow,254,128,126,5,15,3,2
4459,46101,80,15092,80,allow,70,70,0,2,5,2,0
4460,53939,9504,53453,9504,allow,492,306,186,8,15,5,3
4461,49491,53,15104,53,allow,492,94,398,4,45,2,2
4462,65520,443,22541,443,allow,438102,12780,425322,449,15,157,292
4463,49196,53,15790,53,allow,181,94,87,2,33,1,1
4464,53979,26308,39677,26308,allow,70,70,0,2,7,2,0
4465,49888,53,58972,53,allow,363,97,266,4,34,2,2
4466,43495,5223,36493,5223,allow,142,142,0,1,4,1,0
4467,38474,28678,45201,28678,allow,1806,1806,0,22,224,22,0
4468,49443,443,17566,443,allow,70988,47020,23968,152,652,79,73
4469,49474,443,32026,443,allow,10315,2018,8297,24,158,12,12
4470,50132,443,60688,443,allow,8162,1364,6798,22,16,11,11
4471,49480,443,58193,443,allow,1160,638,522,13,113,7,6
4472,65220,53,7048,53,allow,184,94,90,2,29,1,1
4473,49473,443,31044,443,allow,3990,1296,2694,17,158,9,8
4474,56724,53,41138,53,allow,195,102,93,2,29,1,1
4475,49629,53,2341,53,allow,198,102,96,2,29,1,1
4476,59005,443,56215,443,allow,6306,1780,4526,28,33,14,14
4477,64895,53,23891,53,allow,199,102,97,2,29,1,1
4478,55026,53,39957,53,allow,164,86,78,2,29,1,1
4479,49483,53,61034,53,allow,319,94,225,2,29,1,1
4480,57309,53,6657,53,allow,197,102,95,2,29,1,1
4481,65496,53,50374,53,allow,183,94,89,2,30,1,1
4482,64937,53,43310,53,allow,183,94,89,2,29,1,1
4483,55646,53,3427,53,allow,183,94,89,2,30,1,1
4484,10013,40024,56811,40024,allow,156,94,62,2,30,1,1
4485,58868,443,58939,443,allow,239435,36478,202957,319,111,133,186
4486,64355,53,3739,53,allow,213,102,111,2,30,1,1
4487,65496,53,50300,53,allow,183,94,89,2,30,1,1
4488,39886,443,46428,443,allow,315567,15410,300157,404,46,189,215
4489,55600,53,4581,53,allow,209,110,99,2,30,1,1
4490,55939,53,57194,53,allow,193,102,91,2,31,1,1
4491,50137,53,53286,53,allow,448,184,264,6,31,3,3
4492,54979,53,64417,53,allow,183,94,89,2,30,1,1
4493,33264,53,24560,53,allow,164,78,86,2,30,1,1
4494,57375,53,3463,53,allow,198,102,96,2,30,1,1
4495,55637,53,12301,53,allow,209,110,99,2,30,1,1
4496,65373,53,2835,53,allow,197,102,95,2,30,1,1
4497,57270,53,64569,53,allow,200,102,98,2,30,1,1
4498,64930,53,28381,53,allow,193,102,91,2,31,1,1
4499,55477,53,61973,53,allow,183,94,89,2,31,1,1
4500,55087,53,19901,53,allow,183,94,89,2,31,1,1
4501,64578,53,31792,53,allow,193,102,91,2,31,1,1
4502,57067,53,21723,53,allow,183,94,89,2,31,1,1
4503,55675,53,21127,53,allow,198,102,96,2,30,1,1
4504,50522,443,12346,443,allow,13347,4662,8685,40,202,24,16
4505,39343,443,19498,443,allow,8562,1634,6928,27,26,13,14
4506,46103,80,5613,80,allow,70,70,0,2,5,2,0
4507,65260,53,28900,53,allow,184,94,90,2,30,1,1
4508,54979,53,11444,53,allow,183,94,89,2,30,1,1
4509,55060,53,22947,53,allow,195,102,93,2,30,1,1
4510,56317,53,35779,53,allow,183,94,89,2,31,1,1
4511,49326,53,62713,53,allow,193,102,91,2,30,1,1
4512,61226,443,29248,443,allow,3135,1603,1532,22,632,7,15
4513,49224,53,25602,53,allow,199,102,97,2,30,1,1
4514,64332,53,40499,53,allow,167,86,81,2,30,1,1
4515,55224,53,5980,53,allow,209,110,99,2,30,1,1
4516,35550,53,45606,53,allow,164,78,86,2,30,1,1
4517,55224,53,33137,53,allow,209,110,99,2,30,1,1
4518,49376,53,19245,53,allow,209,110,99,2,30,1,1
4519,55346,443,44978,443,allow,13181,6041,7140,60,410,27,33
4520,57401,53,56934,53,allow,179,94,85,2,31,1,1
4521,36926,53,54098,53,allow,164,78,86,2,30,1,1
4522,52092,80,65314,80,allow,3163,716,2447,12,28,7,5
4523,21432,53,21432,53,allow,244,98,146,2,32,1,1
4524,14950,53,14950,53,allow,414,268,146,3,32,2,1
4525,65462,53,20337,53,allow,196,102,94,2,33,1,1
4526,53174,41442,6472,41442,allow,70,70,0,2,8,2,0
4527,46099,80,56104,80,allow,70,70,0,2,5,2,0
4528,65350,53,8382,53,allow,390,105,285,4,42,2,2
4529,49479,443,58848,443,allow,4591,2492,2099,20,113,11,9
4530,43151,443,30299,443,allow,9462,4488,4974,28,96,13,15
4531,49949,443,7206,443,allow,4712,908,3804,18,89,9,9
4532,50676,80,23134,80,allow,13054,6885,6169,27,26,13,14
4533,56660,53,40707,53,allow,183,94,89,2,30,1,1
4534,10009,40008,62477,40008,allow,156,94,62,2,30,1,1
4535,49782,53,28643,53,allow,228,86,142,2,30,1,1
4536,49269,53,11598,53,allow,254,102,152,2,30,1,1
4537,49655,53,32746,53,allow,209,110,99,2,30,1,1
4538,64911,53,65363,53,allow,232,86,146,2,30,1,1
4539,46902,123,43333,123,allow,184,94,90,2,30,1,1
4540,57411,53,35330,53,allow,196,102,94,2,30,1,1
4541,64217,53,33943,53,allow,193,102,91,2,30,1,1
4542,55820,53,49367,53,allow,194,102,92,2,30,1,1
4543,56317,53,26526,53,allow,183,94,89,2,30,1,1
4544,55377,53,41334,53,allow,195,102,93,2,30,1,1
4545,49734,53,51597,53,allow,259,110,149,2,30,1,1
4546,52859,53,16412,53,allow,164,78,86,2,30,1,1
4547,55477,53,62006,53,allow,183,94,89,2,30,1,1
4548,64637,53,39523,53,allow,194,102,92,2,31,1,1
4549,46273,5228,19288,5228,allow,5239,1558,3681,27,4020,9,18
4550,49277,53,15554,53,allow,199,102,97,2,31,1,1
4551,49488,53,28678,53,allow,194,102,92,2,31,1,1
4552,62547,443,41349,443,allow,54095,6413,47682,151,450,61,90
4553,40590,443,36504,443,allow,2965,1650,1315,24,275,12,12
4554,49376,53,53542,53,allow,209,110,99,2,30,1,1
4555,65519,443,19659,443,allow,436359,12780,423579,448,16,157,291
4556,50296,53,13683,53,allow,183,94,89,2,30,1,1
4557,57037,443,39402,443,allow,6847,1658,5189,21,25,12,9
4558,42060,53,44916,53,allow,164,78,86,2,30,1,1
4559,55675,53,47376,53,allow,198,102,96,2,30,1,1
4560,57375,53,63119,53,allow,198,102,96,2,30,1,1
4561,49546,53,30362,53,allow,193,102,91,2,30,1,1
4562,55060,53,16844,53,allow,195,102,93,2,30,1,1
4563,57270,53,53677,53,allow,200,102,98,2,31,1,1
4564,43093,53,41079,53,allow,242,78,164,2,30,1,1
4565,65385,53,41370,53,allow,259,110,149,2,30,1,1
4566,64869,53,31516,53,allow,195,94,101,2,30,1,1
4567,65373,53,50644,53,allow,197,102,95,2,31,1,1
4568,56754,53,50250,53,allow,209,110,99,2,30,1,1
4569,2321,53,2321,53,allow,216,98,118,2,30,1,1
4570,65356,53,60802,53,allow,197,94,103,2,31,1,1
4571,54994,53,25626,53,allow,209,110,99,2,31,1,1
4572,65106,53,25747,53,allow,772,102,670,2,30,1,1
4573,64899,53,5067,53,allow,199,102,97,2,31,1,1
4574,6881,6881,40398,6881,allow,238,118,120,2,1199,1,1
4575,41459,80,32156,80,allow,1866,1032,834,11,150,6,5
4576,37965,61085,23932,61085,allow,132,132,0,3,1199,3,0
4577,37475,443,1375,443,allow,4403,2160,2243,14,136,7,7
4578,55627,53,32877,53,allow,179,94,85,2,30,1,1
4579,65336,53,55246,53,allow,200,102,98,2,30,1,1
4580,56754,53,42272,53,allow,209,110,99,2,30,1,1
4581,64899,53,16096,53,allow,199,102,97,2,30,1,1
4582,59366,53,31679,53,allow,242,78,164,2,30,1,1
4583,59951,53,55881,53,allow,237,86,151,2,30,1,1
4584,50437,53,50192,53,allow,413,170,243,6,30,3,3
4585,55377,53,45027,53,allow,195,102,93,2,30,1,1
4586,49907,53,52196,53,allow,199,102,97,2,30,1,1
4587,55763,53,36537,53,allow,197,94,103,2,31,1,1
4588,64957,53,39699,53,allow,196,102,94,2,30,1,1
4589,49294,53,26484,53,allow,723,102,621,2,30,1,1
4590,49680,53,31932,53,allow,749,94,655,2,30,1,1
4591,65403,53,11897,53,allow,199,102,97,2,31,1,1
4592,49629,53,65217,53,allow,198,102,96,2,31,1,1
4593,38149,53,54452,53,allow,199,94,105,2,31,1,1
4594,55932,53,30562,53,allow,209,110,99,2,31,1,1
4595,49539,53,54919,53,allow,198,94,104,2,31,1,1
4596,64957,53,56586,53,allow,196,102,94,2,31,1,1
4597,63465,443,3023,443,allow,3942,1406,2536,18,135,8,10
4598,53974,26108,3464,26108,allow,70,70,0,2,8,2,0
4599,64083,63666,21856,63666,allow,66,66,0,2,8,2,0
4600,10007,40005,19403,40005,allow,148,86,62,2,31,1,1
4601,64322,53,37052,53,allow,273,90,183,4,32,2,2
4602,64077,20208,16294,20208,allow,66,66,0,2,8,2,0
4603,50711,443,37437,443,allow,2952,1548,1404,18,16,9,9
4604,65377,53,64134,53,allow,404,95,309,4,49,2,2
4605,50021,445,0,0,drop,66,66,0,1,0,1,0
4606,50019,445,0,0,drop,66,66,0,1,0,1,0
4607,31130,30188,0,0,deny,62,62,0,1,0,1,0
4608,50018,445,0,0,drop,66,66,0,1,0,1,0
4609,1025,50584,0,0,deny,62,62,0,1,0,1,0
4610,49900,445,0,0,drop,70,70,0,1,0,1,0
4611,64035,25174,0,0,deny,146,146,0,1,0,1,0
4612,15998,36829,0,0,deny,62,62,0,1,0,1,0
4613,54610,445,0,0,drop,70,70,0,1,0,1,0
4614,29742,50584,0,0,deny,62,62,0,1,0,1,0
4615,54602,445,0,0,drop,70,70,0,1,0,1,0
4616,54594,445,0,0,drop,70,70,0,1,0,1,0
4617,49892,445,0,0,drop,70,70,0,1,0,1,0
4618,5685,35440,0,0,deny,66,66,0,1,0,1,0
4619,59018,22114,0,0,deny,146,146,0,1,0,1,0
4620,47342,36237,0,0,deny,66,66,0,1,0,1,0
4621,49890,445,0,0,drop,70,70,0,1,0,1,0
4622,26287,56205,0,0,deny,66,66,0,1,0,1,0
4623,50007,445,0,0,drop,66,66,0,1,0,1,0
4624,443,45788,0,0,deny,332,332,0,1,0,1,0
4625,49885,445,0,0,drop,70,70,0,1,0,1,0
4626,52236,25174,0,0,deny,62,62,0,1,0,1,0
4627,49884,445,0,0,drop,70,70,0,1,0,1,0
4628,17306,25174,0,0,deny,66,66,0,1,0,1,0
4629,49999,445,0,0,drop,66,66,0,1,0,1,0
4630,54583,445,0,0,drop,70,70,0,1,0,1,0
4631,3456,11392,0,0,deny,66,66,0,1,0,1,0
4632,49880,445,0,0,drop,70,70,0,1,0,1,0
4633,62642,25174,0,0,deny,62,62,0,1,0,1,0
4634,11136,19910,0,0,deny,62,62,0,1,0,1,0
4635,59977,30188,0,0,deny,66,66,0,1,0,1,0
4636,49997,445,0,0,drop,66,66,0,1,0,1,0
4637,49879,445,0,0,drop,70,70,0,1,0,1,0
4638,37008,42707,0,0,deny,62,62,0,1,0,1,0
4639,26762,22114,0,0,deny,62,62,0,1,0,1,0
4640,60141,30188,0,0,deny,66,66,0,1,0,1,0
4641,57539,44847,0,0,deny,62,62,0,1,0,1,0
4642,52812,25174,0,0,deny,66,66,0,1,0,1,0
4643,22263,30188,0,0,deny,66,66,0,1,0,1,0
4644,37959,3855,0,0,deny,72,72,0,1,0,1,0
4645,46516,80,0,0,deny,60,60,0,1,0,1,0
4646,49990,445,0,0,drop,66,66,0,1,0,1,0
4647,57410,25174,0,0,deny,62,62,0,1,0,1,0
4648,49982,445,0,0,drop,66,66,0,1,0,1,0
4649,9231,3389,0,0,deny,66,66,0,1,0,1,0
4650,40054,62413,0,0,deny,62,62,0,1,0,1,0
4651,59345,25174,0,0,deny,62,62,0,1,0,1,0
4652,49874,445,0,0,drop,70,70,0,1,0,1,0
4653,18173,25174,0,0,deny,62,62,0,1,0,1,0
4654,63208,30975,0,0,deny,148,148,0,1,0,1,0
4655,45941,23386,0,0,deny,60,60,0,1,0,1,0
4656,63002,22114,0,0,deny,66,66,0,1,0,1,0
4657,49786,25174,0,0,deny,66,66,0,1,0,1,0
4658,5611,25174,0,0,deny,146,146,0,1,0,1,0
4659,18652,64147,0,0,deny,62,62,0,1,0,1,0
4660,10754,28793,0,0,deny,66,66,0,1,0,1,0
4661,27824,51505,0,0,deny,146,146,0,1,0,1,0
4662,39617,50584,0,0,deny,146,146,0,1,0,1,0
4663,54573,445,0,0,drop,70,70,0,1,0,1,0
4664,54572,445,0,0,drop,70,70,0,1,0,1,0
4665,54571,445,0,0,drop,70,70,0,1,0,1,0
4666,49966,445,0,0,drop,66,66,0,1,0,1,0
4667,49973,445,0,0,drop,66,66,0,1,0,1,0
4668,49971,445,0,0,drop,66,66,0,1,0,1,0
4669,49972,445,0,0,drop,66,66,0,1,0,1,0
4670,49968,445,0,0,drop,66,66,0,1,0,1,0
4671,49974,445,0,0,drop,66,66,0,1,0,1,0
4672,49970,445,0,0,drop,66,66,0,1,0,1,0
4673,49969,445,0,0,drop,66,66,0,1,0,1,0
4674,42973,57470,0,0,deny,62,62,0,1,0,1,0
4675,36357,25174,0,0,deny,66,66,0,1,0,1,0
4676,53579,42707,0,0,deny,66,66,0,1,0,1,0
4677,56876,11392,0,0,deny,66,66,0,1,0,1,0
4678,49861,445,0,0,drop,70,70,0,1,0,1,0
4679,60883,64147,0,0,deny,74,74,0,1,0,1,0
4680,9731,64147,0,0,deny,62,62,0,1,0,1,0
4681,30046,15503,0,0,deny,62,62,0,1,0,1,0
4682,49858,445,0,0,drop,70,70,0,1,0,1,0
4683,52340,22114,0,0,deny,66,66,0,1,0,1,0
4684,48706,23393,0,0,deny,60,60,0,1,0,1,0
4685,48706,23393,0,0,deny,60,60,0,1,0,1,0
4686,65270,3855,0,0,deny,78,78,0,1,0,1,0
4687,49182,21247,0,0,deny,62,62,0,1,0,1,0
4688,54569,445,0,0,drop,70,70,0,1,0,1,0
4689,54567,445,0,0,drop,70,70,0,1,0,1,0
4690,54563,445,0,0,drop,70,70,0,1,0,1,0
4691,54559,445,0,0,drop,70,70,0,1,0,1,0
4692,43645,39004,0,0,deny,145,145,0,1,0,1,0
4693,49954,445,0,0,drop,66,66,0,1,0,1,0
4694,49952,445,0,0,drop,66,66,0,1,0,1,0
4695,49953,445,0,0,drop,66,66,0,1,0,1,0
4696,49853,445,0,0,drop,70,70,0,1,0,1,0
4697,49852,445,0,0,drop,70,70,0,1,0,1,0
4698,34212,11392,0,0,deny,66,66,0,1,0,1,0
4699,49850,445,0,0,drop,70,70,0,1,0,1,0
4700,36770,56205,0,0,deny,62,62,0,1,0,1,0
4701,54551,445,0,0,drop,70,70,0,1,0,1,0
4702,64406,25174,0,0,deny,66,66,0,1,0,1,0
4703,54550,445,0,0,drop,70,70,0,1,0,1,0
4704,54547,445,0,0,drop,70,70,0,1,0,1,0
4705,54539,445,0,0,drop,70,70,0,1,0,1,0
4706,49356,50584,0,0,deny,62,62,0,1,0,1,0
4707,34993,15503,0,0,deny,62,62,0,1,0,1,0
4708,50360,37965,0,0,deny,66,66,0,1,0,1,0
4709,49590,57470,0,0,deny,78,78,0,1,0,1,0
4710,7342,22114,0,0,deny,62,62,0,1,0,1,0
4711,12785,2323,0,0,deny,60,60,0,1,0,1,0
4712,49843,445,0,0,drop,70,70,0,1,0,1,0
4713,50127,64147,0,0,deny,66,66,0,1,0,1,0
4714,33453,64147,0,0,deny,62,62,0,1,0,1,0
4715,35589,25174,0,0,deny,66,66,0,1,0,1,0
4716,49841,445,0,0,drop,70,70,0,1,0,1,0
4717,54531,445,0,0,drop,70,70,0,1,0,1,0
4718,54529,445,0,0,drop,70,70,0,1,0,1,0
4719,54530,445,0,0,drop,70,70,0,1,0,1,0
4720,37749,15503,0,0,deny,62,62,0,1,0,1,0
4721,5223,32965,0,0,deny,66,66,0,1,0,1,0
4722,49840,445,0,0,drop,70,70,0,1,0,1,0
4723,19933,35440,0,0,deny,62,62,0,1,0,1,0
4724,52819,15503,0,0,deny,66,66,0,1,0,1,0
4725,23578,2323,0,0,deny,60,60,0,1,0,1,0
4726,49839,445,0,0,deny,70,70,0,1,0,1,0
4727,49940,445,0,0,drop,66,66,0,1,0,1,0
4728,49838,445,0,0,drop,70,70,0,1,0,1,0
4729,10248,21247,0,0,deny,146,146,0,1,0,1,0
4730,49832,445,0,0,drop,70,70,0,1,0,1,0
4731,49834,445,0,0,drop,70,70,0,1,0,1,0
4732,56067,25174,0,0,deny,62,62,0,1,0,1,0
4733,12290,22114,0,0,deny,62,62,0,1,0,1,0
4734,55994,22114,0,0,deny,66,66,0,1,0,1,0
4735,49677,25174,0,0,deny,66,66,0,1,0,1,0
4736,49820,445,0,0,drop,70,70,0,1,0,1,0
4737,49818,445,0,0,drop,70,70,0,1,0,1,0
4738,49164,25174,0,0,deny,146,146,0,1,0,1,0
4739,54526,445,0,0,drop,70,70,0,1,0,1,0
4740,49813,445,0,0,drop,70,70,0,1,0,1,0
4741,49809,445,0,0,drop,70,70,0,1,0,1,0
4742,49808,445,0,0,drop,70,70,0,1,0,1,0
4743,35949,31573,0,0,deny,146,146,0,1,0,1,0
4744,54525,445,0,0,drop,70,70,0,1,0,1,0
4745,41677,57470,0,0,deny,66,66,0,1,0,1,0
4746,31675,19473,0,0,deny,62,62,0,1,0,1,0
4747,21322,25174,0,0,deny,62,62,0,1,0,1,0
4748,60245,25174,0,0,deny,62,62,0,1,0,1,0
4749,27745,50584,0,0,deny,62,62,0,1,0,1,0
4750,25565,62979,0,0,deny,60,60,0,1,0,1,0
4751,49927,445,0,0,drop,66,66,0,1,0,1,0
4752,49924,445,0,0,drop,66,66,0,1,0,1,0
4753,6889,65473,0,0,deny,143,143,0,1,0,1,0
4754,2850,64147,0,0,deny,66,66,0,1,0,1,0
4755,60571,26467,0,0,deny,62,62,0,1,0,1,0
4756,27448,22114,0,0,deny,62,62,0,1,0,1,0
4757,57677,57470,0,0,deny,62,62,0,1,0,1,0
4758,49797,445,0,0,drop,70,70,0,1,0,1,0
4759,54516,445,0,0,drop,70,70,0,1,0,1,0
4760,54510,445,0,0,drop,70,70,0,1,0,1,0
4761,54506,445,0,0,drop,70,70,0,1,0,1,0
4762,54508,445,0,0,drop,70,70,0,1,0,1,0
4763,58399,56205,0,0,deny,62,62,0,1,0,1,0
4764,49920,445,0,0,drop,66,66,0,1,0,1,0
4765,23873,30188,0,0,deny,62,62,0,1,0,1,0
4766,40780,80,6352,80,allow,1155,781,374,10,16,6,4
4767,38753,443,17390,443,allow,29887852,586245,29301607,27419,299,7975,19444
4768,50038,443,53552,443,allow,2652,1566,1086,15,86,9,6
4769,52370,443,22287,443,allow,7058,2421,4637,21,17,11,10
4770,64080,11801,22050,11801,allow,66,66,0,2,8,2,0
4771,54280,3396,54280,3396,allow,60,60,0,1,5,1,0
4772,64117,80,61513,80,allow,5827,773,5054,16,73,9,7
4773,56781,443,59501,443,allow,7870,1881,5989,20,15,11,9
4774,55999,53,41388,53,allow,774,101,673,2,30,1,1
4775,53751,53,53289,53,allow,578,286,292,9,16,5,4
4776,45123,15000,48758,15000,allow,130,70,60,2,6,1,1
4777,34079,443,61674,443,allow,14068,7909,6159,37,82,23,14
4778,55046,443,8809,443,allow,23425,10763,12662,57,48,31,26
4779,52172,80,27126,80,allow,362,240,122,7,17,5,2
4780,64957,53,47584,53,allow,192,98,94,2,30,1,1
4781,57067,53,57189,53,allow,182,93,89,2,30,1,1
4782,56780,443,59581,443,allow,7922,1933,5989,20,16,11,9
4783,40039,80,57862,80,allow,1155,781,374,10,15,6,4
4784,41620,53,41620,53,allow,257,101,156,2,32,1,1
4785,59924,443,2445,443,allow,682,310,372,12,68,6,6
4786,47169,15000,52806,15000,allow,130,70,60,2,5,1,1
4787,63993,17866,56109,17866,allow,4607,2045,2562,24,45,14,10
4788,52169,80,44471,80,allow,362,240,122,7,17,5,2
4789,34964,80,34964,80,allow,2889,1482,1407,10,15,6,4
4790,50014,443,7099,443,allow,5644,3210,2434,22,86,13,9
4791,52213,56682,21348,56682,allow,70,70,0,2,6,2,0
4792,48276,15000,65405,15000,allow,130,70,60,2,5,1,1
4793,58288,443,58288,443,allow,4661,1754,2907,19,26,11,8
4794,55555,53,19089,53,allow,778,103,675,2,30,1,1
4795,50336,53,11367,53,allow,240,76,164,2,30,1,1
4796,49618,53,25113,53,allow,774,101,673,2,30,1,1
4797,56330,53,9857,53,allow,271,95,176,4,48,2,2
4798,64899,53,35861,53,allow,198,101,97,2,30,1,1
4799,10005,40022,7541,40022,allow,151,89,62,2,30,1,1
4800,56715,53,5613,53,allow,1384,88,1296,4,32,2,2
4801,53971,18810,62225,18810,allow,70,70,0,2,8,2,0
4802,57750,15000,45543,15000,allow,130,70,60,2,5,1,1
4803,52181,1038,36423,1038,allow,66,66,0,1,5,1,0
4804,52169,59681,49857,59681,allow,66,66,0,1,5,1,0
4805,51619,15000,21734,15000,allow,130,70,60,2,6,1,1
4806,49248,80,49248,80,allow,163556,12140,151416,207,22,97,110
4807,49996,443,63041,443,allow,19523,5346,14177,37,87,17,20
4808,52170,45144,10407,45144,allow,66,66,0,1,5,1,0
4809,57452,53,53868,53,allow,776,102,674,2,30,1,1
4810,56385,53,50019,53,allow,249,85,164,4,56,2,2
4811,64559,53,6054,53,allow,196,100,96,2,31,1,1
4812,64578,53,53350,53,allow,186,95,91,2,31,1,1
4813,49246,80,49246,80,allow,133699,9415,124284,169,23,77,92
4814,52170,80,60754,80,allow,362,240,122,7,17,5,2
4815,41958,5222,34545,5222,allow,2380,1500,880,24,130,13,11
4816,52173,80,40738,80,allow,362,240,122,7,17,5,2
4817,55652,443,55652,443,allow,141647,19296,122351,203,55,102,101
4818,44048,443,44048,443,allow,4401,1494,2907,19,29,11,8
4819,56782,443,26053,443,allow,7956,1967,5989,20,15,11,9
4820,49323,443,62942,443,allow,9802,2846,6956,33,79,15,18
4821,64340,53,64340,53,allow,237,91,146,2,33,1,1
4822,53967,54589,5598,54589,allow,70,70,0,2,8,2,0
4823,49247,80,49247,80,allow,135755,6750,129005,160,22,68,92
4824,36586,3142,36586,3142,allow,138,78,60,2,6,1,1
4825,53839,15000,61295,15000,allow,130,70,60,2,5,1,1
4826,47276,443,53172,443,allow,190,70,120,4,15,2,2
4827,20689,53,20689,53,allow,237,91,146,2,33,1,1
4828,61822,53,61822,53,allow,237,91,146,2,33,1,1
4829,49249,80,49249,80,allow,265842,14126,251716,311,22,136,175
4830,11295,40002,55023,40002,allow,209,85,124,4,54,2,2
4831,60252,443,61357,443,allow,5169,790,4379,16,72,8,8
4832,52173,44632,6542,44632,allow,156,66,90,2,5,1,1
4833,50040,443,40234,443,allow,1097,654,443,12,86,7,5
4834,50041,443,57357,443,allow,1097,654,443,12,86,7,5
4835,57356,53,60821,53,allow,198,101,97,2,30,1,1
4836,53417,443,8874,443,allow,9193,6294,2899,27,121,14,13
4837,57727,443,62460,443,allow,54944,4374,50570,88,361,44,44
4838,65370,53,60115,53,allow,186,95,91,2,31,1,1
4839,65346,53,45745,53,allow,182,93,89,2,31,1,1
4840,64204,53,3889,53,allow,186,95,91,2,31,1,1
4841,55933,53,2538,53,allow,180,92,88,2,30,1,1
4842,51052,53,0,0,allow,82,82,0,1,30,1,0
4843,50356,53,7944,53,allow,176,90,86,2,31,1,1
4844,49382,53,52485,53,allow,200,102,98,2,31,1,1
4845,49671,53,37210,53,allow,182,93,89,2,31,1,1
4846,65127,53,25987,53,allow,780,104,676,2,31,1,1
4847,55436,53,43899,53,allow,774,101,673,2,30,1,1
4848,56672,53,28355,53,allow,198,101,97,2,31,1,1
4849,64569,53,10194,53,allow,182,93,89,2,31,1,1
4850,57035,53,19895,53,allow,198,101,97,2,31,1,1
4851,49798,53,59206,53,allow,192,98,94,2,31,1,1
4852,50265,44822,26867,44822,allow,149,149,0,1,1200,1,0
4853,64048,53,43444,53,allow,202,103,99,2,31,1,1
4854,49869,53,53726,53,allow,202,103,99,2,31,1,1
4855,55951,53,2710,53,allow,780,104,676,2,31,1,1
4856,56951,53,25007,53,allow,198,101,97,2,31,1,1
4857,63278,443,14519,443,allow,11570,3553,8017,24,134,10,14
4858,57574,443,28846,443,allow,3595,1957,1638,17,361,9,8
4859,59012,443,51105,443,allow,6278,3531,2747,23,122,12,11
4860,56941,53,4680,53,allow,192,98,94,2,31,1,1
4861,65292,53,23690,53,allow,190,97,93,2,31,1,1
4862,49380,53,10250,53,allow,198,101,97,2,31,1,1
4863,65526,53,17062,53,allow,198,101,97,2,31,1,1
4864,64288,53,10803,53,allow,182,93,89,2,31,1,1
4865,49331,53,64999,53,allow,180,92,88,2,31,1,1
4866,53089,24211,0,0,deny,66,66,0,1,0,1,0
4867,40787,57470,0,0,deny,62,62,0,1,0,1,0
4868,17232,22114,0,0,deny,62,62,0,1,0,1,0
4869,65228,53,0,0,deny,88,88,0,1,0,1,0
4870,2075,19473,0,0,deny,66,66,0,1,0,1,0
4871,49911,445,0,0,drop,66,66,0,1,0,1,0
4872,49909,445,0,0,drop,66,66,0,1,0,1,0
4873,49914,445,0,0,drop,66,66,0,1,0,1,0
4874,49910,445,0,0,drop,66,66,0,1,0,1,0
4875,49905,445,0,0,drop,66,66,0,1,0,1,0
4876,49908,445,0,0,drop,66,66,0,1,0,1,0
4877,49903,445,0,0,drop,66,66,0,1,0,1,0
4878,18745,64147,0,0,deny,66,66,0,1,0,1,0
4879,38503,25,0,0,deny,60,60,0,1,0,1,0
4880,57484,30317,0,0,deny,62,62,0,1,0,1,0
4881,54501,445,0,0,drop,70,70,0,1,0,1,0
4882,53256,5900,0,0,deny,60,60,0,1,0,1,0
4883,49793,445,0,0,drop,70,70,0,1,0,1,0
4884,65530,53,21720,53,allow,167,86,81,2,30,1,1
4885,10004,40014,64871,40014,allow,156,94,62,2,30,1,1
4886,56569,53,13010,53,allow,183,94,89,2,30,1,1
4887,44062,443,52650,443,allow,8998,1684,7314,24,170,12,12
4888,58958,80,41174,80,allow,6969,6315,654,15,15,9,6
4889,50594,443,48288,443,allow,4337,3026,1311,21,141,12,9
4890,34783,5222,34830,5222,allow,482,210,272,8,15,4,4
4891,5588,5588,0,0,allow,3498,1872,1626,48,204,24,24
4892,56385,53,3618,53,allow,249,85,164,4,55,2,2
4893,49277,53,20518,53,allow,199,102,97,2,30,1,1
4894,64752,53,29277,53,allow,195,102,93,2,30,1,1
4895,64276,53,2363,53,allow,354,102,252,2,30,1,1
4896,55933,53,42992,53,allow,182,94,88,2,30,1,1
4897,54994,53,3788,53,allow,209,110,99,2,30,1,1
4898,49437,53,23949,53,allow,199,102,97,2,30,1,1
4899,57356,53,19968,53,allow,199,102,97,2,30,1,1
4900,55004,443,35617,443,allow,27629,9041,18588,88,271,46,42
4901,52175,1101,27107,1101,allow,70,70,0,1,5,1,0
4902,55600,53,6191,53,allow,209,110,99,2,29,1,1
4903,53373,53,58629,53,allow,242,78,164,2,29,1,1
4904,57067,53,18004,53,allow,183,94,89,2,29,1,1
4905,65403,53,40925,53,allow,199,102,97,2,29,1,1
4906,49546,53,27218,53,allow,193,102,91,2,30,1,1
4907,64238,53,6347,53,allow,215,102,113,2,30,1,1
4908,56330,53,48374,53,allow,271,95,176,4,47,2,2
4909,49437,53,10171,53,allow,199,102,97,2,30,1,1
4910,52128,80,31768,80,allow,366,240,126,7,26,5,2
4911,54139,80,14592,80,allow,1515,481,1034,11,15,6,5
4912,33970,443,28633,443,allow,2586,832,1754,14,15,7,7
4913,52124,80,5847,80,allow,366,240,126,7,26,5,2
4914,35514,80,18032,80,allow,841,715,126,5,14,3,2
4915,64078,54561,7261,54561,allow,66,66,0,2,7,2,0
4916,52206,59077,23195,59077,allow,316,136,180,6,9,3,3
4917,50043,443,32430,443,allow,6551,2085,4466,25,85,14,11
4918,36145,443,14544,443,allow,1439,878,561,15,17,10,5
4919,53969,13156,38324,13156,allow,70,70,0,2,7,2,0
4920,53972,59089,65256,59089,allow,70,70,0,2,7,2,0
4921,64079,20233,31225,20233,allow,66,66,0,2,7,2,0
4922,38011,443,55120,443,allow,6732,885,5847,24,368,7,17
4923,49176,443,57308,443,allow,10225,3155,7070,28,57,19,9
4924,49479,53,55939,53,allow,213,94,119,2,29,1,1
4925,54207,443,5893,443,allow,4788,785,4003,15,70,8,7
4926,55005,53,24549,53,allow,183,94,89,2,30,1,1
4927,65339,53,4097,53,allow,775,102,673,2,30,1,1
4928,64559,53,8772,53,allow,198,102,96,2,30,1,1
4929,64048,53,38443,53,allow,209,110,99,2,30,1,1
4930,52102,80,29370,80,allow,22495,1895,20600,33,27,15,18
4931,51880,8001,9632,8001,allow,86,86,0,1,30,1,0
4932,52176,17572,9912,17572,allow,70,70,0,1,5,1,0
4933,52171,63033,25728,63033,allow,70,70,0,1,5,1,0
4934,49382,53,23594,53,allow,200,102,98,2,30,1,1
4935,49552,53,39720,53,allow,102,102,0,1,30,1,0
4936,49869,53,64308,53,allow,209,110,99,2,30,1,1
4937,50708,80,26997,80,allow,1658,1247,411,8,15,5,3
4938,41157,443,35776,443,allow,78535,3648,74887,94,30,41,53
4939,58737,443,61229,443,allow,16417,13221,3196,50,74,31,19
4940,37602,53,37602,53,allow,260,106,154,2,32,1,1
4941,10019,443,53412,443,allow,1497912,26236,1471676,1321,121,299,1022
4942,58739,443,43331,443,allow,22751,17995,4756,67,73,42,25
4943,35985,443,7017,443,allow,6250,1312,4938,23,28,12,11
4944,55939,53,43027,53,allow,193,102,91,2,30,1,1
4945,56330,53,40178,53,allow,271,95,176,4,48,2,2
4946,36101,53,61383,53,allow,168,78,90,2,30,1,1
4947,55749,53,21707,53,allow,413,170,243,6,30,3,3
4948,55637,53,58251,53,allow,209,110,99,2,30,1,1
4949,56569,53,53689,53,allow,183,94,89,2,30,1,1
4950,55932,53,22197,53,allow,209,110,99,2,30,1,1
4951,55653,53,34737,53,allow,199,102,97,2,30,1,1
4952,64559,53,63710,53,allow,198,102,96,2,30,1,1
4953,49629,53,5781,53,allow,198,102,96,2,30,1,1
4954,57295,53,34997,53,allow,448,184,264,6,30,3,3
4955,56941,53,63824,53,allow,196,102,94,2,30,1,1
4956,56941,53,56569,53,allow,193,102,91,2,30,1,1
4957,55675,53,48589,53,allow,198,102,96,2,30,1,1
4958,55182,53,17791,53,allow,199,102,97,2,30,1,1
4959,65292,53,4110,53,allow,195,102,93,2,30,1,1
4960,55182,53,55293,53,allow,199,102,97,2,30,1,1
4961,56941,53,44223,53,allow,196,102,94,2,30,1,1
4962,65260,53,8952,53,allow,199,102,97,2,30,1,1
4963,64976,53,35202,53,allow,229,102,127,2,30,1,1
4964,56672,53,28150,53,allow,199,102,97,2,30,1,1
4965,52168,62118,28732,62118,allow,70,70,0,1,5,1,0
4966,41322,53,41322,53,allow,244,98,146,2,32,1,1
4967,58902,5223,20774,5223,allow,308,86,222,4,13,1,3
4968,49229,8112,22492,8112,allow,2049,1276,773,15,15,8,7
4969,33098,443,57667,443,allow,6044,780,5264,16,66,8,8
4970,48286,443,48286,443,allow,4621,1714,2907,19,26,11,8
4971,47310,443,33854,443,allow,3541,616,2925,19,165,8,11
4972,56180,53,31487,53,allow,200,102,98,2,30,1,1
4973,54106,53,53865,53,allow,164,78,86,2,30,1,1
4974,55933,53,60713,53,allow,182,94,88,2,30,1,1
4975,57401,53,48123,53,allow,179,94,85,2,30,1,1
4976,57356,53,26396,53,allow,199,102,97,2,30,1,1
4977,55932,53,3248,53,allow,209,110,99,2,30,1,1
4978,65260,53,3983,53,allow,199,102,97,2,30,1,1
4979,55764,53,63898,53,allow,250,94,156,2,30,1,1
4980,49666,443,64744,443,allow,14531,7971,6560,36,190,20,16
4981,52212,51343,6977,51343,allow,70,70,0,2,6,2,0
4982,52179,14354,22942,14354,allow,70,70,0,1,5,1,0
4983,52172,7353,21812,7353,allow,70,70,0,1,5,1,0
4984,50934,443,28821,443,allow,9989,3003,6986,30,46,17,13
4985,32962,443,9560,443,allow,3935,1010,2925,20,165,9,11
4986,54994,53,62711,53,allow,209,110,99,2,30,1,1
4987,55377,53,33641,53,allow,195,102,93,2,30,1,1
4988,56180,53,37696,53,allow,200,102,98,2,30,1,1
4989,49343,53,1518,53,allow,209,110,99,2,30,1,1
4990,65513,53,51212,53,allow,216,102,114,2,30,1,1
4991,49284,53,41000,53,allow,195,86,109,2,30,1,1
4992,56180,53,15802,53,allow,200,102,98,2,30,1,1
4993,49650,53,58699,53,allow,539,97,442,4,58,2,2
4994,55948,5223,3545,5223,allow,10038,5272,4766,36,196,20,16
4995,50045,443,55393,443,allow,5661,1526,4135,22,85,12,10
4996,56330,53,41814,53,allow,271,95,176,4,47,2,2
4997,50047,443,14680,443,allow,4612,947,3665,18,85,10,8
4998,50658,443,64697,443,allow,4876,2522,2354,22,83,13,9
4999,6881,6881,3673,6881,allow,237,118,119,2,1200,1,1
5000,50608,443,24048,443,allow,4758,2811,1947,22,140,12,10
5001,50578,80,35081,80,allow,367162,17367,349795,470,143,214,256
5002,39194,53,39194,53,allow,414,268,146,3,32,2,1
5003,52211,56648,57880,56648,allow,70,70,0,2,8,2,0
5004,52232,35126,34717,35126,allow,70,70,0,1,5,1,0
5005,65518,443,8967,443,allow,92157,4519,87638,105,15,39,66
5006,50612,443,9041,443,allow,6782,3367,3415,25,139,15,10
5007,60729,443,20106,443,allow,5737,1929,3808,19,201,11,8
5008,52208,47300,20128,47300,allow,70,70,0,2,9,2,0
5009,38977,53,0,0,allow,82,82,0,2,40,2,0
5010,64132,53,20663,53,allow,381,102,279,4,42,2,2
5011,44060,443,59243,443,allow,9734,1614,8120,24,170,11,13
5012,55774,8060,26633,8060,allow,70,70,0,2,8,2,0
5013,52178,30922,2429,30922,allow,70,70,0,1,5,1,0
5014,43304,443,10226,443,allow,4389,797,3592,15,70,8,7
5015,52180,20121,7972,20121,allow,70,70,0,1,5,1,0
5016,57188,53,28885,53,allow,193,102,91,2,29,1,1
5017,49520,53,8068,53,allow,209,110,99,2,29,1,1
5018,55637,53,5558,53,allow,209,110,99,2,29,1,1
5019,64935,53,54508,53,allow,193,102,91,2,29,1,1
5020,50296,53,43204,53,allow,183,94,89,2,29,1,1
5021,38608,80,62728,80,allow,1289,303,986,12,16,5,7
5022,55005,53,53050,53,allow,183,94,89,2,29,1,1
5023,49662,53,29879,53,allow,211,102,109,2,29,1,1
5024,60591,80,30981,80,allow,1364,860,504,13,17,8,5
5025,65336,53,9283,53,allow,200,102,98,2,29,1,1
5026,64686,53,47974,53,allow,214,102,112,2,29,1,1
5027,65196,53,54719,53,allow,392,90,302,4,55,2,2
5028,38948,53,19233,53,allow,242,78,164,2,29,1,1
5029,56385,53,22600,53,allow,249,85,164,4,55,2,2
5030,64752,53,50636,53,allow,195,102,93,2,30,1,1
5031,51880,51881,42143,51881,allow,86,86,0,1,30,1,0
5032,57258,53,33746,53,allow,215,102,113,2,30,1,1
5033,51880,8001,32545,8001,allow,86,86,0,1,30,1,0
5034,65370,53,23524,53,allow,193,102,91,2,30,1,1
5035,50401,53,50401,53,allow,200,90,110,2,30,1,1
5036,56544,53,54094,53,allow,224,102,122,2,30,1,1
5037,64637,53,52362,53,allow,194,102,92,2,30,1,1
5038,56951,53,9479,53,allow,199,102,97,2,30,1,1
5039,56805,53,39519,53,allow,178,94,84,2,30,1,1
5040,49331,53,5900,53,allow,182,94,88,2,31,1,1
5041,56884,53,35715,53,allow,199,102,97,2,30,1,1
5042,49382,53,23586,53,allow,200,102,98,2,30,1,1
5043,65292,53,3636,53,allow,195,102,93,2,30,1,1
5044,56186,53,56186,53,allow,233,98,135,2,30,1,1
5045,56739,443,22996,443,allow,795,795,0,2,169,2,0
5046,54367,443,60704,443,allow,5892088,193411,5698677,6287,213,2098,4189
5047,54438,443,22711,443,allow,8198,1975,6223,24,361,11,13
5048,17750,18866,37630,18866,allow,150,150,0,1,1200,1,0
5049,45860,443,61779,443,allow,12852,3554,9298,35,24,19,16
5050,36146,443,34524,443,allow,1147,660,487,11,17,7,4
5051,5011,53,5011,53,allow,244,98,146,2,32,1,1
5052,53173,25067,13422,25067,allow,70,70,0,2,8,2,0
5053,52183,13503,58173,13503,allow,70,70,0,1,5,1,0
5054,55933,53,55116,53,allow,330,92,238,4,43,2,2
5055,38713,443,14389,443,allow,90241,3033,87208,89,16,24,65
5056,49543,53,24051,53,allow,880,189,691,6,75,3,3
5057,56941,53,56687,53,allow,193,102,91,2,30,1,1
5058,55653,53,53327,53,allow,199,102,97,2,30,1,1
5059,64569,53,17459,53,allow,183,94,89,2,30,1,1
5060,51446,53,21490,53,allow,168,78,90,2,30,1,1
5061,64066,80,28023,80,allow,314,192,122,6,15,4,2
5062,53101,443,12106,443,allow,1287,800,487,13,16,9,4
5063,52210,15604,53868,15604,allow,70,70,0,2,8,2,0
5064,52182,60769,21483,60769,allow,70,70,0,1,5,1,0
5065,38712,443,31171,443,allow,382972,9177,373795,378,16,120,258
5066,44061,443,59659,443,allow,8551,1685,6866,24,170,12,12
5067,56385,53,50438,53,allow,249,85,164,4,56,2,2
5068,55201,53,9810,53,allow,168,78,90,2,30,1,1
5069,49343,53,21551,53,allow,209,110,99,2,30,1,1
5070,57051,53,56096,53,allow,185,102,83,2,30,1,1
5071,64821,53,30415,53,allow,775,102,673,2,30,1,1
5072,50234,53,63121,53,allow,720,94,626,2,30,1,1
5073,49488,53,56220,53,allow,194,102,92,2,31,1,1
5074,60661,53,54714,53,allow,278,102,176,2,31,1,1
5075,65526,53,37729,53,allow,199,102,97,2,30,1,1
5076,52056,80,64858,80,allow,4562,3936,626,11,28,6,5
5077,53102,443,27329,443,allow,983,496,487,9,16,5,4
5078,52214,27480,12479,27480,allow,70,70,0,2,6,2,0
5079,44065,443,13980,443,allow,6114,862,5252,17,71,9,8
5080,44059,443,60027,443,allow,9730,1613,8117,24,170,11,13
5081,44893,53,32339,53,allow,199,94,105,2,30,1,1
5082,56569,53,42369,53,allow,183,94,89,2,30,1,1
5083,64578,53,30124,53,allow,193,102,91,2,30,1,1
5084,56672,53,60163,53,allow,199,102,97,2,30,1,1
5085,64055,53,3603,53,allow,233,94,139,2,30,1,1
5086,65258,53,62928,53,allow,178,94,84,2,30,1,1
5087,64569,53,45660,53,allow,183,94,89,2,30,1,1
5088,50356,53,30610,53,allow,180,94,86,2,30,1,1
5089,57067,53,11799,53,allow,183,94,89,2,30,1,1
5090,64288,53,3103,53,allow,183,94,89,2,31,1,1
5091,56725,53,48111,53,allow,180,94,86,2,31,1,1
5092,49869,53,29655,53,allow,209,110,99,2,30,1,1
5093,56317,53,15827,53,allow,183,94,89,2,30,1,1
5094,65258,53,21767,53,allow,178,94,84,2,30,1,1
5095,65370,53,10592,53,allow,193,102,91,2,30,1,1
5096,56005,53,10080,53,allow,199,102,97,2,30,1,1
5097,64935,53,65195,53,allow,193,102,91,2,30,1,1
5098,55078,53,15054,53,allow,246,94,152,2,30,1,1
5099,49610,53,51833,53,allow,212,102,110,2,30,1,1
5100,49380,53,58826,53,allow,199,102,97,2,31,1,1
5101,65346,53,19469,53,allow,183,94,89,2,30,1,1
5102,49671,53,47128,53,allow,183,94,89,2,30,1,1
5103,57401,53,55696,53,allow,179,94,85,2,31,1,1
5104,64957,53,58925,53,allow,196,102,94,2,30,1,1
5105,57035,53,3817,53,allow,199,102,97,2,30,1,1
5106,49838,53,52067,53,allow,183,94,89,2,31,1,1
5107,64204,53,35802,53,allow,193,102,91,2,30,1,1
5108,64204,53,37090,53,allow,193,102,91,2,31,1,1
5109,51325,443,32371,443,allow,2959,793,2166,10,120,5,5
5110,57035,53,5245,53,allow,199,102,97,2,30,1,1
5111,49382,53,52583,53,allow,200,102,98,2,31,1,1
5112,56805,53,61616,53,allow,178,94,84,2,31,1,1
5113,65370,53,21172,53,allow,193,102,91,2,30,1,1
5114,50694,443,18706,443,allow,3097,1708,1389,15,19,9,6
5115,50018,53,63073,53,allow,350,91,259,4,41,2,2
5116,49869,53,17507,53,allow,414,103,311,4,31,2,2
5117,53923,25267,60857,25267,allow,1724,1157,567,14,17,9,5
5118,52525,80,56526,80,allow,3951,3437,514,13,15,8,5
5119,57446,443,49278,443,allow,9642,3343,6299,37,16,17,20
5120,49364,53,13056,53,allow,307,307,0,4,60,4,0
5121,62112,443,29747,443,allow,505589,13504,492085,462,345,91,371
5122,50607,443,33073,443,allow,3947,2271,1676,22,140,13,9
5123,37898,53,37898,53,allow,244,98,146,2,33,1,1
5124,5480,53,5480,53,allow,244,98,146,2,33,1,1
5125,52167,61948,3341,61948,allow,70,70,0,1,5,1,0
5126,49991,80,28668,80,allow,2095,1010,1085,11,87,6,5
5127,62149,22114,0,0,deny,66,66,0,1,0,1,0
5128,13589,22114,0,0,deny,146,146,0,1,0,1,0
5129,54496,445,0,0,drop,70,70,0,1,0,1,0
5130,54492,445,0,0,drop,70,70,0,1,0,1,0
5131,54493,445,0,0,drop,70,70,0,1,0,1,0
5132,443,36576,0,0,deny,60,60,0,1,0,1,0
5133,53275,21247,0,0,deny,66,66,0,1,0,1,0
5134,63487,129,0,0,deny,60,60,0,1,0,1,0
5135,53750,25174,0,0,deny,66,66,0,1,0,1,0
5136,49781,445,0,0,drop,70,70,0,1,0,1,0
5137,49784,445,0,0,drop,70,70,0,1,0,1,0
5138,49782,445,0,0,drop,70,70,0,1,0,1,0
5139,53667,22114,0,0,deny,66,66,0,1,0,1,0
5140,20544,5223,0,0,deny,148,148,0,1,0,1,0
5141,49780,445,0,0,drop,70,70,0,1,0,1,0
5142,53721,62413,0,0,deny,62,62,0,1,0,1,0
5143,64005,26467,0,0,deny,66,66,0,1,0,1,0
5144,49777,445,0,0,drop,70,70,0,1,0,1,0
5145,9687,35440,0,0,deny,66,66,0,1,0,1,0
5146,16425,15503,0,0,deny,62,62,0,1,0,1,0
5147,51414,22,0,0,deny,60,60,0,1,0,1,0
5148,43671,17372,0,0,deny,62,62,0,1,0,1,0
5149,58835,17372,0,0,deny,66,66,0,1,0,1,0
5150,54491,445,0,0,drop,70,70,0,1,0,1,0
5151,54488,445,0,0,drop,70,70,0,1,0,1,0
5152,54485,445,0,0,drop,70,70,0,1,0,1,0
5153,63495,50584,0,0,deny,66,66,0,1,0,1,0
5154,49897,445,0,0,drop,66,66,0,1,0,1,0
5155,54483,445,0,0,drop,70,70,0,1,0,1,0
5156,49894,445,0,0,drop,66,66,0,1,0,1,0
5157,12164,22114,0,0,deny,146,146,0,1,0,1,0
5158,12338,64147,0,0,deny,66,66,0,1,0,1,0
5159,17213,22114,0,0,deny,62,62,0,1,0,1,0
5160,61701,15503,0,0,deny,66,66,0,1,0,1,0
5161,49893,445,0,0,drop,66,66,0,1,0,1,0
5162,49891,445,0,0,drop,66,66,0,1,0,1,0
5163,49769,445,0,0,drop,70,70,0,1,0,1,0
5164,53305,50584,0,0,deny,66,66,0,1,0,1,0
5165,62348,50584,0,0,deny,62,62,0,1,0,1,0
5166,64878,26467,0,0,deny,62,62,0,1,0,1,0
5167,49889,445,0,0,drop,66,66,0,1,0,1,0
5168,49938,57470,0,0,deny,62,62,0,1,0,1,0
5169,23753,25174,0,0,deny,62,62,0,1,0,1,0
5170,64013,57470,0,0,deny,74,74,0,1,0,1,0
5171,49761,445,0,0,drop,70,70,0,1,0,1,0
5172,40821,41615,0,0,deny,157,157,0,1,0,1,0
5173,31859,33909,0,0,deny,66,66,0,1,0,1,0
5174,54478,445,0,0,drop,70,70,0,1,0,1,0
5175,49760,445,0,0,drop,70,70,0,1,0,1,0
5176,31691,50584,0,0,deny,62,62,0,1,0,1,0
5177,58751,51221,0,0,deny,62,62,0,1,0,1,0
5178,50488,22114,0,0,deny,62,62,0,1,0,1,0
5179,1025,46776,0,0,deny,62,62,0,1,0,1,0
5180,54471,445,0,0,drop,70,70,0,1,0,1,0
5181,54465,445,0,0,drop,70,70,0,1,0,1,0
5182,29064,23,0,0,deny,60,60,0,1,0,1,0
5183,9552,22114,0,0,deny,146,146,0,1,0,1,0
5184,49196,25174,0,0,deny,62,62,0,1,0,1,0
5185,49754,445,0,0,drop,70,70,0,1,0,1,0
5186,49878,445,0,0,drop,66,66,0,1,0,1,0
5187,56152,56205,0,0,deny,66,66,0,1,0,1,0
5188,49753,445,0,0,drop,70,70,0,1,0,1,0
5189,6899,48817,0,0,deny,139,139,0,1,0,1,0
5190,1048,25174,0,0,deny,62,62,0,1,0,1,0
5191,48478,49903,0,0,deny,62,62,0,1,0,1,0
5192,53194,26467,0,0,deny,66,66,0,1,0,1,0
5193,49749,445,0,0,drop,70,70,0,1,0,1,0
5194,49871,445,0,0,drop,66,66,0,1,0,1,0
5195,59497,64097,0,0,deny,66,66,0,1,0,1,0
5196,54455,445,0,0,drop,70,70,0,1,0,1,0
5197,57325,60043,0,0,deny,66,66,0,1,0,1,0
5198,443,50238,0,0,deny,331,331,0,1,0,1,0
5199,443,23220,0,0,deny,100,100,0,1,0,1,0
5200,51046,25174,0,0,deny,62,62,0,1,0,1,0
5201,49748,445,0,0,drop,70,70,0,1,0,1,0
5202,443,45788,0,0,deny,332,332,0,1,0,1,0
5203,49869,445,0,0,drop,66,66,0,1,0,1,0
5204,62838,44847,0,0,deny,66,66,0,1,0,1,0
5205,61784,49903,0,0,deny,66,66,0,1,0,1,0
5206,22350,25174,0,0,deny,62,62,0,1,0,1,0
5207,14717,64147,0,0,deny,66,66,0,1,0,1,0
5208,18642,42707,0,0,deny,62,62,0,1,0,1,0
5209,53730,37965,0,0,deny,66,66,0,1,0,1,0
5210,60248,46776,0,0,deny,66,66,0,1,0,1,0
5211,49862,445,0,0,drop,66,66,0,1,0,1,0
5212,49743,445,0,0,drop,70,70,0,1,0,1,0
5213,55201,26467,0,0,deny,66,66,0,1,0,1,0
5214,49853,445,0,0,drop,66,66,0,1,0,1,0
5215,22240,22114,0,0,deny,146,146,0,1,0,1,0
5216,2572,17546,0,0,deny,66,66,0,1,0,1,0
5217,18653,42707,0,0,deny,66,66,0,1,0,1,0
5218,15899,37807,0,0,deny,62,62,0,1,0,1,0
5219,28999,37807,0,0,deny,62,62,0,1,0,1,0
5220,34360,25174,0,0,deny,62,62,0,1,0,1,0
5221,58118,22114,0,0,deny,62,62,0,1,0,1,0
5222,64811,51221,0,0,deny,62,62,0,1,0,1,0
5223,54446,445,0,0,drop,70,70,0,1,0,1,0
5224,54443,445,0,0,drop,70,70,0,1,0,1,0
5225,54444,445,0,0,drop,70,70,0,1,0,1,0
5226,50784,50584,0,0,deny,146,146,0,1,0,1,0
5227,49844,445,0,0,drop,66,66,0,1,0,1,0
5228,49842,445,0,0,drop,66,66,0,1,0,1,0
5229,49846,445,0,0,drop,66,66,0,1,0,1,0
5230,49845,445,0,0,drop,66,66,0,1,0,1,0
5231,49840,445,0,0,drop,66,66,0,1,0,1,0
5232,49843,445,0,0,drop,66,66,0,1,0,1,0
5233,49841,445,0,0,drop,66,66,0,1,0,1,0
5234,49838,445,0,0,drop,66,66,0,1,0,1,0
5235,58799,30188,0,0,deny,66,66,0,1,0,1,0
5236,49730,445,0,0,drop,70,70,0,1,0,1,0
5237,17230,25174,0,0,deny,146,146,0,1,0,1,0
5238,11006,23117,0,0,deny,146,146,0,1,0,1,0
5239,65270,3855,0,0,deny,78,78,0,1,0,1,0
5240,44207,44847,0,0,deny,66,66,0,1,0,1,0
5241,55893,45711,0,0,deny,78,78,0,1,0,1,0
5242,49727,445,0,0,drop,70,70,0,1,0,1,0
5243,42608,1,0,0,deny,62,62,0,1,0,1,0
5244,40418,25174,0,0,deny,66,66,0,1,0,1,0
5245,63488,22114,0,0,deny,62,62,0,1,0,1,0
5246,52745,57866,0,0,deny,62,62,0,1,0,1,0
5247,11676,25174,0,0,deny,146,146,0,1,0,1,0
5248,38629,25174,0,0,deny,62,62,0,1,0,1,0
5249,54441,445,0,0,drop,70,70,0,1,0,1,0
5250,54434,445,0,0,drop,70,70,0,1,0,1,0
5251,54432,445,0,0,drop,70,70,0,1,0,1,0
5252,54428,445,0,0,drop,70,70,0,1,0,1,0
5253,64334,25174,0,0,deny,62,62,0,1,0,1,0
5254,51430,25174,0,0,deny,146,146,0,1,0,1,0
5255,5222,7493,0,0,deny,66,66,0,1,0,1,0
5256,56098,64147,0,0,deny,66,66,0,1,0,1,0
5257,1594,44847,0,0,deny,62,62,0,1,0,1,0
5258,57607,21247,0,0,deny,66,66,0,1,0,1,0
5259,60485,22114,0,0,deny,62,62,0,1,0,1,0
5260,49723,445,0,0,drop,70,70,0,1,0,1,0
5261,49826,445,0,0,drop,66,66,0,1,0,1,0
5262,49825,445,0,0,drop,66,66,0,1,0,1,0
5263,49824,445,0,0,drop,66,66,0,1,0,1,0
5264,6666,5000,0,0,deny,60,60,0,1,0,1,0
5265,3765,64147,0,0,deny,62,62,0,1,0,1,0
5266,49721,445,0,0,drop,70,70,0,1,0,1,0
5267,51313,25174,0,0,deny,62,62,0,1,0,1,0
5268,13285,29892,0,0,deny,145,145,0,1,0,1,0
5269,58463,11392,0,0,deny,66,66,0,1,0,1,0
5270,62716,23,0,0,deny,60,60,0,1,0,1,0
5271,49719,445,0,0,drop,70,70,0,1,0,1,0
5272,56377,51505,0,0,deny,66,66,0,1,0,1,0
5273,12457,57866,0,0,deny,62,62,0,1,0,1,0
5274,51456,45680,0,0,deny,139,139,0,1,0,1,0
5275,28792,22,0,0,deny,60,60,0,1,0,1,0
5276,54423,445,0,0,drop,70,70,0,1,0,1,0
5277,51575,9694,0,0,deny,66,66,0,1,0,1,0
5278,44398,50584,0,0,deny,146,146,0,1,0,1,0
5279,54418,445,0,0,drop,70,70,0,1,0,1,0
5280,54419,445,0,0,drop,70,70,0,1,0,1,0
5281,54415,445,0,0,drop,70,70,0,1,0,1,0
5282,54043,36237,0,0,deny,62,62,0,1,0,1,0
5283,60830,50584,0,0,deny,62,62,0,1,0,1,0
5284,62971,44847,0,0,deny,66,66,0,1,0,1,0
5285,9748,21247,0,0,deny,66,66,0,1,0,1,0
5286,38565,51505,0,0,deny,66,66,0,1,0,1,0
5287,61916,64097,0,0,deny,66,66,0,1,0,1,0
5288,3580,25174,0,0,deny,62,62,0,1,0,1,0
5289,34262,23,0,0,deny,60,60,0,1,0,1,0
5290,49712,445,0,0,drop,70,70,0,1,0,1,0
5291,57761,15503,0,0,deny,62,62,0,1,0,1,0
5292,13168,35440,0,0,deny,66,66,0,1,0,1,0
5293,22916,25174,0,0,deny,62,62,0,1,0,1,0
5294,49710,445,0,0,drop,70,70,0,1,0,1,0
5295,19623,25174,0,0,deny,62,62,0,1,0,1,0
5296,57793,37807,0,0,deny,66,66,0,1,0,1,0
5297,22528,25174,0,0,deny,146,146,0,1,0,1,0
5298,49709,445,0,0,drop,70,70,0,1,0,1,0
5299,1027,57866,0,0,deny,62,62,0,1,0,1,0
5300,54404,445,0,0,drop,70,70,0,1,0,1,0
5301,54403,445,0,0,drop,70,70,0,1,0,1,0
5302,54399,445,0,0,drop,70,70,0,1,0,1,0
5303,49708,445,0,0,drop,70,70,0,1,0,1,0
5304,10627,23117,0,0,deny,62,62,0,1,0,1,0
5305,49707,445,0,0,drop,70,70,0,1,0,1,0
5306,23379,57866,0,0,deny,62,62,0,1,0,1,0
5307,49701,445,0,0,drop,70,70,0,1,0,1,0
5308,49702,445,0,0,drop,70,70,0,1,0,1,0
5309,49812,445,0,0,drop,66,66,0,1,0,1,0
5310,52336,64097,0,0,deny,66,66,0,1,0,1,0
5311,58453,50584,0,0,deny,66,66,0,1,0,1,0
5312,37075,48817,0,0,deny,62,62,0,1,0,1,0
5313,49689,445,0,0,drop,70,70,0,1,0,1,0
5314,49687,445,0,0,drop,70,70,0,1,0,1,0
5315,49686,445,0,0,drop,70,70,0,1,0,1,0
5316,7105,25174,0,0,deny,66,66,0,1,0,1,0
5317,49678,445,0,0,drop,70,70,0,1,0,1,0
5318,49679,445,0,0,drop,70,70,0,1,0,1,0
5319,49488,53,14006,53,allow,188,96,92,2,30,1,1
5320,56805,53,35322,53,allow,172,88,84,2,30,1,1
5321,65448,443,34387,443,allow,3224,2373,851,17,23,9,8
5322,55043,443,34590,443,allow,37068,4085,32983,66,48,33,33
5323,49703,443,4967,443,allow,421435,16499,404936,388,210,95,293
5324,64637,53,50285,53,allow,188,96,92,2,30,1,1
5325,49931,443,64224,443,allow,92352,5699,86653,105,134,35,70
5326,49984,53,41486,53,allow,172,88,84,2,30,1,1
5327,41545,443,41545,443,allow,4719,1812,2907,19,29,11,8
5328,50005,80,43332,80,allow,2088,1160,928,10,86,6,4
5329,57470,24409,44348,24409,allow,870,330,540,12,1501,6,6
5330,40033,80,40033,80,allow,424,198,226,7,142,4,3
5331,40080,80,40080,80,allow,424,198,226,7,142,4,3
5332,39943,80,39943,80,allow,424,198,226,7,142,4,3
5333,50749,443,38979,443,allow,4749,1897,2852,16,124,8,8
5334,49035,443,36911,443,allow,4299,2327,1972,23,315,11,12
5335,49709,443,24927,443,allow,523518,15431,508087,466,210,109,357
5336,18381,53,18381,53,allow,237,91,146,2,32,1,1
5337,51260,80,28140,80,allow,2339,1680,659,11,17,6,5
5338,50015,443,26548,443,allow,59858,24345,35513,148,612,78,70
5339,49319,53,3849,53,allow,198,101,97,2,30,1,1
5340,58036,443,28433,443,allow,10454,1724,8730,28,525,12,16
5341,49242,443,58883,443,allow,638,70,568,10,203,2,8
5342,38536,443,1919,443,allow,33980,7386,26594,51,121,22,29
5343,53927,37828,58314,37828,allow,552,306,246,9,16,5,4
5344,50006,80,59669,80,allow,2087,1159,928,10,86,6,4
5345,49707,443,44929,443,allow,593578,18531,575047,531,210,128,403
5346,53172,56013,19244,56013,allow,70,70,0,2,8,2,0
5347,53936,5915,56119,5915,allow,70,70,0,1,5,1,0
5348,52166,57975,20041,57975,allow,66,66,0,1,5,1,0
5349,53932,27258,53010,27258,allow,70,70,0,1,5,1,0
5350,58178,443,51468,443,allow,8000,1760,6240,32,43,16,16
5351,57451,443,58507,443,allow,19175423,168230,19007193,15129,313,2298,12831
5352,42956,53,20926,53,allow,168,78,90,2,30,1,1
5353,56725,53,37417,53,allow,176,90,86,3,55,2,1
5354,48290,443,64782,443,allow,7920,2731,5189,27,82,15,12
5355,49838,53,8093,53,allow,182,93,89,2,31,1,1
5356,41936,443,58038,443,allow,7118,2386,4732,18,133,10,8
5357,50007,80,25590,80,allow,2089,1161,928,10,86,6,4
5358,49704,443,41533,443,allow,513839,16341,497498,453,210,104,349
5359,57570,443,12758,443,allow,21267,5407,15860,36,361,17,19
5360,49930,443,24713,443,allow,16631,7072,9559,50,134,29,21
5361,57447,443,62052,443,allow,7847,1377,6470,27,15,12,15
5362,55796,53,55796,53,allow,253,99,154,2,32,1,1
5363,58179,443,33593,443,allow,7883,1768,6115,30,36,14,16
5364,58666,53,58666,53,allow,235,90,145,2,32,1,1
5365,53963,6882,44227,6882,allow,70,70,0,2,8,2,0
5366,53968,17904,18186,17904,allow,320,140,180,6,7,3,3
5367,47092,15000,12405,15000,allow,138,78,60,2,5,1,1
5368,50017,443,54344,443,allow,51055,17321,33734,147,612,77,70
5369,53245,80,62504,80,allow,2071,1305,766,10,256,6,4
5370,65530,53,20818,53,allow,166,85,81,2,30,1,1
5371,43934,53,43934,53,allow,310,94,216,2,30,1,1
5372,57319,53,22543,53,allow,176,90,86,2,30,1,1
5373,56100,53,56100,53,allow,265,111,154,2,30,1,1
5374,65189,53,20195,53,allow,176,90,86,2,31,1,1
5375,64143,53,9554,53,allow,174,89,85,2,31,1,1
5376,32843,443,63526,443,allow,6444,2640,3804,18,122,9,9
5377,64727,443,24002,443,allow,18620,15824,2796,31,129,18,13
5378,39802,80,39802,80,allow,424,198,226,7,142,4,3
5379,6882,46440,39998,46440,allow,324,150,174,2,1200,1,1
5380,55704,53,48604,53,allow,186,95,91,2,31,1,1
5381,39852,80,39852,80,allow,576,272,304,9,142,5,4
5382,54440,26467,0,0,deny,62,62,0,1,0,1,0
5383,3730,17372,0,0,deny,62,62,0,1,0,1,0
5384,54539,26467,0,0,deny,62,62,0,1,0,1,0
5385,36933,23117,0,0,deny,66,66,0,1,0,1,0
5386,54398,445,0,0,drop,70,70,0,1,0,1,0
5387,9504,25174,0,0,deny,62,62,0,1,0,1,0
5388,53928,15503,0,0,deny,62,62,0,1,0,1,0
5389,54397,445,0,0,drop,70,70,0,1,0,1,0
5390,48706,23393,0,0,deny,60,60,0,1,0,1,0
5391,57557,64147,0,0,deny,62,62,0,1,0,1,0
5392,31780,11392,0,0,deny,62,62,0,1,0,1,0
5393,443,14591,0,0,deny,131,131,0,1,0,1,0
5394,46275,23,0,0,deny,60,60,0,1,0,1,0
5395,443,45788,0,0,deny,332,332,0,1,0,1,0
5396,49797,445,0,0,drop,66,66,0,1,0,1,0
5397,49795,445,0,0,drop,66,66,0,1,0,1,0
5398,3986,17372,0,0,deny,66,66,0,1,0,1,0
5399,443,18177,0,0,deny,66,66,0,1,0,1,0
5400,65442,80,64392,80,allow,366,180,186,7,28,4,3
5401,42318,443,52319,443,allow,10723,2046,8677,29,116,10,19
5402,49380,53,47715,53,allow,199,102,97,2,30,1,1
5403,56805,53,60553,53,allow,178,94,84,2,30,1,1
5404,26906,22114,0,0,deny,66,66,0,1,0,1,0
5405,49001,22114,0,0,deny,62,62,0,1,0,1,0
5406,49667,445,0,0,drop,70,70,0,1,0,1,0
5407,53838,36829,0,0,deny,62,62,0,1,0,1,0
5408,28830,37965,0,0,deny,62,62,0,1,0,1,0
5409,57015,25174,0,0,deny,66,66,0,1,0,1,0
5410,54387,445,0,0,drop,70,70,0,1,0,1,0
5411,54383,445,0,0,drop,70,70,0,1,0,1,0
5412,54376,445,0,0,drop,70,70,0,1,0,1,0
5413,26239,25174,0,0,deny,62,62,0,1,0,1,0
5414,36484,67,0,0,deny,60,60,0,1,0,1,0
5415,49790,445,0,0,drop,66,66,0,1,0,1,0
5416,55246,31573,0,0,deny,62,62,0,1,0,1,0
5417,59068,49813,0,0,deny,74,74,0,1,0,1,0
5418,55393,44512,0,0,deny,66,66,0,1,0,1,0
5419,15018,37965,0,0,deny,62,62,0,1,0,1,0
5420,46162,25174,0,0,deny,62,62,0,1,0,1,0
5421,61550,5529,0,0,deny,145,145,0,1,0,1,0
5422,49785,445,0,0,drop,66,66,0,1,0,1,0
5423,49784,445,0,0,drop,66,66,0,1,0,1,0
5424,49783,445,0,0,drop,66,66,0,1,0,1,0
5425,49776,445,0,0,drop,66,66,0,1,0,1,0
5426,49779,445,0,0,drop,66,66,0,1,0,1,0
5427,49777,445,0,0,drop,66,66,0,1,0,1,0
5428,49778,445,0,0,drop,66,66,0,1,0,1,0
5429,49662,445,0,0,drop,70,70,0,1,0,1,0
5430,18771,35440,0,0,deny,66,66,0,1,0,1,0
5431,51922,44847,0,0,deny,66,66,0,1,0,1,0
5432,15981,23117,0,0,deny,146,146,0,1,0,1,0
5433,54371,445,0,0,drop,70,70,0,1,0,1,0
5434,54367,445,0,0,drop,70,70,0,1,0,1,0
5435,54365,445,0,0,drop,70,70,0,1,0,1,0
5436,54364,445,0,0,drop,70,70,0,1,0,1,0
5437,49652,445,0,0,drop,70,70,0,1,0,1,0
5438,49653,445,0,0,drop,70,70,0,1,0,1,0
5439,49654,445,0,0,drop,70,70,0,1,0,1,0
5440,63593,22114,0,0,deny,66,66,0,1,0,1,0
5441,48706,23393,0,0,deny,60,60,0,1,0,1,0
5442,42558,64147,0,0,deny,62,62,0,1,0,1,0
5443,49650,445,0,0,drop,70,70,0,1,0,1,0
5444,54189,64147,0,0,deny,66,66,0,1,0,1,0
5445,49646,445,0,0,drop,70,70,0,1,0,1,0
5446,49984,53,22558,53,allow,178,94,84,2,30,1,1
5447,30188,51403,44357,51403,allow,502,150,352,2,1200,1,1
5448,64637,53,26983,53,allow,194,102,92,2,31,1,1
5449,53933,20801,53397,20801,allow,70,70,0,1,4,1,0
5450,50927,80,64147,80,allow,876,519,357,10,75,6,4
5451,52524,80,48631,80,allow,3224,2776,448,11,15,7,4
5452,50688,80,9336,80,allow,27391,3550,23841,36,20,15,21
5453,50599,443,63618,443,allow,11301,5604,5697,29,139,17,12
5454,56403,53,56403,53,allow,244,98,146,2,32,1,1
5455,53399,53,53399,53,allow,414,268,146,3,32,2,1
5456,33017,443,34545,443,allow,130,70,60,3,4,2,1
5457,51986,443,52647,443,allow,7567,3038,4529,35,15,21,14
5458,49772,53,51587,53,allow,531,188,343,6,58,3,3
5459,65222,53,38822,53,allow,197,94,103,2,29,1,1
5460,56078,53,50373,53,allow,178,94,84,2,29,1,1
5461,56884,53,20649,53,allow,199,102,97,2,29,1,1
5462,64048,53,43496,53,allow,209,110,99,2,29,1,1
5463,49671,53,11585,53,allow,183,94,89,2,29,1,1
5464,65346,53,42988,53,allow,183,94,89,2,29,1,1
5465,55485,53,55524,53,allow,720,94,626,2,29,1,1
5466,65373,53,10645,53,allow,197,102,95,2,29,1,1
5467,64288,53,49667,53,allow,183,94,89,2,29,1,1
5468,57319,53,20750,53,allow,180,94,86,2,29,1,1
5469,64107,53,23798,53,allow,212,102,110,2,29,1,1
5470,35585,53,60283,53,allow,168,78,90,2,29,1,1
5471,56951,53,31350,53,allow,199,102,97,2,30,1,1
5472,52163,14181,27565,14181,allow,70,70,0,1,5,1,0
5473,52522,80,14593,80,allow,3290,2776,514,12,15,7,5
5474,65443,80,29432,80,allow,366,180,186,7,28,4,3
5475,56725,53,45081,53,allow,262,90,172,4,53,2,2
5476,60290,53,35403,53,allow,213,86,127,2,30,1,1
5477,49433,53,51324,53,allow,278,94,184,2,30,1,1
5478,52237,53,52237,53,allow,220,90,130,2,30,1,1
5479,49380,53,64533,53,allow,199,102,97,2,30,1,1
5480,38911,443,33015,443,allow,13187,2075,11112,35,420,11,24
5481,53572,443,49621,443,allow,5935,342,5593,12,120,5,7
5482,40368,123,25473,123,allow,184,94,90,2,30,1,1
5483,65189,53,27284,53,allow,180,94,86,2,30,1,1
5484,64266,53,14538,53,allow,255,102,153,2,30,1,1
5485,52520,80,54295,80,allow,3224,2776,448,11,15,7,4
5486,49838,53,33413,53,allow,183,94,89,2,30,1,1
5487,47886,80,46758,80,allow,1767,751,1016,10,15,6,4
5488,49798,53,8655,53,allow,196,102,94,2,30,1,1
5489,50928,80,36754,80,allow,875,518,357,10,75,6,4
5490,60499,51413,3005,51413,allow,70,70,0,2,8,2,0
5491,60500,44739,45783,44739,allow,70,70,0,2,8,2,0
5492,65430,80,47649,80,allow,306,180,126,6,29,4,2
5493,52093,80,65106,80,allow,366,240,126,7,26,5,2
5494,44962,8802,46440,8802,allow,4014,2342,1672,42,386,21,21
5495,65441,80,26203,80,allow,366,180,186,7,28,4,3
5496,49331,53,35223,53,allow,182,94,88,2,30,1,1
5497,56440,80,38855,80,allow,17008,1379,15629,22,25,7,15
5498,60384,80,50302,80,allow,1420,715,705,12,16,7,5
5499,49174,53,10035,53,allow,264,110,154,2,30,1,1
5500,56941,53,42543,53,allow,196,102,94,2,30,1,1
5501,56725,53,46910,53,allow,262,90,172,4,59,2,2
5502,56951,53,23495,53,allow,199,102,97,2,30,1,1
5503,50547,53,45838,53,allow,210,110,100,2,30,1,1
5504,41950,53,0,0,allow,86,86,0,1,30,1,0
5505,58771,53,46484,53,allow,168,78,90,2,30,1,1
5506,49798,53,43543,53,allow,196,102,94,2,30,1,1
5507,64569,53,30065,53,allow,183,94,89,2,30,1,1
5508,64143,53,33110,53,allow,179,94,85,2,30,1,1
5509,32966,53,20380,53,allow,199,94,105,2,30,1,1
5510,65346,53,64945,53,allow,183,94,89,2,30,1,1
5511,54402,53,53139,53,allow,291,86,205,2,30,1,1
5512,49184,53,41219,53,allow,199,94,105,2,30,1,1
5513,52165,49740,12957,49740,allow,70,70,0,1,5,1,0
5514,65440,80,8468,80,allow,366,180,186,7,28,4,3
5515,52521,80,12951,80,allow,3676,3228,448,11,15,7,4
5516,46532,3389,46532,3389,allow,4145,1976,2169,22,20,13,9
5517,35337,443,49436,443,allow,6550678,172191,6378487,6426,82,2117,4309
5518,16403,16385,45121,16385,allow,182,62,120,4,30,2,2
5519,49798,53,23227,53,allow,196,102,94,2,30,1,1
5520,57035,53,29329,53,allow,199,102,97,2,30,1,1
5521,49984,53,7504,53,allow,178,94,84,2,30,1,1
5522,65428,80,59063,80,allow,366,180,186,7,29,4,3
5523,50547,53,5293,53,allow,210,110,100,2,30,1,1
5524,49319,53,62578,53,allow,199,102,97,2,30,1,1
5525,65189,53,45878,53,allow,180,94,86,2,30,1,1
5526,63759,443,31179,443,allow,7995,2096,5899,18,120,8,10
5527,49672,443,34216,443,allow,10080,2728,7352,28,188,14,14
5528,34155,443,22614,443,allow,11294,2234,9060,23,139,12,11
5529,52644,6881,4484,6881,allow,719,413,306,10,14,5,5
5530,58172,80,64584,80,allow,12618,1038,11580,28,50,13,15
5531,53970,1024,11868,1024,allow,260,140,120,5,6,3,2
5532,53941,53739,17149,53739,allow,70,70,0,1,4,1,0
5533,60498,55100,34970,55100,allow,258,70,188,4,8,2,2
5534,56661,443,57675,443,allow,334,70,264,5,17,1,4
5535,65432,80,46367,80,allow,486,240,246,9,28,5,4
5536,56005,53,33914,53,allow,199,102,97,2,29,1,1
5537,65530,53,20918,53,allow,167,86,81,2,29,1,1
5538,53724,53,53724,53,allow,268,114,154,2,29,1,1
5539,65526,53,17627,53,allow,199,102,97,2,29,1,1
5540,61291,53,61291,53,allow,261,106,155,2,29,1,1
5541,37639,53,37639,53,allow,245,106,139,2,29,1,1
5542,64578,53,11531,53,allow,193,102,91,2,30,1,1
5543,51726,3389,51726,3389,allow,3444,1730,1714,16,33,8,8
5544,57356,53,7268,53,allow,199,102,97,2,29,1,1
5545,56078,53,48093,53,allow,178,94,84,2,29,1,1
5546,64048,53,15990,53,allow,209,110,99,2,30,1,1
5547,65526,53,9344,53,allow,199,102,97,2,30,1,1
5548,56672,53,24787,53,allow,199,102,97,2,29,1,1
5549,16403,16386,51369,16386,allow,122,62,60,2,29,1,1
5550,54835,443,32514,443,allow,15578,7071,8507,69,140,33,36
5551,64899,53,12836,53,allow,199,102,97,2,29,1,1
5552,49488,53,29306,53,allow,194,102,92,2,30,1,1
5553,49554,53,40462,53,allow,210,110,100,2,31,1,1
5554,65425,80,38267,80,allow,366,180,186,7,29,4,3
5555,52158,443,56576,443,allow,2149,1549,600,14,45,8,6
5556,51988,443,46112,443,allow,10492,3167,7325,40,15,24,16
5557,52110,80,18812,80,allow,422,240,182,8,26,5,3
5558,52106,80,35207,80,allow,422,240,182,8,26,5,3
5559,50013,53,57171,53,allow,258,102,156,2,30,1,1
5560,57001,53,34470,53,allow,210,110,100,2,30,1,1
5561,64143,53,3333,53,allow,179,94,85,2,30,1,1
5562,65292,53,37185,53,allow,195,102,93,2,30,1,1
5563,58755,443,6984,443,allow,4827,2244,2583,16,135,8,8
5564,65429,80,58851,80,allow,366,180,186,7,29,4,3
5565,60501,40829,11084,40829,allow,70,70,0,2,8,2,0
5566,65444,80,16519,80,allow,486,240,246,9,28,5,4
5567,65433,80,53822,80,allow,486,240,246,9,28,5,4
5568,52116,80,18216,80,allow,422,240,182,8,26,5,3
5569,49242,443,26105,443,allow,4528,803,3725,14,15,8,6
5570,52120,80,3357,80,allow,366,240,126,7,26,5,2
5571,52109,80,35580,80,allow,422,240,182,8,26,5,3
5572,52105,80,43976,80,allow,422,240,182,8,26,5,3
5573,63143,16884,9026,16884,allow,618,318,300,10,16,5,5
5574,16403,16384,41860,16384,allow,122,62,60,2,30,1,1
5575,58087,53,39920,53,allow,168,78,90,2,30,1,1
5576,49319,53,9038,53,allow,199,102,97,2,30,1,1
5577,57001,53,50963,53,allow,210,110,100,2,30,1,1
5578,65438,443,60459,443,allow,572,320,252,10,28,6,4
5579,52523,80,47280,80,allow,4302,3722,580,14,15,8,6
5580,64770,53,5158,53,allow,360,93,267,3,37,2,1
5581,52802,80,4743,80,allow,1465,729,736,12,16,7,5
5582,49414,443,6061,443,allow,3427,2159,1268,20,17,11,9
5583,51125,80,6897,80,allow,2880,815,2065,12,25,7,5
5584,64950,53,37238,53,allow,725,277,448,8,61,4,4
5585,49331,53,37708,53,allow,182,94,88,2,30,1,1
5586,49806,53,64642,53,allow,331,102,229,2,30,1,1
5587,57452,443,52384,443,allow,6990,2193,4797,15,120,7,8
5588,58614,53,27670,53,allow,218,78,140,2,31,1,1
5589,58661,443,49876,443,allow,2956,790,2166,10,120,5,5
5590,40364,443,43021,443,allow,20594,14251,6343,40,361,22,18
5591,60731,443,42232,443,allow,12669,5297,7372,31,188,18,13
5592,37965,51413,49792,51413,allow,789,152,637,4,1199,2,2
5593,6881,51184,15075,51184,allow,324,150,174,2,1203,1,1
5594,43464,443,26785,443,allow,8198,656,7542,19,327,5,14
5595,49447,443,57996,443,allow,11281,5398,5883,21,125,11,10
5596,57470,53250,48963,53250,allow,491,150,341,2,1199,1,1
5597,50584,29040,20008,29040,allow,509,150,359,2,1200,1,1
5598,44847,58839,4824,58839,allow,501,150,351,2,1200,1,1
5599,56549,443,22340,443,allow,13979,2593,11386,29,114,11,18
5600,49838,53,31499,53,allow,183,94,89,2,31,1,1
5601,47809,53,47809,53,allow,260,106,154,2,32,1,1
5602,64652,443,64652,443,allow,6792,1521,5271,18,26,11,7
5603,61740,443,6060,443,allow,92202,65396,26806,193,3454,68,125
5604,36535,443,64497,443,allow,6805,1662,5143,25,17,13,12
5605,46326,443,42575,443,allow,430,152,278,7,32,3,4
5606,51134,3389,51134,3389,allow,4213,2429,1784,18,32,9,9
5607,49690,443,64449,443,allow,9107,2174,6933,29,187,14,15
5608,45964,2225,0,0,deny,60,60,0,1,0,1,0
5609,9969,2323,0,0,deny,60,60,0,1,0,1,0
5610,52934,35776,0,0,deny,159,159,0,1,0,1,0
5611,11030,17372,0,0,deny,62,62,0,1,0,1,0
5612,42939,48817,0,0,deny,156,156,0,1,0,1,0
5613,10306,44847,0,0,deny,66,66,0,1,0,1,0
5614,54361,445,0,0,drop,70,70,0,1,0,1,0
5615,54360,445,0,0,drop,70,70,0,1,0,1,0
5616,54358,445,0,0,drop,70,70,0,1,0,1,0
5617,53353,26467,0,0,deny,62,62,0,1,0,1,0
5618,52459,33890,0,0,deny,60,60,0,1,0,1,0
5619,16824,11119,0,0,deny,148,148,0,1,0,1,0
5620,49769,445,0,0,drop,66,66,0,1,0,1,0
5621,54355,445,0,0,drop,70,70,0,1,0,1,0
5622,49641,445,0,0,drop,70,70,0,1,0,1,0
5623,54011,22114,0,0,deny,62,62,0,1,0,1,0
5624,49767,445,0,0,drop,66,66,0,1,0,1,0
5625,5223,14446,0,0,deny,220,220,0,1,0,1,0
5626,41577,53,41577,53,allow,265,111,154,2,0,1,1
5627,51356,22114,0,0,deny,66,66,0,1,0,1,0
5628,22150,6881,0,0,deny,62,62,0,1,0,1,0
5629,443,7387,0,0,deny,60,60,0,1,0,1,0
5630,49765,445,0,0,drop,66,66,0,1,0,1,0
5631,49764,445,0,0,drop,66,66,0,1,0,1,0
5632,48258,37965,0,0,deny,62,62,0,1,0,1,0
5633,49761,445,0,0,drop,66,66,0,1,0,1,0
5634,443,45788,0,0,deny,332,332,0,1,0,1,0
5635,49633,445,0,0,drop,70,70,0,1,0,1,0
5636,59535,25174,0,0,deny,146,146,0,1,0,1,0
5637,49631,445,0,0,drop,70,70,0,1,0,1,0
5638,54351,445,0,0,drop,70,70,0,1,0,1,0
5639,45952,22114,0,0,deny,62,62,0,1,0,1,0
5640,55666,35440,0,0,deny,66,66,0,1,0,1,0
5641,54343,445,0,0,drop,70,70,0,1,0,1,0
5642,54339,445,0,0,drop,70,70,0,1,0,1,0
5643,57726,37965,0,0,deny,62,62,0,1,0,1,0
5644,443,50238,0,0,deny,331,331,0,1,0,1,0
5645,57131,35776,0,0,deny,145,145,0,1,0,1,0
5646,49627,445,0,0,drop,70,70,0,1,0,1,0
5647,14185,48637,0,0,deny,60,60,0,1,0,1,0
5648,49625,445,0,0,drop,70,70,0,1,0,1,0
5649,58724,43890,0,0,deny,66,66,0,1,0,1,0
5650,53692,44512,0,0,deny,66,66,0,1,0,1,0
5651,56604,17372,0,0,deny,66,66,0,1,0,1,0
5652,49750,445,0,0,drop,66,66,0,1,0,1,0
5653,3410,17372,0,0,deny,62,62,0,1,0,1,0
5654,59965,36237,0,0,deny,66,66,0,1,0,1,0
5655,10532,26672,0,0,deny,60,60,0,1,0,1,0
5656,63873,44847,0,0,deny,62,62,0,1,0,1,0
5657,59508,65348,0,0,deny,148,148,0,1,0,1,0
5658,3406,17372,0,0,deny,66,66,0,1,0,1,0
5659,56219,22114,0,0,deny,62,62,0,1,0,1,0
5660,49621,445,0,0,drop,70,70,0,1,0,1,0
5661,42973,57470,0,0,deny,62,62,0,1,0,1,0
5662,18130,25174,0,0,deny,62,62,0,1,0,1,0
5663,49743,445,0,0,drop,66,66,0,1,0,1,0
5664,49620,445,0,0,drop,70,70,0,1,0,1,0
5665,443,45788,0,0,deny,199,199,0,1,0,1,0
5666,54327,445,0,0,drop,70,70,0,1,0,1,0
5667,49741,445,0,0,drop,66,66,0,1,0,1,0
5668,50708,22114,0,0,deny,146,146,0,1,0,1,0
5669,49615,445,0,0,drop,70,70,0,1,0,1,0
5670,45837,25174,0,0,deny,62,62,0,1,0,1,0
5671,40845,64147,0,0,deny,62,62,0,1,0,1,0
5672,43155,35440,0,0,deny,66,66,0,1,0,1,0
5673,49734,445,0,0,drop,66,66,0,1,0,1,0
5674,62197,22114,0,0,deny,62,62,0,1,0,1,0
5675,41653,21247,0,0,deny,62,62,0,1,0,1,0
5676,49726,445,0,0,drop,66,66,0,1,0,1,0
5677,61085,37965,0,0,deny,62,62,0,1,0,1,0
5678,443,45788,0,0,deny,199,199,0,1,0,1,0
5679,14869,44847,0,0,deny,62,62,0,1,0,1,0
5680,59155,39004,0,0,deny,74,74,0,1,0,1,0
5681,51558,37965,0,0,deny,72,72,0,1,0,1,0
5682,2064,22114,0,0,deny,62,62,0,1,0,1,0
5683,54051,28793,0,0,deny,66,66,0,1,0,1,0
5684,49602,445,0,0,drop,70,70,0,1,0,1,0
5685,54319,445,0,0,drop,70,70,0,1,0,1,0
5686,54315,445,0,0,drop,70,70,0,1,0,1,0
5687,54316,445,0,0,drop,70,70,0,1,0,1,0
5688,18843,25174,0,0,deny,146,146,0,1,0,1,0
5689,49716,445,0,0,drop,66,66,0,1,0,1,0
5690,49714,445,0,0,drop,66,66,0,1,0,1,0
5691,49718,445,0,0,drop,66,66,0,1,0,1,0
5692,49715,445,0,0,drop,66,66,0,1,0,1,0
5693,49713,445,0,0,drop,66,66,0,1,0,1,0
5694,49712,445,0,0,drop,66,66,0,1,0,1,0
5695,49711,445,0,0,drop,66,66,0,1,0,1,0
5696,49710,445,0,0,drop,66,66,0,1,0,1,0
5697,49908,56205,0,0,deny,62,62,0,1,0,1,0
5698,38852,37965,0,0,deny,62,62,0,1,0,1,0
5699,65270,3855,0,0,deny,78,78,0,1,0,1,0
5700,58421,30188,0,0,deny,66,66,0,1,0,1,0
5701,50334,64147,0,0,deny,66,66,0,1,0,1,0
5702,8560,50584,0,0,deny,62,62,0,1,0,1,0
5703,41885,25174,0,0,deny,62,62,0,1,0,1,0
5704,55998,15503,0,0,deny,146,146,0,1,0,1,0
5705,0,0,0,0,allow,244,244,0,2,0,2,0
5706,49599,445,0,0,drop,70,70,0,1,0,1,0
5707,5826,26467,0,0,deny,62,62,0,1,0,1,0
5708,27321,25174,0,0,deny,62,62,0,1,0,1,0
5709,14333,51050,0,0,deny,62,62,0,1,0,1,0
5710,54314,445,0,0,drop,70,70,0,1,0,1,0
5711,54306,445,0,0,drop,70,70,0,1,0,1,0
5712,54307,445,0,0,drop,70,70,0,1,0,1,0
5713,54302,445,0,0,drop,70,70,0,1,0,1,0
5714,8116,25773,0,0,reset-both,157,157,0,1,0,1,0
5715,49594,445,0,0,drop,70,70,0,1,0,1,0
5716,49593,445,0,0,drop,70,70,0,1,0,1,0
5717,49695,445,0,0,drop,66,66,0,1,0,1,0
5718,49698,445,0,0,drop,66,66,0,1,0,1,0
5719,49696,445,0,0,drop,66,66,0,1,0,1,0
5720,49591,445,0,0,drop,70,70,0,1,0,1,0
5721,39646,44847,0,0,deny,146,146,0,1,0,1,0
5722,51533,44847,0,0,deny,62,62,0,1,0,1,0
5723,20682,57470,0,0,deny,62,62,0,1,0,1,0
5724,6666,138,0,0,deny,60,60,0,1,0,1,0
5725,48706,23393,0,0,deny,60,60,0,1,0,1,0
5726,50396,62413,0,0,deny,66,66,0,1,0,1,0
5727,59822,56205,0,0,deny,66,66,0,1,0,1,0
5728,60416,37965,0,0,deny,66,66,0,1,0,1,0
5729,52280,44847,0,0,deny,62,62,0,1,0,1,0
5730,54295,445,0,0,drop,70,70,0,1,0,1,0
5731,1101,11119,0,0,deny,146,146,0,1,0,1,0
5732,54293,445,0,0,drop,70,70,0,1,0,1,0
5733,54289,445,0,0,drop,70,70,0,1,0,1,0
5734,54288,445,0,0,drop,70,70,0,1,0,1,0
5735,5223,32965,0,0,deny,66,66,0,1,0,1,0
5736,5223,32965,0,0,deny,119,119,0,1,0,1,0
5737,5223,32965,0,0,deny,167,167,0,1,0,1,0
5738,49584,445,0,0,drop,70,70,0,1,0,1,0
5739,18398,21247,0,0,deny,66,66,0,1,0,1,0
5740,8080,37965,0,0,deny,62,62,0,1,0,1,0
5741,49582,445,0,0,drop,70,70,0,1,0,1,0
5742,23310,22114,0,0,deny,66,66,0,1,0,1,0
5743,12567,23,0,0,deny,60,60,0,1,0,1,0
5744,7561,43890,0,0,deny,66,66,0,1,0,1,0
5745,49581,445,0,0,drop,70,70,0,1,0,1,0
5746,50272,53,9644,53,allow,744,95,649,2,30,1,1
5747,35526,443,57074,443,allow,4566,3317,1249,21,23,12,9
5748,9431,443,45231,443,allow,8693,2545,6148,26,34,13,13
5749,62627,7000,62627,7000,allow,2990,1599,1391,15,15,8,7
5750,52096,80,38227,80,allow,366,240,126,7,25,5,2
5751,56238,80,56238,80,allow,44951,1019,43932,48,15,15,33
5752,56246,80,56246,80,allow,101654,1739,99915,95,15,25,70
5753,56241,80,56241,80,allow,101607,1692,99915,94,15,24,70
5754,51422,80,51422,80,allow,9962,3379,6583,26,26,13,13
5755,51427,80,51427,80,allow,22364,4125,18239,41,26,19,22
5756,56778,443,16345,443,allow,8654,2150,6504,20,15,11,9
5757,27164,53,27164,53,allow,208,94,114,2,30,1,1
5758,52076,80,2859,80,allow,366,240,126,7,26,5,2
5759,52077,80,35958,80,allow,366,240,126,7,26,5,2
5760,55047,443,3031,443,allow,7069,2512,4557,25,46,14,11
5761,21187,53,21187,53,allow,208,94,114,2,30,1,1
5762,64670,53,38301,53,allow,186,95,91,2,31,1,1
5763,54865,443,54865,443,allow,125282,21435,103847,162,20,80,82
5764,9440,443,42891,443,allow,7573,1528,6045,22,33,11,11
5765,56507,80,59986,80,allow,1583,712,871,10,136,6,4
5766,58836,443,33212,443,allow,383990,15580,368410,490,212,192,298
5767,52167,80,36480,80,allow,1734,800,934,10,16,6,4
5768,56242,80,56242,80,allow,101354,1343,100011,89,15,19,70
5769,53532,8569,14217,8569,allow,546,306,240,9,143,5,4
5770,56777,443,21273,443,allow,8654,2150,6504,20,16,11,9
5771,60415,53,0,0,allow,82,82,0,1,30,1,0
5772,56245,80,56245,80,allow,101179,1296,99883,88,15,18,70
5773,49023,5223,46497,5223,allow,70,70,0,2,5,2,0
5774,123,123,44084,123,allow,184,94,90,2,30,1,1
5775,56244,80,56244,80,allow,101473,1494,99979,91,15,21,70
5776,44013,53,44013,53,allow,197,76,121,2,30,1,1
5777,58255,123,13070,123,allow,184,94,90,2,30,1,1
5778,52876,443,52876,443,allow,5045,2187,2858,16,136,8,8
5779,46508,80,61419,80,allow,1056,682,374,10,15,6,4
5780,52193,443,39804,443,allow,8868,4111,4757,24,16,12,12
5781,51424,80,51424,80,allow,4995,3443,1552,23,26,13,10
5782,49325,443,26750,443,allow,5749,3401,2348,29,76,15,14
5783,60490,62336,7987,62336,allow,504,318,186,8,15,5,3
5784,9478,443,35302,443,allow,6092,775,5317,17,28,9,8
5785,49326,443,59214,443,allow,5514,3341,2173,31,75,15,16
5786,41753,443,5130,443,allow,11570,3005,8565,43,255,20,23
5787,38961,443,38961,443,allow,4425,1518,2907,19,29,11,8
5788,56239,80,56239,80,allow,101707,1824,99883,96,15,26,70
5789,55609,443,14768,443,allow,13039,4388,8651,93,1191,47,46
5790,56240,80,56240,80,allow,101524,1673,99851,94,15,24,70
5791,44675,53,44675,53,allow,197,76,121,2,30,1,1
5792,49554,53,13063,53,allow,204,104,100,2,30,1,1
5793,56739,53,56739,53,allow,825,99,726,2,30,1,1
5794,63318,443,32091,443,allow,8451,2698,5753,21,129,9,12
5795,57487,443,7890,443,allow,17065,11570,5495,76,218,39,37
5796,50265,41198,60886,41198,allow,330,330,0,6,1200,6,0
5797,34230,53,34230,53,allow,823,98,725,2,31,1,1
5798,40471,53,40471,53,allow,194,87,107,2,31,1,1
5799,32161,53,32161,53,allow,823,98,725,2,31,1,1
5800,3229,53,3229,53,allow,244,98,146,2,31,1,1
5801,29791,53,29791,53,allow,213,87,126,2,31,1,1
5802,27888,53,27888,53,allow,240,96,144,2,31,1,1
5803,54595,443,41142,443,allow,5692,2502,3190,24,131,12,12
5804,55516,5228,12835,5228,allow,2769,1694,1075,20,3600,10,10
5805,38891,443,20514,443,allow,3489,636,2853,16,143,7,9
5806,50265,63104,28604,63104,allow,330,330,0,6,1200,6,0
5807,56400,35440,0,0,deny,66,66,0,1,0,1,0
5808,49580,445,0,0,drop,70,70,0,1,0,1,0
5809,49579,445,0,0,drop,70,70,0,1,0,1,0
5810,49577,445,0,0,drop,70,70,0,1,0,1,0
5811,49576,445,0,0,drop,70,70,0,1,0,1,0
5812,43642,48817,0,0,deny,134,134,0,1,0,1,0
5813,54278,445,0,0,drop,70,70,0,1,0,1,0
5814,54275,445,0,0,drop,70,70,0,1,0,1,0
5815,54277,445,0,0,drop,70,70,0,1,0,1,0
5816,443,50238,0,0,deny,331,331,0,1,0,1,0
5817,65228,53,0,0,deny,88,88,0,1,0,1,0
5818,62208,37965,0,0,deny,66,66,0,1,0,1,0
5819,54677,443,30863,443,allow,72676,12694,59982,144,127,64,80
5820,9420,443,29951,443,allow,9308,2125,7183,27,34,13,14
5821,53928,47287,32055,47287,allow,612,306,306,10,14,5,5
5822,49683,443,27198,443,allow,11301,2219,9082,29,187,14,15
5823,38568,443,10055,443,allow,11418,1999,9419,28,22,13,15
5824,41581,443,9229,443,allow,6816,1197,5619,24,269,12,12
5825,49984,53,11243,53,allow,373,88,285,4,58,2,2
5826,49986,443,64470,443,allow,11626,1206,10420,31,74,13,18
5827,37666,443,8330,443,allow,3354,2353,1001,18,45,11,7
5828,52518,80,48144,80,allow,3290,2776,514,12,15,7,5
5829,55722,26192,12187,26192,allow,70,70,0,2,8,2,0
5830,39648,443,15824,443,allow,5663,4227,1436,27,47,16,11
5831,9471,443,58396,443,allow,8533,1544,6989,22,30,11,11
5832,60806,40010,25471,40010,allow,316,136,180,6,6,3,3
5833,65045,53,38314,53,allow,339,105,234,4,53,2,2
5834,60219,53,60219,53,allow,414,268,146,3,32,2,1
5835,7532,53,7532,53,allow,228,90,138,2,31,1,1
5836,65189,53,46273,53,allow,328,93,235,4,29,2,2
5837,49319,53,39564,53,allow,199,102,97,2,29,1,1
5838,33768,53,59037,53,allow,168,78,90,2,29,1,1
5839,56174,443,38355,443,allow,18931,4924,14007,46,139,20,26
5840,49681,443,29652,443,allow,7074,2016,5058,26,187,13,13
5841,48817,51414,48817,51414,allow,150,150,0,1,1200,1,0
5842,64670,53,60367,53,allow,193,102,91,2,30,1,1
5843,51423,80,51423,80,allow,7610,2737,4873,23,26,12,11
5844,49684,445,0,0,drop,66,66,0,1,0,1,0
5845,18415,37965,0,0,deny,62,62,0,1,0,1,0
5846,65200,51050,0,0,deny,66,66,0,1,0,1,0
5847,49561,445,0,0,drop,70,70,0,1,0,1,0
5848,61785,64147,0,0,deny,62,62,0,1,0,1,0
5849,49560,445,0,0,drop,70,70,0,1,0,1,0
5850,54268,443,64525,443,allow,10173,1548,8625,25,41,14,11
5851,51135,80,13103,80,allow,366,240,126,7,21,5,2
5852,59808,53,0,0,allow,86,86,0,1,30,1,0
5853,49719,53,33096,53,allow,209,110,99,2,30,1,1
5854,55036,443,33915,443,allow,36364,9639,26725,62,53,31,31
5855,51426,80,51426,80,allow,114697,3049,111648,114,26,35,79
5856,55717,13517,54958,13517,allow,70,70,0,1,5,1,0
5857,55049,443,34090,443,allow,13661,4451,9210,32,46,18,14
5858,49519,443,20384,443,allow,7086,1913,5173,29,270,16,13
5859,64670,53,24174,53,allow,193,102,91,2,30,1,1
5860,63142,443,9605,443,allow,4994,379,4615,9,15,4,5
5861,49554,53,50726,53,allow,210,110,100,2,30,1,1
5862,52164,42271,32377,42271,allow,70,70,0,1,5,1,0
5863,53136,5228,42128,5228,allow,26821,4295,22526,95,5045,40,55
5864,55877,55153,7894,55153,allow,481,150,331,2,1200,1,1
5865,49603,443,57719,443,allow,11841,1700,10141,37,195,16,21
5866,34980,443,26995,443,allow,8211,2165,6046,25,361,13,12
5867,52514,80,2585,80,allow,3224,2776,448,11,15,7,4
5868,52517,80,63047,80,allow,4297,3719,578,14,15,8,6
5869,56251,80,56251,80,allow,101529,1646,99883,94,15,24,70
5870,56243,80,56243,80,allow,101477,1626,99851,93,15,23,70
5871,65253,53,35458,53,allow,321,150,171,2,30,1,1
5872,57619,443,40662,443,allow,9315,2153,7162,23,127,6,17
5873,35570,443,64379,443,allow,3221,705,2516,15,135,7,8
5874,52062,80,7748,80,allow,366,240,126,7,26,5,2
5875,51136,80,1499,80,allow,366,240,126,7,21,5,2
5876,34572,443,63392,443,allow,52330,13948,38382,131,129,71,60
5877,54115,443,7544,443,allow,6840,1394,5446,29,270,14,15
5878,53231,443,26059,443,allow,11825,4129,7696,39,40,21,18
5879,56607,443,33013,443,allow,21604,12969,8635,49,112,28,21
5880,56681,443,64351,443,allow,19154,11130,8024,40,102,24,16
5881,52063,80,12503,80,allow,366,240,126,7,26,5,2
5882,51972,5222,10197,5222,allow,5410,2343,3067,42,53,24,18
5883,55711,10480,9991,10480,allow,564,318,246,9,18,5,4
5884,52043,80,36469,80,allow,4185,3462,723,14,15,7,7
5885,52519,80,46745,80,allow,3771,3257,514,12,14,7,5
5886,57270,443,35956,443,allow,9415,3482,5933,57,16,29,28
5887,65534,53,65534,53,allow,414,268,146,3,31,2,1
5888,40932,443,14613,443,allow,4435,2949,1486,25,80,14,11
5889,64075,1026,16814,1026,allow,66,66,0,2,7,2,0
5890,41399,443,26251,443,allow,8512,2563,5949,27,24,15,12
5891,52336,443,7480,443,allow,134,60,74,3,10,2,1
5892,55720,51610,5460,51610,allow,70,70,0,1,5,1,0
5893,52108,80,27420,80,allow,182,60,122,4,25,2,2
5894,46093,443,55794,443,allow,14746,3097,11649,34,19,19,15
5895,52516,80,41641,80,allow,3224,2776,448,11,15,7,4
5896,55718,16805,50581,16805,allow,70,70,0,1,5,1,0
5897,52515,80,55752,80,allow,4183,3603,580,14,15,8,6
5898,57606,443,30554,443,allow,2614,1689,925,18,22,10,8
5899,52085,80,49733,80,allow,360,240,120,7,25,5,2
5900,37508,443,44640,443,allow,8586,1714,6872,25,43,14,11
5901,57863,443,39260,443,allow,2342,1341,1001,15,19,8,7
5902,52073,80,46138,80,allow,482,300,182,9,26,6,3
5903,36828,53,40804,53,allow,168,78,90,2,30,1,1
5904,64714,53,41976,53,allow,212,102,110,2,30,1,1
5905,57061,53,24920,53,allow,197,94,103,2,29,1,1
5906,64143,53,3615,53,allow,179,94,85,2,30,1,1
5907,49357,53,3200,53,allow,211,102,109,2,30,1,1
5908,39297,443,49533,443,allow,9320,3888,5432,21,119,10,11
5909,50265,45589,64355,45589,allow,132,132,0,3,1200,3,0
5910,50265,54145,30228,54145,allow,858,858,0,14,1200,14,0
5911,52016,80,20046,80,allow,8551,5933,2618,18,26,12,6
5912,123,123,41547,123,allow,184,94,90,2,30,1,1
5913,58734,443,17024,443,allow,8758,3850,4908,26,330,14,12
5914,52092,80,44323,80,allow,426,240,186,8,25,5,3
5915,51973,5222,53843,5222,allow,9184,4142,5042,72,53,40,32
5916,51425,80,51425,80,allow,11369,3404,7965,28,26,14,14
5917,60290,443,20487,443,allow,6753,2052,4701,25,15,13,12
5918,53272,443,50136,443,allow,5544,1703,3841,19,31,11,8
5919,52190,443,60064,443,allow,570322,21029,549293,569,46,181,388
5920,55704,53,57746,53,allow,193,102,91,2,30,1,1
5921,61353,443,57410,443,allow,4401,1654,2747,10,120,5,5
5922,55719,13302,2915,13302,allow,70,70,0,1,5,1,0
5923,52072,80,26468,80,allow,482,300,182,9,26,6,3
5924,123,123,58588,123,allow,184,94,90,2,30,1,1
5925,55704,53,41998,53,allow,193,102,91,2,30,1,1
5926,55704,53,62671,53,allow,193,102,91,2,30,1,1
5927,64596,53,7572,53,allow,237,110,127,2,30,1,1
5928,56687,53,1087,53,allow,225,110,115,2,30,1,1
5929,35140,123,7443,123,allow,184,94,90,2,30,1,1
5930,59787,443,23637,443,allow,276238,23971,252267,482,138,188,294
5931,33939,443,3295,443,allow,3191,1047,2144,13,135,6,7
5932,39536,80,4904,80,allow,2749,1732,1017,21,361,12,9
5933,50265,18183,50480,18183,allow,966,464,502,14,1200,7,7
5934,57470,31373,26422,31373,allow,1386,1386,0,22,1798,22,0
5935,45706,443,50703,443,allow,512213,34626,477587,741,147,283,458
5936,56906,443,9378,443,allow,1712418,88847,1623571,2014,149,715,1299
5937,58956,80,51257,80,allow,2493,1830,663,12,15,6,6
5938,49518,443,29100,443,allow,6602,1573,5029,25,271,11,14
5939,52875,443,52875,443,allow,3133,814,2319,13,136,6,7
5940,52065,80,44925,80,allow,692,300,392,9,26,6,3
5941,52066,80,29968,80,allow,692,300,392,9,26,6,3
5942,52074,80,8248,80,allow,422,240,182,8,26,5,3
5943,33043,443,21466,443,allow,11414,6355,5059,30,40,15,15
5944,53930,19831,55247,19831,allow,70,70,0,1,5,1,0
5945,57910,80,25307,80,allow,6453,1210,5243,14,24,8,6
5946,49554,445,0,0,drop,70,70,0,1,0,1,0
5947,49551,445,0,0,drop,70,70,0,1,0,1,0
5948,49550,445,0,0,drop,70,70,0,1,0,1,0
5949,54270,445,0,0,drop,70,70,0,1,0,1,0
5950,41176,64147,0,0,deny,145,145,0,1,0,1,0
5951,21522,80,0,0,deny,60,60,0,1,0,1,0
5952,65332,56205,0,0,deny,62,62,0,1,0,1,0
5953,54268,445,0,0,drop,70,70,0,1,0,1,0
5954,45286,62413,0,0,deny,146,146,0,1,0,1,0
5955,45981,51505,0,0,deny,146,146,0,1,0,1,0
5956,14409,7363,0,0,deny,145,145,0,1,0,1,0
5957,47342,36237,0,0,deny,66,66,0,1,0,1,0
5958,49671,445,0,0,drop,66,66,0,1,0,1,0
5959,49670,445,0,0,drop,66,66,0,1,0,1,0
5960,56713,25174,0,0,deny,62,62,0,1,0,1,0
5961,49539,445,0,0,drop,70,70,0,1,0,1,0
5962,6881,57470,0,0,deny,146,146,0,1,0,1,0
5963,26287,56205,0,0,deny,66,66,0,1,0,1,0
5964,51993,25174,0,0,deny,66,66,0,1,0,1,0
5965,16862,21247,0,0,deny,62,62,0,1,0,1,0
5966,443,4205,0,0,deny,320,320,0,1,0,1,0
5967,14656,36237,0,0,deny,66,66,0,1,0,1,0
5968,10390,26467,0,0,deny,62,62,0,1,0,1,0
5969,54259,445,0,0,drop,70,70,0,1,0,1,0
5970,54252,445,0,0,drop,70,70,0,1,0,1,0
5971,54251,445,0,0,drop,70,70,0,1,0,1,0
5972,54249,445,0,0,drop,70,70,0,1,0,1,0
5973,59874,22114,0,0,deny,66,66,0,1,0,1,0
5974,17306,25174,0,0,deny,66,66,0,1,0,1,0
5975,59587,25174,0,0,deny,146,146,0,1,0,1,0
5976,64013,57470,0,0,deny,74,74,0,1,0,1,0
5977,49664,445,0,0,drop,66,66,0,1,0,1,0
5978,50169,25174,0,0,deny,62,62,0,1,0,1,0
5979,49534,445,0,0,drop,70,70,0,1,0,1,0
5980,53108,22114,0,0,deny,146,146,0,1,0,1,0
5981,6881,6881,0,0,deny,62,62,0,1,0,1,0
5982,32090,43890,0,0,deny,146,146,0,1,0,1,0
5983,49648,445,0,0,drop,66,66,0,1,0,1,0
5984,49656,445,0,0,drop,66,66,0,1,0,1,0
5985,49654,445,0,0,drop,66,66,0,1,0,1,0
5986,49653,445,0,0,drop,66,66,0,1,0,1,0
5987,49652,445,0,0,drop,66,66,0,1,0,1,0
5988,49659,445,0,0,drop,66,66,0,1,0,1,0
5989,49649,445,0,0,drop,66,66,0,1,0,1,0
5990,57236,53733,0,0,deny,66,66,0,1,0,1,0
5991,49525,445,0,0,drop,70,70,0,1,0,1,0
5992,49524,445,0,0,drop,70,70,0,1,0,1,0
5993,49523,445,0,0,drop,70,70,0,1,0,1,0
5994,54243,445,0,0,drop,70,70,0,1,0,1,0
5995,49520,445,0,0,drop,70,70,0,1,0,1,0
5996,54240,445,0,0,drop,70,70,0,1,0,1,0
5997,54238,445,0,0,drop,70,70,0,1,0,1,0
5998,54236,445,0,0,drop,70,70,0,1,0,1,0
5999,49518,445,0,0,drop,70,70,0,1,0,1,0
6000,38565,51505,0,0,deny,62,62,0,1,0,1,0
6001,57410,25174,0,0,deny,62,62,0,1,0,1,0
6002,29512,30188,0,0,deny,62,62,0,1,0,1,0
6003,44674,25174,0,0,deny,146,146,0,1,0,1,0
6004,50637,36237,0,0,deny,62,62,0,1,0,1,0
6005,54598,37965,0,0,deny,66,66,0,1,0,1,0
6006,57539,44847,0,0,deny,62,62,0,1,0,1,0
6007,49512,445,0,0,drop,70,70,0,1,0,1,0
6008,54234,445,0,0,drop,70,70,0,1,0,1,0
6009,54231,445,0,0,drop,70,70,0,1,0,1,0
6010,54228,445,0,0,drop,70,70,0,1,0,1,0
6011,49640,445,0,0,drop,66,66,0,1,0,1,0
6012,49607,25174,0,0,deny,66,66,0,1,0,1,0
6013,54227,445,0,0,drop,70,70,0,1,0,1,0
6014,63002,22114,0,0,deny,66,66,0,1,0,1,0
6015,443,50238,0,0,deny,331,331,0,1,0,1,0
6016,14185,48637,0,0,deny,60,60,0,1,0,1,0
6017,49639,445,0,0,drop,66,66,0,1,0,1,0
6018,9231,3389,0,0,deny,66,66,0,1,0,1,0
6019,49637,445,0,0,drop,66,66,0,1,0,1,0
6020,49635,445,0,0,drop,66,66,0,1,0,1,0
6021,13840,37965,0,0,deny,146,146,0,1,0,1,0
6022,10754,28793,0,0,deny,66,66,0,1,0,1,0
6023,49505,445,0,0,drop,70,70,0,1,0,1,0
6024,49634,445,0,0,drop,66,66,0,1,0,1,0
6025,10532,26672,0,0,deny,60,60,0,1,0,1,0
6026,7686,25174,0,0,deny,62,62,0,1,0,1,0
6027,49502,445,0,0,drop,70,70,0,1,0,1,0
6028,14023,37965,0,0,deny,62,62,0,1,0,1,0
6029,58148,43890,0,0,deny,66,66,0,1,0,1,0
6030,25031,25174,0,0,deny,146,146,0,1,0,1,0
6031,52819,15503,0,0,deny,66,66,0,1,0,1,0
6032,49786,25174,0,0,deny,66,66,0,1,0,1,0
6033,30046,15503,0,0,deny,62,62,0,1,0,1,0
6034,60883,64147,0,0,deny,74,74,0,1,0,1,0
6035,14360,64147,0,0,deny,62,62,0,1,0,1,0
6036,54225,445,0,0,drop,70,70,0,1,0,1,0
6037,49499,445,0,0,drop,70,70,0,1,0,1,0
6038,54216,445,0,0,drop,70,70,0,1,0,1,0
6039,54210,445,0,0,drop,70,70,0,1,0,1,0
6040,49497,445,0,0,drop,70,70,0,1,0,1,0
6041,56213,26467,0,0,deny,62,62,0,1,0,1,0
6042,1038,37965,0,0,deny,62,62,0,1,0,1,0
6043,17842,22114,0,0,deny,62,62,0,1,0,1,0
6044,49622,445,0,0,drop,66,66,0,1,0,1,0
6045,18652,64147,0,0,deny,62,62,0,1,0,1,0
6046,49493,445,0,0,drop,70,70,0,1,0,1,0
6047,52518,35440,0,0,deny,66,66,0,1,0,1,0
6048,24931,25174,0,0,deny,62,62,0,1,0,1,0
6049,49491,445,0,0,drop,70,70,0,1,0,1,0
6050,61762,44847,0,0,deny,62,62,0,1,0,1,0
6051,40054,62413,0,0,deny,62,62,0,1,0,1,0
6052,13285,29892,0,0,deny,145,145,0,1,0,1,0
6053,1190,25174,0,0,deny,146,146,0,1,0,1,0
6054,15998,36829,0,0,deny,62,62,0,1,0,1,0
6055,52969,44847,0,0,deny,66,66,0,1,0,1,0
6056,49615,445,0,0,drop,66,66,0,1,0,1,0
6057,34212,11392,0,0,deny,66,66,0,1,0,1,0
6058,54201,445,0,0,drop,70,70,0,1,0,1,0
6059,41315,11392,0,0,deny,146,146,0,1,0,1,0
6060,36770,56205,0,0,deny,62,62,0,1,0,1,0
6061,2932,44847,0,0,deny,62,62,0,1,0,1,0
6062,18725,35440,0,0,deny,62,62,0,1,0,1,0
6063,49613,445,0,0,drop,66,66,0,1,0,1,0
6064,49487,445,0,0,drop,70,70,0,1,0,1,0
6065,8889,16164,0,0,deny,60,60,0,1,0,1,0
6066,50360,37965,0,0,deny,66,66,0,1,0,1,0
6067,443,50238,0,0,deny,60,60,0,1,0,1,0
6068,50990,23884,0,0,deny,66,66,0,1,0,1,0
6069,49606,445,0,0,drop,66,66,0,1,0,1,0
6070,443,50238,0,0,deny,99,99,0,1,0,1,0
6071,443,50238,0,0,deny,286,286,0,1,0,1,0
6072,0,0,0,0,deny,94,94,0,1,0,1,0
6073,49598,445,0,0,drop,66,66,0,1,0,1,0
6074,62902,32468,0,0,deny,66,66,0,1,0,1,0
6075,17232,22114,0,0,deny,62,62,0,1,0,1,0
6076,52462,25174,0,0,deny,62,62,0,1,0,1,0
6077,19933,35440,0,0,deny,62,62,0,1,0,1,0
6078,40479,35993,0,0,deny,62,62,0,1,0,1,0
6079,37959,3855,0,0,deny,72,72,0,1,0,1,0
6080,65270,3855,0,0,deny,78,78,0,1,0,1,0
6081,49474,445,0,0,drop,70,70,0,1,0,1,0
6082,54192,445,0,0,drop,70,70,0,1,0,1,0
6083,54189,445,0,0,drop,70,70,0,1,0,1,0
6084,54187,445,0,0,drop,70,70,0,1,0,1,0
6085,49584,445,0,0,drop,66,66,0,1,0,1,0
6086,49589,445,0,0,drop,66,66,0,1,0,1,0
6087,49590,445,0,0,drop,66,66,0,1,0,1,0
6088,49588,445,0,0,drop,66,66,0,1,0,1,0
6089,49585,445,0,0,drop,66,66,0,1,0,1,0
6090,49583,445,0,0,drop,66,66,0,1,0,1,0
6091,49586,445,0,0,drop,66,66,0,1,0,1,0
6092,49582,445,0,0,drop,66,66,0,1,0,1,0
6093,41677,57470,0,0,deny,66,66,0,1,0,1,0
6094,49471,445,0,0,drop,70,70,0,1,0,1,0
6095,55994,22114,0,0,deny,66,66,0,1,0,1,0
6096,49677,25174,0,0,deny,66,66,0,1,0,1,0
6097,26697,37965,0,0,deny,66,66,0,1,0,1,0
6098,44378,995,0,0,deny,60,60,0,1,0,1,0
6099,56451,995,0,0,deny,60,60,0,1,0,1,0
6100,35201,25174,0,0,deny,62,62,0,1,0,1,0
6101,25197,1433,0,0,deny,60,60,0,1,0,1,0
6102,10462,25174,0,0,deny,146,146,0,1,0,1,0
6103,60245,25174,0,0,deny,62,62,0,1,0,1,0
6104,19875,30170,0,0,deny,145,145,0,1,0,1,0
6105,49467,445,0,0,drop,70,70,0,1,0,1,0
6106,1058,36866,0,0,deny,136,136,0,1,0,1,0
6107,49465,445,0,0,drop,70,70,0,1,0,1,0
6108,2850,64147,0,0,deny,66,66,0,1,0,1,0
6109,54184,445,0,0,drop,70,70,0,1,0,1,0
6110,54178,445,0,0,drop,70,70,0,1,0,1,0
6111,54179,445,0,0,drop,70,70,0,1,0,1,0
6112,54172,445,0,0,drop,70,70,0,1,0,1,0
6113,22547,48817,0,0,deny,72,72,0,1,0,1,0
6114,49463,445,0,0,drop,70,70,0,1,0,1,0
6115,63398,25174,0,0,deny,66,66,0,1,0,1,0
6116,49568,445,0,0,drop,66,66,0,1,0,1,0
6117,49570,445,0,0,drop,66,66,0,1,0,1,0
6118,49567,445,0,0,drop,66,66,0,1,0,1,0
6119,18574,56205,0,0,deny,66,66,0,1,0,1,0
6120,51143,443,51143,443,allow,33565,5938,27627,60,128,24,36
6121,49288,80,52653,80,allow,1056,682,374,10,15,6,4
6122,57490,443,55071,443,allow,1778,1219,559,13,26,8,5
6123,6666,3493,6666,3493,allow,60,60,0,1,5,1,0
6124,52070,80,7371,80,allow,362,240,122,7,25,5,2
6125,51077,443,51077,443,allow,32010,3207,28803,52,128,20,32
6126,58895,443,55555,443,allow,148,82,66,2,10,1,1
6127,56233,80,56233,80,allow,44955,1023,43932,48,15,15,33
6128,9381,53,9381,53,allow,200,90,110,2,30,1,1
6129,33733,443,7805,443,allow,6998,2361,4637,20,17,10,10
6130,50693,443,50693,443,allow,19125,2345,16780,37,128,15,22
6131,60106,443,61992,443,allow,7243,4797,2446,42,136,23,19
6132,56230,80,56230,80,allow,44881,949,43932,47,15,14,33
6133,56234,80,56234,80,allow,44817,885,43932,46,15,13,33
6134,52071,80,35794,80,allow,362,240,122,7,25,5,2
6135,38663,15000,54810,15000,allow,138,78,60,2,5,1,1
6136,52067,80,33886,80,allow,362,240,122,7,25,5,2
6137,60524,443,60524,443,allow,1088,641,447,10,26,6,4
6138,44714,443,14525,443,allow,7389,2124,5265,26,316,12,14
6139,13084,53,13084,53,allow,224,88,136,2,30,1,1
6140,57493,443,46334,443,allow,1778,1219,559,13,27,8,5
6141,56928,53,56928,53,allow,823,98,725,2,30,1,1
6142,52078,80,58261,80,allow,366,240,126,7,25,5,2
6143,56231,80,56231,80,allow,44747,815,43932,45,15,12,33
6144,56236,80,56236,80,allow,44755,823,43932,45,15,12,33
6145,49324,443,63452,443,allow,6586,3686,2900,35,75,17,18
6146,52079,80,61511,80,allow,366,240,126,7,25,5,2
6147,52069,80,30929,80,allow,362,240,122,7,25,5,2
6148,52068,80,54676,80,allow,362,240,122,7,25,5,2
6149,49886,7000,49886,7000,allow,1236,676,560,13,15,7,6
6150,61488,443,29110,443,allow,7036,2247,4789,39,141,19,20
6151,49509,443,10156,443,allow,8248,2508,5740,31,271,13,18
6152,32317,53,32317,53,allow,823,98,725,2,30,1,1
6153,56232,80,56232,80,allow,44752,820,43932,45,15,12,33
6154,56235,80,56235,80,allow,44756,824,43932,45,15,12,33
6155,53961,13067,41847,13067,allow,70,70,0,2,8,2,0
6156,64064,29856,32936,29856,allow,66,66,0,1,5,1,0
6157,56237,80,56237,80,allow,44949,1017,43932,48,15,15,33
6158,51544,4545,51544,4545,allow,156,156,0,3,8,3,0
6159,51142,443,51142,443,allow,261206,9686,251520,308,128,121,187
6160,60525,443,60525,443,allow,1088,641,447,10,26,6,4
6161,28549,53,28549,53,allow,194,87,107,2,30,1,1
6162,36672,53,36672,53,allow,234,93,141,2,30,1,1
6163,47674,53,47674,53,allow,200,90,110,2,30,1,1
6164,50313,53,50313,53,allow,202,91,111,2,30,1,1
6165,41389,443,45580,443,allow,280,140,140,5,131,3,2
6166,51414,22,0,0,deny,60,60,0,1,0,1,0
6167,30456,36237,0,0,deny,146,146,0,1,0,1,0
6168,54167,445,0,0,drop,70,70,0,1,0,1,0
6169,5222,21212,0,0,deny,66,66,0,1,0,1,0
6170,2075,19473,0,0,deny,66,66,0,1,0,1,0
6171,31675,19473,0,0,deny,62,62,0,1,0,1,0
6172,16429,56205,0,0,deny,146,146,0,1,0,1,0
6173,65228,53,0,0,deny,88,88,0,1,0,1,0
6174,54166,445,0,0,drop,70,70,0,1,0,1,0
6175,54162,445,0,0,drop,70,70,0,1,0,1,0
6176,54157,445,0,0,drop,70,70,0,1,0,1,0
6177,49456,445,0,0,drop,70,70,0,1,0,1,0
6178,12465,9823,0,0,deny,146,146,0,1,0,1,0
6179,61550,5529,0,0,deny,145,145,0,1,0,1,0
6180,31675,19473,0,0,deny,145,145,0,1,0,1,0
6181,65228,53,0,0,deny,88,88,0,1,0,1,0
6182,59068,57470,0,0,deny,74,74,0,1,0,1,0
6183,49454,445,0,0,drop,70,70,0,1,0,1,0
6184,60805,20010,40863,20010,allow,70,70,0,2,8,2,0
6185,52030,443,43838,443,allow,9090,1914,7176,24,25,13,11
6186,39442,443,24613,443,allow,6420,1513,4907,25,26,14,11
6187,52001,80,20376,80,allow,8117874,148550,7969324,7318,25,2033,5285
6188,55020,443,57548,443,allow,3533,1045,2488,17,147,8,9
6189,55457,53,65037,53,allow,372,126,246,2,29,1,1
6190,62717,443,23146,443,allow,3129,782,2347,17,134,8,9
6191,49440,443,48823,443,allow,3721809,103604,3618205,3808,156,1281,2527
6192,52060,80,41226,80,allow,366,240,126,7,25,5,2
6193,62349,443,37822,443,allow,3942042,47512,3894530,3167,53,526,2641
6194,40122,443,13389,443,allow,8235,2076,6159,24,330,11,13
6195,64560,53,40808,53,allow,578,179,399,6,56,3,3
6196,52059,80,19994,80,allow,426,240,186,8,25,5,3
6197,52166,80,3955,80,allow,2110,1066,1044,12,15,7,5
6198,13554,53,13554,53,allow,404,259,145,3,33,2,1
6199,53955,3290,40369,3290,allow,70,70,0,2,7,2,0
6200,52061,80,7969,80,allow,366,240,126,7,25,5,2
6201,64381,53,4400,53,allow,168,86,82,2,32,1,1
6202,36628,80,34664,80,allow,78,78,0,1,4,1,0
6203,44907,5900,44907,5900,allow,130,66,64,2,4,1,1
6204,55267,53,45498,53,allow,168,78,90,2,29,1,1
6205,65084,53,19424,53,allow,215,102,113,2,29,1,1
6206,1100,27540,42086,27540,allow,132,70,62,2,29,1,1
6207,51156,53,46247,53,allow,168,78,90,2,29,1,1
6208,52043,80,5658,80,allow,1484,805,679,11,25,7,4
6209,52100,443,42530,443,allow,14433889,278906,14154983,13633,66,4079,9554
6210,56750,53,18998,53,allow,279,118,161,2,30,1,1
6211,20850,53,20850,53,allow,245,98,147,2,30,1,1
6212,56102,53,33083,53,allow,199,94,105,2,30,1,1
6213,20826,53,20826,53,allow,228,90,138,2,32,1,1
6214,64074,34067,2832,34067,allow,312,132,180,6,6,3,3
6215,53723,443,52693,443,allow,70,70,0,2,8,2,0
6216,61526,443,1145,443,allow,13977,5303,8674,48,152,20,28
6217,60522,443,60522,443,allow,1088,641,447,10,25,6,4
6218,60523,443,60523,443,allow,1088,641,447,10,25,6,4
6219,52005,443,38700,443,allow,4802,866,3936,19,26,10,9
6220,48163,53,27599,53,allow,199,94,105,2,30,1,1
6221,34352,53,34352,53,allow,240,98,142,2,30,1,1
6222,50680,80,61821,80,allow,23386,2375,21011,30,21,12,18
6223,39537,80,22901,80,allow,903,482,421,10,360,5,5
6224,49378,53,26888,53,allow,210,94,116,2,30,1,1
6225,65066,53,65066,53,allow,240,98,142,2,30,1,1
6226,52039,80,39126,80,allow,366,240,126,7,25,5,2
6227,41207,80,55374,80,allow,79441,3092,76349,103,16,48,55
6228,51132,80,62444,80,allow,426,240,186,8,21,5,3
6229,57509,443,8553,443,allow,5150,3987,1163,18,38,11,7
6230,35797,53,35797,53,allow,217,90,127,2,30,1,1
6231,17734,53,17734,53,allow,217,90,127,2,30,1,1
6232,49488,53,49488,53,allow,823,98,725,2,30,1,1
6233,49171,53,63019,53,allow,301,102,199,2,30,1,1
6234,57445,66,60334,66,allow,70,70,0,1,5,1,0
6235,52000,80,36562,80,allow,416,210,206,7,26,4,3
6236,58921,443,58921,443,allow,4627,1720,2907,19,28,11,8
6237,50884,443,50884,443,allow,187790,7733,180057,229,128,90,139
6238,46370,443,36990,443,allow,11035,8438,2597,39,95,23,16
6239,51671,53,51671,53,allow,200,90,110,2,30,1,1
6240,43303,443,47473,443,allow,6448,1982,4466,22,16,11,11
6241,52064,80,33091,80,allow,692,300,392,9,25,6,3
6242,52075,80,29185,80,allow,422,240,182,8,25,5,3
6243,49927,80,6147,80,allow,1141,636,505,10,45,6,4
6244,43834,443,19453,443,allow,4824,671,4153,13,29,7,6
6245,52057,80,6987,80,allow,422,240,182,8,25,5,3
6246,52058,80,14075,80,allow,362,240,122,7,25,5,2
6247,62640,53,62640,53,allow,414,268,146,3,32,2,1
6248,64063,37832,22712,37832,allow,70,70,0,1,4,1,0
6249,53962,16251,40390,16251,allow,70,70,0,2,7,2,0
6250,55182,443,46108,443,allow,2970,1689,1281,24,18,13,11
6251,47311,443,49307,443,allow,3398,2096,1302,19,16,10,9
6252,52042,443,63896,443,allow,8740,1799,6941,25,25,13,12
6253,51078,443,51078,443,allow,71902,4007,67895,98,127,40,58
6254,56363,53,60359,53,allow,269,94,175,2,30,1,1
6255,64670,53,61851,53,allow,193,102,91,2,29,1,1
6256,36665,443,51014,443,allow,5814771,76275,5738496,4959,154,976,3983
6257,64849,53,44145,53,allow,216,102,114,2,29,1,1
6258,2077,53,2077,53,allow,212,98,114,2,30,1,1
6259,57492,53,57492,53,allow,218,90,128,2,30,1,1
6260,40711,53,40711,53,allow,200,90,110,2,30,1,1
6261,55155,53,55155,53,allow,240,98,142,2,30,1,1
6262,49346,53,28098,53,allow,212,102,110,2,30,1,1
6263,48424,53,48424,53,allow,220,90,130,2,30,1,1
6264,53477,443,34084,443,allow,21476,1330,20146,32,137,12,20
6265,10461,53,10461,53,allow,220,90,130,2,30,1,1
6266,56644,53,3506,53,allow,199,94,105,2,30,1,1
6267,27988,40011,54890,40011,allow,253,190,63,2,30,1,1
6268,13871,53,13871,53,allow,240,98,142,2,30,1,1
6269,58045,443,63795,443,allow,3296,1329,1967,14,135,7,7
6270,1725,80,3568,80,allow,254,128,126,5,16,3,2
6271,38384,443,38384,443,allow,4609,1702,2907,19,29,11,8
6272,1666,53,1666,53,allow,217,90,127,2,30,1,1
6273,64049,53,41804,53,allow,209,102,107,2,30,1,1
6274,38784,443,14395,443,allow,9185,3854,5331,23,16,13,10
6275,55657,443,55657,443,allow,30650,11103,19547,66,51,40,26
6276,36536,53,36536,53,allow,414,268,146,3,32,2,1
6277,60492,11339,45509,11339,allow,70,70,0,1,5,1,0
6278,60489,53151,11462,53151,allow,70,70,0,1,5,1,0
6279,56808,53,42088,53,allow,180,94,86,2,35,1,1
6280,56662,443,10328,443,allow,318,192,126,6,15,4,2
6281,52090,64823,30736,64823,allow,634,568,66,8,29,7,1
6282,55812,443,35991,443,allow,9398,2478,6920,26,82,14,12
6283,52003,80,22055,80,allow,16479,1820,14659,31,26,17,14
6284,52490,53,52490,53,allow,240,98,142,2,30,1,1
6285,52004,443,64314,443,allow,4804,866,3938,19,26,10,9
6286,47518,53,47518,53,allow,414,268,146,3,32,2,1
6287,56645,443,24912,443,allow,37030,24937,12093,83,1286,30,53
6288,51615,53,53355,53,allow,207,86,121,2,30,1,1
6289,63139,53,41966,53,allow,78,78,0,1,30,1,0
6290,55628,53,53766,53,allow,199,94,105,2,30,1,1
6291,28998,53,28998,53,allow,220,90,130,2,30,1,1
6292,38905,53,58412,53,allow,86,86,0,1,30,1,0
6293,63384,53,63384,53,allow,198,90,108,2,30,1,1
6294,65172,53,3984,53,allow,211,102,109,2,30,1,1
6295,34441,53,34441,53,allow,314,98,216,2,30,1,1
6296,54118,443,16400,443,allow,3182,1568,1614,8,120,4,4
6297,49445,443,22095,443,allow,462587,17396,445191,527,130,198,329
6298,6881,51719,22526,51719,allow,324,150,174,2,1199,1,1
6299,65498,443,58734,443,allow,3874,1587,2287,17,143,9,8
6300,15503,57141,65001,57141,allow,481,150,331,2,1200,1,1
6301,49539,443,38043,443,allow,5106,1861,3245,21,143,10,11
6302,61187,443,13311,443,allow,4862,1820,3042,14,120,7,7
6303,53952,26973,12520,26973,allow,70,70,0,2,8,2,0
6304,52021,80,35964,80,allow,422,240,182,8,25,5,3
6305,33507,443,18740,443,allow,194174,11657,182517,258,31,124,134
6306,52162,15104,24399,15104,allow,70,70,0,1,5,1,0
6307,50678,80,52506,80,allow,1549,1097,452,9,21,5,4
6308,52034,80,60212,80,allow,366,240,126,7,25,5,2
6309,52479,443,31867,443,allow,9326,1833,7493,24,131,12,12
6310,53924,45212,17906,45212,allow,70,70,0,1,5,1,0
6311,30629,46783,0,0,deny,145,145,0,1,0,1,0
6312,49453,445,0,0,drop,70,70,0,1,0,1,0
6313,10126,57470,0,0,deny,62,62,0,1,0,1,0
6314,64622,36829,0,0,deny,66,66,0,1,0,1,0
6315,49452,445,0,0,drop,70,70,0,1,0,1,0
6316,49451,445,0,0,drop,70,70,0,1,0,1,0
6317,64949,44847,0,0,deny,66,66,0,1,0,1,0
6318,49445,445,0,0,drop,70,70,0,1,0,1,0
6319,9687,35440,0,0,deny,66,66,0,1,0,1,0
6320,59966,37965,0,0,deny,66,66,0,1,0,1,0
6321,1138,57470,0,0,deny,146,146,0,1,0,1,0
6322,54148,445,0,0,drop,70,70,0,1,0,1,0
6323,54146,445,0,0,drop,70,70,0,1,0,1,0
6324,54144,445,0,0,drop,70,70,0,1,0,1,0
6325,27078,25174,0,0,deny,146,146,0,1,0,1,0
6326,49433,445,0,0,drop,70,70,0,1,0,1,0
6327,49432,445,0,0,drop,70,70,0,1,0,1,0
6328,54633,36237,0,0,deny,66,66,0,1,0,1,0
6329,49427,445,0,0,drop,70,70,0,1,0,1,0
6330,49558,445,0,0,drop,66,66,0,1,0,1,0
6331,49423,445,0,0,drop,70,70,0,1,0,1,0
6332,49422,445,0,0,drop,70,70,0,1,0,1,0
6333,11585,56205,0,0,deny,66,66,0,1,0,1,0
6334,17213,22114,0,0,deny,62,62,0,1,0,1,0
6335,16862,21247,0,0,deny,146,146,0,1,0,1,0
6336,16425,15503,0,0,deny,62,62,0,1,0,1,0
6337,61701,15503,0,0,deny,66,66,0,1,0,1,0
6338,54142,445,0,0,drop,70,70,0,1,0,1,0
6339,9212,51505,0,0,deny,146,146,0,1,0,1,0
6340,64013,57470,0,0,deny,74,74,0,1,0,1,0
6341,54141,445,0,0,drop,70,70,0,1,0,1,0
6342,12881,20082,0,0,deny,146,146,0,1,0,1,0
6343,31859,33909,0,0,deny,66,66,0,1,0,1,0
6344,23753,25174,0,0,deny,62,62,0,1,0,1,0
6345,8760,22114,0,0,deny,62,62,0,1,0,1,0
6346,49411,445,0,0,drop,70,70,0,1,0,1,0
6347,31691,50584,0,0,deny,62,62,0,1,0,1,0
6348,31691,50584,0,0,deny,146,146,0,1,0,1,0
6349,49543,445,0,0,drop,66,66,0,1,0,1,0
6350,49542,445,0,0,drop,66,66,0,1,0,1,0
6351,63380,23,0,0,deny,60,60,0,1,0,1,0
6352,32796,37965,0,0,deny,66,66,0,1,0,1,0
6353,27502,50584,0,0,deny,62,62,0,1,0,1,0
6354,56152,56205,0,0,deny,66,66,0,1,0,1,0
6355,54132,445,0,0,drop,70,70,0,1,0,1,0
6356,54129,445,0,0,drop,70,70,0,1,0,1,0
6357,54127,445,0,0,drop,70,70,0,1,0,1,0
6358,54120,445,0,0,drop,70,70,0,1,0,1,0
6359,49407,445,0,0,drop,70,70,0,1,0,1,0
6360,4752,30188,0,0,deny,62,62,0,1,0,1,0
6361,61392,50584,0,0,deny,146,146,0,1,0,1,0
6362,49535,445,0,0,drop,66,66,0,1,0,1,0
6363,21322,25174,0,0,deny,62,62,0,1,0,1,0
6364,42228,51050,0,0,deny,66,66,0,1,0,1,0
6365,58435,64631,0,0,deny,74,74,0,1,0,1,0
6366,49398,445,0,0,drop,70,70,0,1,0,1,0
6367,49395,445,0,0,drop,70,70,0,1,0,1,0
6368,49396,445,0,0,drop,70,70,0,1,0,1,0
6369,49522,445,0,0,drop,66,66,0,1,0,1,0
6370,49520,445,0,0,drop,66,66,0,1,0,1,0
6371,49530,445,0,0,drop,66,66,0,1,0,1,0
6372,49531,445,0,0,drop,66,66,0,1,0,1,0
6373,49527,445,0,0,drop,66,66,0,1,0,1,0
6374,49524,445,0,0,drop,66,66,0,1,0,1,0
6375,52640,64147,0,0,deny,62,62,0,1,0,1,0
6376,49393,445,0,0,drop,70,70,0,1,0,1,0
6377,49391,445,0,0,drop,70,70,0,1,0,1,0
6378,63334,37807,0,0,deny,66,66,0,1,0,1,0
6379,29177,44847,0,0,deny,66,66,0,1,0,1,0
6380,54115,445,0,0,drop,70,70,0,1,0,1,0
6381,14185,48637,0,0,deny,60,60,0,1,0,1,0
6382,61711,35440,0,0,deny,66,66,0,1,0,1,0
6383,57782,57470,0,0,deny,66,66,0,1,0,1,0
6384,16979,56205,0,0,deny,66,66,0,1,0,1,0
6385,54112,445,0,0,drop,70,70,0,1,0,1,0
6386,54108,445,0,0,drop,70,70,0,1,0,1,0
6387,54110,445,0,0,drop,70,70,0,1,0,1,0
6388,60248,46776,0,0,deny,66,66,0,1,0,1,0
6389,14717,64147,0,0,deny,66,66,0,1,0,1,0
6390,53730,37965,0,0,deny,66,66,0,1,0,1,0
6391,10532,26672,0,0,deny,60,60,0,1,0,1,0
6392,1025,46776,0,0,deny,62,62,0,1,0,1,0
6393,18642,42707,0,0,deny,62,62,0,1,0,1,0
6394,56719,37807,0,0,deny,66,66,0,1,0,1,0
6395,18653,42707,0,0,deny,66,66,0,1,0,1,0
6396,56562,44847,0,0,deny,62,62,0,1,0,1,0
6397,55201,26467,0,0,deny,66,66,0,1,0,1,0
6398,43747,22114,0,0,deny,66,66,0,1,0,1,0
6399,49384,445,0,0,drop,70,70,0,1,0,1,0
6400,64878,26467,0,0,deny,62,62,0,1,0,1,0
6401,2572,17546,0,0,deny,66,66,0,1,0,1,0
6402,54104,445,0,0,drop,70,70,0,1,0,1,0
6403,54106,445,0,0,drop,70,70,0,1,0,1,0
6404,54101,445,0,0,drop,70,70,0,1,0,1,0
6405,19068,37965,0,0,deny,62,62,0,1,0,1,0
6406,49513,445,0,0,drop,66,66,0,1,0,1,0
6407,24376,50584,0,0,deny,66,66,0,1,0,1,0
6408,54099,445,0,0,drop,70,70,0,1,0,1,0
6409,25457,25604,0,0,deny,62,62,0,1,0,1,0
6410,49511,445,0,0,drop,66,66,0,1,0,1,0
6411,8884,2323,0,0,deny,60,60,0,1,0,1,0
6412,49377,445,0,0,drop,70,70,0,1,0,1,0
6413,49508,445,0,0,drop,66,66,0,1,0,1,0
6414,49507,445,0,0,drop,66,66,0,1,0,1,0
6415,49375,445,0,0,drop,70,70,0,1,0,1,0
6416,31660,35440,0,0,deny,66,66,0,1,0,1,0
6417,49505,445,0,0,drop,66,66,0,1,0,1,0
6418,11692,25174,0,0,deny,66,66,0,1,0,1,0
6419,64847,22114,0,0,deny,66,66,0,1,0,1,0
6420,443,54507,0,0,deny,82,82,0,1,0,1,0
6421,52596,17372,0,0,deny,66,66,0,1,0,1,0
6422,40078,44847,0,0,deny,146,146,0,1,0,1,0
6423,49371,445,0,0,drop,70,70,0,1,0,1,0
6424,44207,44847,0,0,deny,66,66,0,1,0,1,0
6425,49369,445,0,0,drop,70,70,0,1,0,1,0
6426,54094,445,0,0,drop,70,70,0,1,0,1,0
6427,56639,48817,0,0,deny,62,62,0,1,0,1,0
6428,54088,445,0,0,drop,70,70,0,1,0,1,0
6429,54084,445,0,0,drop,70,70,0,1,0,1,0
6430,58799,30188,0,0,deny,66,66,0,1,0,1,0
6431,49365,445,0,0,drop,70,70,0,1,0,1,0
6432,20741,64147,0,0,deny,62,62,0,1,0,1,0
6433,13035,25174,0,0,deny,146,146,0,1,0,1,0
6434,49494,445,0,0,drop,66,66,0,1,0,1,0
6435,64923,25174,0,0,deny,66,66,0,1,0,1,0
6436,44453,1433,0,0,deny,60,60,0,1,0,1,0
6437,49363,445,0,0,drop,70,70,0,1,0,1,0
6438,60337,30188,0,0,deny,66,66,0,1,0,1,0
6439,11951,45026,0,0,deny,60,60,0,1,0,1,0
6440,53844,22114,0,0,deny,66,66,0,1,0,1,0
6441,58163,20005,0,0,deny,60,60,0,1,0,1,0
6442,7619,50584,0,0,deny,146,146,0,1,0,1,0
6443,3875,25174,0,0,deny,62,62,0,1,0,1,0
6444,60049,25174,0,0,deny,66,66,0,1,0,1,0
6445,49487,445,0,0,drop,66,66,0,1,0,1,0
6446,54071,445,0,0,drop,70,70,0,1,0,1,0
6447,25543,22114,0,0,deny,62,62,0,1,0,1,0
6448,51575,9694,0,0,deny,66,66,0,1,0,1,0
6449,49359,445,0,0,drop,70,70,0,1,0,1,0
6450,60830,50584,0,0,deny,62,62,0,1,0,1,0
6451,9748,21247,0,0,deny,66,66,0,1,0,1,0
6452,49484,445,0,0,drop,66,66,0,1,0,1,0
6453,56309,22114,0,0,deny,146,146,0,1,0,1,0
6454,5228,3434,0,0,deny,345,345,0,1,0,1,0
6455,25009,35440,0,0,deny,62,62,0,1,0,1,0
6456,49476,445,0,0,drop,66,66,0,1,0,1,0
6457,6121,51505,0,0,deny,62,62,0,1,0,1,0
6458,49470,445,0,0,drop,66,66,0,1,0,1,0
6459,61916,64097,0,0,deny,66,66,0,1,0,1,0
6460,1048,25174,0,0,deny,62,62,0,1,0,1,0
6461,30181,61689,0,0,deny,62,62,0,1,0,1,0
6462,54011,22114,0,0,deny,62,62,0,1,0,1,0
6463,6486,64147,0,0,deny,62,62,0,1,0,1,0
6464,52336,64097,0,0,deny,66,66,0,1,0,1,0
6465,49346,445,0,0,drop,70,70,0,1,0,1,0
6466,54189,22114,0,0,deny,66,66,0,1,0,1,0
6467,58101,46314,0,0,deny,72,72,0,1,0,1,0
6468,39839,22114,0,0,deny,62,62,0,1,0,1,0
6469,49343,445,0,0,drop,70,70,0,1,0,1,0
6470,58079,50584,0,0,deny,62,62,0,1,0,1,0
6471,54063,445,0,0,drop,70,70,0,1,0,1,0
6472,2310,8305,0,0,deny,145,145,0,1,0,1,0
6473,54059,445,0,0,drop,70,70,0,1,0,1,0
6474,58453,50584,0,0,deny,66,66,0,1,0,1,0
6475,54060,445,0,0,drop,70,70,0,1,0,1,0
6476,49454,445,0,0,drop,66,66,0,1,0,1,0
6477,49461,445,0,0,drop,66,66,0,1,0,1,0
6478,49462,445,0,0,drop,66,66,0,1,0,1,0
6479,49457,445,0,0,drop,66,66,0,1,0,1,0
6480,49458,445,0,0,drop,66,66,0,1,0,1,0
6481,49455,445,0,0,drop,66,66,0,1,0,1,0
6482,49456,445,0,0,drop,66,66,0,1,0,1,0
6483,49460,445,0,0,drop,66,66,0,1,0,1,0
6484,54542,25604,0,0,deny,62,62,0,1,0,1,0
6485,36933,23117,0,0,deny,66,66,0,1,0,1,0
6486,31780,11392,0,0,deny,62,62,0,1,0,1,0
6487,9504,25174,0,0,deny,62,62,0,1,0,1,0
6488,30583,25174,0,0,deny,62,62,0,1,0,1,0
6489,55973,25174,0,0,deny,62,62,0,1,0,1,0
6490,54420,80,23681,80,allow,1596,511,1085,10,15,5,5
6491,34671,443,52492,443,allow,8904,1058,7846,18,31,9,9
6492,54014,5228,26717,5228,allow,2493,1541,952,16,3601,8,8
6493,55181,53,13217,53,allow,711,87,624,2,30,1,1
6494,52012,80,40658,80,allow,366,240,126,7,25,5,2
6495,56232,443,31381,443,allow,9920,3980,5940,24,40,12,12
6496,60068,443,30976,443,allow,2227,1018,1209,17,16,8,9
6497,22,51051,22,51051,allow,109,109,0,1,5,1,0
6498,52037,80,5136,80,allow,366,240,126,7,25,5,2
6499,52194,22674,46846,22674,allow,70,70,0,2,8,2,0
6500,52186,57609,20882,57609,allow,70,70,0,2,9,2,0
6501,63107,443,39326,443,allow,3272,800,2472,10,120,5,5
6502,63108,443,56013,443,allow,4609,2177,2432,11,120,6,5
6503,64338,443,59182,443,allow,1786,172,1614,7,120,3,4
6504,61828,443,61828,443,allow,317388,25904,291484,338,200,128,210
6505,26922,443,5779,443,allow,7647,2890,4757,23,20,11,12
6506,40200,5222,30344,5222,allow,8250,3928,4322,80,296,44,36
6507,52038,80,27418,80,allow,366,240,126,7,25,5,2
6508,53954,57868,45044,57868,allow,70,70,0,2,8,2,0
6509,48788,443,25045,443,allow,6254,1075,5179,22,34,10,12
6510,55963,443,55963,443,allow,8882,1866,7016,24,148,13,11
6511,60435,80,13780,80,allow,5518,527,4991,13,75,6,7
6512,40626,443,40626,443,allow,7772,2569,5203,23,148,13,10
6513,56178,443,35008,443,allow,12283477,390003,11893474,13073,164,4327,8746
6514,52024,80,44508,80,allow,422,240,182,8,25,5,3
6515,58192,443,58192,443,allow,4381,1474,2907,19,29,11,8
6516,40217,443,61607,443,allow,5377,857,4520,21,88,8,13
6517,52026,80,21940,80,allow,422,240,182,8,25,5,3
6518,60495,6882,55669,6882,allow,70,70,0,2,8,2,0
6519,60816,443,60816,443,allow,1320,685,635,14,182,7,7
6520,37965,58043,10741,58043,allow,6029,3652,2377,79,3221,45,34
6521,57665,5228,43757,5228,allow,2391,1434,957,16,3601,8,8
6522,49878,24855,0,0,allow,66,66,0,1,91,1,0
6523,52607,443,23239,443,allow,2860,258,2602,9,121,4,5
6524,60813,443,60813,443,allow,1386,751,635,15,182,8,7
6525,16490,25174,0,0,deny,66,66,0,1,0,1,0
6526,46116,57470,0,0,deny,74,74,0,1,0,1,0
6527,49339,445,0,0,drop,70,70,0,1,0,1,0
6528,15899,37807,0,0,deny,62,62,0,1,0,1,0
6529,49308,22114,0,0,deny,66,66,0,1,0,1,0
6530,10467,25174,0,0,deny,62,62,0,1,0,1,0
6531,3381,44847,0,0,deny,78,78,0,1,0,1,0
6532,49337,445,0,0,drop,70,70,0,1,0,1,0
6533,61616,23,0,0,deny,60,60,0,1,0,1,0
6534,47730,22,0,0,deny,60,60,0,1,0,1,0
6535,49335,445,0,0,drop,70,70,0,1,0,1,0
6536,28064,36237,0,0,deny,62,62,0,1,0,1,0
6537,52749,443,45343,443,allow,148418,107579,40839,315,6090,107,208
6538,55713,47783,26233,47783,allow,70,70,0,1,5,1,0
6539,46014,53,46014,53,allow,414,268,146,3,33,2,1
6540,52188,13182,48724,13182,allow,70,70,0,2,9,2,0
6541,52191,32843,25090,32843,allow,70,70,0,2,8,2,0
6542,46975,443,49913,443,allow,70,70,0,1,5,1,0
6543,49505,443,25913,443,allow,6318,2030,4288,25,270,12,13
6544,57808,53,57808,53,allow,222,90,132,2,30,1,1
6545,60814,443,60814,443,allow,1386,751,635,15,181,8,7
6546,52036,80,8626,80,allow,366,240,126,7,24,5,2
6547,55039,443,11955,443,allow,62,62,0,1,4,1,0
6548,65436,53,8668,53,allow,234,94,140,2,29,1,1
6549,60758,53,57238,53,allow,199,94,105,2,30,1,1
6550,52035,80,21577,80,allow,426,240,186,8,24,5,3
6551,52028,80,63717,80,allow,422,240,182,8,24,5,3
6552,53951,8999,2950,8999,allow,70,70,0,2,7,2,0
6553,51555,443,44960,443,allow,876,390,486,12,39,4,8
6554,53922,42285,1496,42285,allow,70,70,0,1,4,1,0
6555,49572,443,43054,443,allow,1820,1101,719,18,18,10,8
6556,54924,443,37000,443,allow,62,62,0,1,4,1,0
6557,52040,80,54028,80,allow,366,240,126,7,24,5,2
6558,35797,443,35797,443,allow,4378,1471,2907,19,27,11,8
6559,55040,443,46427,443,allow,62,62,0,1,4,1,0
6560,52022,80,47623,80,allow,422,240,182,8,24,5,3
6561,52023,80,55578,80,allow,366,240,126,7,24,5,2
6562,43215,443,60115,443,allow,9781,3108,6673,28,15,15,13
6563,52161,19897,37234,19897,allow,70,70,0,1,4,1,0
6564,42166,443,27279,443,allow,4057,966,3091,14,31,8,6
6565,52197,19845,30024,19845,allow,70,70,0,2,7,2,0
6566,59581,53,59581,53,allow,823,98,725,2,29,1,1
6567,53925,61701,1063,61701,allow,70,70,0,1,4,1,0
6568,52012,443,5821,443,allow,126,60,66,3,10,2,1
6569,49440,53,37784,53,allow,210,102,108,2,29,1,1
6570,51805,443,60178,443,allow,6339,1901,4438,16,120,8,8
6571,59779,443,64471,443,allow,70,70,0,1,5,1,0
6572,27988,40037,18791,40037,allow,568,78,490,2,29,1,1
6573,34113,443,8238,443,allow,70,70,0,1,5,1,0
6574,38117,443,59236,443,allow,8598,3880,4718,23,200,13,10
6575,53170,20259,44123,20259,allow,70,70,0,2,8,2,0
6576,65485,53,20874,53,allow,718,94,624,2,30,1,1
6577,52190,29765,3143,29765,allow,70,70,0,2,8,2,0
6578,55204,53,55204,53,allow,239,98,141,2,30,1,1
6579,56753,80,58241,80,allow,1462,703,759,8,16,5,3
6580,38568,53,38568,53,allow,247,98,149,2,33,1,1
6581,54987,443,54987,443,allow,3154,2012,1142,16,18,10,6
6582,65223,443,38564,443,allow,5012,4134,878,17,98,10,7
6583,52159,16297,42997,16297,allow,70,70,0,1,5,1,0
6584,52157,23002,50044,23002,allow,70,70,0,1,5,1,0
6585,40633,53,51896,53,allow,168,78,90,2,30,1,1
6586,34741,53,34741,53,allow,414,268,146,3,33,2,1
6587,52155,63867,61917,63867,allow,70,70,0,1,5,1,0
6588,65165,53,5142,53,allow,177,94,83,2,30,1,1
6589,50519,443,63602,443,allow,16215,1368,14847,36,77,12,24
6590,36838,443,43654,443,allow,9381,1457,7924,21,31,11,10
6591,49507,443,28948,443,allow,9536,2399,7137,32,270,17,15
6592,45309,443,7993,443,allow,3094,2048,1046,18,16,9,9
6593,65383,443,27965,443,allow,839325,38439,800886,1027,94,451,576
6594,54356,443,29580,443,allow,18744,10266,8478,44,35,21,23
6595,51221,44710,11229,44710,allow,481,150,331,2,1200,1,1
6596,49504,443,29645,443,allow,26816,2982,23834,50,270,23,27
6597,52189,24190,3693,24190,allow,70,70,0,2,9,2,0
6598,60675,443,27643,443,allow,1871,1235,636,13,31,8,5
6599,52998,443,34422,443,allow,57778,2562,55216,73,200,29,44
6600,42012,443,37519,443,allow,14271,2106,12165,42,227,17,25
6601,50679,80,31176,80,allow,2139,1167,972,10,20,6,4
6602,49152,514,0,0,allow,142,142,0,2,30,2,0
6603,55152,53,56189,53,allow,177,94,83,2,30,1,1
6604,56748,80,11482,80,allow,946,531,415,11,296,6,5
6605,64898,53,12662,53,allow,487,201,286,6,42,3,3
6606,65435,80,40330,80,allow,11239,7307,3932,19,25,10,9
6607,46266,53,15636,53,allow,308,118,190,2,30,1,1
6608,36834,443,42042,443,allow,8975,1129,7846,19,31,10,9
6609,48656,80,8880,80,allow,1114,534,580,12,15,7,5
6610,36835,443,45000,443,allow,9115,1269,7846,21,31,12,9
6611,37087,80,29544,80,allow,946,531,415,11,296,6,5
6612,50212,1688,47539,1688,allow,70,70,0,1,5,1,0
6613,42167,443,27521,443,allow,4117,1026,3091,15,31,9,6
6614,56431,443,60135,443,allow,55149,7806,47343,134,108,61,73
6615,52093,80,7625,80,allow,3019,716,2303,12,23,7,5
6616,60779,80,5237,80,allow,1248,516,732,9,15,4,5
6617,52020,80,57766,80,allow,426,240,186,8,24,5,3
6618,50265,80,26557,80,allow,2100,1146,954,13,46,6,7
6619,60705,443,45671,443,allow,24145,5933,18212,55,549,27,28
6620,48038,5222,35034,5222,allow,49279,23110,26169,459,384,239,220
6621,49319,53,4413,53,allow,199,94,105,2,30,1,1
6622,36837,443,3546,443,allow,9311,1387,7924,20,31,10,10
6623,40680,5228,59129,5228,allow,234,174,60,2,4,1,1
6624,46112,53,33823,53,allow,168,78,90,2,30,1,1
6625,44228,443,22389,443,allow,2754856,125760,2629096,3115,32,1340,1775
6626,52019,80,54297,80,allow,426,240,186,8,24,5,3
6627,56658,443,35998,443,allow,18959,1799,17160,35,110,15,20
6628,50419,443,44835,443,allow,4590,575,4015,14,28,6,8
6629,50695,80,16857,80,allow,1426,865,561,9,15,5,4
6630,47638,53,47638,53,allow,212,98,114,2,30,1,1
6631,53950,32057,38888,32057,allow,70,70,0,2,7,2,0
6632,55712,27816,8971,27816,allow,316,190,126,5,16,3,2
6633,32645,53,32645,53,allow,404,259,145,3,33,2,1
6634,65516,443,35348,443,allow,451899,13130,438769,463,16,162,301
6635,64613,53,11249,53,allow,212,102,110,2,30,1,1
6636,49570,443,47382,443,allow,162268,121343,40925,316,6101,108,208
6637,64956,53,40414,53,allow,402,118,284,2,29,1,1
6638,49949,53,8662,53,allow,307,110,197,2,30,1,1
6639,54928,8245,11083,8245,allow,280,214,66,2,30,1,1
6640,49506,443,13324,443,allow,6002,1965,4037,23,270,11,12
6641,52831,53,52831,53,allow,200,90,110,2,30,1,1
6642,57243,443,49244,443,allow,27444,3840,23604,58,161,28,30
6643,65411,53,12985,53,allow,194,94,100,2,30,1,1
6644,65114,53,42555,53,allow,380,86,294,2,30,1,1
6645,49797,53,51758,53,allow,718,94,624,2,30,1,1
6646,55152,53,31927,53,allow,177,94,83,2,30,1,1
6647,60068,443,63784,443,allow,10192,5090,5102,43,15,24,19
6648,52193,33027,31412,33027,allow,70,70,0,2,8,2,0
6649,52195,50930,43224,50930,allow,70,70,0,2,8,2,0
6650,52187,38153,15114,38153,allow,70,70,0,2,9,2,0
6651,52158,3841,53385,3841,allow,70,70,0,1,5,1,0
6652,40781,443,27911,443,allow,362,302,60,2,5,1,1
6653,51130,80,19465,80,allow,366,240,126,7,21,5,2
6654,59982,443,64265,443,allow,7693,1284,6409,24,81,12,12
6655,56629,443,11922,443,allow,23887293,546911,23340382,23137,108,7700,15437
6656,65165,53,64230,53,allow,177,94,83,2,30,1,1
6657,51574,443,25990,443,allow,3021,960,2061,14,135,7,7
6658,55027,443,27203,443,allow,17167,5192,11975,32,121,17,15
6659,50560,443,20442,443,allow,17710,10880,6830,44,271,25,19
6660,36836,443,26019,443,allow,9381,1457,7924,21,31,11,10
6661,46899,443,24525,443,allow,70,70,0,1,5,1,0
6662,52156,18238,30723,18238,allow,70,70,0,1,5,1,0
6663,64590,443,12398,443,allow,24686,1935,22751,36,17,17,19
6664,62956,443,13888,443,allow,829275,26662,802613,884,129,295,589
6665,39375,443,57783,443,allow,36154,9709,26445,60,161,27,33
6666,47444,443,24955,443,allow,13920,5009,8911,34,30,18,16
6667,64070,53,27144,53,allow,258,110,148,2,30,1,1
6668,53872,53,43483,53,allow,70,70,0,1,30,1,0
6669,49153,53,53527,53,allow,280,94,186,2,30,1,1
6670,46824,53,42441,53,allow,326,78,248,2,30,1,1
6671,6881,6882,61481,6882,allow,238,118,120,2,1199,1,1
6672,57470,1930,53151,1930,allow,858,858,0,14,1199,14,0
6673,59830,443,56581,443,allow,82533,15815,66718,124,131,50,74
6674,44959,443,64557,443,allow,373033,19903,353130,469,143,180,289
6675,10151,38030,53424,38030,allow,481,150,331,2,1200,1,1
6676,50210,443,12154,443,allow,6444,1320,5124,31,727,10,21
6677,52001,80,13411,80,allow,546,300,246,10,25,6,4
6678,63806,443,63806,443,allow,4651,1744,2907,19,30,11,8
6679,52903,443,59181,443,allow,3478,1580,1898,21,31,12,9
6680,50865,53,50865,53,allow,242,98,144,2,30,1,1
6681,56120,53,62724,53,allow,168,78,90,2,30,1,1
6682,35072,53,51638,53,allow,168,78,90,2,30,1,1
6683,53920,34914,18938,34914,allow,1781,1103,678,15,17,9,6
6684,51270,443,53083,443,allow,190,70,120,4,15,2,2
6685,50673,80,12286,80,allow,20265,5748,14517,34,23,16,18
6686,53226,80,34049,80,allow,1054,602,452,10,20,5,5
6687,60368,443,19000,443,allow,10387,2575,7812,26,108,13,13
6688,49948,53,31917,53,allow,177,94,83,2,30,1,1
6689,49948,53,46968,53,allow,177,94,83,2,30,1,1
6690,20388,53,20388,53,allow,217,90,127,2,30,1,1
6691,55817,53,51311,53,allow,177,94,83,2,30,1,1
6692,56141,53,48700,53,allow,277,134,143,2,30,1,1
6693,65533,53,35566,53,allow,277,134,143,2,30,1,1
6694,42608,1,0,0,deny,62,62,0,1,0,1,0
6695,3986,17372,0,0,deny,66,66,0,1,0,1,0
6696,54053,445,0,0,drop,70,70,0,1,0,1,0
6697,54056,445,0,0,drop,70,70,0,1,0,1,0
6698,54054,445,0,0,drop,70,70,0,1,0,1,0
6699,3730,17372,0,0,deny,62,62,0,1,0,1,0
6700,54048,445,0,0,drop,70,70,0,1,0,1,0
6701,2919,37965,0,0,deny,62,62,0,1,0,1,0
6702,49442,445,0,0,drop,66,66,0,1,0,1,0
6703,49440,445,0,0,drop,66,66,0,1,0,1,0
6704,49439,445,0,0,drop,66,66,0,1,0,1,0
6705,53759,42873,0,0,deny,74,74,0,1,0,1,0
6706,27841,35894,0,0,deny,62,62,0,1,0,1,0
6707,55393,44512,0,0,deny,66,66,0,1,0,1,0
6708,64808,27098,0,0,deny,66,66,0,1,0,1,0
6709,49328,445,0,0,drop,70,70,0,1,0,1,0
6710,54040,445,0,0,drop,70,70,0,1,0,1,0
6711,54280,3385,0,0,deny,60,60,0,1,0,1,0
6712,35100,11392,0,0,deny,62,62,0,1,0,1,0
6713,46162,25174,0,0,deny,62,62,0,1,0,1,0
6714,54034,445,0,0,drop,70,70,0,1,0,1,0
6715,54033,445,0,0,drop,70,70,0,1,0,1,0
6716,59068,49813,0,0,deny,74,74,0,1,0,1,0
6717,54028,445,0,0,drop,70,70,0,1,0,1,0
6718,49326,445,0,0,drop,70,70,0,1,0,1,0
6719,31845,55777,0,0,deny,62,62,0,1,0,1,0
6720,52026,26467,0,0,deny,60,60,0,1,0,1,0
6721,3290,57470,0,0,deny,145,145,0,1,0,1,0
6722,49325,445,0,0,drop,70,70,0,1,0,1,0
6723,51865,61689,0,0,deny,66,66,0,1,0,1,0
6724,11235,30188,0,0,deny,62,62,0,1,0,1,0
6725,49324,445,0,0,drop,70,70,0,1,0,1,0
6726,49323,445,0,0,drop,70,70,0,1,0,1,0
6727,49318,445,0,0,drop,70,70,0,1,0,1,0
6728,49321,445,0,0,drop,70,70,0,1,0,1,0
6729,51922,44847,0,0,deny,66,66,0,1,0,1,0
6730,33814,22114,0,0,deny,146,146,0,1,0,1,0
6731,53928,15503,0,0,deny,62,62,0,1,0,1,0
6732,51414,22,0,0,deny,60,60,0,1,0,1,0
6733,51414,22,0,0,deny,60,60,0,1,0,1,0
6734,52791,25174,0,0,deny,66,66,0,1,0,1,0
6735,62339,25174,0,0,deny,62,62,0,1,0,1,0
6736,49305,445,0,0,drop,70,70,0,1,0,1,0
6737,49304,445,0,0,drop,70,70,0,1,0,1,0
6738,54022,445,0,0,drop,70,70,0,1,0,1,0
6739,54021,445,0,0,drop,70,70,0,1,0,1,0
6740,54015,445,0,0,drop,70,70,0,1,0,1,0
6741,49302,445,0,0,drop,70,70,0,1,0,1,0
6742,53928,15503,0,0,deny,145,145,0,1,0,1,0
6743,10306,44847,0,0,deny,66,66,0,1,0,1,0
6744,48996,22114,0,0,deny,146,146,0,1,0,1,0
6745,49294,445,0,0,drop,70,70,0,1,0,1,0
6746,49295,445,0,0,drop,70,70,0,1,0,1,0
6747,41003,5000,0,0,deny,60,60,0,1,0,1,0
6748,49428,445,0,0,drop,66,66,0,1,0,1,0
6749,41004,5000,0,0,deny,60,60,0,1,0,1,0
6750,33948,1375,0,0,deny,146,146,0,1,0,1,0
6751,63469,64147,0,0,deny,62,62,0,1,0,1,0
6752,46275,64147,0,0,deny,62,62,0,1,0,1,0
6753,51356,22114,0,0,deny,66,66,0,1,0,1,0
6754,22916,25174,0,0,deny,62,62,0,1,0,1,0
6755,53532,22114,0,0,deny,62,62,0,1,0,1,0
6756,54014,445,0,0,drop,70,70,0,1,0,1,0
6757,30542,25174,0,0,deny,62,62,0,1,0,1,0
6758,59153,35440,0,0,deny,62,62,0,1,0,1,0
6759,49283,445,0,0,drop,70,70,0,1,0,1,0
6760,54013,445,0,0,drop,70,70,0,1,0,1,0
6761,7891,25174,0,0,deny,66,66,0,1,0,1,0
6762,50326,46824,0,0,deny,66,66,0,1,0,1,0
6763,49414,445,0,0,drop,66,66,0,1,0,1,0
6764,49411,445,0,0,drop,66,66,0,1,0,1,0
6765,57726,37965,0,0,deny,62,62,0,1,0,1,0
6766,50946,44847,0,0,deny,62,62,0,1,0,1,0
6767,28830,37965,0,0,deny,62,62,0,1,0,1,0
6768,20487,50584,0,0,deny,66,66,0,1,0,1,0
6769,63690,64147,0,0,deny,66,66,0,1,0,1,0
6770,14185,48637,0,0,deny,60,60,0,1,0,1,0
6771,47682,20541,0,0,deny,62,62,0,1,0,1,0
6772,32381,50584,0,0,deny,66,66,0,1,0,1,0
6773,40903,5900,0,0,deny,60,60,0,1,0,1,0
6774,58724,43890,0,0,deny,66,66,0,1,0,1,0
6775,59965,36237,0,0,deny,66,66,0,1,0,1,0
6776,49279,445,0,0,drop,70,70,0,1,0,1,0
6777,3410,17372,0,0,deny,62,62,0,1,0,1,0
6778,53929,443,27958,443,allow,499,425,74,4,0,3,1
6779,53928,443,61918,443,allow,499,425,74,4,0,3,1
6780,10532,26672,0,0,deny,60,60,0,1,0,1,0
6781,3410,17372,0,0,deny,145,145,0,1,0,1,0
6782,3406,17372,0,0,deny,66,66,0,1,0,1,0
6783,54002,445,0,0,drop,70,70,0,1,0,1,0
6784,54001,445,0,0,drop,70,70,0,1,0,1,0
6785,53995,445,0,0,drop,70,70,0,1,0,1,0
6786,53993,445,0,0,drop,70,70,0,1,0,1,0
6787,3090,1,0,0,deny,62,62,0,1,0,1,0
6788,1024,25174,0,0,deny,146,146,0,1,0,1,0
6789,49408,445,0,0,drop,66,66,0,1,0,1,0
6790,49267,445,0,0,drop,70,70,0,1,0,1,0
6791,49269,445,0,0,drop,70,70,0,1,0,1,0
6792,49268,445,0,0,drop,70,70,0,1,0,1,0
6793,12604,80,0,0,deny,60,60,0,1,0,1,0
6794,65216,35440,0,0,deny,66,66,0,1,0,1,0
6795,49265,445,0,0,drop,70,70,0,1,0,1,0
6796,40301,8696,0,0,deny,60,60,0,1,0,1,0
6797,1955,35974,0,0,deny,60,60,0,1,0,1,0
6798,49262,445,0,0,drop,70,70,0,1,0,1,0
6799,49401,445,0,0,drop,66,66,0,1,0,1,0
6800,49396,445,0,0,drop,66,66,0,1,0,1,0
6801,49403,445,0,0,drop,66,66,0,1,0,1,0
6802,49392,445,0,0,drop,66,66,0,1,0,1,0
6803,49402,445,0,0,drop,66,66,0,1,0,1,0
6804,49393,445,0,0,drop,66,66,0,1,0,1,0
6805,49395,445,0,0,drop,66,66,0,1,0,1,0
6806,64772,64147,0,0,deny,62,62,0,1,0,1,0
6807,20706,23718,0,0,deny,66,66,0,1,0,1,0
6808,60308,37965,0,0,deny,66,66,0,1,0,1,0
6809,49001,22114,0,0,deny,62,62,0,1,0,1,0
6810,53987,445,0,0,drop,70,70,0,1,0,1,0
6811,55069,44847,0,0,deny,62,62,0,1,0,1,0
6812,61730,25320,0,0,deny,62,62,0,1,0,1,0
6813,51558,37965,0,0,deny,72,72,0,1,0,1,0
6814,53984,445,0,0,drop,70,70,0,1,0,1,0
6815,53981,445,0,0,drop,70,70,0,1,0,1,0
6816,53980,445,0,0,drop,70,70,0,1,0,1,0
6817,45837,25174,0,0,deny,62,62,0,1,0,1,0
6818,346,23,0,0,deny,60,60,0,1,0,1,0
6819,49257,445,0,0,drop,70,70,0,1,0,1,0
6820,53103,8497,0,0,deny,148,148,0,1,0,1,0
6821,443,4205,0,0,deny,320,320,0,1,0,1,0
6822,4138,55777,0,0,deny,66,66,0,1,0,1,0
6823,43155,35440,0,0,deny,66,66,0,1,0,1,0
6824,54816,35440,0,0,deny,62,62,0,1,0,1,0
6825,55893,45711,0,0,deny,78,78,0,1,0,1,0
6826,45941,23388,0,0,deny,60,60,0,1,0,1,0
6827,53979,445,0,0,drop,70,70,0,1,0,1,0
6828,53972,445,0,0,drop,70,70,0,1,0,1,0
6829,53973,445,0,0,drop,70,70,0,1,0,1,0
6830,61911,50432,0,0,deny,146,146,0,1,0,1,0
6831,59155,39004,0,0,deny,74,74,0,1,0,1,0
6832,49384,445,0,0,drop,66,66,0,1,0,1,0
6833,59223,17500,0,0,deny,66,66,0,1,0,1,0
6834,49249,445,0,0,drop,70,70,0,1,0,1,0
6835,53971,445,0,0,drop,70,70,0,1,0,1,0
6836,49248,445,0,0,drop,70,70,0,1,0,1,0
6837,59225,57587,0,0,deny,66,66,0,1,0,1,0
6838,44408,57470,0,0,deny,62,62,0,1,0,1,0
6839,54555,25174,0,0,deny,66,66,0,1,0,1,0
6840,54976,2273,0,0,deny,60,60,0,1,0,1,0
6841,61280,26467,0,0,deny,66,66,0,1,0,1,0
6842,49383,445,0,0,drop,66,66,0,1,0,1,0
6843,49379,445,0,0,drop,66,66,0,1,0,1,0
6844,49381,445,0,0,drop,66,66,0,1,0,1,0
6845,48258,37965,0,0,deny,62,62,0,1,0,1,0
6846,49378,445,0,0,drop,66,66,0,1,0,1,0
6847,63593,22114,0,0,deny,66,66,0,1,0,1,0
6848,49242,445,0,0,drop,70,70,0,1,0,1,0
6849,56909,50584,0,0,deny,66,66,0,1,0,1,0
6850,49241,445,0,0,drop,70,70,0,1,0,1,0
6851,61143,8080,0,0,deny,60,60,0,1,0,1,0
6852,53964,445,0,0,drop,70,70,0,1,0,1,0
6853,53962,445,0,0,drop,70,70,0,1,0,1,0
6854,53956,445,0,0,drop,70,70,0,1,0,1,0
6855,49237,445,0,0,drop,70,70,0,1,0,1,0
6856,35507,15503,0,0,deny,62,62,0,1,0,1,0
6857,46286,21247,0,0,deny,146,146,0,1,0,1,0
6858,9327,57470,0,0,deny,62,62,0,1,0,1,0
6859,46460,36237,0,0,deny,146,146,0,1,0,1,0
6860,49236,445,0,0,drop,70,70,0,1,0,1,0
6861,13528,51221,0,0,deny,62,62,0,1,0,1,0
6862,49367,445,0,0,drop,66,66,0,1,0,1,0
6863,64882,43890,0,0,deny,66,66,0,1,0,1,0
6864,59214,57866,0,0,deny,66,66,0,1,0,1,0
6865,52604,25174,0,0,deny,66,66,0,1,0,1,0
6866,49531,26467,0,0,deny,66,66,0,1,0,1,0
6867,50974,11392,0,0,deny,66,66,0,1,0,1,0
6868,45964,3111,0,0,deny,60,60,0,1,0,1,0
6869,45964,3111,0,0,deny,60,60,0,1,0,1,0
6870,14208,51221,0,0,deny,66,66,0,1,0,1,0
6871,59822,56205,0,0,deny,66,66,0,1,0,1,0
6872,50396,62413,0,0,deny,66,66,0,1,0,1,0
6873,49359,445,0,0,drop,66,66,0,1,0,1,0
6874,49231,445,0,0,drop,70,70,0,1,0,1,0
6875,53943,445,0,0,drop,70,70,0,1,0,1,0
6876,57131,31061,0,0,deny,145,145,0,1,0,1,0
6877,25565,41288,0,0,deny,60,60,0,1,0,1,0
6878,52929,43890,0,0,deny,66,66,0,1,0,1,0
6879,62575,12207,0,0,deny,66,66,0,1,0,1,0
6880,53381,25174,0,0,deny,62,62,0,1,0,1,0
6881,44414,23718,0,0,deny,66,66,0,1,0,1,0
6882,18218,30349,0,0,deny,148,148,0,1,0,1,0
6883,49356,445,0,0,drop,66,66,0,1,0,1,0
6884,55312,64147,0,0,deny,62,62,0,1,0,1,0
6885,18398,21247,0,0,deny,66,66,0,1,0,1,0
6886,62020,64147,0,0,deny,145,145,0,1,0,1,0
6887,38330,44847,0,0,deny,66,66,0,1,0,1,0
6888,60416,37965,0,0,deny,66,66,0,1,0,1,0
6889,23310,22114,0,0,deny,66,66,0,1,0,1,0
6890,53759,42873,0,0,deny,74,74,0,1,0,1,0
6891,61085,37965,0,0,deny,62,62,0,1,0,1,0
6892,7561,43890,0,0,deny,66,66,0,1,0,1,0
6893,49349,445,0,0,drop,66,66,0,1,0,1,0
6894,49485,56972,0,0,deny,62,62,0,1,0,1,0
6895,56924,26467,0,0,deny,62,62,0,1,0,1,0
6896,37487,25174,0,0,deny,66,66,0,1,0,1,0
6897,36729,443,18622,443,allow,7480,1122,6358,27,257,13,14
6898,38644,1723,38644,1723,allow,146,60,86,2,9,1,1
6899,48470,80,20195,80,allow,959,544,415,11,315,6,5
6900,55681,53,52185,53,allow,711,87,624,2,30,1,1
6901,56334,53,55727,53,allow,170,87,83,2,30,1,1
6902,43686,443,17205,443,allow,6804,914,5890,22,257,10,12
6903,49335,443,62056,443,allow,125790,4516,121274,118,55,28,90
6904,57069,53,40804,53,allow,1335,87,1248,4,32,2,2
6905,53947,867,53640,867,allow,70,70,0,2,8,2,0
6906,60487,1134,57270,1134,allow,70,70,0,1,5,1,0
6907,40218,443,5218,443,allow,5254,927,4327,20,84,9,11
6908,55064,80,48645,80,allow,1646,998,648,13,85,7,6
6909,55157,53,58441,53,allow,711,87,624,2,30,1,1
6910,55710,53,65057,53,allow,198,93,105,2,30,1,1
6911,38402,443,45229,443,allow,3830718,112946,3717772,4353,224,1395,2958
6912,29126,7000,29126,7000,allow,4124,2423,1701,20,16,11,9
6913,52154,4635,6285,4635,allow,66,66,0,1,5,1,0
6914,57339,443,64003,443,allow,1778020,204978,1573042,2589,987,1006,1583
6915,52710,443,22445,443,allow,203346,21619,181727,301,376,140,161
6916,52829,443,52829,443,allow,4613,1706,2907,19,30,11,8
6917,48551,443,38107,443,allow,7104,888,6216,19,27,9,10
6918,48785,443,37520,443,allow,6464,1223,5241,25,33,12,13
6919,59326,80,59326,80,allow,109128,4773,104355,197,16,68,129
6920,60815,443,60815,443,allow,1320,685,635,14,181,7,7
6921,54352,53,16730,53,allow,578,286,292,9,16,5,4
6922,45314,80,7495,80,allow,72376,2899,69477,79,16,29,50
6923,53075,53,27228,53,allow,168,78,90,2,30,1,1
6924,35702,443,51381,443,allow,13428,5815,7613,42,995,22,20
6925,36943,443,59404,443,allow,15329,7087,8242,108,310,61,47
6926,36993,443,63240,443,allow,7768,3071,4697,23,17,12,11
6927,31227,53,31227,53,allow,407,261,146,3,32,2,1
6928,60486,8999,41044,8999,allow,70,70,0,1,5,1,0
6929,43368,443,39927,443,allow,190,70,120,4,15,2,2
6930,57760,80,57760,80,allow,2934,1497,1437,10,16,6,4
6931,48786,443,62894,443,allow,7130,1890,5240,25,33,12,13
6932,57240,53,57240,53,allow,198,89,109,2,30,1,1
6933,56680,53,24501,53,allow,711,87,624,2,30,1,1
6934,43024,53,45972,53,allow,198,93,105,2,30,1,1
6935,57470,6881,1895,6881,allow,528,528,0,9,1200,9,0
6936,55055,443,60639,443,allow,14492,3190,11302,34,16,19,15
6937,1658,443,1658,443,allow,12030,1282,10748,23,17,9,14
6938,40215,443,50672,443,allow,5656,1009,4647,24,87,10,14
6939,25384,443,25384,443,allow,3072,696,2376,13,16,8,5
6940,40220,443,35161,443,allow,5448,989,4459,22,84,10,12
6941,53948,7370,61393,7370,allow,70,70,0,2,8,2,0
6942,49300,443,11217,443,allow,26747,8027,18720,58,92,25,33
6943,53614,443,10121,443,allow,8347,1979,6368,32,19,17,15
6944,55936,53,2278,53,allow,170,87,83,2,30,1,1
6945,51809,443,10522,443,allow,82930,18836,64094,131,128,55,76
6946,19473,51413,8434,51413,allow,459,149,310,2,1200,1,1
6947,36337,443,41043,443,allow,3781,1917,1864,23,396,7,16
6948,58848,24855,0,0,allow,66,66,0,1,90,1,0
6949,41156,443,9223,443,allow,59486,3261,56225,74,360,29,45
6950,54517,443,8632,443,allow,11460,2522,8938,19,122,9,10
6951,49343,445,0,0,drop,66,66,0,1,0,1,0
6952,49218,445,0,0,drop,70,70,0,1,0,1,0
6953,60645,35440,0,0,deny,66,66,0,1,0,1,0
6954,62250,23117,0,0,deny,66,66,0,1,0,1,0
6955,62208,37965,0,0,deny,66,66,0,1,0,1,0
6956,31654,65473,0,0,deny,148,148,0,1,0,1,0
6957,9226,57470,0,0,deny,66,66,0,1,0,1,0
6958,49215,445,0,0,drop,70,70,0,1,0,1,0
6959,37191,48817,0,0,deny,159,159,0,1,0,1,0
6960,9745,26467,0,0,deny,62,62,0,1,0,1,0
6961,13020,26467,0,0,deny,66,66,0,1,0,1,0
6962,39171,22114,0,0,deny,146,146,0,1,0,1,0
6963,54957,53,32234,53,allow,102,102,0,1,30,1,0
6964,36697,443,4687,443,allow,21563,17259,4304,70,78,37,33
6965,38711,443,23557,443,allow,459089,10521,448568,449,16,141,308
6966,57979,443,3610,443,allow,7970957,82522,7888435,6370,179,1027,5343
6967,41451,53,15515,53,allow,359,86,273,2,30,1,1
6968,53934,445,0,0,drop,70,70,0,1,0,1,0
6969,53932,445,0,0,drop,70,70,0,1,0,1,0
6970,53931,445,0,0,drop,70,70,0,1,0,1,0
6971,48016,57470,0,0,deny,62,62,0,1,0,1,0
6972,59347,57470,0,0,deny,66,66,0,1,0,1,0
6973,31130,30188,0,0,deny,66,66,0,1,0,1,0
6974,49328,445,0,0,drop,66,66,0,1,0,1,0
6975,49331,445,0,0,drop,66,66,0,1,0,1,0
6976,49333,445,0,0,drop,66,66,0,1,0,1,0
6977,49332,445,0,0,drop,66,66,0,1,0,1,0
6978,49329,445,0,0,drop,66,66,0,1,0,1,0
6979,49326,445,0,0,drop,66,66,0,1,0,1,0
6980,53721,62413,0,0,deny,146,146,0,1,0,1,0
6981,49211,445,0,0,drop,70,70,0,1,0,1,0
6982,2780,23117,0,0,deny,62,62,0,1,0,1,0
6983,49207,445,0,0,drop,70,70,0,1,0,1,0
6984,51930,57470,0,0,deny,62,62,0,1,0,1,0
6985,54011,44847,0,0,deny,66,66,0,1,0,1,0
6986,19845,30024,0,0,deny,62,62,0,1,0,1,0
6987,55842,64147,0,0,deny,66,66,0,1,0,1,0
6988,49205,445,0,0,drop,70,70,0,1,0,1,0
6989,58638,5900,0,0,deny,62,62,0,1,0,1,0
6990,58638,5900,0,0,deny,62,62,0,1,0,1,0
6991,58638,5900,0,0,deny,62,62,0,1,0,1,0
6992,58638,5900,0,0,deny,62,62,0,1,0,1,0
6993,58638,5900,0,0,deny,62,62,0,1,0,1,0
6994,58638,5900,0,0,deny,62,62,0,1,0,1,0
6995,58638,5900,0,0,deny,62,62,0,1,0,1,0
6996,58638,5900,0,0,deny,62,62,0,1,0,1,0
6997,58638,5900,0,0,deny,62,62,0,1,0,1,0
6998,58638,5900,0,0,deny,62,62,0,1,0,1,0
6999,58638,5900,0,0,deny,62,62,0,1,0,1,0
7000,58638,5900,0,0,deny,62,62,0,1,0,1,0
7001,58638,5900,0,0,deny,62,62,0,1,0,1,0
7002,58638,5900,0,0,deny,62,62,0,1,0,1,0
7003,58638,5900,0,0,deny,62,62,0,1,0,1,0
7004,58638,5900,0,0,deny,62,62,0,1,0,1,0
7005,58638,5900,0,0,deny,62,62,0,1,0,1,0
7006,58638,5900,0,0,deny,62,62,0,1,0,1,0
7007,58638,5900,0,0,deny,62,62,0,1,0,1,0
7008,58638,5900,0,0,deny,62,62,0,1,0,1,0
7009,58638,5900,0,0,deny,62,62,0,1,0,1,0
7010,58638,5900,0,0,deny,62,62,0,1,0,1,0
7011,58638,5900,0,0,deny,62,62,0,1,0,1,0
7012,58638,5900,0,0,deny,62,62,0,1,0,1,0
7013,58638,5900,0,0,deny,62,62,0,1,0,1,0
7014,58638,5900,0,0,deny,62,62,0,1,0,1,0
7015,58638,5900,0,0,deny,62,62,0,1,0,1,0
7016,58638,5900,0,0,deny,62,62,0,1,0,1,0
7017,58638,5900,0,0,deny,62,62,0,1,0,1,0
7018,58638,5900,0,0,deny,62,62,0,1,0,1,0
7019,58638,5900,0,0,deny,62,62,0,1,0,1,0
7020,58638,5900,0,0,deny,62,62,0,1,0,1,0
7021,58638,5900,0,0,deny,62,62,0,1,0,1,0
7022,58638,5900,0,0,deny,62,62,0,1,0,1,0
7023,58638,5900,0,0,deny,62,62,0,1,0,1,0
7024,58638,5900,0,0,deny,62,62,0,1,0,1,0
7025,58638,5900,0,0,deny,62,62,0,1,0,1,0
7026,58638,5900,0,0,deny,62,62,0,1,0,1,0
7027,58638,5900,0,0,deny,62,62,0,1,0,1,0
7028,58638,5900,0,0,deny,62,62,0,1,0,1,0
7029,58638,5900,0,0,deny,62,62,0,1,0,1,0
7030,58638,5900,0,0,deny,62,62,0,1,0,1,0
7031,58638,5900,0,0,deny,62,62,0,1,0,1,0
7032,58638,5900,0,0,deny,62,62,0,1,0,1,0
7033,58638,5900,0,0,deny,62,62,0,1,0,1,0
7034,58638,5900,0,0,deny,62,62,0,1,0,1,0
7035,58638,5900,0,0,deny,62,62,0,1,0,1,0
7036,58638,5900,0,0,deny,62,62,0,1,0,1,0
7037,58638,5900,0,0,deny,62,62,0,1,0,1,0
7038,58638,5900,0,0,deny,62,62,0,1,0,1,0
7039,58638,5900,0,0,deny,62,62,0,1,0,1,0
7040,58638,5900,0,0,deny,62,62,0,1,0,1,0
7041,58638,5900,0,0,deny,62,62,0,1,0,1,0
7042,58638,5900,0,0,deny,62,62,0,1,0,1,0
7043,58638,5900,0,0,deny,62,62,0,1,0,1,0
7044,58638,5900,0,0,deny,62,62,0,1,0,1,0
7045,58638,5900,0,0,deny,62,62,0,1,0,1,0
7046,58638,5900,0,0,deny,62,62,0,1,0,1,0
7047,58638,5900,0,0,deny,62,62,0,1,0,1,0
7048,58638,5900,0,0,deny,62,62,0,1,0,1,0
7049,58638,5900,0,0,deny,62,62,0,1,0,1,0
7050,58638,5900,0,0,deny,62,62,0,1,0,1,0
7051,58638,5900,0,0,deny,62,62,0,1,0,1,0
7052,58638,5900,0,0,deny,62,62,0,1,0,1,0
7053,58638,5900,0,0,deny,62,62,0,1,0,1,0
7054,58638,5900,0,0,deny,62,62,0,1,0,1,0
7055,58638,5900,0,0,deny,62,62,0,1,0,1,0
7056,58638,5900,0,0,deny,62,62,0,1,0,1,0
7057,58638,5900,0,0,deny,62,62,0,1,0,1,0
7058,58638,5900,0,0,deny,62,62,0,1,0,1,0
7059,58638,5900,0,0,deny,62,62,0,1,0,1,0
7060,58638,5900,0,0,deny,62,62,0,1,0,1,0
7061,58638,5900,0,0,deny,62,62,0,1,0,1,0
7062,58638,5900,0,0,deny,62,62,0,1,0,1,0
7063,58638,5900,0,0,deny,62,62,0,1,0,1,0
7064,58638,5900,0,0,deny,62,62,0,1,0,1,0
7065,58638,5900,0,0,deny,62,62,0,1,0,1,0
7066,58638,5900,0,0,deny,62,62,0,1,0,1,0
7067,58638,5900,0,0,deny,62,62,0,1,0,1,0
7068,58638,5900,0,0,deny,62,62,0,1,0,1,0
7069,58638,5900,0,0,deny,62,62,0,1,0,1,0
7070,58638,5900,0,0,deny,62,62,0,1,0,1,0
7071,58638,5900,0,0,deny,62,62,0,1,0,1,0
7072,58638,5900,0,0,deny,62,62,0,1,0,1,0
7073,58638,5900,0,0,deny,62,62,0,1,0,1,0
7074,58638,5900,0,0,deny,62,62,0,1,0,1,0
7075,58638,5900,0,0,deny,62,62,0,1,0,1,0
7076,58638,5900,0,0,deny,62,62,0,1,0,1,0
7077,58638,5900,0,0,deny,62,62,0,1,0,1,0
7078,58638,5900,0,0,deny,62,62,0,1,0,1,0
7079,58638,5900,0,0,deny,62,62,0,1,0,1,0
7080,58638,5900,0,0,deny,62,62,0,1,0,1,0
7081,58638,5900,0,0,deny,62,62,0,1,0,1,0
7082,58638,5900,0,0,deny,62,62,0,1,0,1,0
7083,58638,5900,0,0,deny,62,62,0,1,0,1,0
7084,58638,5900,0,0,deny,62,62,0,1,0,1,0
7085,52026,26467,0,0,deny,60,60,0,1,0,1,0
7086,58638,5900,0,0,deny,62,62,0,1,0,1,0
7087,58638,5900,0,0,deny,62,62,0,1,0,1,0
7088,58638,5900,0,0,deny,62,62,0,1,0,1,0
7089,58638,5900,0,0,deny,62,62,0,1,0,1,0
7090,58638,5900,0,0,deny,62,62,0,1,0,1,0
7091,58638,5900,0,0,deny,62,62,0,1,0,1,0
7092,58638,5900,0,0,deny,62,62,0,1,0,1,0
7093,58638,5900,0,0,deny,62,62,0,1,0,1,0
7094,58638,5900,0,0,deny,62,62,0,1,0,1,0
7095,58638,5900,0,0,deny,62,62,0,1,0,1,0
7096,58638,5900,0,0,deny,62,62,0,1,0,1,0
7097,58638,5900,0,0,deny,62,62,0,1,0,1,0
7098,58638,5900,0,0,deny,62,62,0,1,0,1,0
7099,58638,5900,0,0,deny,62,62,0,1,0,1,0
7100,58638,5900,0,0,deny,62,62,0,1,0,1,0
7101,58638,5900,0,0,deny,62,62,0,1,0,1,0
7102,58638,5900,0,0,deny,62,62,0,1,0,1,0
7103,58638,5900,0,0,deny,62,62,0,1,0,1,0
7104,58638,5900,0,0,deny,62,62,0,1,0,1,0
7105,58638,5900,0,0,deny,62,62,0,1,0,1,0
7106,58638,5900,0,0,deny,62,62,0,1,0,1,0
7107,58638,5900,0,0,deny,62,62,0,1,0,1,0
7108,58638,5900,0,0,deny,62,62,0,1,0,1,0
7109,58638,5900,0,0,deny,62,62,0,1,0,1,0
7110,58638,5900,0,0,deny,62,62,0,1,0,1,0
7111,58638,5900,0,0,deny,62,62,0,1,0,1,0
7112,58638,5900,0,0,deny,62,62,0,1,0,1,0
7113,58638,5900,0,0,deny,62,62,0,1,0,1,0
7114,58638,5900,0,0,deny,62,62,0,1,0,1,0
7115,58638,5900,0,0,deny,62,62,0,1,0,1,0
7116,58638,5900,0,0,deny,62,62,0,1,0,1,0
7117,58638,5900,0,0,deny,62,62,0,1,0,1,0
7118,58638,5900,0,0,deny,62,62,0,1,0,1,0
7119,58638,5900,0,0,deny,62,62,0,1,0,1,0
7120,58638,5900,0,0,deny,62,62,0,1,0,1,0
7121,58638,5900,0,0,deny,62,62,0,1,0,1,0
7122,58638,5900,0,0,deny,62,62,0,1,0,1,0
7123,58638,5900,0,0,deny,62,62,0,1,0,1,0
7124,58638,5900,0,0,deny,62,62,0,1,0,1,0
7125,58638,5900,0,0,deny,62,62,0,1,0,1,0
7126,58638,5900,0,0,deny,62,62,0,1,0,1,0
7127,58638,5900,0,0,deny,62,62,0,1,0,1,0
7128,58638,5900,0,0,deny,62,62,0,1,0,1,0
7129,58638,5900,0,0,deny,62,62,0,1,0,1,0
7130,58638,5900,0,0,deny,62,62,0,1,0,1,0
7131,58638,5900,0,0,deny,62,62,0,1,0,1,0
7132,58638,5900,0,0,deny,62,62,0,1,0,1,0
7133,58638,5900,0,0,deny,62,62,0,1,0,1,0
7134,58638,5900,0,0,deny,62,62,0,1,0,1,0
7135,58638,5900,0,0,deny,62,62,0,1,0,1,0
7136,58638,5900,0,0,deny,62,62,0,1,0,1,0
7137,58638,5900,0,0,deny,62,62,0,1,0,1,0
7138,58638,5900,0,0,deny,62,62,0,1,0,1,0
7139,58638,5900,0,0,deny,62,62,0,1,0,1,0
7140,58638,5900,0,0,deny,62,62,0,1,0,1,0
7141,58638,5900,0,0,deny,62,62,0,1,0,1,0
7142,58638,5900,0,0,deny,62,62,0,1,0,1,0
7143,58638,5900,0,0,deny,62,62,0,1,0,1,0
7144,58638,5900,0,0,deny,62,62,0,1,0,1,0
7145,58638,5900,0,0,deny,62,62,0,1,0,1,0
7146,58638,5900,0,0,deny,62,62,0,1,0,1,0
7147,58638,5900,0,0,deny,62,62,0,1,0,1,0
7148,58638,5900,0,0,deny,62,62,0,1,0,1,0
7149,58638,5900,0,0,deny,62,62,0,1,0,1,0
7150,58638,5900,0,0,deny,62,62,0,1,0,1,0
7151,58638,5900,0,0,deny,62,62,0,1,0,1,0
7152,58638,5900,0,0,deny,62,62,0,1,0,1,0
7153,58638,5900,0,0,deny,62,62,0,1,0,1,0
7154,58638,5900,0,0,deny,62,62,0,1,0,1,0
7155,58638,5900,0,0,deny,62,62,0,1,0,1,0
7156,58638,5900,0,0,deny,62,62,0,1,0,1,0
7157,58638,5900,0,0,deny,62,62,0,1,0,1,0
7158,58638,5900,0,0,deny,62,62,0,1,0,1,0
7159,58638,5900,0,0,deny,62,62,0,1,0,1,0
7160,58638,5900,0,0,deny,62,62,0,1,0,1,0
7161,58638,5900,0,0,deny,62,62,0,1,0,1,0
7162,58638,5900,0,0,deny,62,62,0,1,0,1,0
7163,58638,5900,0,0,deny,62,62,0,1,0,1,0
7164,58638,5900,0,0,deny,62,62,0,1,0,1,0
7165,58638,5900,0,0,deny,62,62,0,1,0,1,0
7166,58638,5900,0,0,deny,62,62,0,1,0,1,0
7167,58638,5900,0,0,deny,62,62,0,1,0,1,0
7168,58638,5900,0,0,deny,62,62,0,1,0,1,0
7169,58638,5900,0,0,deny,62,62,0,1,0,1,0
7170,58638,5900,0,0,deny,62,62,0,1,0,1,0
7171,58638,5900,0,0,deny,62,62,0,1,0,1,0
7172,58638,5900,0,0,deny,62,62,0,1,0,1,0
7173,58638,5900,0,0,deny,62,62,0,1,0,1,0
7174,58638,5900,0,0,deny,62,62,0,1,0,1,0
7175,58638,5900,0,0,deny,62,62,0,1,0,1,0
7176,58638,5900,0,0,deny,62,62,0,1,0,1,0
7177,58638,5900,0,0,deny,62,62,0,1,0,1,0
7178,58638,5900,0,0,deny,62,62,0,1,0,1,0
7179,58638,5900,0,0,deny,62,62,0,1,0,1,0
7180,58638,5900,0,0,deny,62,62,0,1,0,1,0
7181,58638,5900,0,0,deny,62,62,0,1,0,1,0
7182,58638,5900,0,0,deny,62,62,0,1,0,1,0
7183,58638,5900,0,0,deny,62,62,0,1,0,1,0
7184,58638,5900,0,0,deny,62,62,0,1,0,1,0
7185,58638,5900,0,0,deny,62,62,0,1,0,1,0
7186,58638,5900,0,0,deny,62,62,0,1,0,1,0
7187,58638,5900,0,0,deny,62,62,0,1,0,1,0
7188,58638,5900,0,0,deny,62,62,0,1,0,1,0
7189,58638,5900,0,0,deny,62,62,0,1,0,1,0
7190,58638,5900,0,0,deny,62,62,0,1,0,1,0
7191,58638,5900,0,0,deny,62,62,0,1,0,1,0
7192,58638,5900,0,0,deny,62,62,0,1,0,1,0
7193,58638,5900,0,0,deny,62,62,0,1,0,1,0
7194,58638,5900,0,0,deny,62,62,0,1,0,1,0
7195,58638,5900,0,0,deny,62,62,0,1,0,1,0
7196,58638,5900,0,0,deny,62,62,0,1,0,1,0
7197,58638,5900,0,0,deny,62,62,0,1,0,1,0
7198,58638,5900,0,0,deny,62,62,0,1,0,1,0
7199,58638,5900,0,0,deny,62,62,0,1,0,1,0
7200,58638,5900,0,0,deny,62,62,0,1,0,1,0
7201,58638,5900,0,0,deny,62,62,0,1,0,1,0
7202,58638,5900,0,0,deny,62,62,0,1,0,1,0
7203,58638,5900,0,0,deny,62,62,0,1,0,1,0
7204,58638,5900,0,0,deny,62,62,0,1,0,1,0
7205,58638,5900,0,0,deny,62,62,0,1,0,1,0
7206,58638,5900,0,0,deny,62,62,0,1,0,1,0
7207,58638,5900,0,0,deny,62,62,0,1,0,1,0
7208,58638,5900,0,0,deny,62,62,0,1,0,1,0
7209,58638,5900,0,0,deny,62,62,0,1,0,1,0
7210,58638,5900,0,0,deny,62,62,0,1,0,1,0
7211,58638,5900,0,0,deny,62,62,0,1,0,1,0
7212,58638,5900,0,0,deny,62,62,0,1,0,1,0
7213,58638,5900,0,0,deny,62,62,0,1,0,1,0
7214,58638,5900,0,0,deny,62,62,0,1,0,1,0
7215,58638,5900,0,0,deny,62,62,0,1,0,1,0
7216,58638,5900,0,0,deny,62,62,0,1,0,1,0
7217,58638,5900,0,0,deny,62,62,0,1,0,1,0
7218,58638,5900,0,0,deny,62,62,0,1,0,1,0
7219,58638,5900,0,0,deny,62,62,0,1,0,1,0
7220,58638,5900,0,0,deny,62,62,0,1,0,1,0
7221,58638,5900,0,0,deny,62,62,0,1,0,1,0
7222,58638,5900,0,0,deny,62,62,0,1,0,1,0
7223,58638,5900,0,0,deny,62,62,0,1,0,1,0
7224,58638,5900,0,0,deny,62,62,0,1,0,1,0
7225,58638,5900,0,0,deny,62,62,0,1,0,1,0
7226,58638,5900,0,0,deny,62,62,0,1,0,1,0
7227,58638,5900,0,0,deny,62,62,0,1,0,1,0
7228,58638,5900,0,0,deny,62,62,0,1,0,1,0
7229,58638,5900,0,0,deny,62,62,0,1,0,1,0
7230,58638,5900,0,0,deny,62,62,0,1,0,1,0
7231,58638,5900,0,0,deny,62,62,0,1,0,1,0
7232,58638,5900,0,0,deny,62,62,0,1,0,1,0
7233,58638,5900,0,0,deny,62,62,0,1,0,1,0
7234,58638,5900,0,0,deny,62,62,0,1,0,1,0
7235,58638,5900,0,0,deny,62,62,0,1,0,1,0
7236,58638,5900,0,0,deny,62,62,0,1,0,1,0
7237,58638,5900,0,0,deny,62,62,0,1,0,1,0
7238,58638,5900,0,0,deny,62,62,0,1,0,1,0
7239,58638,5900,0,0,deny,62,62,0,1,0,1,0
7240,58638,5900,0,0,deny,62,62,0,1,0,1,0
7241,58638,5900,0,0,deny,62,62,0,1,0,1,0
7242,58638,5900,0,0,deny,62,62,0,1,0,1,0
7243,58638,5900,0,0,deny,62,62,0,1,0,1,0
7244,58638,5900,0,0,deny,62,62,0,1,0,1,0
7245,53930,445,0,0,drop,70,70,0,1,0,1,0
7246,58638,5900,0,0,deny,62,62,0,1,0,1,0
7247,58638,5900,0,0,deny,62,62,0,1,0,1,0
7248,53923,445,0,0,drop,70,70,0,1,0,1,0
7249,58638,5900,0,0,deny,62,62,0,1,0,1,0
7250,58638,5900,0,0,deny,62,62,0,1,0,1,0
7251,53922,445,0,0,drop,70,70,0,1,0,1,0
7252,58638,5900,0,0,deny,62,62,0,1,0,1,0
7253,58638,5900,0,0,deny,62,62,0,1,0,1,0
7254,53916,445,0,0,drop,70,70,0,1,0,1,0
7255,58638,5900,0,0,deny,62,62,0,1,0,1,0
7256,58638,5900,0,0,deny,62,62,0,1,0,1,0
7257,58638,5900,0,0,deny,62,62,0,1,0,1,0
7258,58638,5900,0,0,deny,62,62,0,1,0,1,0
7259,58638,5900,0,0,deny,62,62,0,1,0,1,0
7260,58638,5900,0,0,deny,62,62,0,1,0,1,0
7261,58638,5900,0,0,deny,62,62,0,1,0,1,0
7262,58638,5900,0,0,deny,62,62,0,1,0,1,0
7263,58638,5900,0,0,deny,62,62,0,1,0,1,0
7264,58638,5900,0,0,deny,62,62,0,1,0,1,0
7265,58638,5900,0,0,deny,62,62,0,1,0,1,0
7266,58638,5900,0,0,deny,62,62,0,1,0,1,0
7267,58638,5900,0,0,deny,62,62,0,1,0,1,0
7268,58638,5900,0,0,deny,62,62,0,1,0,1,0
7269,58638,5900,0,0,deny,62,62,0,1,0,1,0
7270,58638,5900,0,0,deny,62,62,0,1,0,1,0
7271,58638,5900,0,0,deny,62,62,0,1,0,1,0
7272,58638,5900,0,0,deny,62,62,0,1,0,1,0
7273,58638,5900,0,0,deny,62,62,0,1,0,1,0
7274,58638,5900,0,0,deny,62,62,0,1,0,1,0
7275,58638,5900,0,0,deny,62,62,0,1,0,1,0
7276,58638,5900,0,0,deny,62,62,0,1,0,1,0
7277,58638,5900,0,0,deny,62,62,0,1,0,1,0
7278,58638,5900,0,0,deny,62,62,0,1,0,1,0
7279,58638,5900,0,0,deny,62,62,0,1,0,1,0
7280,58638,5900,0,0,deny,62,62,0,1,0,1,0
7281,58638,5900,0,0,deny,62,62,0,1,0,1,0
7282,58638,5900,0,0,deny,62,62,0,1,0,1,0
7283,58638,5900,0,0,deny,62,62,0,1,0,1,0
7284,58638,5900,0,0,deny,62,62,0,1,0,1,0
7285,58638,5900,0,0,deny,62,62,0,1,0,1,0
7286,58638,5900,0,0,deny,62,62,0,1,0,1,0
7287,58638,5900,0,0,deny,62,62,0,1,0,1,0
7288,58638,5900,0,0,deny,62,62,0,1,0,1,0
7289,58638,5900,0,0,deny,62,62,0,1,0,1,0
7290,58638,5900,0,0,deny,62,62,0,1,0,1,0
7291,58638,5900,0,0,deny,62,62,0,1,0,1,0
7292,58638,5900,0,0,deny,62,62,0,1,0,1,0
7293,58638,5900,0,0,deny,62,62,0,1,0,1,0
7294,58638,5900,0,0,deny,62,62,0,1,0,1,0
7295,58638,5900,0,0,deny,62,62,0,1,0,1,0
7296,58638,5900,0,0,deny,62,62,0,1,0,1,0
7297,58638,5900,0,0,deny,62,62,0,1,0,1,0
7298,58638,5900,0,0,deny,62,62,0,1,0,1,0
7299,58638,5900,0,0,deny,62,62,0,1,0,1,0
7300,58638,5900,0,0,deny,62,62,0,1,0,1,0
7301,58638,5900,0,0,deny,62,62,0,1,0,1,0
7302,58638,5900,0,0,deny,62,62,0,1,0,1,0
7303,58638,5900,0,0,deny,62,62,0,1,0,1,0
7304,58638,5900,0,0,deny,62,62,0,1,0,1,0
7305,58638,5900,0,0,deny,62,62,0,1,0,1,0
7306,58638,5900,0,0,deny,62,62,0,1,0,1,0
7307,58638,5900,0,0,deny,62,62,0,1,0,1,0
7308,58638,5900,0,0,deny,62,62,0,1,0,1,0
7309,58638,5900,0,0,deny,62,62,0,1,0,1,0
7310,58638,5900,0,0,deny,62,62,0,1,0,1,0
7311,58638,5900,0,0,deny,62,62,0,1,0,1,0
7312,58638,5900,0,0,deny,62,62,0,1,0,1,0
7313,58638,5900,0,0,deny,62,62,0,1,0,1,0
7314,58638,5900,0,0,deny,62,62,0,1,0,1,0
7315,58638,5900,0,0,deny,62,62,0,1,0,1,0
7316,58638,5900,0,0,deny,62,62,0,1,0,1,0
7317,58638,5900,0,0,deny,62,62,0,1,0,1,0
7318,58638,5900,0,0,deny,62,62,0,1,0,1,0
7319,58638,5900,0,0,deny,62,62,0,1,0,1,0
7320,58638,5900,0,0,deny,62,62,0,1,0,1,0
7321,58638,5900,0,0,deny,62,62,0,1,0,1,0
7322,58638,5900,0,0,deny,62,62,0,1,0,1,0
7323,58638,5900,0,0,deny,62,62,0,1,0,1,0
7324,58638,5900,0,0,deny,62,62,0,1,0,1,0
7325,58638,5900,0,0,deny,62,62,0,1,0,1,0
7326,58638,5900,0,0,deny,62,62,0,1,0,1,0
7327,58638,5900,0,0,deny,62,62,0,1,0,1,0
7328,58638,5900,0,0,deny,62,62,0,1,0,1,0
7329,58638,5900,0,0,deny,62,62,0,1,0,1,0
7330,58638,5900,0,0,deny,62,62,0,1,0,1,0
7331,58638,5900,0,0,deny,62,62,0,1,0,1,0
7332,58638,5900,0,0,deny,62,62,0,1,0,1,0
7333,58638,5900,0,0,deny,62,62,0,1,0,1,0
7334,58638,5900,0,0,deny,62,62,0,1,0,1,0
7335,58638,5900,0,0,deny,62,62,0,1,0,1,0
7336,58638,5900,0,0,deny,62,62,0,1,0,1,0
7337,58638,5900,0,0,deny,62,62,0,1,0,1,0
7338,58638,5900,0,0,deny,62,62,0,1,0,1,0
7339,58638,5900,0,0,deny,62,62,0,1,0,1,0
7340,58638,5900,0,0,deny,62,62,0,1,0,1,0
7341,58638,5900,0,0,deny,62,62,0,1,0,1,0
7342,58638,5900,0,0,deny,62,62,0,1,0,1,0
7343,58638,5900,0,0,deny,62,62,0,1,0,1,0
7344,58638,5900,0,0,deny,62,62,0,1,0,1,0
7345,58638,5900,0,0,deny,62,62,0,1,0,1,0
7346,58638,5900,0,0,deny,62,62,0,1,0,1,0
7347,58638,5900,0,0,deny,62,62,0,1,0,1,0
7348,58638,5900,0,0,deny,62,62,0,1,0,1,0
7349,58638,5900,0,0,deny,62,62,0,1,0,1,0
7350,58638,5900,0,0,deny,62,62,0,1,0,1,0
7351,58638,5900,0,0,deny,62,62,0,1,0,1,0
7352,58638,5900,0,0,deny,62,62,0,1,0,1,0
7353,58638,5900,0,0,deny,62,62,0,1,0,1,0
7354,58638,5900,0,0,deny,62,62,0,1,0,1,0
7355,58638,5900,0,0,deny,62,62,0,1,0,1,0
7356,58638,5900,0,0,deny,62,62,0,1,0,1,0
7357,58638,5900,0,0,deny,62,62,0,1,0,1,0
7358,58638,5900,0,0,deny,62,62,0,1,0,1,0
7359,58638,5900,0,0,deny,62,62,0,1,0,1,0
7360,58638,5900,0,0,deny,62,62,0,1,0,1,0
7361,58638,5900,0,0,deny,62,62,0,1,0,1,0
7362,58638,5900,0,0,deny,62,62,0,1,0,1,0
7363,58638,5900,0,0,deny,62,62,0,1,0,1,0
7364,58638,5900,0,0,deny,62,62,0,1,0,1,0
7365,58638,5900,0,0,deny,62,62,0,1,0,1,0
7366,58638,5900,0,0,deny,62,62,0,1,0,1,0
7367,58638,5900,0,0,deny,62,62,0,1,0,1,0
7368,58638,5900,0,0,deny,62,62,0,1,0,1,0
7369,58638,5900,0,0,deny,62,62,0,1,0,1,0
7370,58638,5900,0,0,deny,62,62,0,1,0,1,0
7371,58638,5900,0,0,deny,62,62,0,1,0,1,0
7372,58638,5900,0,0,deny,62,62,0,1,0,1,0
7373,58638,5900,0,0,deny,62,62,0,1,0,1,0
7374,58638,5900,0,0,deny,62,62,0,1,0,1,0
7375,58638,5900,0,0,deny,62,62,0,1,0,1,0
7376,58638,5900,0,0,deny,62,62,0,1,0,1,0
7377,58638,5900,0,0,deny,62,62,0,1,0,1,0
7378,58638,5900,0,0,deny,62,62,0,1,0,1,0
7379,58638,5900,0,0,deny,62,62,0,1,0,1,0
7380,58638,5900,0,0,deny,62,62,0,1,0,1,0
7381,58638,5900,0,0,deny,62,62,0,1,0,1,0
7382,58638,5900,0,0,deny,62,62,0,1,0,1,0
7383,58638,5900,0,0,deny,62,62,0,1,0,1,0
7384,58638,5900,0,0,deny,62,62,0,1,0,1,0
7385,58638,5900,0,0,deny,62,62,0,1,0,1,0
7386,58638,5900,0,0,deny,62,62,0,1,0,1,0
7387,58638,5900,0,0,deny,62,62,0,1,0,1,0
7388,58638,5900,0,0,deny,62,62,0,1,0,1,0
7389,58638,5900,0,0,deny,62,62,0,1,0,1,0
7390,58638,5900,0,0,deny,62,62,0,1,0,1,0
7391,58638,5900,0,0,deny,62,62,0,1,0,1,0
7392,58638,5900,0,0,deny,62,62,0,1,0,1,0
7393,58638,5900,0,0,deny,62,62,0,1,0,1,0
7394,58638,5900,0,0,deny,62,62,0,1,0,1,0
7395,58638,5900,0,0,deny,62,62,0,1,0,1,0
7396,58638,5900,0,0,deny,62,62,0,1,0,1,0
7397,58638,5900,0,0,deny,62,62,0,1,0,1,0
7398,58638,5900,0,0,deny,62,62,0,1,0,1,0
7399,58638,5900,0,0,deny,62,62,0,1,0,1,0
7400,58638,5900,0,0,deny,62,62,0,1,0,1,0
7401,58638,5900,0,0,deny,62,62,0,1,0,1,0
7402,58638,5900,0,0,deny,62,62,0,1,0,1,0
7403,58638,5900,0,0,deny,62,62,0,1,0,1,0
7404,58638,5900,0,0,deny,62,62,0,1,0,1,0
7405,58638,5900,0,0,deny,62,62,0,1,0,1,0
7406,58638,5900,0,0,deny,62,62,0,1,0,1,0
7407,58638,5900,0,0,deny,62,62,0,1,0,1,0
7408,58638,5900,0,0,deny,62,62,0,1,0,1,0
7409,58638,5900,0,0,deny,62,62,0,1,0,1,0
7410,58638,5900,0,0,deny,62,62,0,1,0,1,0
7411,58638,5900,0,0,deny,62,62,0,1,0,1,0
7412,58638,5900,0,0,deny,62,62,0,1,0,1,0
7413,58638,5900,0,0,deny,62,62,0,1,0,1,0
7414,58638,5900,0,0,deny,62,62,0,1,0,1,0
7415,58638,5900,0,0,deny,62,62,0,1,0,1,0
7416,58638,5900,0,0,deny,62,62,0,1,0,1,0
7417,58638,5900,0,0,deny,62,62,0,1,0,1,0
7418,58638,5900,0,0,deny,62,62,0,1,0,1,0
7419,58638,5900,0,0,deny,62,62,0,1,0,1,0
7420,58638,5900,0,0,deny,62,62,0,1,0,1,0
7421,58638,5900,0,0,deny,62,62,0,1,0,1,0
7422,58638,5900,0,0,deny,62,62,0,1,0,1,0
7423,58638,5900,0,0,deny,62,62,0,1,0,1,0
7424,58638,5900,0,0,deny,62,62,0,1,0,1,0
7425,58638,5900,0,0,deny,62,62,0,1,0,1,0
7426,58638,5900,0,0,deny,62,62,0,1,0,1,0
7427,58638,5900,0,0,deny,62,62,0,1,0,1,0
7428,58638,5900,0,0,deny,62,62,0,1,0,1,0
7429,58638,5900,0,0,deny,62,62,0,1,0,1,0
7430,58638,5900,0,0,deny,62,62,0,1,0,1,0
7431,58638,5900,0,0,deny,62,62,0,1,0,1,0
7432,58638,5900,0,0,deny,62,62,0,1,0,1,0
7433,58638,5900,0,0,deny,62,62,0,1,0,1,0
7434,58638,5900,0,0,deny,62,62,0,1,0,1,0
7435,58638,5900,0,0,deny,62,62,0,1,0,1,0
7436,58638,5900,0,0,deny,62,62,0,1,0,1,0
7437,58638,5900,0,0,deny,62,62,0,1,0,1,0
7438,58638,5900,0,0,deny,62,62,0,1,0,1,0
7439,58638,5900,0,0,deny,62,62,0,1,0,1,0
7440,58638,5900,0,0,deny,62,62,0,1,0,1,0
7441,58638,5900,0,0,deny,62,62,0,1,0,1,0
7442,58638,5900,0,0,deny,62,62,0,1,0,1,0
7443,58638,5900,0,0,deny,62,62,0,1,0,1,0
7444,58638,5900,0,0,deny,62,62,0,1,0,1,0
7445,58638,5900,0,0,deny,62,62,0,1,0,1,0
7446,58638,5900,0,0,deny,62,62,0,1,0,1,0
7447,58638,5900,0,0,deny,62,62,0,1,0,1,0
7448,58638,5900,0,0,deny,62,62,0,1,0,1,0
7449,58638,5900,0,0,deny,62,62,0,1,0,1,0
7450,58638,5900,0,0,deny,62,62,0,1,0,1,0
7451,58638,5900,0,0,deny,62,62,0,1,0,1,0
7452,58638,5900,0,0,deny,62,62,0,1,0,1,0
7453,58638,5900,0,0,deny,62,62,0,1,0,1,0
7454,58638,5900,0,0,deny,62,62,0,1,0,1,0
7455,58638,5900,0,0,deny,62,62,0,1,0,1,0
7456,58638,5900,0,0,deny,62,62,0,1,0,1,0
7457,58638,5900,0,0,deny,62,62,0,1,0,1,0
7458,58638,5900,0,0,deny,62,62,0,1,0,1,0
7459,58638,5900,0,0,deny,62,62,0,1,0,1,0
7460,58638,5900,0,0,deny,62,62,0,1,0,1,0
7461,58638,5900,0,0,deny,62,62,0,1,0,1,0
7462,58638,5900,0,0,deny,62,62,0,1,0,1,0
7463,58638,5900,0,0,deny,62,62,0,1,0,1,0
7464,58638,5900,0,0,deny,62,62,0,1,0,1,0
7465,58638,5900,0,0,deny,62,62,0,1,0,1,0
7466,58638,5900,0,0,deny,62,62,0,1,0,1,0
7467,58638,5900,0,0,deny,62,62,0,1,0,1,0
7468,58638,5900,0,0,deny,62,62,0,1,0,1,0
7469,58638,5900,0,0,deny,62,62,0,1,0,1,0
7470,58638,5900,0,0,deny,62,62,0,1,0,1,0
7471,58638,5900,0,0,deny,62,62,0,1,0,1,0
7472,51993,25174,0,0,deny,66,66,0,1,0,1,0
7473,58638,5900,0,0,deny,62,62,0,1,0,1,0
7474,58638,5900,0,0,deny,62,62,0,1,0,1,0
7475,58638,5900,0,0,deny,62,62,0,1,0,1,0
7476,58638,5900,0,0,deny,62,62,0,1,0,1,0
7477,58638,5900,0,0,deny,62,62,0,1,0,1,0
7478,58638,5900,0,0,deny,62,62,0,1,0,1,0
7479,58638,5900,0,0,deny,62,62,0,1,0,1,0
7480,58638,5900,0,0,deny,62,62,0,1,0,1,0
7481,58638,5900,0,0,deny,62,62,0,1,0,1,0
7482,58638,5900,0,0,deny,62,62,0,1,0,1,0
7483,58638,5900,0,0,deny,62,62,0,1,0,1,0
7484,58638,5900,0,0,deny,62,62,0,1,0,1,0
7485,58638,5900,0,0,deny,62,62,0,1,0,1,0
7486,58638,5900,0,0,deny,62,62,0,1,0,1,0
7487,58638,5900,0,0,deny,62,62,0,1,0,1,0
7488,58638,5900,0,0,deny,62,62,0,1,0,1,0
7489,58638,5900,0,0,deny,62,62,0,1,0,1,0
7490,58638,5900,0,0,deny,62,62,0,1,0,1,0
7491,58638,5900,0,0,deny,62,62,0,1,0,1,0
7492,58638,5900,0,0,deny,62,62,0,1,0,1,0
7493,58638,5900,0,0,deny,62,62,0,1,0,1,0
7494,57928,30188,0,0,deny,62,62,0,1,0,1,0
7495,443,54507,0,0,deny,82,82,0,1,0,1,0
7496,6881,26171,65454,26171,allow,219,118,101,2,1199,1,1
7497,60493,55172,57169,55172,allow,320,140,180,6,7,3,3
7498,56345,443,39296,443,allow,39990,1989,38001,50,147,17,33
7499,53332,80,59740,80,allow,9094,5469,3625,22,166,12,10
7500,54796,443,9714,443,allow,6668,1926,4742,20,15,11,9
7501,41056,443,45681,443,allow,8185,1381,6804,22,831,11,11
7502,39293,443,5290,443,allow,70,70,0,1,4,1,0
7503,55048,80,23955,80,allow,3084,1646,1438,19,131,10,9
7504,57835,53,49650,53,allow,308,118,190,2,29,1,1
7505,57700,53,7203,53,allow,308,118,190,2,29,1,1
7506,58459,53,37044,53,allow,307,86,221,2,29,1,1
7507,56038,53,40238,53,allow,177,94,83,2,29,1,1
7508,55047,53,41022,53,allow,308,94,214,2,29,1,1
7509,52599,53,38138,53,allow,338,94,244,2,29,1,1
7510,65226,443,51904,443,allow,35968,13816,22152,77,96,34,43
7511,64945,53,47640,53,allow,292,126,166,2,29,1,1
7512,55936,53,21289,53,allow,177,94,83,2,30,1,1
7513,49658,53,2388,53,allow,195,102,93,2,30,1,1
7514,50241,53,25762,53,allow,728,102,626,2,30,1,1
7515,56334,53,34646,53,allow,177,94,83,2,30,1,1
7516,9480,443,14084,443,allow,6100,777,5323,17,25,9,8
7517,45032,53,45032,53,allow,216,82,134,2,33,1,1
7518,57665,53,28556,53,allow,168,78,90,2,30,1,1
7519,41785,443,3150,443,allow,13183,1682,11501,26,78,12,14
7520,50377,53,9572,53,allow,167,78,89,2,30,1,1
7521,35817,443,2802,443,allow,3120,1862,1258,18,15,11,7
7522,42574,53,42574,53,allow,262,106,156,2,32,1,1
7523,31176,53,31176,53,allow,414,268,146,3,32,2,1
7524,41664,53,40771,53,allow,376,78,298,2,30,1,1
7525,56334,53,19616,53,allow,177,94,83,2,30,1,1
7526,9479,443,13111,443,allow,6100,777,5323,17,25,9,8
7527,56324,53,13523,53,allow,177,94,83,2,30,1,1
7528,52182,53,34693,53,allow,199,94,105,2,30,1,1
7529,56080,443,20631,443,allow,3970,1726,2244,13,135,6,7
7530,59116,53,59116,53,allow,203,82,121,2,30,1,1
7531,62077,443,1621,443,allow,17761,7207,10554,44,46,25,19
7532,9474,443,14729,443,allow,6100,777,5323,17,26,9,8
7533,9473,443,29099,443,allow,6100,777,5323,17,26,9,8
7534,38555,443,24882,443,allow,40928,36006,4922,59,16,34,25
7535,58369,53,2783,53,allow,167,78,89,2,30,1,1
7536,50378,53,37644,53,allow,167,78,89,2,30,1,1
7537,49454,53,42230,53,allow,248,118,130,2,30,1,1
7538,56324,53,52043,53,allow,177,94,83,2,30,1,1
7539,46461,53,27823,53,allow,199,94,105,2,30,1,1
7540,57837,443,41125,443,allow,17236,1691,15545,19,146,5,14
7541,38728,53,38728,53,allow,414,268,146,3,33,2,1
7542,40865,8100,52976,8100,allow,78,78,0,1,5,1,0
7543,9475,443,36657,443,allow,4063,969,3094,16,26,9,7
7544,55710,63545,52051,63545,allow,504,318,186,8,15,5,3
7545,33641,443,2360,443,allow,15017,6951,8066,49,20,25,24
7546,65126,53,19594,53,allow,216,94,122,2,30,1,1
7547,49634,53,7065,53,allow,257,102,155,2,30,1,1
7548,58368,53,61007,53,allow,167,78,89,2,30,1,1
7549,55074,443,36824,443,allow,3143,2172,971,19,25,9,10
7550,55066,80,57629,80,allow,2554,1742,812,15,77,8,7
7551,39995,443,36730,443,allow,4160,2228,1932,25,159,13,12
7552,60416,443,11714,443,allow,4953,1111,3842,22,104,12,10
7553,53831,443,42938,443,allow,190,70,120,4,15,2,2
7554,60406,80,16333,80,allow,1370,704,666,23,105,12,11
7555,43477,443,38784,443,allow,20739,7254,13485,97,734,44,53
7556,58057,80,11789,80,allow,2708,1386,1322,23,75,12,11
7557,52002,80,36032,80,allow,546,300,246,10,24,6,4
7558,54957,53,30594,53,allow,197,102,95,2,33,1,1
7559,54036,443,30085,443,allow,43295,8391,34904,66,49,32,34
7560,53909,20545,63910,20545,allow,612,366,246,10,19,6,4
7561,41786,443,30860,443,allow,174542,9281,165261,227,78,104,123
7562,48372,8100,12918,8100,allow,78,78,0,1,5,1,0
7563,56751,80,54705,80,allow,1462,703,759,8,16,5,3
7564,9476,443,21369,443,allow,3999,905,3094,15,26,8,7
7565,64282,53,55682,53,allow,215,94,121,2,30,1,1
7566,65453,53,23093,53,allow,311,94,217,2,30,1,1
7567,51103,5223,3221,5223,allow,4968,1304,3664,26,1190,13,13
7568,60369,443,60379,443,allow,7939,955,6984,22,107,11,11
7569,55936,53,1988,53,allow,177,94,83,2,29,1,1
7570,40657,443,5933,443,allow,9869,2395,7474,36,129,20,16
7571,49757,53,24825,53,allow,212,94,118,2,29,1,1
7572,55817,53,47066,53,allow,177,94,83,2,30,1,1
7573,50677,80,32544,80,allow,3664,1440,2224,12,20,6,6
7574,56582,53,17999,53,allow,196,102,94,2,32,1,1
7575,58366,53,25101,53,allow,167,78,89,2,30,1,1
7576,60488,27615,38598,27615,allow,70,70,0,1,5,1,0
7577,60485,13314,55482,13314,allow,70,70,0,1,5,1,0
7578,58367,53,2848,53,allow,167,78,89,2,30,1,1
7579,56038,53,12140,53,allow,177,94,83,2,30,1,1
7580,44577,53,21603,53,allow,199,94,105,2,30,1,1
7581,22114,4789,50813,4789,allow,70,70,0,1,30,1,0
7582,58365,53,51432,53,allow,260,86,174,2,30,1,1
7583,57464,53,0,0,allow,86,86,0,1,30,1,0
7584,59183,53,39038,53,allow,260,86,174,2,30,1,1
7585,57470,1,59410,1,allow,132,132,0,3,1199,3,0
7586,64059,80,17237,80,allow,374,192,182,7,15,4,3
7587,60415,443,32364,443,allow,7727,2796,4931,36,104,18,18
7588,65517,443,57866,443,allow,92117,4799,87318,107,15,43,64
7589,64432,53,45233,53,allow,482,188,294,6,44,3,3
7590,46225,53,7961,53,allow,199,94,105,2,30,1,1
7591,46912,53,4234,53,allow,168,78,90,2,30,1,1
7592,51115,80,32483,80,allow,1426,930,496,10,22,7,3
7593,59328,80,59328,80,allow,24437,12718,11719,41,15,16,25
7594,64381,53,35709,53,allow,168,86,82,2,32,1,1
7595,51804,53,51804,53,allow,247,98,149,2,33,1,1
7596,49071,443,20590,443,allow,130,70,60,3,5,2,1
7597,56752,80,35742,80,allow,1462,703,759,8,16,5,3
7598,62076,443,11320,443,allow,7370,2873,4497,23,47,13,10
7599,57075,53,34299,53,allow,212,102,110,2,30,1,1
7600,60817,443,60817,443,allow,1320,685,635,14,180,7,7
7601,50156,443,23478,443,allow,6666,1682,4984,28,1157,15,13
7602,27114,53,27114,53,allow,414,268,146,3,33,2,1
7603,64994,53,18089,53,allow,216,102,114,2,30,1,1
7604,54533,443,7224,443,allow,2638,330,2308,12,135,5,7
7605,49789,53,40494,53,allow,177,94,83,2,30,1,1
7606,64690,53,18350,53,allow,338,110,228,2,30,1,1
7607,56887,53,19033,53,allow,177,94,83,2,31,1,1
7608,43732,443,60967,443,allow,5719,1339,4380,19,361,9,10
7609,8941,443,25184,443,allow,541643,15245,526398,507,416,103,404
7610,52196,25336,19782,25336,allow,316,136,180,6,6,3,3
7611,52152,58114,56068,58114,allow,70,70,0,1,5,1,0
7612,49573,443,10413,443,allow,1326,876,450,11,55,6,5
7613,49674,443,19357,443,allow,5917,1570,4347,20,53,10,10
7614,49578,443,49511,443,allow,6947,833,6114,20,54,9,11
7615,49574,443,40939,443,allow,16191,13348,2843,30,55,17,13
7616,3764,9694,0,0,deny,66,66,0,1,0,1,0
7617,16862,21247,0,0,deny,62,62,0,1,0,1,0
7618,58638,5900,0,0,deny,62,62,0,1,0,1,0
7619,58638,5900,0,0,deny,62,62,0,1,0,1,0
7620,58638,5900,0,0,deny,62,62,0,1,0,1,0
7621,58638,5900,0,0,deny,62,62,0,1,0,1,0
7622,49557,443,57017,443,allow,38022,18448,19574,53,57,27,26
7623,63427,443,12602,443,allow,15135,12791,2344,43,81,22,21
7624,62080,443,19549,443,allow,2902,1562,1340,22,46,12,10
7625,55936,53,60791,53,allow,177,94,83,2,30,1,1
7626,49227,53,48621,53,allow,718,94,624,2,30,1,1
7627,49641,443,54383,443,allow,5776,1079,4697,15,53,8,7
7628,50489,443,45489,443,allow,1268,638,630,12,17,7,5
7629,49639,443,62054,443,allow,5776,1079,4697,15,53,8,7
7630,52201,44054,14407,44054,allow,70,70,0,1,5,1,0
7631,52150,37603,63249,37603,allow,70,70,0,1,5,1,0
7632,49595,80,13926,80,allow,1285,772,513,11,53,6,5
7633,64985,53,50795,53,allow,412,97,315,4,58,2,2
7634,58638,5900,0,0,deny,62,62,0,1,0,1,0
7635,58638,5900,0,0,deny,62,62,0,1,0,1,0
7636,58638,5900,0,0,deny,62,62,0,1,0,1,0
7637,58638,5900,0,0,deny,62,62,0,1,0,1,0
7638,58638,5900,0,0,deny,62,62,0,1,0,1,0
7639,58638,5900,0,0,deny,62,62,0,1,0,1,0
7640,58638,5900,0,0,deny,62,62,0,1,0,1,0
7641,58638,5900,0,0,deny,62,62,0,1,0,1,0
7642,58638,5900,0,0,deny,62,62,0,1,0,1,0
7643,58638,5900,0,0,deny,62,62,0,1,0,1,0
7644,58638,5900,0,0,deny,62,62,0,1,0,1,0
7645,58638,5900,0,0,deny,62,62,0,1,0,1,0
7646,58638,5900,0,0,deny,62,62,0,1,0,1,0
7647,58638,5900,0,0,deny,62,62,0,1,0,1,0
7648,58638,5900,0,0,deny,62,62,0,1,0,1,0
7649,58638,5900,0,0,deny,62,62,0,1,0,1,0
7650,58638,5900,0,0,deny,62,62,0,1,0,1,0
7651,58638,5900,0,0,deny,62,62,0,1,0,1,0
7652,58638,5900,0,0,deny,62,62,0,1,0,1,0
7653,58638,5900,0,0,deny,62,62,0,1,0,1,0
7654,58638,5900,0,0,deny,62,62,0,1,0,1,0
7655,58638,5900,0,0,deny,62,62,0,1,0,1,0
7656,58638,5900,0,0,deny,62,62,0,1,0,1,0
7657,58638,5900,0,0,deny,62,62,0,1,0,1,0
7658,58638,5900,0,0,deny,62,62,0,1,0,1,0
7659,58638,5900,0,0,deny,62,62,0,1,0,1,0
7660,58638,5900,0,0,deny,62,62,0,1,0,1,0
7661,58638,5900,0,0,deny,62,62,0,1,0,1,0
7662,58638,5900,0,0,deny,62,62,0,1,0,1,0
7663,58638,5900,0,0,deny,62,62,0,1,0,1,0
7664,58638,5900,0,0,deny,62,62,0,1,0,1,0
7665,58638,5900,0,0,deny,62,62,0,1,0,1,0
7666,58638,5900,0,0,deny,62,62,0,1,0,1,0
7667,58638,5900,0,0,deny,62,62,0,1,0,1,0
7668,58638,5900,0,0,deny,62,62,0,1,0,1,0
7669,58638,5900,0,0,deny,62,62,0,1,0,1,0
7670,58638,5900,0,0,deny,62,62,0,1,0,1,0
7671,58638,5900,0,0,deny,62,62,0,1,0,1,0
7672,58638,5900,0,0,deny,62,62,0,1,0,1,0
7673,58638,5900,0,0,deny,62,62,0,1,0,1,0
7674,58638,5900,0,0,deny,62,62,0,1,0,1,0
7675,58638,5900,0,0,deny,62,62,0,1,0,1,0
7676,58638,5900,0,0,deny,62,62,0,1,0,1,0
7677,58638,5900,0,0,deny,62,62,0,1,0,1,0
7678,58638,5900,0,0,deny,62,62,0,1,0,1,0
7679,58638,5900,0,0,deny,62,62,0,1,0,1,0
7680,58638,5900,0,0,deny,62,62,0,1,0,1,0
7681,58638,5900,0,0,deny,62,62,0,1,0,1,0
7682,58638,5900,0,0,deny,62,62,0,1,0,1,0
7683,58638,5900,0,0,deny,62,62,0,1,0,1,0
7684,58638,5900,0,0,deny,62,62,0,1,0,1,0
7685,58638,5900,0,0,deny,62,62,0,1,0,1,0
7686,58638,5900,0,0,deny,62,62,0,1,0,1,0
7687,58638,5900,0,0,deny,62,62,0,1,0,1,0
7688,58638,5900,0,0,deny,62,62,0,1,0,1,0
7689,58638,5900,0,0,deny,62,62,0,1,0,1,0
7690,58638,5900,0,0,deny,62,62,0,1,0,1,0
7691,58638,5900,0,0,deny,62,62,0,1,0,1,0
7692,58638,5900,0,0,deny,62,62,0,1,0,1,0
7693,58638,5900,0,0,deny,62,62,0,1,0,1,0
7694,58638,5900,0,0,deny,62,62,0,1,0,1,0
7695,58638,5900,0,0,deny,62,62,0,1,0,1,0
7696,58638,5900,0,0,deny,62,62,0,1,0,1,0
7697,58638,5900,0,0,deny,62,62,0,1,0,1,0
7698,58638,5900,0,0,deny,62,62,0,1,0,1,0
7699,58638,5900,0,0,deny,62,62,0,1,0,1,0
7700,58638,5900,0,0,deny,62,62,0,1,0,1,0
7701,58638,5900,0,0,deny,62,62,0,1,0,1,0
7702,58638,5900,0,0,deny,62,62,0,1,0,1,0
7703,58638,5900,0,0,deny,62,62,0,1,0,1,0
7704,58638,5900,0,0,deny,62,62,0,1,0,1,0
7705,58638,5900,0,0,deny,62,62,0,1,0,1,0
7706,58638,5900,0,0,deny,62,62,0,1,0,1,0
7707,58638,5900,0,0,deny,62,62,0,1,0,1,0
7708,58638,5900,0,0,deny,62,62,0,1,0,1,0
7709,58638,5900,0,0,deny,62,62,0,1,0,1,0
7710,58638,5900,0,0,deny,62,62,0,1,0,1,0
7711,58638,5900,0,0,deny,62,62,0,1,0,1,0
7712,58638,5900,0,0,deny,62,62,0,1,0,1,0
7713,58638,5900,0,0,deny,62,62,0,1,0,1,0
7714,58638,5900,0,0,deny,62,62,0,1,0,1,0
7715,58638,5900,0,0,deny,62,62,0,1,0,1,0
7716,58638,5900,0,0,deny,62,62,0,1,0,1,0
7717,58638,5900,0,0,deny,62,62,0,1,0,1,0
7718,58638,5900,0,0,deny,62,62,0,1,0,1,0
7719,58638,5900,0,0,deny,62,62,0,1,0,1,0
7720,58638,5900,0,0,deny,62,62,0,1,0,1,0
7721,58638,5900,0,0,deny,62,62,0,1,0,1,0
7722,58638,5900,0,0,deny,62,62,0,1,0,1,0
7723,58638,5900,0,0,deny,62,62,0,1,0,1,0
7724,58638,5900,0,0,deny,62,62,0,1,0,1,0
7725,58638,5900,0,0,deny,62,62,0,1,0,1,0
7726,58638,5900,0,0,deny,62,62,0,1,0,1,0
7727,49847,23,0,0,deny,60,60,0,1,0,1,0
7728,58638,5900,0,0,deny,62,62,0,1,0,1,0
7729,58638,5900,0,0,deny,62,62,0,1,0,1,0
7730,58638,5900,0,0,deny,62,62,0,1,0,1,0
7731,49314,445,0,0,drop,66,66,0,1,0,1,0
7732,49312,445,0,0,drop,66,66,0,1,0,1,0
7733,49311,445,0,0,drop,66,66,0,1,0,1,0
7734,58638,5900,0,0,deny,62,62,0,1,0,1,0
7735,58638,5900,0,0,deny,62,62,0,1,0,1,0
7736,58638,5900,0,0,deny,62,62,0,1,0,1,0
7737,58638,5900,0,0,deny,62,62,0,1,0,1,0
7738,58638,5900,0,0,deny,62,62,0,1,0,1,0
7739,58638,5900,0,0,deny,62,62,0,1,0,1,0
7740,58638,5900,0,0,deny,62,62,0,1,0,1,0
7741,58638,5900,0,0,deny,62,62,0,1,0,1,0
7742,58638,5900,0,0,deny,62,62,0,1,0,1,0
7743,58638,5900,0,0,deny,62,62,0,1,0,1,0
7744,58638,5900,0,0,deny,62,62,0,1,0,1,0
7745,58638,5900,0,0,deny,62,62,0,1,0,1,0
7746,58638,5900,0,0,deny,62,62,0,1,0,1,0
7747,58638,5900,0,0,deny,62,62,0,1,0,1,0
7748,58638,5900,0,0,deny,62,62,0,1,0,1,0
7749,58638,5900,0,0,deny,62,62,0,1,0,1,0
7750,58638,5900,0,0,deny,62,62,0,1,0,1,0
7751,58638,5900,0,0,deny,62,62,0,1,0,1,0
7752,58638,5900,0,0,deny,62,62,0,1,0,1,0
7753,58638,5900,0,0,deny,62,62,0,1,0,1,0
7754,58638,5900,0,0,deny,62,62,0,1,0,1,0
7755,58638,5900,0,0,deny,62,62,0,1,0,1,0
7756,58638,5900,0,0,deny,62,62,0,1,0,1,0
7757,58638,5900,0,0,deny,62,62,0,1,0,1,0
7758,58638,5900,0,0,deny,62,62,0,1,0,1,0
7759,58638,5900,0,0,deny,62,62,0,1,0,1,0
7760,58638,5900,0,0,deny,62,62,0,1,0,1,0
7761,58638,5900,0,0,deny,62,62,0,1,0,1,0
7762,58638,5900,0,0,deny,62,62,0,1,0,1,0
7763,58638,5900,0,0,deny,62,62,0,1,0,1,0
7764,58638,5900,0,0,deny,62,62,0,1,0,1,0
7765,58638,5900,0,0,deny,62,62,0,1,0,1,0
7766,58638,5900,0,0,deny,62,62,0,1,0,1,0
7767,58638,5900,0,0,deny,62,62,0,1,0,1,0
7768,58638,5900,0,0,deny,62,62,0,1,0,1,0
7769,58638,5900,0,0,deny,62,62,0,1,0,1,0
7770,58638,5900,0,0,deny,62,62,0,1,0,1,0
7771,58638,5900,0,0,deny,62,62,0,1,0,1,0
7772,58638,5900,0,0,deny,62,62,0,1,0,1,0
7773,58638,5900,0,0,deny,62,62,0,1,0,1,0
7774,58638,5900,0,0,deny,62,62,0,1,0,1,0
7775,58638,5900,0,0,deny,62,62,0,1,0,1,0
7776,58638,5900,0,0,deny,62,62,0,1,0,1,0
7777,58638,5900,0,0,deny,62,62,0,1,0,1,0
7778,58638,5900,0,0,deny,62,62,0,1,0,1,0
7779,58638,5900,0,0,deny,62,62,0,1,0,1,0
7780,58638,5900,0,0,deny,62,62,0,1,0,1,0
7781,58638,5900,0,0,deny,62,62,0,1,0,1,0
7782,58638,5900,0,0,deny,62,62,0,1,0,1,0
7783,58638,5900,0,0,deny,62,62,0,1,0,1,0
7784,58638,5900,0,0,deny,62,62,0,1,0,1,0
7785,58638,5900,0,0,deny,62,62,0,1,0,1,0
7786,58638,5900,0,0,deny,62,62,0,1,0,1,0
7787,58638,5900,0,0,deny,62,62,0,1,0,1,0
7788,58638,5900,0,0,deny,62,62,0,1,0,1,0
7789,58638,5900,0,0,deny,62,62,0,1,0,1,0
7790,58638,5900,0,0,deny,62,62,0,1,0,1,0
7791,58638,5900,0,0,deny,62,62,0,1,0,1,0
7792,58638,5900,0,0,deny,62,62,0,1,0,1,0
7793,58638,5900,0,0,deny,62,62,0,1,0,1,0
7794,58638,5900,0,0,deny,62,62,0,1,0,1,0
7795,58638,5900,0,0,deny,62,62,0,1,0,1,0
7796,58638,5900,0,0,deny,62,62,0,1,0,1,0
7797,58638,5900,0,0,deny,62,62,0,1,0,1,0
7798,58638,5900,0,0,deny,62,62,0,1,0,1,0
7799,58638,5900,0,0,deny,62,62,0,1,0,1,0
7800,58638,5900,0,0,deny,62,62,0,1,0,1,0
7801,58638,5900,0,0,deny,62,62,0,1,0,1,0
7802,58638,5900,0,0,deny,62,62,0,1,0,1,0
7803,58638,5900,0,0,deny,62,62,0,1,0,1,0
7804,58638,5900,0,0,deny,62,62,0,1,0,1,0
7805,58638,5900,0,0,deny,62,62,0,1,0,1,0
7806,58638,5900,0,0,deny,62,62,0,1,0,1,0
7807,58638,5900,0,0,deny,62,62,0,1,0,1,0
7808,58638,5900,0,0,deny,62,62,0,1,0,1,0
7809,58638,5900,0,0,deny,62,62,0,1,0,1,0
7810,58638,5900,0,0,deny,62,62,0,1,0,1,0
7811,58638,5900,0,0,deny,62,62,0,1,0,1,0
7812,58638,5900,0,0,deny,62,62,0,1,0,1,0
7813,58638,5900,0,0,deny,62,62,0,1,0,1,0
7814,58638,5900,0,0,deny,62,62,0,1,0,1,0
7815,58638,5900,0,0,deny,62,62,0,1,0,1,0
7816,58638,5900,0,0,deny,62,62,0,1,0,1,0
7817,58638,5900,0,0,deny,62,62,0,1,0,1,0
7818,58638,5900,0,0,deny,62,62,0,1,0,1,0
7819,58638,5900,0,0,deny,62,62,0,1,0,1,0
7820,58638,5900,0,0,deny,62,62,0,1,0,1,0
7821,58638,5900,0,0,deny,62,62,0,1,0,1,0
7822,58638,5900,0,0,deny,62,62,0,1,0,1,0
7823,58638,5900,0,0,deny,62,62,0,1,0,1,0
7824,58638,5900,0,0,deny,62,62,0,1,0,1,0
7825,58638,5900,0,0,deny,62,62,0,1,0,1,0
7826,58638,5900,0,0,deny,62,62,0,1,0,1,0
7827,58638,5900,0,0,deny,62,62,0,1,0,1,0
7828,58638,5900,0,0,deny,62,62,0,1,0,1,0
7829,58638,5900,0,0,deny,62,62,0,1,0,1,0
7830,58638,5900,0,0,deny,62,62,0,1,0,1,0
7831,58638,5900,0,0,deny,62,62,0,1,0,1,0
7832,58638,5900,0,0,deny,62,62,0,1,0,1,0
7833,58638,5900,0,0,deny,62,62,0,1,0,1,0
7834,58638,5900,0,0,deny,62,62,0,1,0,1,0
7835,58638,5900,0,0,deny,62,62,0,1,0,1,0
7836,58638,5900,0,0,deny,62,62,0,1,0,1,0
7837,58638,5900,0,0,deny,62,62,0,1,0,1,0
7838,58638,5900,0,0,deny,62,62,0,1,0,1,0
7839,58638,5900,0,0,deny,62,62,0,1,0,1,0
7840,58638,5900,0,0,deny,62,62,0,1,0,1,0
7841,58638,5900,0,0,deny,62,62,0,1,0,1,0
7842,58638,5900,0,0,deny,62,62,0,1,0,1,0
7843,58638,5900,0,0,deny,62,62,0,1,0,1,0
7844,58638,5900,0,0,deny,62,62,0,1,0,1,0
7845,58638,5900,0,0,deny,62,62,0,1,0,1,0
7846,58638,5900,0,0,deny,62,62,0,1,0,1,0
7847,58638,5900,0,0,deny,62,62,0,1,0,1,0
7848,58638,5900,0,0,deny,62,62,0,1,0,1,0
7849,58638,5900,0,0,deny,62,62,0,1,0,1,0
7850,58638,5900,0,0,deny,62,62,0,1,0,1,0
7851,58638,5900,0,0,deny,62,62,0,1,0,1,0
7852,58638,5900,0,0,deny,62,62,0,1,0,1,0
7853,58638,5900,0,0,deny,62,62,0,1,0,1,0
7854,58638,5900,0,0,deny,62,62,0,1,0,1,0
7855,58638,5900,0,0,deny,62,62,0,1,0,1,0
7856,58638,5900,0,0,deny,62,62,0,1,0,1,0
7857,58638,5900,0,0,deny,62,62,0,1,0,1,0
7858,58638,5900,0,0,deny,62,62,0,1,0,1,0
7859,58638,5900,0,0,deny,62,62,0,1,0,1,0
7860,58638,5900,0,0,deny,62,62,0,1,0,1,0
7861,58638,5900,0,0,deny,62,62,0,1,0,1,0
7862,58638,5900,0,0,deny,62,62,0,1,0,1,0
7863,58638,5900,0,0,deny,62,62,0,1,0,1,0
7864,58638,5900,0,0,deny,62,62,0,1,0,1,0
7865,58638,5900,0,0,deny,62,62,0,1,0,1,0
7866,58638,5900,0,0,deny,62,62,0,1,0,1,0
7867,58638,5900,0,0,deny,62,62,0,1,0,1,0
7868,58638,5900,0,0,deny,62,62,0,1,0,1,0
7869,58638,5900,0,0,deny,62,62,0,1,0,1,0
7870,58638,5900,0,0,deny,62,62,0,1,0,1,0
7871,58638,5900,0,0,deny,62,62,0,1,0,1,0
7872,58638,5900,0,0,deny,62,62,0,1,0,1,0
7873,58638,5900,0,0,deny,62,62,0,1,0,1,0
7874,58638,5900,0,0,deny,62,62,0,1,0,1,0
7875,58638,5900,0,0,deny,62,62,0,1,0,1,0
7876,58638,5900,0,0,deny,62,62,0,1,0,1,0
7877,58638,5900,0,0,deny,62,62,0,1,0,1,0
7878,58638,5900,0,0,deny,62,62,0,1,0,1,0
7879,58638,5900,0,0,deny,62,62,0,1,0,1,0
7880,58638,5900,0,0,deny,62,62,0,1,0,1,0
7881,58638,5900,0,0,deny,62,62,0,1,0,1,0
7882,58638,5900,0,0,deny,62,62,0,1,0,1,0
7883,58638,5900,0,0,deny,62,62,0,1,0,1,0
7884,58638,5900,0,0,deny,62,62,0,1,0,1,0
7885,58638,5900,0,0,deny,62,62,0,1,0,1,0
7886,58638,5900,0,0,deny,62,62,0,1,0,1,0
7887,58638,5900,0,0,deny,62,62,0,1,0,1,0
7888,58638,5900,0,0,deny,62,62,0,1,0,1,0
7889,58638,5900,0,0,deny,62,62,0,1,0,1,0
7890,58638,5900,0,0,deny,62,62,0,1,0,1,0
7891,58638,5900,0,0,deny,62,62,0,1,0,1,0
7892,58638,5900,0,0,deny,62,62,0,1,0,1,0
7893,58638,5900,0,0,deny,62,62,0,1,0,1,0
7894,58638,5900,0,0,deny,62,62,0,1,0,1,0
7895,58638,5900,0,0,deny,62,62,0,1,0,1,0
7896,58638,5900,0,0,deny,62,62,0,1,0,1,0
7897,58638,5900,0,0,deny,62,62,0,1,0,1,0
7898,58638,5900,0,0,deny,62,62,0,1,0,1,0
7899,58638,5900,0,0,deny,62,62,0,1,0,1,0
7900,58638,5900,0,0,deny,62,62,0,1,0,1,0
7901,58638,5900,0,0,deny,62,62,0,1,0,1,0
7902,58638,5900,0,0,deny,62,62,0,1,0,1,0
7903,58638,5900,0,0,deny,62,62,0,1,0,1,0
7904,14656,36237,0,0,deny,66,66,0,1,0,1,0
7905,64363,22114,0,0,deny,62,62,0,1,0,1,0
7906,52236,25174,0,0,deny,66,66,0,1,0,1,0
7907,60899,25174,0,0,deny,62,62,0,1,0,1,0
7908,49197,445,0,0,drop,70,70,0,1,0,1,0
7909,58638,5900,0,0,deny,62,62,0,1,0,1,0
7910,58638,5900,0,0,deny,62,62,0,1,0,1,0
7911,58638,5900,0,0,deny,62,62,0,1,0,1,0
7912,58638,5900,0,0,deny,62,62,0,1,0,1,0
7913,58638,5900,0,0,deny,62,62,0,1,0,1,0
7914,58638,5900,0,0,deny,62,62,0,1,0,1,0
7915,58638,5900,0,0,deny,62,62,0,1,0,1,0
7916,58638,5900,0,0,deny,62,62,0,1,0,1,0
7917,58638,5900,0,0,deny,62,62,0,1,0,1,0
7918,58638,5900,0,0,deny,62,62,0,1,0,1,0
7919,58638,5900,0,0,deny,62,62,0,1,0,1,0
7920,58638,5900,0,0,deny,62,62,0,1,0,1,0
7921,58638,5900,0,0,deny,62,62,0,1,0,1,0
7922,58638,5900,0,0,deny,62,62,0,1,0,1,0
7923,58638,5900,0,0,deny,62,62,0,1,0,1,0
7924,58638,5900,0,0,deny,62,62,0,1,0,1,0
7925,58638,5900,0,0,deny,62,62,0,1,0,1,0
7926,58638,5900,0,0,deny,62,62,0,1,0,1,0
7927,43888,64147,0,0,deny,62,62,0,1,0,1,0
7928,58638,5900,0,0,deny,62,62,0,1,0,1,0
7929,58638,5900,0,0,deny,62,62,0,1,0,1,0
7930,56528,64147,0,0,deny,62,62,0,1,0,1,0
7931,49195,445,0,0,drop,70,70,0,1,0,1,0
7932,62642,25174,0,0,deny,66,66,0,1,0,1,0
7933,14333,51050,0,0,deny,62,62,0,1,0,1,0
7934,53911,445,0,0,drop,70,70,0,1,0,1,0
7935,39063,44847,0,0,deny,66,66,0,1,0,1,0
7936,28649,43890,0,0,deny,62,62,0,1,0,1,0
7937,53910,445,0,0,drop,70,70,0,1,0,1,0
7938,53902,445,0,0,drop,70,70,0,1,0,1,0
7939,53901,445,0,0,drop,70,70,0,1,0,1,0
7940,33948,50432,0,0,deny,146,146,0,1,0,1,0
7941,31066,57470,0,0,deny,74,74,0,1,0,1,0
7942,443,44138,0,0,deny,60,60,0,1,0,1,0
7943,49194,445,0,0,drop,70,70,0,1,0,1,0
7944,57236,53733,0,0,deny,66,66,0,1,0,1,0
7945,49193,445,0,0,drop,70,70,0,1,0,1,0
7946,52944,23,0,0,deny,60,60,0,1,0,1,0
7947,55155,2767,0,0,deny,62,62,0,1,0,1,0
7948,49192,445,0,0,drop,70,70,0,1,0,1,0
7949,23512,57354,0,0,deny,145,145,0,1,0,1,0
7950,11136,19910,0,0,deny,62,62,0,1,0,1,0
7951,49189,445,0,0,drop,70,70,0,1,0,1,0
7952,49190,445,0,0,drop,70,70,0,1,0,1,0
7953,8194,21247,0,0,deny,62,62,0,1,0,1,0
7954,1280,25174,0,0,deny,62,62,0,1,0,1,0
7955,22263,30188,0,0,deny,66,66,0,1,0,1,0
7956,59436,22114,0,0,deny,62,62,0,1,0,1,0
7957,49172,445,0,0,drop,70,70,0,1,0,1,0
7958,49171,445,0,0,drop,70,70,0,1,0,1,0
7959,49169,445,0,0,drop,70,70,0,1,0,1,0
7960,23079,9694,0,0,deny,62,62,0,1,0,1,0
7961,49160,445,0,0,drop,70,70,0,1,0,1,0
7962,49161,445,0,0,drop,70,70,0,1,0,1,0
7963,53892,445,0,0,drop,70,70,0,1,0,1,0
7964,53889,445,0,0,drop,70,70,0,1,0,1,0
7965,53887,445,0,0,drop,70,70,0,1,0,1,0
7966,58435,64631,0,0,deny,74,74,0,1,0,1,0
7967,1660,8696,0,0,deny,62,62,0,1,0,1,0
7968,47561,26467,0,0,deny,62,62,0,1,0,1,0
7969,37008,42707,0,0,deny,62,62,0,1,0,1,0
7970,49300,445,0,0,drop,66,66,0,1,0,1,0
7971,18173,25174,0,0,deny,66,66,0,1,0,1,0
7972,65529,445,0,0,drop,70,70,0,1,0,1,0
7973,49607,25174,0,0,deny,66,66,0,1,0,1,0
7974,7686,25174,0,0,deny,62,62,0,1,0,1,0
7975,58148,43890,0,0,deny,66,66,0,1,0,1,0
7976,53193,22,53193,22,deny,295,126,169,4,0,2,2
7977,53886,445,0,0,drop,70,70,0,1,0,1,0
7978,36419,50584,0,0,deny,62,62,0,1,0,1,0
7979,36629,23117,0,0,deny,62,62,0,1,0,1,0
7980,1117,37965,0,0,deny,62,62,0,1,0,1,0
7981,53884,445,0,0,drop,70,70,0,1,0,1,0
7982,53579,42707,0,0,deny,66,66,0,1,0,1,0
7983,57585,51221,0,0,deny,62,62,0,1,0,1,0
7984,17004,64147,0,0,deny,66,66,0,1,0,1,0
7985,40301,8696,0,0,deny,60,60,0,1,0,1,0
7986,1955,35974,0,0,deny,60,60,0,1,0,1,0
7987,17842,22114,0,0,deny,62,62,0,1,0,1,0
7988,5912,22114,0,0,deny,62,62,0,1,0,1,0
7989,49283,445,0,0,drop,66,66,0,1,0,1,0
7990,49286,445,0,0,drop,66,66,0,1,0,1,0
7991,2049,32480,0,0,deny,62,62,0,1,0,1,0
7992,59048,57470,0,0,deny,66,66,0,1,0,1,0
7993,24351,57470,0,0,deny,62,62,0,1,0,1,0
7994,65525,445,0,0,drop,70,70,0,1,0,1,0
7995,25328,23,0,0,deny,60,60,0,1,0,1,0
7996,50169,25174,0,0,deny,62,62,0,1,0,1,0
7997,49182,21247,0,0,deny,66,66,0,1,0,1,0
7998,8080,37965,0,0,deny,62,62,0,1,0,1,0
7999,4748,64147,0,0,deny,62,62,0,1,0,1,0
8000,53874,445,0,0,drop,70,70,0,1,0,1,0
8001,53867,445,0,0,drop,70,70,0,1,0,1,0
8002,53866,445,0,0,drop,70,70,0,1,0,1,0
8003,53864,445,0,0,drop,70,70,0,1,0,1,0
8004,52518,35440,0,0,deny,66,66,0,1,0,1,0
8005,24931,25174,0,0,deny,62,62,0,1,0,1,0
8006,54598,37965,0,0,deny,66,66,0,1,0,1,0
8007,65516,445,0,0,drop,70,70,0,1,0,1,0
8008,65513,445,0,0,drop,70,70,0,1,0,1,0
8009,65514,445,0,0,drop,70,70,0,1,0,1,0
8010,61948,48817,0,0,deny,145,145,0,1,0,1,0
8011,64461,31652,0,0,reset-both,62,62,0,1,0,1,0
8012,65511,445,0,0,drop,70,70,0,1,0,1,0
8013,45908,3383,0,0,deny,60,60,0,1,0,1,0
8014,65508,445,0,0,drop,70,70,0,1,0,1,0
8015,49281,445,0,0,drop,66,66,0,1,0,1,0
8016,52969,44847,0,0,deny,66,66,0,1,0,1,0
8017,49272,445,0,0,drop,66,66,0,1,0,1,0
8018,49274,445,0,0,drop,66,66,0,1,0,1,0
8019,49264,445,0,0,drop,66,66,0,1,0,1,0
8020,49269,445,0,0,drop,66,66,0,1,0,1,0
8021,49271,445,0,0,drop,66,66,0,1,0,1,0
8022,49267,445,0,0,drop,66,66,0,1,0,1,0
8023,49263,445,0,0,drop,66,66,0,1,0,1,0
8024,10380,5223,0,0,deny,148,148,0,1,0,1,0
8025,55985,44847,0,0,deny,146,146,0,1,0,1,0
8026,53860,445,0,0,drop,70,70,0,1,0,1,0
8027,53856,445,0,0,drop,70,70,0,1,0,1,0
8028,53854,445,0,0,drop,70,70,0,1,0,1,0
8029,53852,445,0,0,drop,70,70,0,1,0,1,0
8030,2864,25174,0,0,deny,66,66,0,1,0,1,0
8031,65503,445,0,0,drop,70,70,0,1,0,1,0
8032,21179,44847,0,0,deny,62,62,0,1,0,1,0
8033,13285,29892,0,0,deny,145,145,0,1,0,1,0
8034,7342,22114,0,0,deny,66,66,0,1,0,1,0
8035,23843,26467,0,0,deny,62,62,0,1,0,1,0
8036,50990,23884,0,0,deny,66,66,0,1,0,1,0
8037,35589,25174,0,0,deny,66,66,0,1,0,1,0
8038,65495,445,0,0,drop,70,70,0,1,0,1,0
8039,65493,445,0,0,drop,70,70,0,1,0,1,0
8040,53850,445,0,0,drop,70,70,0,1,0,1,0
8041,53845,445,0,0,drop,70,70,0,1,0,1,0
8042,53844,445,0,0,drop,70,70,0,1,0,1,0
8043,49256,445,0,0,drop,66,66,0,1,0,1,0
8044,53843,445,0,0,drop,70,70,0,1,0,1,0
8045,63867,35993,0,0,deny,66,66,0,1,0,1,0
8046,49254,445,0,0,drop,66,66,0,1,0,1,0
8047,62902,32468,0,0,deny,66,66,0,1,0,1,0
8048,38565,51505,0,0,deny,62,62,0,1,0,1,0
8049,49252,445,0,0,drop,66,66,0,1,0,1,0
8050,49250,445,0,0,drop,66,66,0,1,0,1,0
8051,443,4205,0,0,deny,320,320,0,1,0,1,0
8052,65489,445,0,0,drop,70,70,0,1,0,1,0
8053,12290,22114,0,0,deny,66,66,0,1,0,1,0
8054,49248,445,0,0,drop,66,66,0,1,0,1,0
8055,65487,445,0,0,drop,70,70,0,1,0,1,0
8056,28583,22114,0,0,deny,146,146,0,1,0,1,0
8057,54277,22114,0,0,deny,62,62,0,1,0,1,0
8058,65483,445,0,0,drop,70,70,0,1,0,1,0
8059,53836,445,0,0,drop,70,70,0,1,0,1,0
8060,53830,445,0,0,drop,70,70,0,1,0,1,0
8061,53827,445,0,0,drop,70,70,0,1,0,1,0
8062,65482,445,0,0,drop,70,70,0,1,0,1,0
8063,55586,23,0,0,deny,60,60,0,1,0,1,0
8064,60527,35440,0,0,deny,66,66,0,1,0,1,0
8065,9731,64147,0,0,deny,62,62,0,1,0,1,0
8066,30270,37965,0,0,deny,66,66,0,1,0,1,0
8067,14023,37965,0,0,deny,62,62,0,1,0,1,0
8068,18574,56205,0,0,deny,66,66,0,1,0,1,0
8069,49336,25174,0,0,deny,62,62,0,1,0,1,0
8070,56887,53,57938,53,allow,170,87,83,2,30,1,1
8071,36215,443,40898,443,allow,3554,2208,1346,18,256,10,8
8072,64231,443,45459,443,allow,2227,1018,1209,17,16,8,9
8073,49452,443,8798,443,allow,16012,6573,9439,43,175,20,23
8074,49353,443,32645,443,allow,7030,1195,5835,20,76,10,10
8075,49349,80,16332,80,allow,2391,532,1859,11,76,6,5
8076,50269,443,40163,443,allow,7543,2533,5010,26,55,14,12
8077,14667,80,14667,80,allow,3197,2167,1030,17,72,10,7
8078,55376,53,17927,53,allow,711,87,624,2,30,1,1
8079,43576,80,43576,80,allow,44566,6675,37891,58,23,27,31
8080,64385,443,64385,443,allow,18895,2061,16834,34,18,18,16
8081,49385,443,8821,443,allow,16316,7445,8871,49,237,23,26
8082,55660,443,55660,443,allow,51312,5706,45606,77,48,38,39
8083,57093,53,32863,53,allow,711,87,624,2,30,1,1
8084,57888,443,62185,443,allow,9802,5628,4174,56,225,29,27
8085,49351,443,50580,443,allow,11389,1184,10205,22,76,9,13
8086,61614,53,61614,53,allow,257,101,156,2,33,1,1
8087,39223,80,40485,80,allow,1052,612,440,10,15,5,5
8088,64376,443,64376,443,allow,4592,1685,2907,19,29,11,8
8089,65462,53,18628,53,allow,98,98,0,1,30,1,0
8090,54627,80,54627,80,allow,12385,1831,10554,20,20,9,11
8091,50584,49001,53256,49001,allow,480,150,330,2,1200,1,1
8092,57598,80,57598,80,allow,40484,2008,38476,47,145,17,30
8093,57594,80,57594,80,allow,110070,5374,104696,112,156,36,76
8094,55659,443,55659,443,allow,25716,7632,18084,52,48,31,21
8095,52147,30265,61743,30265,allow,66,66,0,1,5,1,0
8096,60143,443,49806,443,allow,16448,5420,11028,47,319,23,24
8097,1230,3389,1230,3389,allow,3910,1805,2105,20,19,12,8
8098,49196,53,19330,53,allow,91,91,0,1,30,1,0
8099,55646,443,13625,443,allow,11771,2624,9147,50,19,25,25
8100,64095,53,19951,53,allow,170,87,83,2,30,1,1
8101,55602,53,61633,53,allow,711,87,624,2,30,1,1
8102,57288,53,40155,53,allow,170,87,83,2,30,1,1
8103,49661,443,62284,443,allow,6950,2484,4466,20,53,11,9
8104,55054,443,36646,443,allow,7993,677,7316,16,15,8,8
8105,36336,443,11755,443,allow,8111,5060,3051,31,396,11,20
8106,38369,15000,42954,15000,allow,130,70,60,2,6,1,1
8107,52184,57262,18616,57262,allow,70,70,0,2,8,2,0
8108,55127,53,18845,53,allow,253,87,166,4,44,2,2
8109,52151,30692,49782,30692,allow,66,66,0,1,5,1,0
8110,2001,80,2001,80,allow,1535,652,883,9,16,5,4
8111,49352,443,51520,443,allow,10055,1184,8871,21,76,9,12
8112,37997,80,37997,80,allow,3581,2902,679,13,23,8,5
8113,55456,53,57964,53,allow,711,87,624,2,30,1,1
8114,56658,53,1646,53,allow,170,87,83,2,30,1,1
8115,56945,53,29864,53,allow,711,87,624,2,30,1,1
8116,55097,53,65390,53,allow,170,87,83,2,31,1,1
8117,30960,45761,37537,45761,allow,462,462,0,8,3632,8,0
8118,57170,3389,57170,3389,allow,3413,1458,1955,16,19,8,8
8119,49481,53,49481,53,allow,222,101,121,2,31,1,1
8120,55820,60038,0,0,allow,66,66,0,1,91,1,0
8121,57052,53,52166,53,allow,170,87,83,2,31,1,1
8122,30960,45760,12069,45760,allow,462,462,0,8,3632,8,0
8123,53191,443,21271,443,allow,7694,3364,4330,21,123,11,10
8124,55833,53,54382,53,allow,170,87,83,2,31,1,1
8125,65477,445,0,0,drop,70,70,0,1,0,1,0
8126,58399,56205,0,0,deny,66,66,0,1,0,1,0
8127,41719,50584,0,0,deny,146,146,0,1,0,1,0
8128,57578,51221,0,0,deny,62,62,0,1,0,1,0
8129,443,54507,0,0,deny,82,82,0,1,0,1,0
8130,49230,445,0,0,drop,66,66,0,1,0,1,0
8131,23873,30188,0,0,deny,66,66,0,1,0,1,0
8132,53815,445,0,0,drop,70,70,0,1,0,1,0
8133,58608,62413,0,0,deny,62,62,0,1,0,1,0
8134,34166,50584,0,0,deny,146,146,0,1,0,1,0
8135,23844,26467,0,0,deny,62,62,0,1,0,1,0
8136,57484,30317,0,0,deny,66,66,0,1,0,1,0
8137,44265,80,44265,80,allow,22407,7251,15156,35,23,16,19
8138,28040,443,50475,443,allow,5578,1390,4188,19,15,9,10
8139,26054,80,26054,80,allow,1798,540,1258,10,15,6,4
8140,34408,443,19414,443,allow,9649,3714,5935,47,340,24,23
8141,56658,53,51855,53,allow,177,94,83,2,30,1,1
8142,44812,443,17089,443,allow,6152,420,5732,13,120,6,7
8143,57600,80,57600,80,allow,3164,815,2349,12,144,6,6
8144,53918,24300,60964,24300,allow,1735,975,760,11,16,7,4
8145,49559,443,14886,443,allow,1332,876,456,11,56,6,5
8146,57444,443,3253,443,allow,9581,3281,6300,36,16,16,20
8147,60033,443,2482,443,allow,4223,2828,1395,23,28,13,10
8148,53214,443,52186,443,allow,526,156,370,8,14,3,5
8149,64117,53,35902,53,allow,350,94,256,2,29,1,1
8150,53227,53,11040,53,allow,78,78,0,1,29,1,0
8151,56031,53,65070,53,allow,177,94,83,2,30,1,1
8152,41688,443,15969,443,allow,626036,38764,587272,713,191,245,468
8153,49302,443,38802,443,allow,9232,3149,6083,55,40,31,24
8154,49214,80,50752,80,allow,2734,1498,1236,21,262,11,10
8155,53164,443,44686,443,allow,38442,16213,22229,67,46,30,37
8156,57599,80,57599,80,allow,60244,2829,57415,65,144,22,43
8157,60513,443,14543,443,allow,9456,1987,7469,28,30,15,13
8158,57597,80,57597,80,allow,80556,2669,77887,84,144,28,56
8159,49638,443,58989,443,allow,5776,1079,4697,15,52,8,7
8160,51123,443,33422,443,allow,6625,1673,4952,20,20,10,10
8161,49587,443,57871,443,allow,5879,870,5009,18,53,9,9
8162,49481,80,30554,80,allow,11436,5021,6415,38,126,20,18
8163,49364,443,4324,443,allow,5141,896,4245,17,69,8,9
8164,60804,40010,37467,40010,allow,316,136,180,6,5,3,3
8165,56611,53,59791,53,allow,181,94,87,2,31,1,1
8166,44984,80,44984,80,allow,7061,2943,4118,16,23,9,7
8167,49989,53,19506,53,allow,301,85,216,4,53,2,2
8168,49658,53,46008,53,allow,195,102,93,2,29,1,1
8169,55695,53,3075,53,allow,177,94,83,2,29,1,1
8170,50412,80,26565,80,allow,1524,341,1183,11,36,4,7
8171,62082,443,37456,443,allow,2826,1618,1208,21,45,12,9
8172,49572,443,30462,443,allow,7538,4953,2585,21,54,12,9
8173,49577,443,34979,443,allow,6947,833,6114,20,53,9,11
8174,49670,443,18797,443,allow,16957,6203,10754,30,52,14,16
8175,49994,53,33575,53,allow,86,86,0,1,29,1,0
8176,38710,443,50238,443,allow,89931,3417,86514,94,15,30,64
8177,56658,53,42222,53,allow,177,94,83,2,29,1,1
8178,1936,80,29393,80,allow,214,140,74,4,15,3,1
8179,65254,53,46437,53,allow,459,94,365,4,45,2,2
8180,56668,53,61814,53,allow,177,94,83,2,29,1,1
8181,64095,53,40106,53,allow,177,94,83,2,30,1,1
8182,55695,53,64745,53,allow,177,94,83,2,29,1,1
8183,57288,53,46993,53,allow,177,94,83,2,30,1,1
8184,55541,53,64093,53,allow,177,94,83,2,30,1,1
8185,21133,33447,47731,33447,allow,481,150,331,2,1199,1,1
8186,49100,80,49100,80,allow,3568,2889,679,13,23,8,5
8187,43228,443,18463,443,allow,1527,940,587,14,22,8,6
8188,52174,43106,42661,43106,allow,258,70,188,4,9,2,2
8189,52149,52188,10170,52188,allow,70,70,0,1,5,1,0
8190,55127,53,39994,53,allow,253,87,166,4,43,2,2
8191,57288,53,13037,53,allow,177,94,83,2,30,1,1
8192,49303,443,12405,443,allow,10844,5117,5727,42,17,25,17
8193,51118,80,35500,80,allow,366,240,126,7,21,5,2
8194,50272,53,50516,53,allow,168,78,90,2,30,1,1
8195,53079,80,59311,80,allow,2424,1110,1314,11,78,7,4
8196,53921,18183,42637,18183,allow,826,386,440,12,15,6,6
8197,49304,443,13306,443,allow,12436,7656,4780,41,17,23,18
8198,52148,29104,16660,29104,allow,70,70,0,1,5,1,0
8199,57375,443,64184,443,allow,130,70,60,2,15,1,1
8200,55658,443,55658,443,allow,26504,10384,16120,58,48,37,21
8201,37662,443,57596,443,allow,4428,2241,2187,19,46,11,8
8202,54260,443,6069,443,allow,5904,1876,4028,18,18,10,8
8203,64973,53,14211,53,allow,210,102,108,2,30,1,1
8204,49633,53,37557,53,allow,210,102,108,2,30,1,1
8205,49346,443,65391,443,allow,7292,950,6342,19,75,9,10
8206,56678,443,37527,443,allow,4099,2450,1649,36,2615,19,17
8207,64784,53,13638,53,allow,226,102,124,2,30,1,1
8208,57052,53,26525,53,allow,177,94,83,2,30,1,1
8209,65225,443,9124,443,allow,3350,2037,1313,25,95,14,11
8210,64095,53,56290,53,allow,177,94,83,2,30,1,1
8211,57316,53,12512,53,allow,177,94,83,2,30,1,1
8212,57316,53,3738,53,allow,177,94,83,2,30,1,1
8213,50276,53,20646,53,allow,94,94,0,1,30,1,0
8214,57288,53,40505,53,allow,177,94,83,2,30,1,1
8215,55541,53,4475,53,allow,177,94,83,2,30,1,1
8216,50418,443,31085,443,allow,4507,744,3763,17,29,7,10
8217,44307,443,62796,443,allow,92044,19483,72561,147,186,55,92
8218,55295,3389,55295,3389,allow,4365,2581,1784,20,33,11,9
8219,50643,80,56301,80,allow,5660,3544,2116,17,47,10,7
8220,38139,443,10441,443,allow,49386,4604,44782,82,32,43,39
8221,62081,443,56055,443,allow,3044,1694,1350,23,45,13,10
8222,38113,443,46610,443,allow,2849678,105912,2743766,3255,124,1284,1971
8223,49479,80,63239,80,allow,9192,4788,4404,30,126,17,13
8224,49579,443,1881,443,allow,6629,827,5802,19,53,9,10
8225,43897,443,6897,443,allow,6259,1816,4443,30,2615,16,14
8226,50486,443,7512,443,allow,1043,556,487,10,16,6,4
8227,62073,443,32648,443,allow,9559,3243,6316,28,46,16,12
8228,55600,443,16865,443,allow,11891,2141,9750,40,231,19,21
8229,62075,443,48853,443,allow,9318,3002,6316,28,46,16,12
8230,57596,80,57596,80,allow,64768,3074,61694,72,145,26,46
8231,49586,443,54181,443,allow,5879,870,5009,18,53,9,9
8232,49636,443,48846,443,allow,6158,1149,5009,17,52,9,8
8233,49657,443,3247,443,allow,6181,833,5348,19,52,9,10
8234,49588,443,55419,443,allow,5879,870,5009,18,53,9,9
8235,49656,443,39036,443,allow,6006,763,5243,17,52,8,9
8236,52910,53,52910,53,allow,414,268,146,3,32,2,1
8237,55966,443,29704,443,allow,214312,69934,144378,612,671,303,309
8238,52185,13269,32926,13269,allow,70,70,0,2,7,2,0
8239,26253,53,26253,53,allow,414,268,146,3,33,2,1
8240,52182,60769,63523,60769,allow,70,70,0,2,8,2,0
8241,52200,42430,1127,42430,allow,70,70,0,1,5,1,0
8242,52202,64241,11975,64241,allow,164,70,94,2,4,1,1
8243,52199,35549,6211,35549,allow,70,70,0,1,5,1,0
8244,49347,443,42711,443,allow,8309,949,7360,19,75,9,10
8245,52198,12727,17212,12727,allow,70,70,0,1,5,1,0
8246,51974,443,46910,443,allow,17456,7877,9579,47,49,24,23
8247,51135,80,18450,80,allow,254,128,126,5,15,3,2
8248,51120,80,28128,80,allow,366,240,126,7,21,5,2
8249,43218,443,34506,443,allow,2683108,71922,2611186,2467,150,623,1844
8250,65303,53,28109,53,allow,94,94,0,1,29,1,0
8251,38066,443,48945,443,allow,328599,275779,52820,868,342,483,385
8252,49931,53,22854,53,allow,594,196,398,6,82,3,3
8253,65068,53,6356,53,allow,336,111,225,4,29,2,2
8254,56668,53,54886,53,allow,177,94,83,2,29,1,1
8255,64036,53,37626,53,allow,692,224,468,6,49,3,3
8256,64095,53,63030,53,allow,177,94,83,2,29,1,1
8257,56334,53,1244,53,allow,177,94,83,2,29,1,1
8258,18657,53,18657,53,allow,295,90,205,2,29,1,1
8259,49434,53,25380,53,allow,183,86,97,2,29,1,1
8260,56658,53,20785,53,allow,177,94,83,2,29,1,1
8261,56031,53,4995,53,allow,177,94,83,2,29,1,1
8262,49789,53,65450,53,allow,177,94,83,2,30,1,1
8263,59829,443,54560,443,allow,948180,35714,912466,1121,119,378,743
8264,59683,443,7689,443,allow,16524,4274,12250,35,133,15,20
8265,65221,53,28071,53,allow,196,86,110,2,30,1,1
8266,65221,53,13826,53,allow,168,86,82,2,30,1,1
8267,57052,53,38641,53,allow,177,94,83,2,30,1,1
8268,61686,53,52741,53,allow,196,86,110,2,30,1,1
8269,9068,443,2083,443,allow,5045,2005,3040,14,119,7,7
8270,41906,80,41906,80,allow,127215,3221,123994,137,3685,42,95
8271,50012,53,43824,53,allow,94,94,0,1,30,1,0
8272,60340,443,5002,443,allow,6844,2441,4403,19,181,9,10
8273,52090,80,61372,80,allow,2774,703,2071,12,22,7,5
8274,43226,443,42884,443,allow,1583877,43930,1539947,1405,93,297,1108
8275,49300,443,11326,443,allow,10704,4094,6610,52,47,29,23
8276,56887,53,35999,53,allow,177,94,83,2,30,1,1
8277,56172,53,39320,53,allow,216,102,114,2,30,1,1
8278,55026,443,35367,443,allow,17336,5332,12004,33,121,18,15
8279,44847,6892,1040,6892,allow,279,161,118,3,1200,2,1
8280,30188,14038,49780,14038,allow,502,150,352,2,1200,1,1
8281,47929,80,47929,80,allow,11976,6928,5048,25,24,14,11
8282,53958,80,11138,80,allow,130,70,60,2,15,1,1
8283,52183,13503,62699,13503,allow,70,70,0,2,8,2,0
8284,51700,80,43241,80,allow,30853,2456,28397,48,78,25,23
8285,39980,443,41321,443,allow,130,70,60,2,15,1,1
8286,45418,443,36338,443,allow,137754,15176,122578,229,99,106,123
8287,55127,53,60626,53,allow,253,87,166,4,44,2,2
8288,52091,80,64640,80,allow,2825,716,2109,12,22,7,5
8289,62072,443,3018,443,allow,6095,1965,4130,26,46,15,11
8290,38065,443,63801,443,allow,911697,74083,837614,1247,343,459,788
8291,40392,443,64453,443,allow,8105,2278,5827,27,196,15,12
8292,49424,53,36639,53,allow,210,102,108,2,30,1,1
8293,56887,53,63111,53,allow,177,94,83,2,30,1,1
8294,49609,53,45961,53,allow,177,94,83,2,31,1,1
8295,49469,53,17330,53,allow,718,94,624,2,30,1,1
8296,65448,53,13119,53,allow,209,110,99,2,30,1,1
8297,58320,53,15987,53,allow,331,86,245,2,30,1,1
8298,55189,53,54191,53,allow,211,102,109,2,30,1,1
8299,55677,53,59623,53,allow,177,94,83,2,30,1,1
8300,57052,53,21671,53,allow,177,94,83,2,30,1,1
8301,56291,53,26927,53,allow,177,94,83,2,31,1,1
8302,57673,53,25100,53,allow,273,94,179,2,30,1,1
8303,60812,443,60812,443,allow,2871,1671,1200,17,179,9,8
8304,56375,53,31585,53,allow,177,94,83,2,31,1,1
8305,53202,443,37949,443,allow,6043,1568,4475,11,120,4,7
8306,56394,443,33249,443,allow,12371,1344,11027,30,3944,10,20
8307,64106,53,22227,53,allow,309,102,207,4,53,2,2
8308,49414,443,32360,443,allow,11485,3381,8104,39,124,23,16
8309,49410,443,22106,443,allow,87590,6597,80993,129,125,48,81
8310,55127,53,49558,53,allow,253,87,166,4,44,2,2
8311,45440,25,45440,25,allow,7679,1922,5757,34,17,15,19
8312,52179,14354,64270,14354,allow,70,70,0,2,8,2,0
8313,53941,53739,11665,53739,allow,70,70,0,2,8,2,0
8314,52146,18174,63624,18174,allow,70,70,0,1,5,1,0
8315,52933,443,60920,443,allow,5582,1388,4194,19,15,9,10
8316,52088,80,52684,80,allow,3442,1728,1714,15,21,9,6
8317,44943,443,56912,443,allow,16225,2078,14147,38,42,19,19
8318,55929,80,55929,80,allow,450,246,204,8,29,5,3
8319,43886,5223,33165,5223,allow,3721,1173,2548,18,257,11,7
8320,28039,443,43641,443,allow,5576,1388,4188,19,15,9,10
8321,38647,443,52794,443,allow,15266,12916,2350,42,81,24,18
8322,46683,443,34091,443,allow,416,210,206,7,28,4,3
8323,55926,80,55926,80,allow,450,246,204,8,29,5,3
8324,55927,80,55927,80,allow,450,246,204,8,29,5,3
8325,52932,443,34898,443,allow,20789,4927,15862,35,31,20,15
8326,64622,36829,0,0,deny,66,66,0,1,0,1,0
8327,21704,16933,0,0,deny,62,62,0,1,0,1,0
8328,40787,57470,0,0,deny,62,62,0,1,0,1,0
8329,49227,445,0,0,drop,66,66,0,1,0,1,0
8330,60389,16933,0,0,deny,66,66,0,1,0,1,0
8331,49220,445,0,0,drop,66,66,0,1,0,1,0
8332,1053,2310,0,0,deny,148,148,0,1,0,1,0
8333,12348,50265,0,0,deny,62,62,0,1,0,1,0
8334,65464,445,0,0,drop,70,70,0,1,0,1,0
8335,49216,445,0,0,drop,66,66,0,1,0,1,0
8336,64723,56205,0,0,deny,62,62,0,1,0,1,0
8337,56388,22114,0,0,deny,66,66,0,1,0,1,0
8338,64949,44847,0,0,deny,66,66,0,1,0,1,0
8339,65461,445,0,0,drop,70,70,0,1,0,1,0
8340,1377,44847,0,0,deny,146,146,0,1,0,1,0
8341,62149,22114,0,0,deny,66,66,0,1,0,1,0
8342,18725,35440,0,0,deny,62,62,0,1,0,1,0
8343,18725,35440,0,0,deny,146,146,0,1,0,1,0
8344,52026,26467,0,0,deny,60,60,0,1,0,1,0
8345,54633,36237,0,0,deny,66,66,0,1,0,1,0
8346,42094,35440,0,0,deny,62,62,0,1,0,1,0
8347,60571,26467,0,0,deny,62,62,0,1,0,1,0
8348,53806,445,0,0,drop,70,70,0,1,0,1,0
8349,53804,445,0,0,drop,70,70,0,1,0,1,0
8350,53803,445,0,0,drop,70,70,0,1,0,1,0
8351,49204,445,0,0,drop,66,66,0,1,0,1,0
8352,49198,445,0,0,drop,66,66,0,1,0,1,0
8353,49199,445,0,0,drop,66,66,0,1,0,1,0
8354,49201,445,0,0,drop,66,66,0,1,0,1,0
8355,49203,445,0,0,drop,66,66,0,1,0,1,0
8356,49202,445,0,0,drop,66,66,0,1,0,1,0
8357,49200,445,0,0,drop,66,66,0,1,0,1,0
8358,49196,445,0,0,drop,66,66,0,1,0,1,0
8359,65456,445,0,0,drop,70,70,0,1,0,1,0
8360,49938,57470,0,0,deny,66,66,0,1,0,1,0
8361,65455,445,0,0,drop,70,70,0,1,0,1,0
8362,62348,50584,0,0,deny,66,66,0,1,0,1,0
8363,51754,18375,0,0,deny,62,62,0,1,0,1,0
8364,2525,23,0,0,deny,60,60,0,1,0,1,0
8365,65453,445,0,0,drop,70,70,0,1,0,1,0
8366,11585,56205,0,0,deny,66,66,0,1,0,1,0
8367,50488,22114,0,0,deny,66,66,0,1,0,1,0
8368,57677,57470,0,0,deny,62,62,0,1,0,1,0
8369,55406,25174,0,0,deny,62,62,0,1,0,1,0
8370,49196,25174,0,0,deny,66,66,0,1,0,1,0
8371,1369,48817,0,0,deny,145,145,0,1,0,1,0
8372,53800,445,0,0,drop,70,70,0,1,0,1,0
8373,53801,445,0,0,drop,70,70,0,1,0,1,0
8374,53799,445,0,0,drop,70,70,0,1,0,1,0
8375,53794,445,0,0,drop,70,70,0,1,0,1,0
8376,55620,30188,0,0,deny,66,66,0,1,0,1,0
8377,4752,30188,0,0,deny,62,62,0,1,0,1,0
8378,47125,8055,0,0,deny,159,159,0,1,0,1,0
8379,64989,50265,0,0,deny,66,66,0,1,0,1,0
8380,32796,37965,0,0,deny,66,66,0,1,0,1,0
8381,32679,37965,0,0,deny,62,62,0,1,0,1,0
8382,49184,445,0,0,drop,66,66,0,1,0,1,0
8383,49182,445,0,0,drop,66,66,0,1,0,1,0
8384,49183,445,0,0,drop,66,66,0,1,0,1,0
8385,65446,445,0,0,drop,70,70,0,1,0,1,0
8386,39941,2767,0,0,deny,62,62,0,1,0,1,0
8387,65444,445,0,0,drop,70,70,0,1,0,1,0
8388,36881,56205,0,0,deny,62,62,0,1,0,1,0
8389,49393,30188,0,0,deny,62,62,0,1,0,1,0
8390,65443,445,0,0,drop,70,70,0,1,0,1,0
8391,53783,445,0,0,drop,70,70,0,1,0,1,0
8392,65442,445,0,0,drop,70,70,0,1,0,1,0
8393,65441,445,0,0,drop,70,70,0,1,0,1,0
8394,53781,445,0,0,drop,70,70,0,1,0,1,0
8395,53777,445,0,0,drop,70,70,0,1,0,1,0
8396,53776,445,0,0,drop,70,70,0,1,0,1,0
8397,443,54507,0,0,deny,82,82,0,1,0,1,0
8398,65439,445,0,0,drop,70,70,0,1,0,1,0
8399,65438,445,0,0,deny,70,70,0,1,0,1,0
8400,51046,25174,0,0,deny,66,66,0,1,0,1,0
8401,48478,49903,0,0,deny,62,62,0,1,0,1,0
8402,16979,56205,0,0,deny,66,66,0,1,0,1,0
8403,29177,44847,0,0,deny,66,66,0,1,0,1,0
8404,58751,51221,0,0,deny,62,62,0,1,0,1,0
8405,443,14591,0,0,deny,131,131,0,1,0,1,0
8406,61711,35440,0,0,deny,66,66,0,1,0,1,0
8407,443,4205,0,0,deny,320,320,0,1,0,1,0
8408,61784,49903,0,0,deny,66,66,0,1,0,1,0
8409,59326,57470,0,0,deny,74,74,0,1,0,1,0
8410,53927,443,24116,443,allow,495,421,74,4,0,3,1
8411,53923,443,32187,443,allow,499,425,74,4,0,3,1
8412,2238,22114,0,0,deny,62,62,0,1,0,1,0
8413,65423,445,0,0,drop,70,70,0,1,0,1,0
8414,65422,445,0,0,drop,70,70,0,1,0,1,0
8415,65418,445,0,0,drop,70,70,0,1,0,1,0
8416,22350,25174,0,0,deny,66,66,0,1,0,1,0
8417,65413,445,0,0,drop,70,70,0,1,0,1,0
8418,65412,445,0,0,drop,70,70,0,1,0,1,0
8419,56719,37807,0,0,deny,66,66,0,1,0,1,0
8420,61911,15503,0,0,deny,146,146,0,1,0,1,0
8421,43747,22114,0,0,deny,66,66,0,1,0,1,0
8422,53764,445,0,0,drop,70,70,0,1,0,1,0
8423,53761,445,0,0,drop,70,70,0,1,0,1,0
8424,53759,445,0,0,drop,70,70,0,1,0,1,0
8425,40301,8696,0,0,deny,60,60,0,1,0,1,0
8426,1955,35974,0,0,deny,60,60,0,1,0,1,0
8427,52596,17372,0,0,deny,66,66,0,1,0,1,0
8428,45941,23386,0,0,deny,60,60,0,1,0,1,0
8429,49172,445,0,0,drop,66,66,0,1,0,1,0
8430,24376,50584,0,0,deny,66,66,0,1,0,1,0
8431,34360,25174,0,0,deny,66,66,0,1,0,1,0
8432,58118,22114,0,0,deny,66,66,0,1,0,1,0
8433,65401,445,0,0,drop,70,70,0,1,0,1,0
8434,6832,51505,0,0,deny,62,62,0,1,0,1,0
8435,31660,35440,0,0,deny,66,66,0,1,0,1,0
8436,64811,51221,0,0,deny,66,66,0,1,0,1,0
8437,42453,17,0,0,deny,60,60,0,1,0,1,0
8438,443,54507,0,0,deny,82,82,0,1,0,1,0
8439,53758,445,0,0,drop,70,70,0,1,0,1,0
8440,53757,445,0,0,drop,70,70,0,1,0,1,0
8441,15333,60043,0,0,deny,62,62,0,1,0,1,0
8442,11692,25174,0,0,deny,66,66,0,1,0,1,0
8443,62400,35993,0,0,deny,62,62,0,1,0,1,0
8444,61911,3855,0,0,deny,146,146,0,1,0,1,0
8445,65397,445,0,0,drop,70,70,0,1,0,1,0
8446,55893,45711,0,0,deny,78,78,0,1,0,1,0
8447,49156,445,0,0,drop,66,66,0,1,0,1,0
8448,65533,445,0,0,drop,66,66,0,1,0,1,0
8449,53071,25174,0,0,deny,66,66,0,1,0,1,0
8450,3524,25174,0,0,deny,62,62,0,1,0,1,0
8451,61898,50584,0,0,deny,66,66,0,1,0,1,0
8452,38629,25174,0,0,deny,66,66,0,1,0,1,0
8453,64334,25174,0,0,deny,66,66,0,1,0,1,0
8454,65388,445,0,0,drop,70,70,0,1,0,1,0
8455,65387,445,0,0,drop,70,70,0,1,0,1,0
8456,65386,445,0,0,drop,70,70,0,1,0,1,0
8457,18577,25174,0,0,deny,62,62,0,1,0,1,0
8458,64923,25174,0,0,deny,66,66,0,1,0,1,0
8459,65382,445,0,0,drop,70,70,0,1,0,1,0
8460,53748,445,0,0,drop,70,70,0,1,0,1,0
8461,53745,445,0,0,drop,70,70,0,1,0,1,0
8462,53746,445,0,0,drop,70,70,0,1,0,1,0
8463,53737,445,0,0,drop,70,70,0,1,0,1,0
8464,60485,22114,0,0,deny,66,66,0,1,0,1,0
8465,65381,445,0,0,drop,70,70,0,1,0,1,0
8466,3765,64147,0,0,deny,66,66,0,1,0,1,0
8467,53844,22114,0,0,deny,66,66,0,1,0,1,0
8468,19068,37965,0,0,deny,62,62,0,1,0,1,0
8469,443,54507,0,0,deny,82,82,0,1,0,1,0
8470,51313,25174,0,0,deny,66,66,0,1,0,1,0
8471,65530,445,0,0,drop,66,66,0,1,0,1,0
8472,0,0,0,0,allow,480,244,236,4,0,2,2
8473,56377,51505,0,0,deny,66,66,0,1,0,1,0
8474,1594,44847,0,0,deny,62,62,0,1,0,1,0
8475,61911,1,0,0,deny,146,146,0,1,0,1,0
8476,65519,445,0,0,drop,66,66,0,1,0,1,0
8477,65522,445,0,0,drop,66,66,0,1,0,1,0
8478,65513,445,0,0,drop,66,66,0,1,0,1,0
8479,65524,445,0,0,drop,66,66,0,1,0,1,0
8480,65521,445,0,0,drop,66,66,0,1,0,1,0
8481,65515,445,0,0,drop,66,66,0,1,0,1,0
8482,65518,445,0,0,drop,66,66,0,1,0,1,0
8483,54043,36237,0,0,deny,66,66,0,1,0,1,0
8484,53730,445,0,0,drop,70,70,0,1,0,1,0
8485,443,4205,0,0,deny,320,320,0,1,0,1,0
8486,20741,64147,0,0,deny,62,62,0,1,0,1,0
8487,51414,50584,0,0,deny,62,62,0,1,0,1,0
8488,65374,445,0,0,drop,70,70,0,1,0,1,0
8489,53728,445,0,0,drop,70,70,0,1,0,1,0
8490,53724,445,0,0,drop,70,70,0,1,0,1,0
8491,53726,445,0,0,drop,70,70,0,1,0,1,0
8492,443,56513,0,0,deny,78,78,0,1,0,1,0
8493,57761,15503,0,0,deny,66,66,0,1,0,1,0
8494,3580,25174,0,0,deny,62,62,0,1,0,1,0
8495,65367,445,0,0,drop,70,70,0,1,0,1,0
8496,32701,23,0,0,deny,60,60,0,1,0,1,0
8497,65365,445,0,0,drop,70,70,0,1,0,1,0
8498,3381,44847,0,0,deny,78,78,0,1,0,1,0
8499,20619,25174,0,0,deny,62,62,0,1,0,1,0
8500,16424,55108,0,0,deny,145,145,0,1,0,1,0
8501,10627,23117,0,0,deny,66,66,0,1,0,1,0
8502,53722,445,0,0,drop,70,70,0,1,0,1,0
8503,53718,445,0,0,drop,70,70,0,1,0,1,0
8504,53717,445,0,0,drop,70,70,0,1,0,1,0
8505,39839,22114,0,0,deny,62,62,0,1,0,1,0
8506,65506,445,0,0,drop,66,66,0,1,0,1,0
8507,53715,445,0,0,drop,70,70,0,1,0,1,0
8508,65360,445,0,0,drop,70,70,0,1,0,1,0
8509,19875,30170,0,0,deny,145,145,0,1,0,1,0
8510,65503,445,0,0,drop,66,66,0,1,0,1,0
8511,10467,25174,0,0,deny,62,62,0,1,0,1,0
8512,443,54507,0,0,deny,82,82,0,1,0,1,0
8513,65359,445,0,0,drop,70,70,0,1,0,1,0
8514,65502,445,0,0,drop,66,66,0,1,0,1,0
8515,65500,445,0,0,drop,66,66,0,1,0,1,0
8516,19579,23,0,0,deny,60,60,0,1,0,1,0
8517,65499,445,0,0,drop,66,66,0,1,0,1,0
8518,12457,57866,0,0,deny,66,66,0,1,0,1,0
8519,54440,26467,0,0,deny,66,66,0,1,0,1,0
8520,8889,2917,0,0,deny,60,60,0,1,0,1,0
8521,65355,445,0,0,drop,70,70,0,1,0,1,0
8522,23519,25174,0,0,deny,62,62,0,1,0,1,0
8523,47612,5228,36863,5228,allow,2880,1648,1232,22,3602,10,12
8524,52961,5228,16793,5228,allow,1410,933,477,11,3600,6,5
8525,56951,53,51481,53,allow,250,86,164,4,31,2,2
8526,49800,53,17712,53,allow,87,87,0,1,30,1,0
8527,52006,443,14012,443,allow,2898,2047,851,19,22,11,8
8528,53932,27258,15001,27258,allow,70,70,0,2,7,2,0
8529,19302,443,26733,443,allow,2227,1018,1209,17,15,8,9
8530,57470,13613,11885,13613,allow,1577,594,983,20,1601,10,10
8531,49609,53,22044,53,allow,170,87,83,2,30,1,1
8532,47039,443,29901,443,allow,2809,1884,925,19,25,11,8
8533,53936,5915,64456,5915,allow,70,70,0,2,7,2,0
8534,62060,443,7381,443,allow,12169,4985,7184,34,52,19,15
8535,34768,443,18480,443,allow,11605,6867,4738,29,256,17,12
8536,55276,53,33496,53,allow,170,87,83,2,31,1,1
8537,55661,443,55661,443,allow,24362,8850,15512,52,47,32,20
8538,49408,443,34465,443,allow,7967,2176,5791,27,125,14,13
8539,54669,80,16041,80,allow,1148,599,549,14,318,7,7
8540,52181,1038,23058,1038,allow,70,70,0,2,8,2,0
8541,48110,443,9219,443,allow,537031,23421,513610,622,43,258,364
8542,2298,53,2298,53,allow,221,83,138,2,32,1,1
8543,27727,53,27727,53,allow,407,261,146,3,32,2,1
8544,57172,3389,57172,3389,allow,3347,1458,1889,15,18,8,7
8545,55277,53,53790,53,allow,701,88,613,2,30,1,1
8546,57880,53,57880,53,allow,231,97,134,2,30,1,1
8547,55967,53,9494,53,allow,701,88,613,2,30,1,1
8548,64381,53,43493,53,allow,168,86,82,2,31,1,1
8549,55375,53,46240,53,allow,711,87,624,2,31,1,1
8550,53912,8999,51602,8999,allow,1869,1009,860,15,18,9,6
8551,60452,443,43264,443,allow,5807,2168,3639,17,135,8,9
8552,46212,443,28562,443,allow,190,70,120,4,15,2,2
8553,50460,443,50460,443,allow,1159,668,491,11,31,6,5
8554,52709,443,18513,443,allow,266282,13744,252538,313,374,128,185
8555,50817,443,46052,443,allow,17161,1619,15542,18,153,4,14
8556,53872,443,4533,443,allow,11541,4181,7360,62,283,27,35
8557,62828,443,62828,443,allow,4604,1697,2907,19,29,11,8
8558,34477,5900,34477,5900,allow,60,60,0,1,5,1,0
8559,35924,443,41677,443,allow,4310,1640,2670,22,159,10,12
8560,56756,53,22443,53,allow,711,87,624,2,30,1,1
8561,59111,443,56216,443,allow,10912,6095,4817,28,17,15,13
8562,61508,443,13468,443,allow,215490,8471,207019,194,45,45,149
8563,61507,443,11095,443,allow,443128,10267,432861,362,45,60,302
8564,50198,443,55477,443,allow,29124,1724,27400,41,160,16,25
8565,59363,443,28293,443,allow,15860,1930,13930,37,195,14,23
8566,50478,80,50478,80,allow,2086,1637,449,10,19,6,4
8567,52173,44632,63328,44632,allow,258,70,188,4,9,2,2
8568,46211,443,37976,443,allow,190,70,120,4,16,2,2
8569,56985,53,26642,53,allow,916,86,830,2,30,1,1
8570,57220,53,51033,53,allow,701,88,613,2,30,1,1
8571,57340,53,41414,53,allow,711,87,624,2,30,1,1
8572,56375,53,7933,53,allow,170,87,83,2,30,1,1
8573,37075,48817,0,0,deny,62,62,0,1,0,1,0
8574,55973,25174,0,0,deny,62,62,0,1,0,1,0
8575,16490,25174,0,0,deny,66,66,0,1,0,1,0
8576,443,4205,0,0,deny,187,187,0,1,0,1,0
8577,12226,37965,0,0,deny,62,62,0,1,0,1,0
8578,53709,445,0,0,drop,70,70,0,1,0,1,0
8579,34932,38608,0,0,deny,62,62,0,1,0,1,0
8580,57557,64147,0,0,deny,66,66,0,1,0,1,0
8581,65354,445,0,0,drop,70,70,0,1,0,1,0
8582,49308,22114,0,0,deny,66,66,0,1,0,1,0
8583,49418,22114,0,0,deny,62,62,0,1,0,1,0
8584,53706,445,0,0,drop,70,70,0,1,0,1,0
8585,53701,445,0,0,drop,70,70,0,1,0,1,0
8586,33948,15503,0,0,deny,146,146,0,1,0,1,0
8587,28064,36237,0,0,deny,62,62,0,1,0,1,0
8588,53838,36829,0,0,deny,66,66,0,1,0,1,0
8589,65487,445,0,0,drop,66,66,0,1,0,1,0
8590,65349,445,0,0,drop,70,70,0,1,0,1,0
8591,57470,13613,29471,13613,allow,1577,594,983,20,1600,10,10
8592,49406,80,42946,80,allow,2074,1309,765,10,124,6,4
8593,50454,80,50454,80,allow,450,246,204,8,33,5,3
8594,53921,443,59413,443,allow,499,425,74,4,0,3,1
8595,53912,443,42597,443,allow,499,425,74,4,0,3,1
8596,53922,443,26654,443,allow,499,425,74,4,0,3,1
8597,53920,443,44819,443,allow,499,425,74,4,0,3,1
8598,53915,443,3997,443,allow,499,425,74,4,0,3,1
8599,53911,443,51915,443,allow,499,425,74,4,0,3,1
8600,53909,443,45501,443,allow,499,425,74,4,0,3,1
8601,53919,443,62398,443,allow,499,425,74,4,0,3,1
8602,53916,443,57375,443,allow,499,425,74,4,0,3,1
8603,53907,443,41234,443,allow,499,425,74,4,0,3,1
8604,53917,443,58017,443,allow,499,425,74,4,0,3,1
8605,53918,443,16862,443,allow,499,425,74,4,0,3,1
8606,53908,443,36300,443,allow,499,425,74,4,0,3,1
8607,53914,443,31627,443,allow,499,425,74,4,0,3,1
8608,53906,443,56748,443,allow,499,425,74,4,0,3,1
8609,53913,443,40081,443,allow,499,425,74,4,0,3,1
8610,53910,443,14287,443,allow,499,425,74,4,0,3,1
8611,53905,443,17585,443,allow,499,425,74,4,0,3,1
8612,443,4205,0,0,deny,187,187,0,1,0,1,0
8613,443,60040,0,0,deny,60,60,0,1,0,1,0
8614,26239,25174,0,0,deny,66,66,0,1,0,1,0
8615,23218,62413,0,0,deny,62,62,0,1,0,1,0
8616,20706,23718,0,0,deny,66,66,0,1,0,1,0
8617,55246,31573,0,0,deny,66,66,0,1,0,1,0
8618,65480,445,0,0,drop,66,66,0,1,0,1,0
8619,35100,11392,0,0,deny,62,62,0,1,0,1,0
8620,53687,445,0,0,drop,70,70,0,1,0,1,0
8621,37308,43890,0,0,deny,62,62,0,1,0,1,0
8622,45944,44847,0,0,deny,62,62,0,1,0,1,0
8623,50198,5529,0,0,deny,148,148,0,1,0,1,0
8624,59032,25174,0,0,deny,66,66,0,1,0,1,0
8625,15018,37965,0,0,deny,62,62,0,1,0,1,0
8626,52026,26467,0,0,deny,60,60,0,1,0,1,0
8627,65478,445,0,0,drop,66,66,0,1,0,1,0
8628,51865,61689,0,0,deny,66,66,0,1,0,1,0
8629,30181,61689,0,0,deny,62,62,0,1,0,1,0
8630,55833,53,8720,53,allow,177,94,83,2,30,1,1
8631,57271,53,1300,53,allow,228,102,126,2,30,1,1
8632,40362,443,26484,443,allow,8229,2091,6138,24,361,12,12
8633,57102,443,24363,443,allow,17207,7111,10096,44,51,23,21
8634,39353,9339,55496,9339,allow,170706,9877,160829,260,46,110,150
8635,49409,443,26346,443,allow,6574,2176,4398,28,124,14,14
8636,37664,443,11325,443,allow,3338,2337,1001,18,45,11,7
8637,52180,20121,52199,20121,allow,70,70,0,2,7,2,0
8638,52934,443,64385,443,allow,5584,1390,4194,19,14,9,10
8639,53167,22083,32129,22083,allow,70,70,0,1,4,1,0
8640,33042,443,44384,443,allow,10328,5341,4987,26,35,13,13
8641,49412,443,12912,443,allow,9266,2595,6671,35,123,18,17
8642,52178,30922,40190,30922,allow,70,70,0,2,7,2,0
8643,55097,53,14648,53,allow,177,94,83,2,29,1,1
8644,33261,443,59567,443,allow,14176,1843,12333,30,201,16,14
8645,55097,53,54198,53,allow,177,94,83,2,29,1,1
8646,50393,80,25546,80,allow,366,180,186,7,26,4,3
8647,56669,443,3032,443,allow,7458,4186,3272,24,102,14,10
8648,50391,80,6997,80,allow,300,180,120,6,26,4,2
8649,57867,27019,27516,27019,allow,468,390,78,5,30,4,1
8650,55276,53,62860,53,allow,177,94,83,2,30,1,1
8651,57350,53,14841,53,allow,177,94,83,2,30,1,1
8652,34147,53,34147,53,allow,227,106,121,2,30,1,1
8653,56273,53,48350,53,allow,197,102,95,2,33,1,1
8654,32228,53,32228,53,allow,228,90,138,2,33,1,1
8655,50395,80,11837,80,allow,487,180,307,6,26,4,2
8656,45717,80,45717,80,allow,2081,1632,449,10,19,6,4
8657,50394,80,50061,80,allow,306,180,126,6,26,4,2
8658,40358,53,40358,53,allow,414,268,146,3,32,2,1
8659,5588,5588,0,0,allow,3498,1872,1626,48,200,24,24
8660,35066,443,6201,443,allow,33823,28233,5590,84,102,47,37
8661,64898,53,64087,53,allow,487,201,286,6,39,3,3
8662,56273,53,58204,53,allow,197,102,95,2,30,1,1
8663,56375,53,41703,53,allow,177,94,83,2,30,1,1
8664,65426,80,28723,80,allow,65980,5156,60824,86,23,39,47
8665,57470,64050,27080,64050,allow,1660,677,983,20,1600,10,10
8666,57408,53,37720,53,allow,195,102,93,2,30,1,1
8667,65469,53,36424,53,allow,308,110,198,2,30,1,1
8668,57350,53,37868,53,allow,177,94,83,2,30,1,1
8669,32914,5222,62781,5222,allow,8702,4668,4034,92,626,50,42
8670,57408,53,13747,53,allow,195,102,93,2,33,1,1
8671,50392,80,28117,80,allow,306,180,126,6,26,4,2
8672,9417,443,16764,443,allow,324745,7830,316915,327,31,112,215
8673,52002,80,8270,80,allow,7480,4670,2810,47,324,30,17
8674,64758,53,44548,53,allow,311,102,209,2,30,1,1
8675,56291,53,26835,53,allow,177,94,83,2,30,1,1
8676,49609,53,44498,53,allow,177,94,83,2,30,1,1
8677,17750,6881,35389,6881,allow,150,150,0,1,1200,1,0
8678,50265,60276,27315,60276,allow,481,150,331,2,1200,1,1
8679,55893,443,18162,443,allow,6176,908,5268,17,15,8,9
8680,43674,80,1697,80,allow,13872,1244,12628,29,19,14,15
8681,52176,17572,27555,17572,allow,70,70,0,2,8,2,0
8682,56066,53,13837,53,allow,184,102,82,2,30,1,1
8683,60851,443,17568,443,allow,36974,3935,33039,56,61,27,29
8684,50396,80,52675,80,allow,487,180,307,6,26,4,2
8685,53933,20801,58007,20801,allow,70,70,0,2,7,2,0
8686,55924,80,55924,80,allow,450,246,204,8,28,5,3
8687,52143,33283,33804,33283,allow,70,70,0,1,5,1,0
8688,55925,80,55925,80,allow,450,246,204,8,28,5,3
8689,47785,443,12110,443,allow,9224,2055,7169,37,41,19,18
8690,42607,443,6741,443,allow,10221,3259,6962,36,120,18,18
8691,49413,443,21606,443,allow,7849,1104,6745,23,123,12,11
8692,55928,80,55928,80,allow,17982,2112,15870,35,28,18,17
8693,51502,443,63032,443,allow,6559,2158,4401,30,17,16,14
8694,49407,80,27843,80,allow,2408,1466,942,10,124,6,4
8695,46684,443,11949,443,allow,26724,2570,24154,52,42,26,26
8696,52175,1101,39473,1101,allow,70,70,0,2,8,2,0
8697,37661,443,23960,443,allow,3226,2225,1001,18,46,11,7
8698,52111,80,49500,80,allow,1582,866,716,11,20,7,4
8699,54101,443,19141,443,allow,4013,2840,1173,23,27,13,10
8700,49415,443,37841,443,allow,9623,3235,6388,33,118,18,15
8701,49411,443,49244,443,allow,17524,2569,14955,38,124,17,21
8702,50453,80,50453,80,allow,450,246,204,8,30,5,3
8703,64798,53,18186,53,allow,177,94,83,2,29,1,1
8704,34661,53,34661,53,allow,414,268,146,3,33,2,1
8705,56795,53,50687,53,allow,177,94,83,2,29,1,1
8706,38759,443,29453,443,allow,8057,2726,5331,27,239,13,14
8707,64798,53,6106,53,allow,177,94,83,2,29,1,1
8708,49960,53,57227,53,allow,198,94,104,2,29,1,1
8709,55677,53,14201,53,allow,177,94,83,2,29,1,1
8710,65329,53,20205,53,allow,278,102,176,2,29,1,1
8711,49215,53,25508,53,allow,214,102,112,2,30,1,1
8712,49954,53,47734,53,allow,228,110,118,2,30,1,1
8713,56795,53,22826,53,allow,177,94,83,2,30,1,1
8714,55833,53,34904,53,allow,177,94,83,2,30,1,1
8715,32813,53,32813,53,allow,414,268,146,3,33,2,1
8716,36079,53,36079,53,allow,235,90,145,2,32,1,1
8717,52144,15208,55499,15208,allow,70,70,0,1,5,1,0
8718,51169,443,52987,443,allow,21686,7655,14031,77,379,40,37
8719,33044,443,11890,443,allow,9695,5259,4436,24,35,12,12
8720,44448,443,36659,443,allow,5960,1651,4309,21,85,12,9
8721,27997,53,0,0,allow,223,86,137,2,30,1,1
8722,33583,443,54351,443,allow,479444,14906,464538,489,62,173,316
8723,55276,53,58176,53,allow,177,94,83,2,30,1,1
8724,48223,5222,8848,5222,allow,14939,1037,13902,35,579,11,24
8725,61631,443,61631,443,allow,4748,1841,2907,19,26,11,8
8726,50390,80,49086,80,allow,360,180,180,7,26,4,3
8727,49301,443,5775,443,allow,6550,1836,4714,25,46,15,10
8728,25849,53,25849,53,allow,404,259,145,3,32,2,1
8729,50485,443,22667,443,allow,6028,2012,4016,25,16,14,11
8730,56066,53,44669,53,allow,196,86,110,2,30,1,1
8731,56375,53,48204,53,allow,177,94,83,2,30,1,1
8732,56573,443,64654,443,allow,16205,6113,10092,36,110,20,16
8733,54360,443,26291,443,allow,12260,3870,8390,52,283,27,25
8734,50389,443,61820,443,allow,306,180,126,6,26,4,2
8735,10371,53,10371,53,allow,404,259,145,3,33,2,1
8736,42630,53,12099,53,allow,168,78,90,2,30,1,1
8737,60222,443,32889,443,allow,12428,5331,7097,47,32,21,26
8738,56476,53,12813,53,allow,94,94,0,1,30,1,0
8739,57163,443,53866,443,allow,4694,2454,2240,14,135,7,7
8740,62323,443,8004,443,allow,6383,2838,3545,17,135,9,8
8741,57631,443,50238,443,allow,16277,3466,12811,46,1801,22,24
8742,52171,63033,49679,63033,allow,70,70,0,2,8,2,0
8743,49722,53,53892,53,allow,873,280,593,8,80,4,4
8744,64053,47783,24062,47783,allow,70,70,0,1,5,1,0
8745,54955,53,60657,53,allow,177,94,83,2,31,1,1
8746,55939,53,41055,53,allow,177,94,83,2,30,1,1
8747,64780,53,37698,53,allow,627,224,403,6,56,3,3
8748,58900,5223,13059,5223,allow,160,86,74,2,6,1,1
8749,61408,443,17703,443,allow,9492,3543,5949,49,117,25,24
8750,60880,443,55222,443,allow,25751,2629,23122,49,49,23,26
8751,55375,53,40220,53,allow,222,102,120,2,30,1,1
8752,55833,53,32426,53,allow,177,94,83,2,30,1,1
8753,34378,443,1903,443,allow,11269403,319214,10950189,11392,382,3773,7619
8754,49246,53,17908,53,allow,177,94,83,2,30,1,1
8755,56143,53,50780,53,allow,177,94,83,2,30,1,1
8756,52231,50934,0,0,deny,62,62,0,1,0,1,0
8757,41914,443,49039,443,allow,466,392,74,4,0,3,1
8758,65336,445,0,0,drop,70,70,0,1,0,1,0
8759,17213,22114,0,0,deny,146,146,0,1,0,1,0
8760,42558,64147,0,0,deny,62,62,0,1,0,1,0
8761,65469,445,0,0,drop,66,66,0,1,0,1,0
8762,50765,22114,0,0,deny,62,62,0,1,0,1,0
8763,65463,445,0,0,drop,66,66,0,1,0,1,0
8764,65333,445,0,0,drop,70,70,0,1,0,1,0
8765,54189,64147,0,0,deny,66,66,0,1,0,1,0
8766,3875,25174,0,0,deny,62,62,0,1,0,1,0
8767,1480,12447,0,0,deny,62,62,0,1,0,1,0
8768,26921,26467,0,0,deny,62,62,0,1,0,1,0
8769,45941,23386,0,0,deny,60,60,0,1,0,1,0
8770,11030,17372,0,0,deny,62,62,0,1,0,1,0
8771,61387,43890,0,0,deny,62,62,0,1,0,1,0
8772,53532,22114,0,0,deny,62,62,0,1,0,1,0
8773,17811,23,0,0,deny,60,60,0,1,0,1,0
8774,59097,2767,0,0,deny,66,66,0,1,0,1,0
8775,65328,445,0,0,drop,70,70,0,1,0,1,0
8776,53678,445,0,0,drop,70,70,0,1,0,1,0
8777,53676,445,0,0,drop,70,70,0,1,0,1,0
8778,53674,445,0,0,drop,70,70,0,1,0,1,0
8779,65327,445,0,0,drop,70,70,0,1,0,1,0
8780,65451,445,0,0,drop,66,66,0,1,0,1,0
8781,65453,445,0,0,drop,66,66,0,1,0,1,0
8782,65448,445,0,0,drop,66,66,0,1,0,1,0
8783,65450,445,0,0,drop,66,66,0,1,0,1,0
8784,65449,445,0,0,drop,66,66,0,1,0,1,0
8785,65452,445,0,0,drop,66,66,0,1,0,1,0
8786,65447,445,0,0,drop,66,66,0,1,0,1,0
8787,43056,11119,0,0,deny,146,146,0,1,0,1,0
8788,65325,445,0,0,drop,70,70,0,1,0,1,0
8789,64727,25174,0,0,deny,66,66,0,1,0,1,0
8790,6889,9074,0,0,deny,143,143,0,1,0,1,0
8791,39380,49903,0,0,deny,146,146,0,1,0,1,0
8792,39380,46783,0,0,deny,146,146,0,1,0,1,0
8793,50311,443,61436,443,allow,466,392,74,4,0,3,1
8794,50326,46824,0,0,deny,66,66,0,1,0,1,0
8795,25889,11446,0,0,deny,62,62,0,1,0,1,0
8796,31003,10511,0,0,deny,145,145,0,1,0,1,0
8797,19270,56448,0,0,deny,78,78,0,1,0,1,0
8798,31619,51221,0,0,deny,62,62,0,1,0,1,0
8799,63690,64147,0,0,deny,66,66,0,1,0,1,0
8800,63469,64147,0,0,deny,62,62,0,1,0,1,0
8801,20487,50584,0,0,deny,66,66,0,1,0,1,0
8802,56604,17372,0,0,deny,66,66,0,1,0,1,0
8803,53672,445,0,0,drop,70,70,0,1,0,1,0
8804,53666,445,0,0,drop,70,70,0,1,0,1,0
8805,53665,445,0,0,drop,70,70,0,1,0,1,0
8806,53661,445,0,0,drop,70,70,0,1,0,1,0
8807,65318,445,0,0,drop,70,70,0,1,0,1,0
8808,32381,50584,0,0,deny,66,66,0,1,0,1,0
8809,53692,44512,0,0,deny,66,66,0,1,0,1,0
8810,65316,445,0,0,drop,70,70,0,1,0,1,0
8811,65435,445,0,0,drop,66,66,0,1,0,1,0
8812,65434,445,0,0,drop,66,66,0,1,0,1,0
8813,65433,445,0,0,drop,66,66,0,1,0,1,0
8814,56219,22114,0,0,deny,66,66,0,1,0,1,0
8815,65315,445,0,0,drop,70,70,0,1,0,1,0
8816,63873,44847,0,0,deny,66,66,0,1,0,1,0
8817,65314,445,0,0,drop,70,70,0,1,0,1,0
8818,65313,445,0,0,drop,70,70,0,1,0,1,0
8819,65216,35440,0,0,deny,66,66,0,1,0,1,0
8820,65308,445,0,0,drop,70,70,0,1,0,1,0
8821,65307,445,0,0,drop,70,70,0,1,0,1,0
8822,53654,445,0,0,drop,70,70,0,1,0,1,0
8823,40301,8696,0,0,deny,60,60,0,1,0,1,0
8824,1955,35974,0,0,deny,60,60,0,1,0,1,0
8825,55439,37965,0,0,deny,66,66,0,1,0,1,0
8826,53646,445,0,0,drop,70,70,0,1,0,1,0
8827,53644,445,0,0,drop,70,70,0,1,0,1,0
8828,53643,445,0,0,drop,70,70,0,1,0,1,0
8829,49788,1433,0,0,deny,60,60,0,1,0,1,0
8830,49788,1433,0,0,deny,60,60,0,1,0,1,0
8831,65295,445,0,0,drop,70,70,0,1,0,1,0
8832,65294,445,0,0,drop,70,70,0,1,0,1,0
8833,65291,445,0,0,drop,70,70,0,1,0,1,0
8834,4015,23117,0,0,deny,62,62,0,1,0,1,0
8835,65285,445,0,0,drop,70,70,0,1,0,1,0
8836,65284,445,0,0,drop,70,70,0,1,0,1,0
8837,56826,22114,0,0,deny,62,62,0,1,0,1,0
8838,39380,1,0,0,deny,146,146,0,1,0,1,0
8839,59782,26467,0,0,deny,62,62,0,1,0,1,0
8840,53637,445,0,0,drop,70,70,0,1,0,1,0
8841,53635,445,0,0,drop,70,70,0,1,0,1,0
8842,53633,445,0,0,drop,70,70,0,1,0,1,0
8843,54007,50265,0,0,deny,66,66,0,1,0,1,0
8844,49929,26467,0,0,deny,62,62,0,1,0,1,0
8845,55893,45711,0,0,deny,78,78,0,1,0,1,0
8846,14869,44847,0,0,deny,62,62,0,1,0,1,0
8847,65421,445,0,0,drop,66,66,0,1,0,1,0
8848,65273,445,0,0,drop,70,70,0,1,0,1,0
8849,1029,44847,0,0,deny,62,62,0,1,0,1,0
8850,59223,17500,0,0,deny,66,66,0,1,0,1,0
8851,61280,26467,0,0,deny,66,66,0,1,0,1,0
8852,59225,57587,0,0,deny,66,66,0,1,0,1,0
8853,54555,25174,0,0,deny,66,66,0,1,0,1,0
8854,60479,25174,0,0,deny,62,62,0,1,0,1,0
8855,40845,64147,0,0,deny,62,62,0,1,0,1,0
8856,39795,5900,0,0,deny,60,60,0,1,0,1,0
8857,11337,15503,0,0,deny,62,62,0,1,0,1,0
8858,58421,30188,0,0,deny,66,66,0,1,0,1,0
8859,53629,445,0,0,drop,70,70,0,1,0,1,0
8860,56909,50584,0,0,deny,66,66,0,1,0,1,0
8861,64295,26467,0,0,deny,62,62,0,1,0,1,0
8862,41885,25174,0,0,deny,66,66,0,1,0,1,0
8863,8560,50584,0,0,deny,66,66,0,1,0,1,0
8864,0,0,0,0,deny,70,70,0,1,0,1,0
8865,53626,445,0,0,drop,70,70,0,1,0,1,0
8866,55587,43890,0,0,deny,62,62,0,1,0,1,0
8867,65268,445,0,0,drop,70,70,0,1,0,1,0
8868,64016,25174,0,0,deny,62,62,0,1,0,1,0
8869,65407,445,0,0,drop,66,66,0,1,0,1,0
8870,65403,445,0,0,drop,66,66,0,1,0,1,0
8871,56614,25174,0,0,deny,66,66,0,1,0,1,0
8872,65260,445,0,0,drop,70,70,0,1,0,1,0
8873,65258,445,0,0,drop,70,70,0,1,0,1,0
8874,65257,445,0,0,drop,70,70,0,1,0,1,0
8875,50052,65008,0,0,deny,60,60,0,1,0,1,0
8876,65255,445,0,0,drop,70,70,0,1,0,1,0
8877,39809,23,0,0,deny,60,60,0,1,0,1,0
8878,65252,445,0,0,drop,70,70,0,1,0,1,0
8879,64882,43890,0,0,deny,66,66,0,1,0,1,0
8880,62197,22114,0,0,deny,66,66,0,1,0,1,0
8881,49531,26467,0,0,deny,66,66,0,1,0,1,0
8882,53614,445,0,0,drop,70,70,0,1,0,1,0
8883,53608,445,0,0,drop,70,70,0,1,0,1,0
8884,50974,11392,0,0,deny,66,66,0,1,0,1,0
8885,53611,445,0,0,drop,70,70,0,1,0,1,0
8886,53609,445,0,0,drop,70,70,0,1,0,1,0
8887,52604,25174,0,0,deny,66,66,0,1,0,1,0
8888,30542,25174,0,0,deny,62,62,0,1,0,1,0
8889,51533,44847,0,0,deny,66,66,0,1,0,1,0
8890,65401,445,0,0,drop,66,66,0,1,0,1,0
8891,4232,50584,0,0,deny,62,62,0,1,0,1,0
8892,52280,44847,0,0,deny,66,66,0,1,0,1,0
8893,52929,43890,0,0,deny,66,66,0,1,0,1,0
8894,65394,445,0,0,drop,66,66,0,1,0,1,0
8895,65392,445,0,0,drop,66,66,0,1,0,1,0
8896,65393,445,0,0,drop,66,66,0,1,0,1,0
8897,65396,445,0,0,drop,66,66,0,1,0,1,0
8898,65388,445,0,0,drop,66,66,0,1,0,1,0
8899,65389,445,0,0,drop,66,66,0,1,0,1,0
8900,65386,445,0,0,drop,66,66,0,1,0,1,0
8901,65247,445,0,0,drop,70,70,0,1,0,1,0
8902,44414,23718,0,0,deny,66,66,0,1,0,1,0
8903,53602,445,0,0,drop,70,70,0,1,0,1,0
8904,25276,50584,0,0,deny,146,146,0,1,0,1,0
8905,64870,65473,0,0,deny,148,148,0,1,0,1,0
8906,5826,26467,0,0,deny,62,62,0,1,0,1,0
8907,53599,445,0,0,drop,70,70,0,1,0,1,0
8908,53597,445,0,0,drop,70,70,0,1,0,1,0
8909,53595,445,0,0,drop,70,70,0,1,0,1,0
8910,1024,44847,0,0,deny,146,146,0,1,0,1,0
8911,53161,51221,0,0,deny,66,66,0,1,0,1,0
8912,48071,25174,0,0,deny,146,146,0,1,0,1,0
8913,58049,50265,0,0,deny,145,145,0,1,0,1,0
8914,65239,445,0,0,drop,70,70,0,1,0,1,0
8915,58007,62413,0,0,deny,62,62,0,1,0,1,0
8916,65236,445,0,0,drop,70,70,0,1,0,1,0
8917,33973,50265,0,0,deny,62,62,0,1,0,1,0
8918,56400,35440,0,0,deny,66,66,0,1,0,1,0
8919,48839,37807,0,0,deny,62,62,0,1,0,1,0
8920,43563,443,50861,443,allow,466,392,74,4,0,3,1
8921,52169,59681,50827,59681,allow,70,70,0,2,8,2,0
8922,55037,443,53217,443,allow,13372,3722,9650,37,47,21,16
8923,52010,80,6411,80,allow,1327,822,505,11,21,7,4
8924,55715,34309,29460,34309,allow,260,140,120,5,8,3,2
8925,55133,53,7400,53,allow,711,87,624,2,30,1,1
8926,55647,53,47322,53,allow,711,87,624,2,30,1,1
8927,33498,25,33498,25,allow,7825,2062,5763,36,17,17,19
8928,64051,19548,23106,19548,allow,66,66,0,1,5,1,0
8929,18485,81,18485,81,allow,146,60,86,2,10,1,1
8930,55708,22094,3066,22094,allow,564,318,246,9,15,5,4
8931,6881,8229,31730,8229,allow,150,150,0,1,1200,1,0
8932,56893,53,37100,53,allow,170,87,83,2,31,1,1
8933,57150,53,24486,53,allow,170,87,83,2,30,1,1
8934,59957,25,59957,25,allow,1721,681,1040,22,17,10,12
8935,37593,443,32259,443,allow,21234,9602,11632,48,70,28,20
8936,49275,7000,49275,7000,allow,2163,676,1487,14,15,7,7
8937,52170,45144,16828,45144,allow,70,70,0,2,8,2,0
8938,52142,54954,48530,54954,allow,66,66,0,1,5,1,0
8939,47903,443,31427,443,allow,9323,2192,7131,25,25,13,12
8940,40379,53,38675,53,allow,168,78,90,2,30,1,1
8941,51859,7700,19893,7700,allow,8425,6015,2410,73,34,37,36
8942,64056,51266,3673,51266,allow,66,66,0,1,5,1,0
8943,50428,443,6305,443,allow,4356,806,3550,14,15,7,7
8944,55496,80,55496,80,allow,124,60,64,2,5,1,1
8945,56217,53,65360,53,allow,711,87,624,2,30,1,1
8946,55259,443,24007,443,allow,4523,3044,1479,17,64,10,7
8947,64279,53,15836,53,allow,170,87,83,2,30,1,1
8948,56597,53,51184,53,allow,711,87,624,2,30,1,1
8949,56998,53,18836,53,allow,711,87,624,2,30,1,1
8950,55757,53,46754,53,allow,170,87,83,2,30,1,1
8951,54955,53,57414,53,allow,170,87,83,2,30,1,1
8952,26900,27017,56455,27017,allow,926,410,516,12,31,6,6
8953,36812,53,60347,53,allow,168,78,90,2,31,1,1
8954,57192,53,34742,53,allow,170,87,83,2,31,1,1
8955,45189,443,22726,443,allow,10789,5723,5066,36,136,17,19
8956,56924,53,50260,53,allow,170,87,83,2,31,1,1
8957,49985,53,61904,53,allow,312,90,222,2,31,1,1
8958,56075,443,56807,443,allow,5640,3241,2399,22,120,11,11
8959,43747,22114,0,0,deny,62,62,0,1,0,1,0
8960,60645,35440,0,0,deny,66,66,0,1,0,1,0
8961,48978,25174,0,0,deny,62,62,0,1,0,1,0
8962,53591,445,0,0,drop,70,70,0,1,0,1,0
8963,53589,445,0,0,drop,70,70,0,1,0,1,0
8964,53588,445,0,0,drop,70,70,0,1,0,1,0
8965,65233,445,0,0,drop,70,70,0,1,0,1,0
8966,9327,57470,0,0,deny,62,62,0,1,0,1,0
8967,65377,445,0,0,drop,66,66,0,1,0,1,0
8968,65231,445,0,0,drop,70,70,0,1,0,1,0
8969,53586,445,0,0,drop,70,70,0,1,0,1,0
8970,9226,57470,0,0,deny,66,66,0,1,0,1,0
8971,45941,23386,0,0,deny,60,60,0,1,0,1,0
8972,18517,31652,0,0,reset-both,62,62,0,1,0,1,0
8973,65376,445,0,0,drop,66,66,0,1,0,1,0
8974,65374,445,0,0,drop,66,66,0,1,0,1,0
8975,65373,445,0,0,drop,66,66,0,1,0,1,0
8976,61785,64147,0,0,deny,66,66,0,1,0,1,0
8977,36369,443,28864,443,allow,4039,2616,1423,24,45,14,10
8978,52172,7353,52329,7353,allow,70,70,0,2,7,2,0
8979,60881,443,30566,443,allow,8284,1577,6707,29,48,14,15
8980,49246,53,4565,53,allow,177,94,83,2,30,1,1
8981,56143,53,46074,53,allow,177,94,83,2,30,1,1
8982,54340,443,58977,443,allow,79305,3202,76103,98,347,32,66
8983,38160,443,10215,443,allow,8185,2274,5911,18,135,8,10
8984,57470,51413,33371,51413,allow,460,150,310,2,1199,1,1
8985,37965,10909,61398,10909,allow,844,152,692,4,1199,2,2
8986,55588,53,19559,53,allow,168,86,82,2,30,1,1
8987,36379,443,4482,443,allow,4041,2623,1418,22,94,12,10
8988,14247,53,14247,53,allow,197,90,107,2,30,1,1
8989,56086,443,37563,443,allow,7535,1003,6532,24,304,7,17
8990,57040,443,58515,443,allow,59451,47894,11557,177,91,99,78
8991,9462,443,5144,443,allow,4717,2929,1788,23,26,13,10
8992,9401,443,34975,443,allow,7135,1346,5789,21,32,10,11
8993,53943,40534,14905,40534,allow,320,140,180,6,5,3,3
8994,49392,80,13895,80,allow,156587,46628,109959,307,314,203,104
8995,49227,2710,25043,2710,allow,70,70,0,1,5,1,0
8996,50589,443,28626,443,allow,10257,6305,3952,31,134,19,12
8997,49274,53,43421,53,allow,212,102,110,2,29,1,1
8998,55276,53,25720,53,allow,177,94,83,2,29,1,1
8999,55757,53,24073,53,allow,177,94,83,2,30,1,1
9000,64279,53,29219,53,allow,177,94,83,2,29,1,1
9001,55718,16805,42718,16805,allow,70,70,0,2,8,2,0
9002,65023,53,34897,53,allow,587,104,483,4,40,2,2
9003,49226,443,24983,443,allow,532687,14365,518322,560,20,211,349
9004,32911,443,37831,443,allow,970703,43045,927658,1244,141,563,681
9005,26900,27017,54890,27017,allow,758,328,430,10,30,5,5
9006,33045,443,23219,443,allow,4446,1298,3148,15,34,8,7
9007,50636,80,12150,80,allow,16521,6496,10025,31,49,16,15
9008,65082,53,42896,53,allow,305,94,211,4,35,2,2
9009,53914,44209,7956,44209,allow,1729,985,744,16,16,9,7
9010,55605,53,59793,53,allow,198,102,96,2,33,1,1
9011,55646,53,7208,53,allow,216,94,122,2,30,1,1
9012,60227,443,25151,443,allow,6553,871,5682,19,45,9,10
9013,64381,53,44937,53,allow,952,291,661,8,68,4,4
9014,55605,53,59160,53,allow,198,102,96,2,30,1,1
9015,49905,443,37995,443,allow,798502,33164,765338,927,103,379,548
9016,65177,53,43720,53,allow,258,110,148,2,30,1,1
9017,55601,53,58800,53,allow,177,94,83,2,30,1,1
9018,21447,53,34557,53,allow,80280,68084,12196,889,90,816,73
9019,59182,53,44334,53,allow,260,86,174,2,30,1,1
9020,63970,53,19074,53,allow,228,110,118,2,30,1,1
9021,57150,53,64897,53,allow,177,94,83,2,30,1,1
9022,56566,53,0,0,allow,86,86,0,1,30,1,0
9023,55584,53,28071,53,allow,177,94,83,2,30,1,1
9024,11491,53,11491,53,allow,247,98,149,2,32,1,1
9025,51976,443,42576,443,allow,2466,1497,969,21,46,12,9
9026,56467,80,52250,80,allow,22601,1621,20980,35,142,18,17
9027,65226,53,19267,53,allow,79,79,0,2,34,2,0
9028,58760,443,41927,443,allow,45482,2178,43304,56,15,22,34
9029,51975,443,30656,443,allow,4692,2376,2316,30,47,16,14
9030,40457,443,34174,443,allow,5630,3451,2179,39,67,20,19
9031,60878,443,39667,443,allow,31315,6036,25279,65,49,32,33
9032,60879,443,57510,443,allow,15774,5540,10234,48,48,26,22
9033,52003,80,10916,80,allow,7464,4661,2803,47,323,30,17
9034,60702,443,49529,443,allow,13618,5262,8356,54,101,26,28
9035,53934,48339,61953,48339,allow,320,140,180,6,6,3,3
9036,40510,1488,40510,1488,allow,156,156,0,3,7,3,0
9037,50591,443,54685,443,allow,5611,3452,2159,22,133,13,9
9038,52168,62118,2887,62118,allow,70,70,0,2,8,2,0
9039,58046,80,28676,80,allow,2306,1112,1194,23,76,12,11
9040,51977,443,5724,443,allow,2497,1528,969,22,46,13,9
9041,58014,443,11079,443,allow,5528,3392,2136,31,80,16,15
9042,51635,80,51635,80,allow,699944,13137,686807,676,20,195,481
9043,51113,80,51632,80,allow,1948,1092,856,10,20,7,3
9044,32909,443,28727,443,allow,160821,7879,152942,201,141,88,113
9045,53942,28921,35066,28921,allow,320,140,180,6,6,3,3
9046,42226,53,42226,53,allow,259,114,145,2,29,1,1
9047,40355,443,8929,443,allow,15367456,244322,15123134,12866,268,1819,11047
9048,49609,53,20657,53,allow,177,94,83,2,29,1,1
9049,55939,53,47586,53,allow,177,94,83,2,29,1,1
9050,64055,45105,31145,45105,allow,70,70,0,1,4,1,0
9051,54955,53,54702,53,allow,177,94,83,2,29,1,1
9052,50214,53,15199,53,allow,718,94,624,2,29,1,1
9053,56951,53,31366,53,allow,168,86,82,2,29,1,1
9054,65456,53,31398,53,allow,364,102,262,2,29,1,1
9055,56808,53,18042,53,allow,180,94,86,2,35,1,1
9056,55013,53,63318,53,allow,728,102,626,2,29,1,1
9057,56951,53,44679,53,allow,168,86,82,2,29,1,1
9058,52087,80,10358,80,allow,2757,648,2109,12,23,7,5
9059,63419,53,63419,53,allow,216,90,126,2,30,1,1
9060,32910,443,36297,443,allow,2299332,50663,2248669,2117,141,553,1564
9061,55959,53,27240,53,allow,216,102,114,2,29,1,1
9062,50021,53,13540,53,allow,821,102,719,2,30,1,1
9063,56951,53,25030,53,allow,168,86,82,2,29,1,1
9064,56893,53,21610,53,allow,177,94,83,2,30,1,1
9065,64279,53,42792,53,allow,177,94,83,2,30,1,1
9066,57395,53,57395,53,allow,208,82,126,2,30,1,1
9067,55757,53,45063,53,allow,177,94,83,2,30,1,1
9068,54955,53,32337,53,allow,177,94,83,2,30,1,1
9069,47548,53,51360,53,allow,168,78,90,2,30,1,1
9070,64951,53,50176,53,allow,402,118,284,2,30,1,1
9071,57150,53,36180,53,allow,177,94,83,2,30,1,1
9072,64783,53,10599,53,allow,214,94,120,2,30,1,1
9073,51112,80,46143,80,allow,2433,1280,1153,11,20,7,4
9074,58920,80,59955,80,allow,318,192,126,6,37,4,2
9075,52140,53155,46318,53155,allow,70,70,0,1,5,1,0
9076,50684,80,50889,80,allow,1658,1247,411,8,15,5,3
9077,50674,443,55479,443,allow,8709,1708,7001,22,19,11,11
9078,32908,443,31863,443,allow,1780845,46018,1734827,1751,141,546,1205
9079,58153,443,33248,443,allow,12215,7275,4940,26,26,16,10
9080,49472,53,52589,53,allow,209,102,107,2,30,1,1
9081,55778,53,1773,53,allow,94,94,0,1,30,1,0
9082,50284,53,6888,53,allow,168,78,90,2,30,1,1
9083,21954,53,21954,53,allow,220,90,130,2,30,1,1
9084,41348,53,0,0,allow,86,86,0,1,30,1,0
9085,55719,13302,11300,13302,allow,70,70,0,2,8,2,0
9086,55720,51610,62012,51610,allow,70,70,0,2,8,2,0
9087,60401,80,25195,80,allow,190,64,126,4,103,2,2
9088,34388,443,29047,443,allow,7002,1252,5750,28,258,15,13
9089,64279,53,4406,53,allow,177,94,83,2,30,1,1
9090,56893,53,56270,53,allow,177,94,83,2,30,1,1
9091,55757,53,50237,53,allow,177,94,83,2,30,1,1
9092,36058,443,41067,443,allow,11769,1894,9875,27,99,13,14
9093,49299,443,14634,443,allow,6681,1950,4731,24,45,14,10
9094,52097,80,35130,80,allow,1621,896,725,11,19,7,4
9095,37435,53,37435,53,allow,414,268,146,3,32,2,1
9096,55717,13517,61965,13517,allow,70,70,0,2,8,2,0
9097,60066,80,60066,80,allow,355862,9048,346814,358,163,116,242
9098,48713,80,15220,80,allow,3588672,75353,3513319,3500,154,1175,2325
9099,56716,80,53461,80,allow,3742344,115431,3626913,3995,79,1382,2613
9100,32928,443,19319,443,allow,1527,940,587,14,90,8,6
9101,55601,53,28384,53,allow,177,94,83,2,30,1,1
9102,57385,53,16664,53,allow,177,94,83,2,30,1,1
9103,55588,53,33228,53,allow,168,86,82,2,30,1,1
9104,44351,53,3058,53,allow,168,78,90,2,30,1,1
9105,55067,53,26485,53,allow,178,94,84,2,31,1,1
9106,56924,53,38205,53,allow,177,94,83,2,31,1,1
9107,55257,80,57672,80,allow,3564,1625,1939,12,131,6,6
9108,65227,53,53714,53,allow,180,86,94,2,30,1,1
9109,51551,53,57627,53,allow,304,86,218,2,30,1,1
9110,57385,53,42061,53,allow,177,94,83,2,30,1,1
9111,55921,53,32858,53,allow,177,94,83,2,30,1,1
9112,26900,27017,37818,27017,allow,422,164,258,6,30,3,3
9113,64573,443,4149,443,allow,4158,2117,2041,11,120,6,5
9114,49160,61365,56372,61365,allow,502,150,352,3,1200,2,1
9115,55859,443,4096,443,allow,399086,26649,372437,488,462,156,332
9116,50265,27813,47510,27813,allow,198,198,0,4,1200,4,0
9117,34960,443,12324,443,allow,190,70,120,4,15,2,2
9118,50302,443,11942,443,allow,11313,2617,8696,27,47,15,12
9119,38323,443,27893,443,allow,130,70,60,2,15,1,1
9120,54957,53,54042,53,allow,197,102,95,2,35,1,1
9121,59788,443,27023,443,allow,248845,14935,233910,308,49,148,160
9122,57007,80,33678,80,allow,214,140,74,4,31,3,1
9123,57008,80,59299,80,allow,214,140,74,4,31,3,1
9124,57012,80,14292,80,allow,214,140,74,4,31,3,1
9125,55067,53,40121,53,allow,178,94,84,2,30,1,1
9126,39915,443,23556,443,allow,27886,17603,10283,138,462,76,62
9127,57015,80,24329,80,allow,214,140,74,4,31,3,1
9128,57909,80,13139,80,allow,6510,1210,5300,15,18,8,7
9129,26900,27017,15895,27017,allow,254,82,172,4,30,2,2
9130,56893,53,50861,53,allow,177,94,83,2,30,1,1
9131,65152,53,13700,53,allow,177,94,83,2,30,1,1
9132,55498,53,32880,53,allow,177,94,83,2,31,1,1
9133,60802,40010,3447,40010,allow,316,136,180,6,6,3,3
9134,52167,61948,12539,61948,allow,70,70,0,2,8,2,0
9135,52001,80,32528,80,allow,7578,4652,2926,49,323,30,19
9136,14752,53,14752,53,allow,229,98,131,2,30,1,1
9137,13020,26467,0,0,deny,66,66,0,1,0,1,0
9138,9745,26467,0,0,deny,62,62,0,1,0,1,0
9139,31130,30188,0,0,deny,66,66,0,1,0,1,0
9140,65371,445,0,0,drop,66,66,0,1,0,1,0
9141,65227,445,0,0,drop,70,70,0,1,0,1,0
9142,65226,445,0,0,drop,70,70,0,1,0,1,0
9143,54816,35440,0,0,deny,62,62,0,1,0,1,0
9144,49923,443,51816,443,allow,466,392,74,4,1,3,1
9145,65332,56205,0,0,deny,66,66,0,1,0,1,0
9146,53580,445,0,0,drop,70,70,0,1,0,1,0
9147,1043,30170,0,0,deny,159,159,0,1,0,1,0
9148,54816,35440,0,0,deny,146,146,0,1,0,1,0
9149,53573,445,0,0,drop,70,70,0,1,0,1,0
9150,53571,445,0,0,drop,70,70,0,1,0,1,0
9151,10390,26467,0,0,deny,66,66,0,1,0,1,0
9152,65221,445,0,0,drop,70,70,0,1,0,1,0
9153,65360,445,0,0,drop,66,66,0,1,0,1,0
9154,51430,25174,0,0,deny,62,62,0,1,0,1,0
9155,57550,50584,0,0,deny,62,62,0,1,0,1,0
9156,19594,23117,0,0,deny,62,62,0,1,0,1,0
9157,52236,25174,0,0,deny,66,66,0,1,0,1,0
9158,33814,22114,0,0,deny,62,62,0,1,0,1,0
9159,59874,22114,0,0,deny,66,66,0,1,0,1,0
9160,57985,26467,0,0,deny,62,62,0,1,0,1,0
9161,65352,445,0,0,drop,66,66,0,1,0,1,0
9162,53559,445,0,0,drop,70,70,0,1,0,1,0
9163,65349,445,0,0,drop,66,66,0,1,0,1,0
9164,20682,57470,0,0,deny,62,62,0,1,0,1,0
9165,65208,445,0,0,drop,70,70,0,1,0,1,0
9166,50052,65010,0,0,deny,60,60,0,1,0,1,0
9167,62642,25174,0,0,deny,66,66,0,1,0,1,0
9168,8194,21247,0,0,deny,62,62,0,1,0,1,0
9169,4545,1900,0,0,deny,136,136,0,1,0,1,0
9170,1865,25174,0,0,deny,146,146,0,1,0,1,0
9171,65205,445,0,0,drop,70,70,0,1,0,1,0
9172,65342,445,0,0,drop,66,66,0,1,0,1,0
9173,27046,51505,0,0,deny,66,66,0,1,0,1,0
9174,22263,30188,0,0,deny,66,66,0,1,0,1,0
9175,65335,445,0,0,drop,66,66,0,1,0,1,0
9176,23079,9694,0,0,deny,62,62,0,1,0,1,0
9177,26698,25174,0,0,deny,62,62,0,1,0,1,0
9178,18415,37965,0,0,deny,62,62,0,1,0,1,0
9179,50637,36237,0,0,deny,66,66,0,1,0,1,0
9180,1090,26296,0,0,deny,159,159,0,1,0,1,0
9181,57131,7774,0,0,deny,145,145,0,1,0,1,0
9182,65201,445,0,0,drop,70,70,0,1,0,1,0
9183,65199,445,0,0,drop,70,70,0,1,0,1,0
9184,18173,25174,0,0,deny,66,66,0,1,0,1,0
9185,19270,56448,0,0,deny,78,78,0,1,0,1,0
9186,53579,42707,0,0,deny,66,66,0,1,0,1,0
9187,53550,445,0,0,drop,70,70,0,1,0,1,0
9188,53548,445,0,0,drop,70,70,0,1,0,1,0
9189,53546,445,0,0,drop,70,70,0,1,0,1,0
9190,65197,445,0,0,drop,70,70,0,1,0,1,0
9191,64014,3389,64014,3389,reset-both,293,223,70,4,0,3,1
9192,65324,445,0,0,drop,66,66,0,1,0,1,0
9193,65321,445,0,0,drop,66,66,0,1,0,1,0
9194,65325,445,0,0,drop,66,66,0,1,0,1,0
9195,65326,445,0,0,drop,66,66,0,1,0,1,0
9196,65319,445,0,0,drop,66,66,0,1,0,1,0
9197,65327,445,0,0,drop,66,66,0,1,0,1,0
9198,65323,445,0,0,drop,66,66,0,1,0,1,0
9199,65320,445,0,0,drop,66,66,0,1,0,1,0
9200,37008,42707,0,0,deny,62,62,0,1,0,1,0
9201,36419,50584,0,0,deny,62,62,0,1,0,1,0
9202,29512,30188,0,0,deny,66,66,0,1,0,1,0
9203,36629,23117,0,0,deny,62,62,0,1,0,1,0
9204,26651,25174,0,0,deny,62,62,0,1,0,1,0
9205,14447,25174,0,0,deny,62,62,0,1,0,1,0
9206,10381,22114,0,0,deny,62,62,0,1,0,1,0
9207,15319,51505,0,0,deny,62,62,0,1,0,1,0
9208,2938,64147,0,0,deny,62,62,0,1,0,1,0
9209,14692,25174,0,0,deny,146,146,0,1,0,1,0
9210,65190,445,0,0,drop,70,70,0,1,0,1,0
9211,61761,44847,0,0,deny,66,66,0,1,0,1,0
9212,6666,27017,0,0,deny,60,60,0,1,0,1,0
9213,53543,445,0,0,drop,70,70,0,1,0,1,0
9214,53532,445,0,0,drop,70,70,0,1,0,1,0
9215,53531,445,0,0,drop,70,70,0,1,0,1,0
9216,53529,445,0,0,drop,70,70,0,1,0,1,0
9217,65188,445,0,0,drop,70,70,0,1,0,1,0
9218,56213,26467,0,0,deny,66,66,0,1,0,1,0
9219,49182,21247,0,0,deny,66,66,0,1,0,1,0
9220,38859,22114,0,0,deny,62,62,0,1,0,1,0
9221,65306,445,0,0,drop,66,66,0,1,0,1,0
9222,65305,445,0,0,drop,66,66,0,1,0,1,0
9223,65304,445,0,0,drop,66,66,0,1,0,1,0
9224,65187,445,0,0,drop,70,70,0,1,0,1,0
9225,65186,445,0,0,drop,70,70,0,1,0,1,0
9226,65185,445,0,0,drop,70,70,0,1,0,1,0
9227,65183,445,0,0,drop,70,70,0,1,0,1,0
9228,65181,445,0,0,drop,70,70,0,1,0,1,0
9229,53527,445,0,0,drop,70,70,0,1,0,1,0
9230,57928,30188,0,0,deny,62,62,0,1,0,1,0
9231,53524,445,0,0,drop,70,70,0,1,0,1,0
9232,53523,445,0,0,drop,70,70,0,1,0,1,0
9233,53520,445,0,0,drop,70,70,0,1,0,1,0
9234,17101,25174,0,0,deny,62,62,0,1,0,1,0
9235,65167,445,0,0,drop,70,70,0,1,0,1,0
9236,2932,44847,0,0,deny,66,66,0,1,0,1,0
9237,65166,445,0,0,drop,70,70,0,1,0,1,0
9238,55893,45711,0,0,deny,78,78,0,1,0,1,0
9239,65161,445,0,0,drop,70,70,0,1,0,1,0
9240,57928,30188,0,0,deny,146,146,0,1,0,1,0
9241,65157,445,0,0,drop,70,70,0,1,0,1,0
9242,65156,445,0,0,drop,70,70,0,1,0,1,0
9243,11136,19910,0,0,deny,62,62,0,1,0,1,0
9244,7342,22114,0,0,deny,66,66,0,1,0,1,0
9245,21179,44847,0,0,deny,62,62,0,1,0,1,0
9246,13285,29892,0,0,deny,145,145,0,1,0,1,0
9247,35589,25174,0,0,deny,66,66,0,1,0,1,0
9248,34281,52862,0,0,deny,145,145,0,1,0,1,0
9249,53120,25174,0,0,deny,62,62,0,1,0,1,0
9250,53508,445,0,0,drop,70,70,0,1,0,1,0
9251,53507,445,0,0,drop,70,70,0,1,0,1,0
9252,53503,445,0,0,drop,70,70,0,1,0,1,0
9253,36405,443,39984,443,allow,466,392,74,4,0,3,1
9254,65145,445,0,0,drop,70,70,0,1,0,1,0
9255,65292,445,0,0,drop,66,66,0,1,0,1,0
9256,51548,995,0,0,deny,60,60,0,1,0,1,0
9257,33720,995,0,0,deny,60,60,0,1,0,1,0
9258,52462,25174,0,0,deny,66,66,0,1,0,1,0
9259,12694,22114,0,0,deny,66,66,0,1,0,1,0
9260,68,67,0,0,deny,594,594,0,1,0,1,0
9261,27110,22114,0,0,deny,60,60,0,1,0,1,0
9262,12290,22114,0,0,deny,66,66,0,1,0,1,0
9263,53501,445,0,0,drop,70,70,0,1,0,1,0
9264,65141,445,0,0,drop,70,70,0,1,0,1,0
9265,53499,445,0,0,drop,70,70,0,1,0,1,0
9266,27502,50584,0,0,deny,66,66,0,1,0,1,0
9267,10192,25174,0,0,deny,66,66,0,1,0,1,0
9268,65132,445,0,0,drop,70,70,0,1,0,1,0
9269,65130,445,0,0,drop,70,70,0,1,0,1,0
9270,65131,445,0,0,drop,70,70,0,1,0,1,0
9271,65126,445,0,0,drop,70,70,0,1,0,1,0
9272,65280,445,0,0,drop,66,66,0,1,0,1,0
9273,65276,445,0,0,drop,66,66,0,1,0,1,0
9274,57172,17,0,0,deny,60,60,0,1,0,1,0
9275,65125,445,0,0,deny,70,70,0,1,0,1,0
9276,15585,64147,0,0,deny,62,62,0,1,0,1,0
9277,53563,35440,0,0,deny,62,62,0,1,0,1,0
9278,55735,50584,0,0,deny,62,62,0,1,0,1,0
9279,57677,57470,0,0,deny,62,62,0,1,0,1,0
9280,63398,25174,0,0,deny,66,66,0,1,0,1,0
9281,53487,445,0,0,drop,70,70,0,1,0,1,0
9282,53486,445,0,0,drop,70,70,0,1,0,1,0
9283,53482,445,0,0,drop,70,70,0,1,0,1,0
9284,53481,445,0,0,drop,70,70,0,1,0,1,0
9285,35268,81,0,0,deny,60,60,0,1,0,1,0
9286,49160,1171,0,0,deny,146,146,0,1,0,1,0
9287,65271,445,0,0,drop,66,66,0,1,0,1,0
9288,58399,56205,0,0,deny,66,66,0,1,0,1,0
9289,11754,25174,0,0,deny,62,62,0,1,0,1,0
9290,49754,35440,0,0,deny,62,62,0,1,0,1,0
9291,37657,443,62208,443,allow,8926,2746,6180,27,46,16,11
9292,26755,443,24399,443,allow,7283,2586,4697,22,19,11,11
9293,55588,53,17857,53,allow,168,86,82,2,34,1,1
9294,52166,57975,14625,57975,allow,70,70,0,2,8,2,0
9295,53975,443,21855,443,allow,2845,1694,1151,18,125,10,8
9296,39717,443,63809,443,allow,10921,3102,7819,25,217,13,12
9297,59244,53,54257,53,allow,168,78,90,2,30,1,1
9298,54512,80,54512,80,allow,1923,1474,449,10,20,6,4
9299,39718,443,30883,443,allow,10457,3150,7307,25,217,13,12
9300,53915,1026,61852,1026,allow,70,70,0,1,5,1,0
9301,49531,80,9012,80,allow,78,78,0,1,5,1,0
9302,57004,80,5611,80,allow,214,140,74,4,30,3,1
9303,60571,443,5687,443,allow,8728,4031,4697,23,17,12,11
9304,59955,25,59955,25,allow,1656,677,979,21,16,10,11
9305,57010,80,42816,80,allow,214,140,74,4,30,3,1
9306,26900,27017,57110,27017,allow,422,164,258,6,30,3,3
9307,26900,27017,64702,27017,allow,422,164,258,6,30,3,3
9308,55035,443,52274,443,allow,13310,3162,10148,31,46,16,15
9309,55034,443,64856,443,allow,45487,4986,40501,74,47,36,38
9310,56609,3389,56609,3389,allow,3327,1438,1889,15,16,8,7
9311,39272,443,24238,443,allow,7134,1963,5171,22,284,11,11
9312,39715,443,41417,443,allow,65276,4554,60722,82,217,34,48
9313,39714,443,60107,443,allow,922046,41258,880788,1106,218,498,608
9314,45628,80,45628,80,allow,1243,530,713,10,20,5,5
9315,37659,443,25278,443,allow,3354,2353,1001,18,45,11,7
9316,65482,443,27020,443,allow,6762,3351,3411,31,160,14,17
9317,50116,22,50116,22,allow,60,60,0,1,5,1,0
9318,64064,29856,35804,29856,allow,66,66,0,2,8,2,0
9319,44885,443,34599,443,allow,296,78,218,4,19,1,3
9320,53976,443,52741,443,allow,1591,1004,587,15,125,8,7
9321,10026,443,31835,443,allow,3409,1599,1810,24,80,12,12
9322,19520,7000,19520,7000,allow,4579,2182,2397,16,17,9,7
9323,26900,27017,31530,27017,allow,168,82,86,2,30,1,1
9324,53661,443,31154,443,allow,8267,1779,6488,23,150,13,10
9325,60332,53,8836,53,allow,419,111,308,2,31,1,1
9326,52326,443,20319,443,allow,4939,2553,2386,51,72,28,23
9327,56606,3389,56606,3389,allow,4130,2105,2025,18,16,9,9
9328,37660,443,48083,443,allow,3354,2353,1001,18,45,11,7
9329,59956,25,59956,25,allow,1867,743,1124,24,16,11,13
9330,39318,443,24928,443,allow,6933,2226,4707,33,140,18,15
9331,39719,443,7093,443,allow,450036,17745,432291,541,217,241,300
9332,44884,443,49689,443,allow,296,78,218,4,19,1,3
9333,59900,3389,59900,3389,allow,4286,2261,2025,20,18,11,9
9334,57456,443,62626,443,allow,6350,1550,4800,23,41,12,11
9335,55033,443,57495,443,allow,19846,10062,9784,42,47,22,20
9336,65445,80,60875,80,allow,1279,714,565,11,19,6,5
9337,47971,443,27561,443,allow,11482,2506,8976,48,1329,24,24
9338,26900,27017,50644,27017,allow,422,164,258,6,30,3,3
9339,65152,53,43515,53,allow,170,87,83,2,30,1,1
9340,55067,53,8321,53,allow,172,88,84,2,30,1,1
9341,55498,53,58802,53,allow,170,87,83,2,30,1,1
9342,55877,1135,9849,1135,allow,489,149,340,2,1200,1,1
9343,26900,27017,11369,27017,allow,422,164,258,6,30,3,3
9344,56519,53,32715,53,allow,711,87,624,2,30,1,1
9345,49223,443,17029,443,allow,14838,6995,7843,52,244,26,26
9346,46563,443,26794,443,allow,127147,41867,85280,198,240,91,107
9347,56905,443,19184,443,allow,7537,2310,5227,19,142,8,11
9348,65119,445,0,0,drop,70,70,0,1,0,1,0
9349,44235,50265,0,0,deny,145,145,0,1,0,1,0
9350,23873,30188,0,0,deny,66,66,0,1,0,1,0
9351,47303,31170,0,0,deny,145,145,0,1,0,1,0
9352,65263,445,0,0,drop,66,66,0,1,0,1,0
9353,65262,445,0,0,drop,66,66,0,1,0,1,0
9354,65268,445,0,0,drop,66,66,0,1,0,1,0
9355,65267,445,0,0,drop,66,66,0,1,0,1,0
9356,65259,445,0,0,drop,66,66,0,1,0,1,0
9357,65264,445,0,0,drop,66,66,0,1,0,1,0
9358,65257,445,0,0,drop,66,66,0,1,0,1,0
9359,53473,445,0,0,drop,70,70,0,1,0,1,0
9360,57484,30317,0,0,deny,66,66,0,1,0,1,0
9361,53471,445,0,0,drop,70,70,0,1,0,1,0
9362,21704,16933,0,0,deny,62,62,0,1,0,1,0
9363,53469,445,0,0,drop,70,70,0,1,0,1,0
9364,53467,445,0,0,drop,70,70,0,1,0,1,0
9365,65111,445,0,0,drop,70,70,0,1,0,1,0
9366,65109,445,0,0,drop,70,70,0,1,0,1,0
9367,54221,57470,0,0,deny,66,66,0,1,0,1,0
9368,59966,37965,0,0,deny,66,66,0,1,0,1,0
9369,53015,64147,0,0,deny,62,62,0,1,0,1,0
9370,65104,445,0,0,drop,70,70,0,1,0,1,0
9371,443,14591,0,0,deny,131,131,0,1,0,1,0
9372,65103,445,0,0,drop,70,70,0,1,0,1,0
9373,64723,56205,0,0,deny,62,62,0,1,0,1,0
9374,53462,445,0,0,drop,70,70,0,1,0,1,0
9375,53460,445,0,0,drop,70,70,0,1,0,1,0
9376,53459,445,0,0,drop,70,70,0,1,0,1,0
9377,48448,48817,0,0,deny,66,66,0,1,0,1,0
9378,61550,5529,0,0,deny,145,145,0,1,0,1,0
9379,65250,445,0,0,drop,66,66,0,1,0,1,0
9380,53458,445,0,0,drop,70,70,0,1,0,1,0
9381,62914,11392,0,0,deny,146,146,0,1,0,1,0
9382,10126,57470,0,0,deny,62,62,0,1,0,1,0
9383,65248,445,0,0,drop,66,66,0,1,0,1,0
9384,443,49689,0,0,deny,60,60,0,1,0,1,0
9385,443,34599,0,0,deny,60,60,0,1,0,1,0
9386,53704,23,0,0,deny,60,60,0,1,0,1,0
9387,65099,445,0,0,drop,70,70,0,1,0,1,0
9388,1024,25174,0,0,deny,62,62,0,1,0,1,0
9389,65246,445,0,0,drop,66,66,0,1,0,1,0
9390,65244,445,0,0,drop,66,66,0,1,0,1,0
9391,13110,52126,0,0,deny,145,145,0,1,0,1,0
9392,65242,445,0,0,drop,66,66,0,1,0,1,0
9393,65098,445,0,0,drop,70,70,0,1,0,1,0
9394,62348,50584,0,0,deny,66,66,0,1,0,1,0
9395,49938,57470,0,0,deny,66,66,0,1,0,1,0
9396,49370,443,33059,443,allow,5782,1008,4774,17,1,8,9
9397,40787,57470,0,0,deny,62,62,0,1,0,1,0
9398,65496,57470,0,0,deny,146,146,0,1,0,1,0
9399,22547,48817,0,0,deny,72,72,0,1,0,1,0
9400,53456,445,0,0,drop,70,70,0,1,0,1,0
9401,50488,22114,0,0,deny,66,66,0,1,0,1,0
9402,58715,64097,0,0,deny,62,62,0,1,0,1,0
9403,8760,22114,0,0,deny,66,66,0,1,0,1,0
9404,53448,445,0,0,drop,70,70,0,1,0,1,0
9405,53442,445,0,0,drop,70,70,0,1,0,1,0
9406,54883,51505,0,0,deny,62,62,0,1,0,1,0
9407,62149,22114,0,0,deny,66,66,0,1,0,1,0
9408,65093,445,0,0,drop,70,70,0,1,0,1,0
9409,31066,57470,0,0,deny,74,74,0,1,0,1,0
9410,37732,5007,0,0,deny,60,60,0,1,0,1,0
9411,49196,25174,0,0,deny,66,66,0,1,0,1,0
9412,65232,445,0,0,drop,66,66,0,1,0,1,0
9413,52827,25174,0,0,deny,62,62,0,1,0,1,0
9414,59096,57866,0,0,deny,62,62,0,1,0,1,0
9415,64653,53,13693,53,allow,241,94,147,2,30,1,1
9416,54022,443,12904,443,allow,7653,1188,6465,21,16,12,9
9417,38135,443,62915,443,allow,2568507,98538,2469969,2956,65,1228,1728
9418,55075,53,27475,53,allow,168,78,90,2,30,1,1
9419,53121,443,47087,443,allow,36181,3264,32917,51,62,24,27
9420,52007,80,41883,80,allow,83736,4405,79331,114,19,48,66
9421,56742,443,19670,443,allow,1327,918,409,10,34,6,4
9422,39011,80,17481,80,allow,1114,534,580,12,15,7,5
9423,59789,443,29818,443,allow,103556,8767,94789,144,48,75,69
9424,59790,443,41784,443,allow,238429,14932,223497,314,48,159,155
9425,57150,53,60378,53,allow,177,94,83,2,29,1,1
9426,55921,53,64539,53,allow,177,94,83,2,29,1,1
9427,42520,53,41857,53,allow,168,78,90,2,30,1,1
9428,57578,443,34885,443,allow,13999,3478,10521,33,134,15,18
9429,55957,53,34097,53,allow,178,94,84,2,30,1,1
9430,57006,80,58727,80,allow,214,140,74,4,30,3,1
9431,57014,80,25497,80,allow,214,140,74,4,30,3,1
9432,59122,80,13058,80,allow,2865,2000,865,12,16,7,5
9433,57011,80,37769,80,allow,214,140,74,4,30,3,1
9434,59407,443,59407,443,allow,4736,1829,2907,19,29,11,8
9435,57009,80,12239,80,allow,214,140,74,4,30,3,1
9436,49670,443,17269,443,allow,98424,28850,69574,508,2054,274,234
9437,50637,80,36749,80,allow,175050,8089,166961,167,48,48,119
9438,57013,80,33223,80,allow,526,304,222,8,30,5,3
9439,52139,38259,26811,38259,allow,70,70,0,1,4,1,0
9440,59787,443,50421,443,allow,173218,14836,158382,227,48,114,113
9441,59786,443,7763,443,allow,170002,17069,152933,229,48,118,111
9442,52164,42271,30250,42271,allow,70,70,0,2,8,2,0
9443,53917,35885,37941,35885,allow,70,70,0,1,4,1,0
9444,64063,37832,48121,37832,allow,66,66,0,2,7,2,0
9445,58267,443,58267,443,allow,4674,1767,2907,19,26,11,8
9446,58983,53,44611,53,allow,168,78,90,2,29,1,1
9447,49985,53,62790,53,allow,227,102,125,2,29,1,1
9448,57192,53,44126,53,allow,177,94,83,2,30,1,1
9449,57192,53,42489,53,allow,177,94,83,2,30,1,1
9450,39852,53,51714,53,allow,223,78,145,2,30,1,1
9451,54023,443,2526,443,allow,7653,1188,6465,21,16,12,9
9452,51965,443,54764,443,allow,12738,5385,7353,37,67,21,16
9453,21447,53,55331,53,allow,245648,213726,31922,2763,89,2579,184
9454,26900,27017,43770,27017,allow,422,164,258,6,30,3,3
9455,46881,53,46881,53,allow,197,90,107,2,30,1,1
9456,56414,53,14395,53,allow,178,94,84,2,30,1,1
9457,64985,53,10267,53,allow,86,86,0,1,60,1,0
9458,53922,42285,39226,42285,allow,70,70,0,2,8,2,0
9459,64630,53,37942,53,allow,350,94,256,2,30,1,1
9460,53171,443,32050,443,allow,11080,4277,6803,23,42,10,13
9461,51605,443,15283,443,allow,4343,2350,1993,17,36,9,8
9462,64586,443,13912,443,allow,8573,2039,6534,25,32,14,11
9463,55709,30217,48170,30217,allow,70,70,0,1,5,1,0
9464,50178,443,40731,443,allow,6353,1075,5278,18,26,10,8
9465,49407,53,49407,53,allow,247,98,149,2,32,1,1
9466,65431,53,65431,53,allow,262,106,156,2,31,1,1
9467,5588,5588,0,0,allow,3498,1872,1626,48,195,24,24
9468,50487,80,64502,80,allow,13796,627,13169,20,30,8,12
9469,15732,53,15732,53,allow,414,268,146,3,32,2,1
9470,55244,53,11760,53,allow,168,78,90,2,30,1,1
9471,26900,27017,31467,27017,allow,422,164,258,6,30,3,3
9472,26900,27017,33518,27017,allow,422,164,258,6,30,3,3
9473,55498,53,29212,53,allow,177,94,83,2,30,1,1
9474,26900,27017,60170,27017,allow,422,164,258,6,30,3,3
9475,26900,27017,41644,27017,allow,422,164,258,6,30,3,3
9476,26900,27017,15818,27017,allow,422,164,258,6,30,3,3
9477,26900,27017,41011,27017,allow,422,164,258,6,30,3,3
9478,26900,27017,26279,27017,allow,422,164,258,6,30,3,3
9479,55407,53,58404,53,allow,195,94,101,2,30,1,1
9480,56924,53,57471,53,allow,177,94,83,2,30,1,1
9481,53162,443,22912,443,allow,23929,10333,13596,51,43,25,26
9482,52138,25621,21857,25621,allow,70,70,0,1,5,1,0
9483,49484,80,9940,80,allow,3333,672,2661,12,15,7,5
9484,33893,443,60654,443,allow,8623,1758,6865,36,28,17,19
9485,54025,443,49847,443,allow,7653,1188,6465,21,16,12,9
9486,51602,443,19989,443,allow,19664,8943,10721,42,37,22,20
9487,55498,53,62567,53,allow,177,94,83,2,30,1,1
9488,40404,80,22213,80,allow,1502,467,1035,9,180,5,4
9489,19787,53,19787,53,allow,414,268,146,3,32,2,1
9490,40430,80,30893,80,allow,1566,754,812,10,15,6,4
9491,26900,27017,6136,27017,allow,422,164,258,6,30,3,3
9492,65152,53,60141,53,allow,177,94,83,2,30,1,1
9493,48817,6886,48817,6886,allow,491,150,341,2,1200,1,1
9494,6881,47488,39178,47488,allow,150,150,0,2,1200,2,0
9495,56182,80,62619,80,allow,2085,797,1288,10,15,6,4
9496,41763,443,59315,443,allow,9797,1934,7863,21,15,12,9
9497,56744,443,47935,443,allow,6205,986,5219,16,32,10,6
9498,57005,80,30107,80,allow,214,140,74,4,30,3,1
9499,51996,80,49659,80,allow,6518746,206365,6312381,6886,22,2687,4199
9500,57445,66,37294,66,allow,70,70,0,2,8,2,0
9501,51690,80,20015,80,allow,1273,471,802,11,290,6,5
9502,52163,14181,24095,14181,allow,70,70,0,2,8,2,0
9503,10903,53,10903,53,allow,247,98,149,2,32,1,1
9504,52165,49740,56721,49740,allow,70,70,0,2,8,2,0
9505,6775,53,6775,53,allow,228,90,138,2,32,1,1
9506,53930,19831,49369,19831,allow,70,70,0,2,7,2,0
9507,443,35556,443,35556,allow,70,70,0,1,4,1,0
9508,59785,443,14021,443,allow,1077274,41232,1036042,1152,49,455,697
9509,60492,11339,16258,11339,allow,70,70,0,2,8,2,0
9510,50684,80,15318,80,allow,62,62,0,1,5,1,0
9511,55584,53,38540,53,allow,177,94,83,2,29,1,1
9512,53122,443,60812,443,allow,12409,2224,10185,36,26,19,17
9513,54658,6881,23302,6881,allow,705,583,122,6,26,4,2
9514,58002,80,62017,80,allow,2362,1608,754,22,80,12,10
9515,64398,53,23095,53,allow,181,86,95,2,29,1,1
9516,26900,27017,9336,27017,allow,422,164,258,6,30,3,3
9517,42813,443,40546,443,allow,1241645,28525,1213120,1200,65,328,872
9518,65152,53,30200,53,allow,177,94,83,2,30,1,1
9519,41940,443,2811,443,allow,26974,22004,4970,80,216,42,38
9520,54979,53,4787,53,allow,102,102,0,1,59,1,0
9521,65075,53,31161,53,allow,293,94,199,2,29,1,1
9522,55199,53,60419,53,allow,223,78,145,2,30,1,1
9523,26900,27017,55012,27017,allow,422,164,258,6,30,3,3
9524,49861,53,46345,53,allow,261,94,167,2,30,1,1
9525,26900,27017,46101,27017,allow,422,164,258,6,30,3,3
9526,49996,53,34015,53,allow,210,102,108,2,30,1,1
9527,51608,443,59688,443,allow,4646,2347,2299,17,34,9,8
9528,56994,53,32105,53,allow,177,94,83,2,30,1,1
9529,49201,53,24647,53,allow,243,86,157,2,30,1,1
9530,33671,443,8770,443,allow,12536,1564,10972,30,809,13,17
9531,52651,53,52651,53,allow,414,268,146,3,31,2,1
9532,57396,443,49419,443,allow,362,302,60,2,5,1,1
9533,52136,42939,1692,42939,allow,70,70,0,1,5,1,0
9534,54024,443,29413,443,allow,7653,1188,6465,21,16,12,9
9535,56924,53,46939,53,allow,177,94,83,2,30,1,1
9536,51604,443,33369,443,allow,19611,6865,12746,46,37,24,22
9537,26900,27017,12054,27017,allow,422,164,258,6,30,3,3
9538,36946,123,44700,123,allow,184,94,90,2,30,1,1
9539,59038,53,59038,53,allow,832,106,726,2,30,1,1
9540,65403,53,49597,53,allow,359,94,265,2,30,1,1
9541,6755,53,6755,53,allow,247,98,149,2,32,1,1
9542,60489,53151,64380,53151,allow,70,70,0,2,8,2,0
9543,53925,61701,5754,61701,allow,70,70,0,2,8,2,0
9544,53916,23505,16942,23505,allow,70,70,0,1,5,1,0
9545,50684,80,37949,80,allow,66772,4924,61848,110,19,60,50
9546,26900,27017,32007,27017,allow,422,164,258,6,30,3,3
9547,26900,27017,38519,27017,allow,422,164,258,6,30,3,3
9548,51609,443,37311,443,allow,4598,2312,2286,17,34,9,8
9549,65092,53,51583,53,allow,263,94,169,2,30,1,1
9550,65319,53,54613,53,allow,200,94,106,2,30,1,1
9551,57354,53,4539,53,allow,177,94,83,2,30,1,1
9552,50356,443,55689,443,allow,505625,19174,486451,584,143,204,380
9553,58170,443,59368,443,allow,12391,6068,6323,52,133,24,28
9554,55891,443,55891,443,allow,4581,1674,2907,19,30,11,8
9555,57021,443,20461,443,allow,227559,47160,180399,379,143,187,192
9556,54539,80,58817,80,allow,4162,3455,707,14,15,8,6
9557,17840,53,17840,53,allow,414,268,146,3,32,2,1
9558,58732,443,10734,443,allow,1038,502,536,16,33,8,8
9559,53924,45212,48371,45212,allow,70,70,0,2,8,2,0
9560,44979,443,29869,443,allow,130,70,60,3,5,2,1
9561,43513,443,9885,443,allow,224,164,60,3,5,2,1
9562,50629,443,56409,443,allow,70,70,0,1,5,1,0
9563,65515,443,2957,443,allow,419763,12080,407683,429,16,147,282
9564,54021,443,39071,443,allow,7653,1188,6465,21,16,12,9
9565,55067,53,59893,53,allow,178,94,84,2,30,1,1
9566,51603,443,54804,443,allow,19849,6817,13032,45,37,23,22
9567,40554,53,2086,53,allow,223,78,145,2,30,1,1
9568,64470,53,40171,53,allow,261,94,167,2,30,1,1
9569,65194,53,61837,53,allow,402,142,260,2,31,1,1
9570,6881,48947,47849,48947,allow,228,118,110,2,1199,1,1
9571,4544,41599,1547,41599,allow,710,710,0,6,302,6,0
9572,54035,443,14205,443,allow,4454,2001,2453,11,120,6,5
9573,64049,1029,15442,1029,allow,70,70,0,1,5,1,0
9574,57192,53,38984,53,allow,177,94,83,2,30,1,1
9575,6881,6881,10552,6881,allow,238,118,120,2,1200,1,1
9576,52161,19897,63116,19897,allow,70,70,0,2,8,2,0
9577,52135,46475,11599,46475,allow,70,70,0,1,5,1,0
9578,49368,443,7264,443,allow,9482,4710,4772,19,17,11,8
9579,39323,443,25500,443,allow,1394,733,661,14,81,8,6
9580,52004,80,9207,80,allow,84657,4275,80382,105,19,45,60
9581,46212,443,38830,443,allow,67265,57889,9376,174,102,98,76
9582,51137,443,57006,443,allow,9269,5449,3820,70,460,33,37
9583,59177,443,33565,443,allow,280,140,140,5,130,3,2
9584,63046,443,63046,443,allow,4419,1512,2907,19,30,11,8
9585,61988,443,61988,443,allow,4338,1431,2907,19,30,11,8
9586,26900,27017,55723,27017,allow,20322,11404,8918,118,133,67,51
9587,64647,53,58835,53,allow,575,193,382,6,80,3,3
9588,64260,53,38791,53,allow,211,78,133,2,30,1,1
9589,54277,22114,0,0,deny,62,62,0,1,0,1,0
9590,58143,57866,0,0,deny,66,66,0,1,0,1,0
9591,37007,22114,0,0,deny,146,146,0,1,0,1,0
9592,36881,56205,0,0,deny,62,62,0,1,0,1,0
9593,65224,445,0,0,drop,66,66,0,1,0,1,0
9594,53431,445,0,0,drop,70,70,0,1,0,1,0
9595,63213,57866,0,0,deny,62,62,0,1,0,1,0
9596,42228,51050,0,0,deny,66,66,0,1,0,1,0
9597,61591,22114,0,0,deny,146,146,0,1,0,1,0
9598,65080,445,0,0,drop,70,70,0,1,0,1,0
9599,51046,25174,0,0,deny,66,66,0,1,0,1,0
9600,63334,37807,0,0,deny,66,66,0,1,0,1,0
9601,48478,49903,0,0,deny,62,62,0,1,0,1,0
9602,65221,445,0,0,drop,66,66,0,1,0,1,0
9603,40967,1433,0,0,deny,60,60,0,1,0,1,0
9604,61784,49903,0,0,deny,66,66,0,1,0,1,0
9605,57782,57470,0,0,deny,66,66,0,1,0,1,0
9606,65077,445,0,0,drop,70,70,0,1,0,1,0
9607,2238,22114,0,0,deny,62,62,0,1,0,1,0
9608,1024,64147,0,0,deny,62,62,0,1,0,1,0
9609,22350,25174,0,0,deny,66,66,0,1,0,1,0
9610,40967,1433,0,0,deny,60,60,0,1,0,1,0
9611,65215,445,0,0,drop,66,66,0,1,0,1,0
9612,9731,64147,0,0,deny,62,62,0,1,0,1,0
9613,45964,2225,0,0,deny,60,60,0,1,0,1,0
9614,19270,56448,0,0,deny,78,78,0,1,0,1,0
9615,65207,445,0,0,drop,66,66,0,1,0,1,0
9616,7067,22114,0,0,deny,146,146,0,1,0,1,0
9617,56562,44847,0,0,deny,66,66,0,1,0,1,0
9618,31281,30188,0,0,deny,62,62,0,1,0,1,0
9619,65072,445,0,0,drop,70,70,0,1,0,1,0
9620,65071,445,0,0,drop,70,70,0,1,0,1,0
9621,64878,26467,0,0,deny,145,145,0,1,0,1,0
9622,52640,64147,0,0,deny,62,62,0,1,0,1,0
9623,60571,26467,0,0,deny,62,62,0,1,0,1,0
9624,58725,10387,0,0,deny,145,145,0,1,0,1,0
9625,65069,445,0,0,drop,70,70,0,1,0,1,0
9626,61369,64147,0,0,deny,62,62,0,1,0,1,0
9627,34360,25174,0,0,deny,66,66,0,1,0,1,0
9628,58118,22114,0,0,deny,66,66,0,1,0,1,0
9629,53423,445,0,0,drop,70,70,0,1,0,1,0
9630,53419,445,0,0,drop,70,70,0,1,0,1,0
9631,53418,445,0,0,drop,70,70,0,1,0,1,0
9632,1594,44847,0,0,deny,62,62,0,1,0,1,0
9633,65198,445,0,0,drop,66,66,0,1,0,1,0
9634,65195,445,0,0,drop,66,66,0,1,0,1,0
9635,65192,445,0,0,drop,66,66,0,1,0,1,0
9636,65199,445,0,0,drop,66,66,0,1,0,1,0
9637,65196,445,0,0,drop,66,66,0,1,0,1,0
9638,65197,445,0,0,drop,66,66,0,1,0,1,0
9639,65193,445,0,0,drop,66,66,0,1,0,1,0
9640,65191,445,0,0,drop,66,66,0,1,0,1,0
9641,57677,23,0,0,deny,60,60,0,1,0,1,0
9642,64811,51221,0,0,deny,66,66,0,1,0,1,0
9643,56952,22114,0,0,deny,146,146,0,1,0,1,0
9644,58751,51221,0,0,deny,62,62,0,1,0,1,0
9645,64847,22114,0,0,deny,66,66,0,1,0,1,0
9646,42094,35440,0,0,deny,62,62,0,1,0,1,0
9647,1968,23,0,0,deny,60,60,0,1,0,1,0
9648,51076,25174,0,0,deny,146,146,0,1,0,1,0
9649,56639,48817,0,0,deny,66,66,0,1,0,1,0
9650,65062,445,0,0,drop,70,70,0,1,0,1,0
9651,25457,25604,0,0,deny,62,62,0,1,0,1,0
9652,65060,445,0,0,drop,70,70,0,1,0,1,0
9653,46604,57866,0,0,deny,62,62,0,1,0,1,0
9654,55893,45711,0,0,deny,78,78,0,1,0,1,0
9655,53416,445,0,0,drop,70,70,0,1,0,1,0
9656,53408,445,0,0,drop,70,70,0,1,0,1,0
9657,53404,445,0,0,drop,70,70,0,1,0,1,0
9658,53403,445,0,0,drop,70,70,0,1,0,1,0
9659,65059,445,0,0,drop,70,70,0,1,0,1,0
9660,56578,25174,0,0,deny,62,62,0,1,0,1,0
9661,19204,57866,0,0,deny,62,62,0,1,0,1,0
9662,38629,25174,0,0,deny,66,66,0,1,0,1,0
9663,18577,25174,0,0,deny,62,62,0,1,0,1,0
9664,65058,445,0,0,drop,70,70,0,1,0,1,0
9665,65057,445,0,0,drop,70,70,0,1,0,1,0
9666,65178,445,0,0,drop,66,66,0,1,0,1,0
9667,65177,445,0,0,drop,66,66,0,1,0,1,0
9668,65176,445,0,0,drop,66,66,0,1,0,1,0
9669,57471,62413,0,0,deny,62,62,0,1,0,1,0
9670,65055,445,0,0,drop,70,70,0,1,0,1,0
9671,65051,445,0,0,drop,70,70,0,1,0,1,0
9672,3765,64147,0,0,deny,66,66,0,1,0,1,0
9673,7905,22114,0,0,deny,62,62,0,1,0,1,0
9674,60337,30188,0,0,deny,66,66,0,1,0,1,0
9675,31785,25174,0,0,deny,146,146,0,1,0,1,0
9676,62043,25174,0,0,deny,62,62,0,1,0,1,0
9677,64334,25174,0,0,deny,66,66,0,1,0,1,0
9678,60485,22114,0,0,deny,66,66,0,1,0,1,0
9679,0,0,0,0,deny,156,156,0,2,0,2,0
9680,0,0,0,0,deny,156,156,0,2,0,2,0
9681,0,0,0,0,deny,156,156,0,2,0,2,0
9682,0,0,0,0,deny,156,156,0,2,0,2,0
9683,0,0,0,0,deny,102,102,0,1,0,1,0
9684,61609,25174,0,0,deny,146,146,0,1,0,1,0
9685,51313,25174,0,0,deny,66,66,0,1,0,1,0
9686,50593,64147,0,0,deny,62,62,0,1,0,1,0
9687,56377,51505,0,0,deny,66,66,0,1,0,1,0
9688,12794,35440,0,0,deny,146,146,0,1,0,1,0
9689,53398,445,0,0,drop,70,70,0,1,0,1,0
9690,60049,25174,0,0,deny,66,66,0,1,0,1,0
9691,65039,445,0,0,drop,70,70,0,1,0,1,0
9692,65038,445,0,0,drop,70,70,0,1,0,1,0
9693,65034,445,0,0,drop,70,70,0,1,0,1,0
9694,27055,25174,0,0,deny,62,62,0,1,0,1,0
9695,53395,445,0,0,drop,70,70,0,1,0,1,0
9696,53394,445,0,0,drop,70,70,0,1,0,1,0
9697,53392,445,0,0,drop,70,70,0,1,0,1,0
9698,65029,445,0,0,drop,70,70,0,1,0,1,0
9699,65028,445,0,0,drop,70,70,0,1,0,1,0
9700,11056,6881,0,0,deny,146,146,0,1,0,1,0
9701,55250,25174,0,0,deny,146,146,0,1,0,1,0
9702,54043,36237,0,0,deny,66,66,0,1,0,1,0
9703,3580,25174,0,0,deny,62,62,0,1,0,1,0
9704,57761,15503,0,0,deny,66,66,0,1,0,1,0
9705,2919,37965,0,0,deny,62,62,0,1,0,1,0
9706,52699,25174,0,0,deny,62,62,0,1,0,1,0
9707,25009,35440,0,0,deny,66,66,0,1,0,1,0
9708,22542,30188,0,0,deny,62,62,0,1,0,1,0
9709,63786,25174,0,0,deny,62,62,0,1,0,1,0
9710,65017,445,0,0,drop,70,70,0,1,0,1,0
9711,53380,445,0,0,deny,70,70,0,1,0,1,0
9712,53379,445,0,0,drop,70,70,0,1,0,1,0
9713,53375,445,0,0,drop,70,70,0,1,0,1,0
9714,6486,64147,0,0,deny,66,66,0,1,0,1,0
9715,54189,22114,0,0,deny,66,66,0,1,0,1,0
9716,65165,445,0,0,drop,66,66,0,1,0,1,0
9717,10627,23117,0,0,deny,66,66,0,1,0,1,0
9718,55082,25174,0,0,deny,62,62,0,1,0,1,0
9719,58091,51505,0,0,deny,62,62,0,1,0,1,0
9720,37834,30349,0,0,deny,145,145,0,1,0,1,0
9721,63173,36237,0,0,deny,62,62,0,1,0,1,0
9722,54542,25604,0,0,deny,66,66,0,1,0,1,0
9723,12457,57866,0,0,deny,66,66,0,1,0,1,0
9724,65013,445,0,0,drop,70,70,0,1,0,1,0
9725,24616,48983,0,0,deny,146,146,0,1,0,1,0
9726,58079,50584,0,0,deny,66,66,0,1,0,1,0
9727,30583,25174,0,0,deny,66,66,0,1,0,1,0
9728,23519,25174,0,0,deny,62,62,0,1,0,1,0
9729,53373,445,0,0,drop,70,70,0,1,0,1,0
9730,32474,48817,0,0,deny,148,148,0,1,0,1,0
9731,18655,44847,0,0,deny,66,66,0,1,0,1,0
9732,52130,1035,52488,1035,allow,66,66,0,1,5,1,0
9733,41630,15000,14960,15000,allow,130,70,60,2,5,1,1
9734,46409,80,19897,80,allow,4674,767,3907,17,15,9,8
9735,56263,443,47325,443,allow,101747,13436,88311,135,319,53,82
9736,55521,53,16753,53,allow,711,87,624,2,30,1,1
9737,60491,38789,32066,38789,allow,320,140,180,6,7,3,3
9738,58888,443,23971,443,allow,7329,949,6380,17,35,7,10
9739,56112,80,39554,80,allow,8113,1082,7031,19,16,10,9
9740,9439,443,40829,443,allow,6092,775,5317,17,25,9,8
9741,55440,53,50711,53,allow,711,87,624,2,30,1,1
9742,9430,443,49322,443,allow,6094,771,5323,17,26,9,8
9743,59810,443,33915,443,allow,630054,19786,610268,711,381,261,450
9744,54957,53,36470,53,allow,99,99,0,1,30,1,0
9745,49394,443,62275,443,allow,1392,731,661,14,80,8,6
9746,62120,443,62120,443,allow,4378,1471,2907,19,27,11,8
9747,9432,443,6777,443,allow,6094,771,5323,17,26,9,8
9748,56110,80,5106,80,allow,31087,1654,29433,42,16,18,24
9749,58890,15000,13228,15000,allow,138,78,60,2,5,1,1
9750,64898,53,23347,53,allow,487,201,286,6,37,3,3
9751,49878,53,34561,53,allow,216,94,122,2,30,1,1
9752,13794,3389,13794,3389,allow,3910,1805,2105,20,19,12,8
9753,55772,53,55772,53,allow,194,87,107,2,30,1,1
9754,37319,80,37445,80,allow,1056,682,374,10,15,6,4
9755,9442,443,1324,443,allow,6100,777,5323,17,25,9,8
9756,49396,443,4932,443,allow,1394,733,661,14,80,8,6
9757,9437,443,16715,443,allow,6285,839,5446,19,25,10,9
9758,52133,15015,35766,15015,allow,66,66,0,1,5,1,0
9759,56998,53,8754,53,allow,170,87,83,2,31,1,1
9760,55032,443,43927,443,allow,12704,3182,9522,35,49,16,19
9761,52348,80,52348,80,allow,2910,1489,1421,10,16,6,4
9762,52131,28980,37358,28980,allow,66,66,0,1,5,1,0
9763,56808,53,41016,53,allow,90,90,0,1,30,1,0
9764,55568,443,60113,443,allow,8979,5057,3922,89,110,51,38
9765,56994,53,65507,53,allow,170,87,83,2,30,1,1
9766,55957,53,38699,53,allow,172,88,84,2,30,1,1
9767,56273,53,61553,53,allow,194,99,95,2,30,1,1
9768,50584,53,13408,53,allow,793,101,692,2,30,1,1
9769,37682,5228,19029,5228,allow,5554,755,4799,14,3600,8,6
9770,54888,443,50282,443,allow,1775,169,1606,7,122,3,4
9771,65498,53,22566,53,allow,752,93,659,2,31,1,1
9772,15503,61471,17657,61471,allow,490,149,341,2,1200,1,1
9773,22571,51505,0,0,deny,62,62,0,1,0,1,0
9774,6121,51505,0,0,deny,66,66,0,1,0,1,0
9775,53366,445,0,0,drop,70,70,0,1,0,1,0
9776,65003,445,0,0,drop,70,70,0,1,0,1,0
9777,65002,445,0,0,drop,70,70,0,1,0,1,0
9778,65001,445,0,0,drop,70,70,0,1,0,1,0
9779,37075,48817,0,0,deny,62,62,0,1,0,1,0
9780,65000,445,0,0,drop,70,70,0,1,0,1,0
9781,57557,64147,0,0,deny,66,66,0,1,0,1,0
9782,64997,445,0,0,drop,70,70,0,1,0,1,0
9783,65150,445,0,0,drop,66,66,0,1,0,1,0
9784,65147,445,0,0,drop,66,66,0,1,0,1,0
9785,47063,15503,0,0,deny,146,146,0,1,0,1,0
9786,54440,26467,0,0,deny,66,66,0,1,0,1,0
9787,53360,445,0,0,drop,70,70,0,1,0,1,0
9788,53358,445,0,0,drop,70,70,0,1,0,1,0
9789,53354,445,0,0,drop,70,70,0,1,0,1,0
9790,53352,445,0,0,drop,70,70,0,1,0,1,0
9791,27811,57866,0,0,deny,146,146,0,1,0,1,0
9792,55246,31573,0,0,deny,66,66,0,1,0,1,0
9793,64990,445,0,0,drop,70,70,0,1,0,1,0
9794,53838,36829,0,0,deny,66,66,0,1,0,1,0
9795,65143,445,0,0,drop,66,66,0,1,0,1,0
9796,26239,25174,0,0,deny,66,66,0,1,0,1,0
9797,64808,27098,0,0,deny,66,66,0,1,0,1,0
9798,65135,445,0,0,drop,66,66,0,1,0,1,0
9799,65136,445,0,0,drop,66,66,0,1,0,1,0
9800,65138,445,0,0,drop,66,66,0,1,0,1,0
9801,65130,445,0,0,drop,66,66,0,1,0,1,0
9802,65131,445,0,0,drop,66,66,0,1,0,1,0
9803,65132,445,0,0,drop,66,66,0,1,0,1,0
9804,65128,445,0,0,drop,66,66,0,1,0,1,0
9805,53346,445,0,0,drop,70,70,0,1,0,1,0
9806,56793,56205,0,0,deny,62,62,0,1,0,1,0
9807,45944,44847,0,0,deny,62,62,0,1,0,1,0
9808,64981,445,0,0,drop,70,70,0,1,0,1,0
9809,33401,51505,0,0,deny,62,62,0,1,0,1,0
9810,64980,445,0,0,drop,70,70,0,1,0,1,0
9811,53343,445,0,0,drop,70,70,0,1,0,1,0
9812,53342,445,0,0,drop,70,70,0,1,0,1,0
9813,53340,445,0,0,drop,70,70,0,1,0,1,0
9814,60976,22114,0,0,deny,62,62,0,1,0,1,0
9815,52091,11392,0,0,deny,62,62,0,1,0,1,0
9816,11235,30188,0,0,deny,66,66,0,1,0,1,0
9817,1030,35776,0,0,deny,139,139,0,1,0,1,0
9818,29884,25174,0,0,deny,62,62,0,1,0,1,0
9819,64974,445,0,0,drop,70,70,0,1,0,1,0
9820,64973,445,0,0,drop,70,70,0,1,0,1,0
9821,17280,22114,0,0,deny,62,62,0,1,0,1,0
9822,49894,1433,0,0,deny,60,60,0,1,0,1,0
9823,49894,1433,0,0,deny,60,60,0,1,0,1,0
9824,27841,35894,0,0,deny,62,62,0,1,0,1,0
9825,62339,25174,0,0,deny,66,66,0,1,0,1,0
9826,52358,30188,0,0,deny,66,66,0,1,0,1,0
9827,31845,55777,0,0,deny,62,62,0,1,0,1,0
9828,58955,57470,0,0,deny,74,74,0,1,0,1,0
9829,59493,44847,0,0,deny,66,66,0,1,0,1,0
9830,53337,445,0,0,drop,70,70,0,1,0,1,0
9831,53336,445,0,0,drop,70,70,0,1,0,1,0
9832,53335,445,0,0,drop,70,70,0,1,0,1,0
9833,34772,15503,0,0,deny,146,146,0,1,0,1,0
9834,65121,445,0,0,drop,66,66,0,1,0,1,0
9835,53330,445,0,0,drop,70,70,0,1,0,1,0
9836,64969,445,0,0,drop,70,70,0,1,0,1,0
9837,65120,445,0,0,drop,66,66,0,1,0,1,0
9838,65117,445,0,0,drop,66,66,0,1,0,1,0
9839,42065,53,0,0,allow,86,86,0,1,30,1,0
9840,24486,53,24486,53,allow,414,268,146,3,31,2,1
9841,123,123,26744,123,allow,184,94,90,2,30,1,1
9842,25436,53,25436,53,allow,220,90,130,2,30,1,1
9843,52086,80,55343,80,allow,2703,632,2071,12,22,7,5
9844,9456,443,36831,443,allow,6096,777,5319,17,25,9,8
9845,54811,443,21381,443,allow,3392,2305,1087,22,80,11,11
9846,64045,7426,33466,7426,allow,70,70,0,1,4,1,0
9847,64047,16221,14226,16221,allow,70,70,0,1,4,1,0
9848,55716,36989,39721,36989,allow,320,140,180,6,6,3,3
9849,52132,55014,27986,55014,allow,70,70,0,1,4,1,0
9850,9455,443,43647,443,allow,6096,777,5319,17,25,9,8
9851,56414,53,12496,53,allow,178,94,84,2,29,1,1
9852,55957,53,35891,53,allow,178,94,84,2,29,1,1
9853,52134,18470,56970,18470,allow,70,70,0,1,4,1,0
9854,55957,53,33865,53,allow,178,94,84,2,30,1,1
9855,52853,443,21647,443,allow,9582,3906,5676,21,135,10,11
9856,37965,18122,9264,18122,allow,3957,2324,1633,51,1794,29,22
9857,59377,443,61380,443,allow,43483,26315,17168,86,62,54,32
9858,60136,443,31780,443,allow,21278,12533,8745,57,183,36,21
9859,56922,53,40001,53,allow,168,86,82,2,30,1,1
9860,47230,443,43067,443,allow,9930,3002,6928,34,120,17,17
9861,60703,443,30992,443,allow,66716,4091,62625,98,278,43,55
9862,56126,53,5534,53,allow,177,94,83,2,30,1,1
9863,64852,53,45042,53,allow,209,110,99,2,30,1,1
9864,58808,80,14493,80,allow,2295,1574,721,10,375,6,4
9865,64966,53,61255,53,allow,347,100,247,4,49,2,2
9866,52206,443,46301,443,allow,6278,682,5596,17,20,8,9
9867,38709,443,40146,443,allow,398925,9369,389556,391,16,123,268
9868,55705,54638,46726,54638,allow,504,318,186,8,15,5,3
9869,56273,53,51229,53,allow,197,102,95,2,33,1,1
9870,63873,61002,7411,61002,allow,5431,3164,2267,32,76,18,14
9871,49768,53,39040,53,allow,459,103,356,4,43,2,2
9872,55704,13343,3338,13343,allow,564,318,246,9,15,5,4
9873,49369,443,29095,443,allow,7165,1099,6066,16,15,9,7
9874,61391,443,41670,443,allow,11151,3001,8150,51,365,25,26
9875,18157,53,35666,53,allow,215,94,121,2,30,1,1
9876,37590,443,37590,443,allow,4572,1665,2907,19,27,11,8
9877,57149,53,34608,53,allow,382,94,288,2,30,1,1
9878,63141,55860,18547,55860,allow,316,190,126,5,15,3,2
9879,49435,53,64990,53,allow,608,199,409,6,69,3,3
9880,53166,39564,63800,39564,allow,70,70,0,1,5,1,0
9881,56654,53,47578,53,allow,102,102,0,1,30,1,0
9882,65035,53,56043,53,allow,234,102,132,2,30,1,1
9883,56998,53,31320,53,allow,177,94,83,2,30,1,1
9884,56998,53,64754,53,allow,177,94,83,2,30,1,1
9885,62995,53,21772,53,allow,102,102,0,1,30,1,0
9886,53166,53,17813,53,allow,168,78,90,2,30,1,1
9887,33861,443,34883,443,allow,8084,2638,5446,26,20,14,12
9888,47957,443,9309,443,allow,7658,4247,3411,29,31,15,14
9889,65374,53,40635,53,allow,376,102,274,4,47,2,2
9890,64932,53,8604,53,allow,230,102,128,2,30,1,1
9891,57121,53,54174,53,allow,257,110,147,2,30,1,1
9892,65352,53,23820,53,allow,416,102,314,2,30,1,1
9893,34981,80,29727,80,allow,1658,1344,314,10,15,5,5
9894,5924,53,5924,53,allow,220,90,130,2,30,1,1
9895,56600,443,42581,443,allow,13773,6668,7105,31,105,19,12
9896,65323,53,53376,53,allow,247,118,129,2,30,1,1
9897,64406,53,3194,53,allow,102,102,0,1,30,1,0
9898,57158,53,11939,53,allow,969,86,883,2,30,1,1
9899,42578,443,22827,443,allow,68806,2442,66364,71,215,19,52
9900,39325,443,37130,443,allow,1396,735,661,14,80,8,6
9901,46525,53,46525,53,allow,404,259,145,3,32,2,1
9902,55713,47783,7321,47783,allow,70,70,0,2,8,2,0
9903,52162,15104,33803,15104,allow,70,70,0,2,7,2,0
9904,65514,443,30386,443,allow,92638,4519,88119,105,15,39,66
9905,64048,44918,54494,44918,allow,70,70,0,1,4,1,0
9906,42569,443,10285,443,allow,7284,1456,5828,21,360,10,11
9907,52177,21079,54277,21079,allow,316,136,180,6,5,3,3
9908,9445,443,7220,443,allow,6094,771,5323,17,25,9,8
9909,64041,80,63585,80,allow,314,192,122,6,15,4,2
9910,40709,443,9964,443,allow,5565,1382,4183,22,158,11,11
9911,49196,53,18490,53,allow,230,91,139,3,47,2,1
9912,49293,5223,22335,5223,allow,202,142,60,2,15,1,1
9913,49746,53,11363,53,allow,236,94,142,2,29,1,1
9914,51174,80,58764,80,allow,1658,1344,314,10,15,5,5
9915,10963,53,53121,53,allow,177,86,91,2,30,1,1
9916,65313,53,20235,53,allow,802,288,514,8,75,4,4
9917,57354,53,26026,53,allow,177,94,83,2,29,1,1
9918,55048,53,48265,53,allow,215,94,121,2,29,1,1
9919,49432,53,40864,53,allow,338,118,220,2,29,1,1
9920,57273,53,29269,53,allow,177,94,83,2,30,1,1
9921,53791,53,19031,53,allow,102,102,0,1,30,1,0
9922,52758,53,52758,53,allow,197,90,107,2,30,1,1
9923,51166,53,27662,53,allow,168,78,90,2,30,1,1
9924,55218,53,56966,53,allow,402,142,260,2,30,1,1
9925,56994,53,35888,53,allow,177,94,83,2,30,1,1
9926,54553,53,37407,53,allow,102,102,0,1,30,1,0
9927,55305,53,21908,53,allow,94,94,0,1,30,1,0
9928,36502,53,33412,53,allow,168,78,90,2,30,1,1
9929,45186,443,63714,443,allow,5959,169,5790,10,121,3,7
9930,32971,443,64078,443,allow,12597,6029,6568,36,267,15,21
9931,46351,53,46351,53,allow,262,106,156,2,31,1,1
9932,53929,60741,10876,60741,allow,320,140,180,6,6,3,3
9933,49455,53,42395,53,allow,1750,184,1566,6,85,3,3
9934,49766,53,54774,53,allow,234,102,132,2,30,1,1
9935,60438,53,64563,53,allow,78,78,0,1,30,1,0
9936,58863,443,30901,443,allow,4546411,95150,4451261,4312,109,1197,3115
9937,37513,443,37513,443,allow,4347,1440,2907,19,30,11,8
9938,56558,443,56558,443,allow,4656,1749,2907,19,27,11,8
9939,19253,53,19253,53,allow,414,268,146,3,32,2,1
9940,55786,53,55786,53,allow,247,98,149,2,32,1,1
9941,52052,80,13756,80,allow,2308,1541,767,11,18,7,4
9942,57273,53,15438,53,allow,177,94,83,2,30,1,1
9943,59182,53,59092,53,allow,168,78,90,2,30,1,1
9944,32860,53,58856,53,allow,168,78,90,2,30,1,1
9945,56922,53,64459,53,allow,168,86,82,2,30,1,1
9946,20270,3478,6426,3478,allow,443,294,149,2,300,1,1
9947,37437,443,24632,443,allow,4809,818,3991,15,15,8,7
9948,52159,16297,7644,16297,allow,70,70,0,2,8,2,0
9949,50212,1688,56560,1688,allow,70,70,0,2,8,2,0
9950,51989,80,41304,80,allow,4166,1708,2458,14,16,7,7
9951,45057,443,6642,443,allow,7536,1915,5621,31,20,17,14
9952,50387,80,54775,80,allow,8105,3187,4918,18,24,9,9
9953,64631,53,53048,53,allow,226,102,124,2,30,1,1
9954,61637,53,21621,53,allow,86,86,0,1,30,1,0
9955,55445,53,8991,53,allow,102,102,0,1,30,1,0
9956,56994,53,19050,53,allow,177,94,83,2,30,1,1
9957,50265,53606,10997,53606,allow,528,528,0,9,1200,9,0
9958,51811,443,43399,443,allow,4007,2063,1944,12,122,6,6
9959,50545,443,51366,443,allow,9654,1771,7883,27,186,14,13
9960,55435,443,60769,443,allow,684908,25994,658914,762,141,263,499
9961,57408,53,58963,53,allow,195,102,93,2,33,1,1
9962,15450,53,15450,53,allow,216,82,134,2,33,1,1
9963,52127,44198,61078,44198,allow,70,70,0,1,5,1,0
9964,49367,443,60799,443,allow,22639,7456,15183,32,16,17,15
9965,50634,53,32177,53,allow,218,86,132,2,30,1,1
9966,44099,443,23895,443,allow,8049289,98432,7950857,6501,125,717,5784
9967,55160,443,10978,443,allow,333522,14341,319181,347,129,109,238
9968,49219,80,41190,80,allow,2010,664,1346,11,84,7,4
9969,64764,53,35102,53,allow,211,102,109,2,30,1,1
9970,50426,53,48591,53,allow,889,404,485,10,30,5,5
9971,56126,53,21706,53,allow,177,94,83,2,30,1,1
9972,49702,53,29408,53,allow,771,102,669,2,31,1,1
9973,44886,443,1331,443,allow,7775,2973,4802,36,57,19,17
9974,54986,53,53684,53,allow,164,78,86,2,30,1,1
9975,36291,53,42350,53,allow,199,94,105,2,31,1,1
9976,59605,443,24489,443,allow,4507,1525,2982,24,148,13,11
9977,65116,445,0,0,drop,66,66,0,1,0,1,0
9978,50493,15503,0,0,deny,146,146,0,1,0,1,0
9979,64968,445,0,0,drop,70,70,0,1,0,1,0
9980,54189,64147,0,0,deny,66,66,0,1,0,1,0
9981,42558,64147,0,0,deny,62,62,0,1,0,1,0
9982,65115,445,0,0,drop,66,66,0,1,0,1,0
9983,58021,22114,0,0,deny,62,62,0,1,0,1,0
9984,56326,56205,0,0,deny,66,66,0,1,0,1,0
9985,59153,35440,0,0,deny,66,66,0,1,0,1,0
9986,53327,445,0,0,drop,70,70,0,1,0,1,0
9987,5617,64147,0,0,deny,145,145,0,1,0,1,0
9988,64963,445,0,0,drop,70,70,0,1,0,1,0
9989,24292,48817,0,0,deny,148,148,0,1,0,1,0
9990,7891,25174,0,0,deny,66,66,0,1,0,1,0
9991,53317,445,0,0,drop,70,70,0,1,0,1,0
9992,53316,445,0,0,drop,70,70,0,1,0,1,0
9993,50946,44847,0,0,deny,66,66,0,1,0,1,0
9994,47342,20541,0,0,deny,66,66,0,1,0,1,0
9995,65103,445,0,0,drop,66,66,0,1,0,1,0
9996,60308,37965,0,0,deny,66,66,0,1,0,1,0
9997,53692,44512,0,0,deny,66,66,0,1,0,1,0
9998,61000,15503,0,0,deny,146,146,0,1,0,1,0
9999,12318,41864,0,0,deny,139,139,0,1,0,1,0
10000,56202,15503,0,0,deny,146,146,0,1,0,1,0
10001,12616,23,0,0,deny,60,60,0,1,0,1,0
10002,59326,57470,0,0,deny,74,74,0,1,0,1,0
10003,56604,17372,0,0,deny,66,66,0,1,0,1,0
10004,11030,17372,0,0,deny,62,62,0,1,0,1,0
10005,42030,25,0,0,deny,74,74,0,1,0,1,0
10006,3090,1,0,0,deny,66,66,0,1,0,1,0
10007,63873,44847,0,0,deny,66,66,0,1,0,1,0
10008,56219,22114,0,0,deny,66,66,0,1,0,1,0
10009,46275,64147,0,0,deny,62,62,0,1,0,1,0
10010,443,14591,0,0,deny,131,131,0,1,0,1,0
10011,993,58185,0,0,deny,129,129,0,1,0,1,0
10012,65096,445,0,0,drop,66,66,0,1,0,1,0
10013,53302,445,0,0,drop,70,70,0,1,0,1,0
10014,64950,445,0,0,drop,70,70,0,1,0,1,0
10015,45964,2225,0,0,deny,60,60,0,1,0,1,0
10016,61730,25320,0,0,deny,66,66,0,1,0,1,0
10017,55429,25174,0,0,deny,66,66,0,1,0,1,0
10018,58646,44847,0,0,deny,62,62,0,1,0,1,0
10019,64947,445,0,0,drop,70,70,0,1,0,1,0
10020,12616,23,0,0,deny,60,60,0,1,0,1,0
10021,65093,445,0,0,drop,66,66,0,1,0,1,0
10022,64772,64147,0,0,deny,66,66,0,1,0,1,0
10023,55069,44847,0,0,deny,66,66,0,1,0,1,0
10024,62392,15503,0,0,deny,146,146,0,1,0,1,0
10025,56679,5900,0,0,deny,60,60,0,1,0,1,0
10026,65085,445,0,0,drop,66,66,0,1,0,1,0
10027,65078,445,0,0,drop,66,66,0,1,0,1,0
10028,7360,14914,0,0,deny,157,157,0,1,0,1,0
10029,64942,445,0,0,drop,70,70,0,1,0,1,0
10030,54007,50265,0,0,deny,66,66,0,1,0,1,0
10031,64941,445,0,0,drop,70,70,0,1,0,1,0
10032,4138,55777,0,0,deny,66,66,0,1,0,1,0
10033,64939,445,0,0,drop,70,70,0,1,0,1,0
10034,54758,35993,0,0,deny,62,62,0,1,0,1,0
10035,14869,44847,0,0,deny,62,62,0,1,0,1,0
10036,56205,51505,0,0,deny,66,66,0,1,0,1,0
10037,55893,45711,0,0,deny,78,78,0,1,0,1,0
10038,31539,37965,0,0,deny,62,62,0,1,0,1,0
10039,53294,445,0,0,drop,70,70,0,1,0,1,0
10040,53292,445,0,0,drop,70,70,0,1,0,1,0
10041,53291,445,0,0,drop,70,70,0,1,0,1,0
10042,65063,445,0,0,drop,66,66,0,1,0,1,0
10043,65065,445,0,0,drop,66,66,0,1,0,1,0
10044,65069,445,0,0,drop,66,66,0,1,0,1,0
10045,65066,445,0,0,drop,66,66,0,1,0,1,0
10046,65070,445,0,0,drop,66,66,0,1,0,1,0
10047,65068,445,0,0,drop,66,66,0,1,0,1,0
10048,65071,445,0,0,drop,66,66,0,1,0,1,0
10049,65067,445,0,0,drop,66,66,0,1,0,1,0
10050,58421,30188,0,0,deny,66,66,0,1,0,1,0
10051,8560,50584,0,0,deny,66,66,0,1,0,1,0
10052,64932,445,0,0,drop,70,70,0,1,0,1,0
10053,14208,51221,0,0,deny,66,66,0,1,0,1,0
10054,13528,51221,0,0,deny,62,62,0,1,0,1,0
10055,38053,50584,0,0,deny,62,62,0,1,0,1,0
10056,64930,445,0,0,drop,70,70,0,1,0,1,0
10057,6126,25174,0,0,deny,62,62,0,1,0,1,0
10058,54280,3385,0,0,deny,60,60,0,1,0,1,0
10059,32307,22114,0,0,deny,146,146,0,1,0,1,0
10060,11337,15503,0,0,deny,62,62,0,1,0,1,0
10061,52430,22114,0,0,deny,62,62,0,1,0,1,0
10062,64929,445,0,0,drop,70,70,0,1,0,1,0
10063,57420,22114,0,0,deny,62,62,0,1,0,1,0
10064,64928,445,0,0,drop,70,70,0,1,0,1,0
10065,53289,445,0,0,drop,70,70,0,1,0,1,0
10066,53287,445,0,0,drop,70,70,0,1,0,1,0
10067,53283,445,0,0,drop,70,70,0,1,0,1,0
10068,53277,445,0,0,drop,70,70,0,1,0,1,0
10069,64927,445,0,0,drop,70,70,0,1,0,1,0
10070,51769,17,0,0,deny,60,60,0,1,0,1,0
10071,64921,445,0,0,drop,70,70,0,1,0,1,0
10072,64922,445,0,0,drop,70,70,0,1,0,1,0
10073,17262,25174,0,0,deny,62,62,0,1,0,1,0
10074,59214,57866,0,0,deny,66,66,0,1,0,1,0
10075,65050,445,0,0,drop,66,66,0,1,0,1,0
10076,65049,445,0,0,drop,66,66,0,1,0,1,0
10077,65047,445,0,0,drop,66,66,0,1,0,1,0
10078,993,49276,0,0,deny,129,129,0,1,0,1,0
10079,53669,23,0,0,deny,60,60,0,1,0,1,0
10080,51533,44847,0,0,deny,66,66,0,1,0,1,0
10081,64909,445,0,0,drop,70,70,0,1,0,1,0
10082,64908,445,0,0,drop,70,70,0,1,0,1,0
10083,64904,445,0,0,drop,70,70,0,1,0,1,0
10084,55899,57470,0,0,deny,78,78,0,1,0,1,0
10085,64898,445,0,0,drop,70,70,0,1,0,1,0
10086,62197,22114,0,0,deny,66,66,0,1,0,1,0
10087,60000,1879,0,0,deny,145,145,0,1,0,1,0
10088,64899,445,0,0,drop,70,70,0,1,0,1,0
10089,53270,445,0,0,drop,70,70,0,1,0,1,0
10090,52280,44847,0,0,deny,66,66,0,1,0,1,0
10091,53265,445,0,0,drop,70,70,0,1,0,1,0
10092,53263,445,0,0,drop,70,70,0,1,0,1,0
10093,53259,445,0,0,drop,70,70,0,1,0,1,0
10094,62575,12207,0,0,deny,66,66,0,1,0,1,0
10095,53160,25174,0,0,deny,62,62,0,1,0,1,0
10096,64324,37807,0,0,deny,146,146,0,1,0,1,0
10097,60606,3389,0,0,deny,60,60,0,1,0,1,0
10098,19875,30170,0,0,deny,145,145,0,1,0,1,0
10099,55312,64147,0,0,deny,66,66,0,1,0,1,0
10100,12878,25174,0,0,deny,146,146,0,1,0,1,0
10101,29178,35440,0,0,deny,62,62,0,1,0,1,0
10102,38330,44847,0,0,deny,66,66,0,1,0,1,0
10103,64733,35440,0,0,deny,62,62,0,1,0,1,0
10104,45964,55559,0,0,deny,60,60,0,1,0,1,0
10105,53381,25174,0,0,deny,66,66,0,1,0,1,0
10106,22220,25174,0,0,deny,62,62,0,1,0,1,0
10107,64887,445,0,0,drop,70,70,0,1,0,1,0
10108,56400,35440,0,0,deny,66,66,0,1,0,1,0
10109,5060,37965,0,0,deny,66,66,0,1,0,1,0
10110,49485,56972,0,0,deny,66,66,0,1,0,1,0
10111,55605,53,56113,53,allow,196,100,96,2,30,1,1
10112,39682,443,54017,443,allow,4439,862,3577,16,160,9,7
10113,60996,443,58632,443,allow,6043,1568,4475,11,120,4,7
10114,55703,13836,63794,13836,allow,70,70,0,1,5,1,0
10115,52124,11296,48870,11296,allow,66,66,0,1,5,1,0
10116,52154,4635,63801,4635,allow,70,70,0,2,8,2,0
10117,30960,45751,20805,45751,allow,66,66,0,1,3600,1,0
10118,51595,443,49515,443,allow,10614,5312,5302,25,91,14,11
10119,37654,443,34226,443,allow,12531,5566,6965,34,46,20,14
10120,46863,15000,49470,15000,allow,130,70,60,2,5,1,1
10121,62055,443,14508,443,allow,11694,4947,6747,34,48,19,15
10122,56099,53,33681,53,allow,701,88,613,2,30,1,1
10123,56228,53,46587,53,allow,711,87,624,2,30,1,1
10124,38658,443,22719,443,allow,1294,864,430,12,81,7,5
10125,58149,443,24568,443,allow,153,93,60,2,5,1,1
10126,50920,443,56379,443,allow,3440,2371,1069,17,96,10,7
10127,62064,443,63626,443,allow,11582,2503,9079,33,47,17,16
10128,57408,53,58813,53,allow,190,97,93,2,30,1,1
10129,46792,443,1807,443,allow,7298,2661,4637,21,18,11,10
10130,56374,53,54087,53,allow,711,87,624,2,30,1,1
10131,50585,80,63970,80,allow,1726,963,763,13,80,7,6
10132,37655,443,41125,443,allow,9811,3415,6396,29,46,17,12
10133,37649,443,13055,443,allow,32391,21443,10948,69,47,41,28
10134,47969,443,44705,443,allow,10825,4667,6158,25,159,15,10
10135,58402,53,52417,53,allow,578,286,292,9,15,5,4
10136,37453,443,30746,443,allow,8891,1846,7045,27,147,14,13
10137,57368,53,6129,53,allow,701,88,613,2,30,1,1
10138,37656,443,58778,443,allow,9875,3479,6396,29,46,17,12
10139,52129,55550,34471,55550,allow,66,66,0,1,5,1,0
10140,53976,443,65435,443,allow,9921,2236,7685,35,32,17,18
10141,60487,1134,43276,1134,allow,70,70,0,2,8,2,0
10142,59148,443,64998,443,allow,26615,22329,4286,52,272,30,22
10143,49240,53,28241,53,allow,198,101,97,2,30,1,1
10144,55830,53,42279,53,allow,170,87,83,2,30,1,1
10145,61712,443,30612,443,allow,7443,2692,4751,19,76,11,8
10146,43057,443,23412,443,allow,7725,1980,5745,25,20,14,11
10147,41803,443,1948,443,allow,11804,4009,7795,41,150,21,20
10148,30960,45758,64660,45758,allow,462,462,0,8,3632,8,0
10149,60486,8999,61783,8999,allow,70,70,0,2,8,2,0
10150,57248,443,46396,443,allow,4113,1387,2726,15,36,8,7
10151,57246,8525,57246,8525,allow,138,78,60,2,5,1,1
10152,58664,53,14984,53,allow,192,90,102,2,30,1,1
10153,65316,53,63877,53,allow,780,93,687,2,30,1,1
10154,56738,53,36120,53,allow,264,87,177,4,37,2,2
10155,55601,53,41824,53,allow,815,95,720,2,30,1,1
10156,55850,53,58369,53,allow,816,97,719,2,30,1,1
10157,50408,53,36344,53,allow,182,93,89,2,31,1,1
10158,62188,443,50318,443,allow,6973,2413,4560,22,148,11,11
10159,6882,5406,43769,5406,allow,654,150,504,3,1200,1,2
10160,50579,53,55360,53,allow,174,89,85,2,31,1,1
10161,49708,53,5780,53,allow,172,88,84,2,31,1,1
10162,64125,53,8672,53,allow,198,101,97,2,31,1,1
10163,55308,443,11904,443,allow,14364,4095,10269,33,404,13,20
10164,56249,443,29498,443,allow,80340,72269,8071,106,122,65,41
10165,51662,443,4972,443,allow,7532,3051,4481,13,121,6,7
10166,50584,34393,36839,34393,allow,509,150,359,2,1200,1,1
10167,56848,53,54786,53,allow,764,99,665,2,31,1,1
10168,61528,443,29665,443,allow,138544,7073,131471,165,144,59,106
10169,39617,80,39617,80,allow,419378,16035,403343,506,132,226,280
10170,37014,25174,0,0,deny,66,66,0,1,0,1,0
10171,9504,25174,0,0,deny,146,146,0,1,0,1,0
10172,53250,445,0,0,drop,70,70,0,1,0,1,0
10173,53252,445,0,0,drop,70,70,0,1,0,1,0
10174,53247,445,0,0,drop,70,70,0,1,0,1,0
10175,43747,22114,0,0,deny,62,62,0,1,0,1,0
10176,62250,23117,0,0,deny,66,66,0,1,0,1,0
10177,65038,445,0,0,drop,66,66,0,1,0,1,0
10178,61785,64147,0,0,deny,66,66,0,1,0,1,0
10179,51783,50584,0,0,deny,62,62,0,1,0,1,0
10180,40845,64147,0,0,deny,62,62,0,1,0,1,0
10181,64883,445,0,0,drop,70,70,0,1,0,1,0
10182,54502,443,10226,443,allow,6750,1755,4995,16,103,9,7
10183,65529,53,12629,53,allow,199,102,97,2,30,1,1
10184,45364,443,12194,443,allow,9276,2422,6854,25,186,14,11
10185,54518,25174,0,0,deny,62,62,0,1,0,1,0
10186,50708,22114,0,0,deny,62,62,0,1,0,1,0
10187,48350,57470,0,0,deny,74,74,0,1,0,1,0
10188,64872,445,0,0,drop,70,70,0,1,0,1,0
10189,64874,445,0,0,drop,70,70,0,1,0,1,0
10190,64871,445,0,0,drop,70,70,0,1,0,1,0
10191,53245,445,0,0,drop,70,70,0,1,0,1,0
10192,46879,37807,0,0,deny,146,146,0,1,0,1,0
10193,45941,23386,0,0,deny,60,60,0,1,0,1,0
10194,64869,445,0,0,drop,70,70,0,1,0,1,0
10195,53244,445,0,0,drop,70,70,0,1,0,1,0
10196,64867,445,0,0,drop,70,70,0,1,0,1,0
10197,55477,22114,0,0,deny,146,146,0,1,0,1,0
10198,65332,56205,0,0,deny,66,66,0,1,0,1,0
10199,54011,44847,0,0,deny,66,66,0,1,0,1,0
10200,51930,57470,0,0,deny,66,66,0,1,0,1,0
10201,2780,23117,0,0,deny,66,66,0,1,0,1,0
10202,40120,23,0,0,deny,60,60,0,1,0,1,0
10203,5826,26467,0,0,deny,62,62,0,1,0,1,0
10204,10390,26467,0,0,deny,66,66,0,1,0,1,0
10205,65023,445,0,0,drop,66,66,0,1,0,1,0
10206,65019,445,0,0,drop,66,66,0,1,0,1,0
10207,37887,22114,0,0,deny,66,66,0,1,0,1,0
10208,443,14591,0,0,deny,60,60,0,1,0,1,0
10209,4111,25174,0,0,deny,62,62,0,1,0,1,0
10210,23719,22114,0,0,deny,62,62,0,1,0,1,0
10211,68,67,0,0,deny,346,346,0,1,0,1,0
10212,64860,445,0,0,drop,70,70,0,1,0,1,0
10213,53233,445,0,0,drop,70,70,0,1,0,1,0
10214,53230,445,0,0,drop,70,70,0,1,0,1,0
10215,56738,53,8511,53,allow,264,87,177,4,37,2,2
10216,52155,63867,51864,63867,allow,70,70,0,2,7,2,0
10217,64801,53,57986,53,allow,211,102,109,2,29,1,1
10218,49240,53,11212,53,allow,199,102,97,2,29,1,1
10219,49271,53,54358,53,allow,186,102,84,2,30,1,1
10220,52125,80,43801,80,allow,2178,1003,1175,10,15,6,4
10221,57235,15187,23276,15187,allow,1269359015,948477220,320881795,1036116,9283,747520,288596
10222,50410,443,7615,443,allow,14049,602,13447,19,35,6,13
10223,43495,5223,54062,5223,allow,139,139,0,2,6,2,0
10224,64030,24096,24415,24096,allow,442,320,122,7,17,5,2
10225,34331,53,34331,53,allow,404,259,145,3,32,2,1
10226,35073,443,44227,443,allow,6201,1790,4411,24,330,13,11
10227,38708,443,36955,443,allow,90166,3481,86685,96,15,31,65
10228,62914,993,49276,993,allow,9285,4057,5228,80,45,39,41
10229,62056,443,37684,443,allow,13784,6865,6919,38,47,21,17
10230,37785,80,22917,80,allow,2293,1576,717,12,15,6,6
10231,41592,443,47156,443,allow,2913,1752,1161,15,15,9,6
10232,57691,53,57691,53,allow,247,98,149,2,32,1,1
10233,64899,53,42372,53,allow,767,102,665,2,29,1,1
10234,52156,18238,49104,18238,allow,70,70,0,2,7,2,0
10235,52157,23002,39596,23002,allow,70,70,0,2,7,2,0
10236,52158,3841,65016,3841,allow,70,70,0,2,7,2,0
10237,40839,53,42784,53,allow,78,78,0,1,29,1,0
10238,53910,1024,45263,1024,allow,70,70,0,1,4,1,0
10239,49240,53,18179,53,allow,199,102,97,2,30,1,1
10240,65282,53,39898,53,allow,193,102,91,2,30,1,1
10241,51815,443,62038,443,allow,9061,3443,5618,64,121,27,37
10242,55830,53,20748,53,allow,177,94,83,2,30,1,1
10243,59604,443,43036,443,allow,4507,1525,2982,24,147,13,11
10244,27366,5222,55342,5222,allow,3833,1007,2826,27,68,11,16
10245,62911,993,63006,993,allow,8753,4199,4554,76,54,41,35
10246,49240,53,19807,53,allow,330,101,229,4,47,2,2
10247,49271,53,62549,53,allow,178,94,84,2,30,1,1
10248,44401,53,44401,53,allow,197,90,107,2,30,1,1
10249,20341,53,20341,53,allow,225,90,135,2,30,1,1
10250,55683,53,63904,53,allow,391,134,257,2,30,1,1
10251,51647,443,26913,443,allow,6400,1830,4570,26,316,13,13
10252,41484,443,26840,443,allow,433834,12764,421070,452,32,156,296
10253,49922,53,18616,53,allow,583,105,478,4,42,2,2
10254,35202,443,16914,443,allow,10848,4083,6765,37,16,21,16
10255,35012,80,6218,80,allow,1295,572,723,12,15,7,5
10256,50472,443,48641,443,allow,251744,9600,242144,302,23,129,173
10257,57208,53,43799,53,allow,184,86,98,2,30,1,1
10258,62061,443,61994,443,allow,53531,5139,48392,75,47,34,41
10259,55706,33677,37931,33677,allow,210,140,70,4,14,3,1
10260,53853,443,28816,443,allow,3692,2154,1538,25,81,12,13
10261,50577,80,14735,80,allow,469212,19981,449231,601,134,276,325
10262,33108,22,33108,22,allow,7930,3351,4579,56,38,27,29
10263,62916,993,58185,993,allow,8832,3647,5185,77,41,35,42
10264,65529,53,2543,53,allow,199,102,97,2,30,1,1
10265,61044,53,61044,53,allow,180,82,98,2,30,1,1
10266,64610,53,2406,53,allow,292,102,190,2,30,1,1
10267,56231,53,14277,53,allow,268,94,174,2,30,1,1
10268,57161,53,62554,53,allow,196,94,102,2,30,1,1
10269,50683,443,31278,443,allow,12362,1650,10712,33,300,14,19
10270,65196,53,20787,53,allow,164,86,78,2,30,1,1
10271,62909,993,50101,993,allow,8033,4241,3792,67,54,42,25
10272,50080,5223,34413,5223,allow,10876,5991,4885,39,93,22,17
10273,65282,53,16283,53,allow,193,102,91,2,30,1,1
10274,49442,53,12597,53,allow,326,110,216,2,30,1,1
10275,65057,53,20625,53,allow,397,102,295,2,30,1,1
10276,48496,443,6861,443,allow,2661,1558,1103,18,807,7,11
10277,56840,53,4523,53,allow,242,110,132,2,30,1,1
10278,45979,80,24142,80,allow,1638,1324,314,10,15,5,5
10279,37653,443,30565,443,allow,9605,2939,6666,29,46,17,12
10280,60488,27615,36232,27615,allow,70,70,0,2,8,2,0
10281,52126,56057,8315,56057,allow,70,70,0,1,5,1,0
10282,55543,3389,55543,3389,allow,3488,1774,1714,17,32,9,8
10283,60485,13314,64825,13314,allow,70,70,0,2,8,2,0
10284,56799,443,37236,443,allow,7511,2237,5274,17,16,9,8
10285,52128,21294,45027,21294,allow,70,70,0,1,4,1,0
10286,62920,993,31712,993,allow,7974,4175,3799,65,32,40,25
10287,49163,443,41945,443,allow,2529,1230,1299,17,16,9,8
10288,65465,53,17852,53,allow,755,102,653,2,29,1,1
10289,56738,53,23984,53,allow,264,87,177,4,37,2,2
10290,56998,53,58740,53,allow,177,94,83,2,29,1,1
10291,52308,53,36287,53,allow,70,70,0,1,29,1,0
10292,65462,53,17722,53,allow,102,102,0,1,30,1,0
10293,55988,53,26621,53,allow,353,94,259,2,30,1,1
10294,60944,443,4014,443,allow,5081,896,4185,16,70,8,8
10295,40932,443,9497,443,allow,10803,4485,6318,36,345,19,17
10296,42854,443,46516,443,allow,4268,2836,1432,25,19,13,12
10297,22659,53,22659,53,allow,247,98,149,2,32,1,1
10298,52077,53,26834,53,allow,199,94,105,2,30,1,1
10299,53913,28402,8057,28402,allow,70,70,0,1,4,1,0
10300,55039,53,9278,53,allow,177,94,83,2,30,1,1
10301,55039,53,21186,53,allow,177,94,83,2,30,1,1
10302,13859,53,13859,53,allow,215,98,117,2,30,1,1
10303,64823,53,48646,53,allow,210,102,108,2,30,1,1
10304,55830,53,13004,53,allow,177,94,83,2,30,1,1
10305,49709,80,19787,80,allow,1702,1388,314,10,15,5,5
10306,65130,53,36063,53,allow,266,110,156,2,30,1,1
10307,55830,53,38726,53,allow,177,94,83,2,29,1,1
10308,56185,53,59066,53,allow,216,94,122,2,30,1,1
10309,64220,53,21263,53,allow,265,110,155,2,30,1,1
10310,59399,53,32458,53,allow,232,94,138,2,30,1,1
10311,31126,53,31126,53,allow,240,98,142,2,30,1,1
10312,56326,53,62646,53,allow,177,94,83,2,30,1,1
10313,64125,53,22287,53,allow,199,102,97,2,31,1,1
10314,58345,123,37586,123,allow,184,94,90,2,30,1,1
10315,65343,53,9995,53,allow,197,102,95,2,30,1,1
10316,65082,53,20499,53,allow,183,94,89,2,31,1,1
10317,51813,443,19561,443,allow,3182,1568,1614,8,121,4,4
10318,55293,53,52510,53,allow,230,110,120,2,30,1,1
10319,65100,53,63534,53,allow,199,102,97,2,30,1,1
10320,41139,443,57233,443,allow,9152383,160511,8991872,8428,252,2261,6167
10321,61800,3389,61800,3389,allow,3429,1474,1955,16,16,8,8
10322,35247,80,59441,80,allow,1614,1300,314,10,15,5,5
10323,41444,80,42580,80,allow,1000,577,423,10,200,6,4
10324,56439,80,9837,80,allow,17128,1499,15629,24,25,9,15
10325,49701,443,3982,443,allow,28497,1646,26851,31,138,9,22
10326,64912,53,63953,53,allow,356,118,238,2,30,1,1
10327,43853,443,27275,443,allow,6156,4764,1392,17,231,11,6
10328,32869,53,32869,53,allow,197,90,107,2,30,1,1
10329,40453,443,22159,443,allow,114,114,0,2,120,2,0
10330,65218,53,61017,53,allow,193,102,91,2,31,1,1
10331,27777,80,27777,80,allow,12281469,369857,11911612,13837,31,5536,8301
10332,34310,80,6005,80,allow,1614,1300,314,10,15,5,5
10333,44894,443,39327,443,allow,1849,1130,719,17,36,9,8
10334,50640,80,59027,80,allow,2374,936,1438,13,45,7,6
10335,62908,993,3979,993,allow,8772,3614,5158,77,54,35,42
10336,64426,53,20042,53,allow,289,101,188,4,51,2,2
10337,49582,53,29592,53,allow,168,78,90,2,30,1,1
10338,54613,53,0,0,allow,86,86,0,1,30,1,0
10339,58771,53,58771,53,allow,226,106,120,2,30,1,1
10340,12567,53,12567,53,allow,231,90,141,2,30,1,1
10341,52125,49224,3384,49224,allow,70,70,0,1,5,1,0
10342,62066,443,55561,443,allow,11816,3175,8641,32,46,16,16
10343,62915,993,36226,993,allow,8257,4187,4070,70,43,42,28
10344,65343,53,45711,53,allow,197,102,95,2,30,1,1
10345,57442,53,59819,53,allow,411,110,301,2,30,1,1
10346,51221,45722,40795,45722,allow,481,150,331,2,1200,1,1
10347,36588,5223,46105,5223,allow,4336,1518,2818,23,3005,14,9
10348,55423,53,31871,53,allow,177,94,83,2,31,1,1
10349,64259,53,65307,53,allow,211,78,133,2,31,1,1
10350,49515,53,61596,53,allow,195,102,93,2,31,1,1
10351,49516,53,19547,53,allow,183,94,89,2,31,1,1
10352,61163,443,25794,443,allow,8637,5348,3289,37,738,15,22
10353,44847,20009,63949,20009,allow,502,150,352,2,1200,1,1
10354,37965,52608,29898,52608,allow,1577,594,983,20,2766,10,10
10355,38945,443,48637,443,allow,20511,4206,16305,24,134,7,17
10356,65355,53,61445,53,allow,741,94,647,2,30,1,1
10357,65100,53,16934,53,allow,199,102,97,2,30,1,1
10358,38731,443,59272,443,allow,13181,5856,7325,23,135,11,12
10359,10151,10016,24460,10016,allow,460,150,310,2,1200,1,1
10360,30188,13384,3738,13384,allow,501,150,351,2,1200,1,1
10361,49659,443,27992,443,allow,11455,2804,8651,59,121,28,31
10362,52152,58114,40189,58114,allow,70,70,0,2,8,2,0
10363,51987,443,55315,443,allow,134,60,74,3,5,2,1
10364,50128,443,52903,443,allow,15069,5689,9380,51,35,27,24
10365,59284,443,33120,443,allow,10243,3289,6954,41,26,21,20
10366,45564,443,62998,443,allow,4851,848,4003,16,16,9,7
10367,51157,443,53397,443,allow,2791,1800,991,26,186,15,11
10368,50408,53,10616,53,allow,183,94,89,2,30,1,1
10369,20253,53,20253,53,allow,404,259,145,3,33,2,1
10370,5048,53,5048,53,allow,247,98,149,2,34,1,1
10371,19850,53,19850,53,allow,404,259,145,3,32,2,1
10372,54978,80,11814,80,allow,1448,539,909,17,32,9,8
10373,49860,53,46004,53,allow,212,102,110,2,30,1,1
10374,60484,52001,52870,52001,allow,320,140,180,6,8,3,3
10375,46202,443,10482,443,allow,19149,2846,16303,41,25,20,21
10376,58058,53,0,0,allow,86,86,0,1,30,1,0
10377,53226,445,0,0,drop,70,70,0,1,0,1,0
10378,53223,445,0,0,drop,70,70,0,1,0,1,0
10379,64363,22114,0,0,deny,66,66,0,1,0,1,0
10380,60899,25174,0,0,deny,66,66,0,1,0,1,0
10381,33814,22114,0,0,deny,62,62,0,1,0,1,0
10382,65014,445,0,0,drop,66,66,0,1,0,1,0
10383,59874,22114,0,0,deny,66,66,0,1,0,1,0
10384,27922,25174,0,0,deny,62,62,0,1,0,1,0
10385,57348,25174,0,0,deny,62,62,0,1,0,1,0
10386,3764,9694,0,0,deny,66,66,0,1,0,1,0
10387,60605,3389,0,0,deny,60,60,0,1,0,1,0
10388,9212,51505,0,0,deny,62,62,0,1,0,1,0
10389,62194,50584,0,0,deny,62,62,0,1,0,1,0
10390,39583,37965,0,0,deny,66,66,0,1,0,1,0
10391,12909,47807,0,0,deny,148,148,0,1,0,1,0
10392,50052,65008,0,0,deny,60,60,0,1,0,1,0
10393,65006,445,0,0,drop,66,66,0,1,0,1,0
10394,65009,445,0,0,drop,66,66,0,1,0,1,0
10395,65008,445,0,0,drop,66,66,0,1,0,1,0
10396,65005,445,0,0,drop,66,66,0,1,0,1,0
10397,64999,445,0,0,drop,66,66,0,1,0,1,0
10398,65002,445,0,0,drop,66,66,0,1,0,1,0
10399,65000,445,0,0,drop,66,66,0,1,0,1,0
10400,56528,64147,0,0,deny,62,62,0,1,0,1,0
10401,64853,445,0,0,drop,70,70,0,1,0,1,0
10402,28649,43890,0,0,deny,66,66,0,1,0,1,0
10403,64850,445,0,0,drop,70,70,0,1,0,1,0
10404,39063,44847,0,0,deny,66,66,0,1,0,1,0
10405,53220,445,0,0,drop,70,70,0,1,0,1,0
10406,31066,57470,0,0,deny,74,74,0,1,0,1,0
10407,53215,445,0,0,drop,70,70,0,1,0,1,0
10408,53214,445,0,0,drop,70,70,0,1,0,1,0
10409,53211,445,0,0,drop,70,70,0,1,0,1,0
10410,55155,2767,0,0,deny,66,66,0,1,0,1,0
10411,42722,56448,0,0,deny,70,70,0,1,0,1,0
10412,64846,445,0,0,drop,70,70,0,1,0,1,0
10413,52459,3399,0,0,deny,60,60,0,1,0,1,0
10414,50394,25174,0,0,deny,62,62,0,1,0,1,0
10415,43888,64147,0,0,deny,62,62,0,1,0,1,0
10416,64845,445,0,0,drop,70,70,0,1,0,1,0
10417,1280,25174,0,0,deny,66,66,0,1,0,1,0
10418,443,56513,0,0,deny,78,78,0,1,0,1,0
10419,59436,22114,0,0,deny,66,66,0,1,0,1,0
10420,19298,30188,0,0,deny,62,62,0,1,0,1,0
10421,64841,445,0,0,drop,70,70,0,1,0,1,0
10422,50637,36237,0,0,deny,66,66,0,1,0,1,0
10423,53206,445,0,0,drop,70,70,0,1,0,1,0
10424,53204,445,0,0,drop,70,70,0,1,0,1,0
10425,53203,445,0,0,drop,70,70,0,1,0,1,0
10426,47771,25174,0,0,deny,146,146,0,1,0,1,0
10427,64993,445,0,0,drop,66,66,0,1,0,1,0
10428,53202,445,0,0,drop,70,70,0,1,0,1,0
10429,64840,445,0,0,drop,70,70,0,1,0,1,0
10430,64991,445,0,0,drop,66,66,0,1,0,1,0
10431,64988,445,0,0,drop,66,66,0,1,0,1,0
10432,64987,445,0,0,drop,66,66,0,1,0,1,0
10433,64985,445,0,0,drop,66,66,0,1,0,1,0
10434,5912,22114,0,0,deny,62,62,0,1,0,1,0
10435,1660,8696,0,0,deny,62,62,0,1,0,1,0
10436,51455,53733,0,0,deny,62,62,0,1,0,1,0
10437,60579,25174,0,0,deny,62,62,0,1,0,1,0
10438,10312,23117,0,0,deny,62,62,0,1,0,1,0
10439,64835,445,0,0,drop,70,70,0,1,0,1,0
10440,48839,37807,0,0,deny,62,62,0,1,0,1,0
10441,17004,64147,0,0,deny,66,66,0,1,0,1,0
10442,53197,445,0,0,drop,70,70,0,1,0,1,0
10443,33589,23,0,0,deny,60,60,0,1,0,1,0
10444,20953,23,0,0,deny,60,60,0,1,0,1,0
10445,6247,51221,0,0,deny,62,62,0,1,0,1,0
10446,10381,22114,0,0,deny,62,62,0,1,0,1,0
10447,53193,445,0,0,drop,70,70,0,1,0,1,0
10448,53191,445,0,0,drop,70,70,0,1,0,1,0
10449,52625,25174,0,0,deny,62,62,0,1,0,1,0
10450,29512,30188,0,0,deny,66,66,0,1,0,1,0
10451,2049,32480,0,0,deny,66,66,0,1,0,1,0
10452,61761,44847,0,0,deny,66,66,0,1,0,1,0
10453,56213,26467,0,0,deny,66,66,0,1,0,1,0
10454,4748,64147,0,0,deny,66,66,0,1,0,1,0
10455,45964,2225,0,0,deny,60,60,0,1,0,1,0
10456,64975,445,0,0,deny,66,66,0,1,0,1,0
10457,13588,15503,0,0,deny,62,62,0,1,0,1,0
10458,47561,26467,0,0,deny,62,62,0,1,0,1,0
10459,64822,445,0,0,drop,70,70,0,1,0,1,0
10460,21993,25174,0,0,deny,62,62,0,1,0,1,0
10461,63136,25174,0,0,deny,62,62,0,1,0,1,0
10462,1143,25174,0,0,deny,62,62,0,1,0,1,0
10463,64967,445,0,0,drop,66,66,0,1,0,1,0
10464,53176,445,0,0,drop,70,70,0,1,0,1,0
10465,60180,31573,0,0,deny,62,62,0,1,0,1,0
10466,64819,445,0,0,drop,70,70,0,1,0,1,0
10467,2864,25174,0,0,deny,66,66,0,1,0,1,0
10468,443,14591,0,0,deny,60,60,0,1,0,1,0
10469,443,14591,0,0,deny,85,85,0,1,0,1,0
10470,443,14591,0,0,deny,100,100,0,1,0,1,0
10471,993,3979,0,0,deny,129,129,0,1,0,1,0
10472,2932,44847,0,0,deny,66,66,0,1,0,1,0
10473,64965,445,0,0,drop,66,66,0,1,0,1,0
10474,55893,45711,0,0,deny,78,78,0,1,0,1,0
10475,51430,25174,0,0,deny,62,62,0,1,0,1,0
10476,20682,57470,0,0,deny,62,62,0,1,0,1,0
10477,57585,51221,0,0,deny,62,62,0,1,0,1,0
10478,64815,445,0,0,drop,70,70,0,1,0,1,0
10479,15347,55108,0,0,deny,148,148,0,1,0,1,0
10480,64958,445,0,0,drop,66,66,0,1,0,1,0
10481,50052,65010,0,0,deny,60,60,0,1,0,1,0
10482,64813,445,0,0,drop,70,70,0,1,0,1,0
10483,64954,445,0,0,drop,66,66,0,1,0,1,0
10484,24351,57470,0,0,deny,62,62,0,1,0,1,0
10485,0,0,0,0,allow,244,244,0,2,0,2,0
10486,64811,445,0,0,drop,70,70,0,1,0,1,0
10487,53120,25174,0,0,deny,62,62,0,1,0,1,0
10488,18415,37965,0,0,deny,62,62,0,1,0,1,0
10489,59937,18375,0,0,deny,62,62,0,1,0,1,0
10490,52462,25174,0,0,deny,66,66,0,1,0,1,0
10491,62339,25174,0,0,deny,66,66,0,1,0,1,0
10492,54914,51505,0,0,deny,62,62,0,1,0,1,0
10493,63867,35993,0,0,deny,66,66,0,1,0,1,0
10494,59048,57470,0,0,deny,66,66,0,1,0,1,0
10495,68,67,0,0,deny,594,594,0,1,0,1,0
10496,53166,445,0,0,drop,70,70,0,1,0,1,0
10497,53165,445,0,0,drop,70,70,0,1,0,1,0
10498,53162,445,0,0,drop,70,70,0,1,0,1,0
10499,64940,445,0,0,drop,66,66,0,1,0,1,0
10500,64939,445,0,0,drop,66,66,0,1,0,1,0
10501,64937,445,0,0,drop,66,66,0,1,0,1,0
10502,64941,445,0,0,drop,66,66,0,1,0,1,0
10503,64936,445,0,0,drop,66,66,0,1,0,1,0
10504,64938,445,0,0,drop,66,66,0,1,0,1,0
10505,64934,445,0,0,drop,66,66,0,1,0,1,0
10506,64933,445,0,0,drop,66,66,0,1,0,1,0
10507,33886,52255,0,0,deny,162,162,0,1,0,1,0
10508,30729,22114,0,0,deny,62,62,0,1,0,1,0
10509,64804,445,0,0,drop,70,70,0,1,0,1,0
10510,59060,50584,0,0,deny,62,62,0,1,0,1,0
10511,64802,445,0,0,drop,70,70,0,1,0,1,0
10512,51615,25174,0,0,deny,62,62,0,1,0,1,0
10513,64801,445,0,0,drop,70,70,0,1,0,1,0
10514,10192,25174,0,0,deny,66,66,0,1,0,1,0
10515,64800,445,0,0,drop,70,70,0,1,0,1,0
10516,64799,445,0,0,drop,70,70,0,1,0,1,0
10517,50236,25174,0,0,deny,62,62,0,1,0,1,0
10518,64793,445,0,0,drop,70,70,0,1,0,1,0
10519,64795,445,0,0,drop,70,70,0,1,0,1,0
10520,2346,25174,0,0,deny,62,62,0,1,0,1,0
10521,36456,25174,0,0,deny,146,146,0,1,0,1,0
10522,53160,445,0,0,drop,70,70,0,1,0,1,0
10523,53157,445,0,0,drop,70,70,0,1,0,1,0
10524,53155,445,0,0,drop,70,70,0,1,0,1,0
10525,53144,445,0,0,drop,70,70,0,1,0,1,0
10526,55735,50584,0,0,deny,62,62,0,1,0,1,0
10527,26425,22114,0,0,deny,146,146,0,1,0,1,0
10528,23843,26467,0,0,deny,62,62,0,1,0,1,0
10529,63398,25174,0,0,deny,66,66,0,1,0,1,0
10530,54976,15503,0,0,deny,62,62,0,1,0,1,0
10531,64921,445,0,0,drop,66,66,0,1,0,1,0
10532,64920,445,0,0,drop,66,66,0,1,0,1,0
10533,64918,445,0,0,drop,66,66,0,1,0,1,0
10534,60527,35440,0,0,deny,66,66,0,1,0,1,0
10535,64781,445,0,0,drop,70,70,0,1,0,1,0
10536,64780,445,0,0,drop,70,70,0,1,0,1,0
10537,80,18811,0,0,deny,60,60,0,1,0,1,0
10538,64775,445,0,0,drop,70,70,0,1,0,1,0
10539,64770,445,0,0,drop,70,70,0,1,0,1,0
10540,64771,445,0,0,drop,70,70,0,1,0,1,0
10541,49336,25174,0,0,deny,66,66,0,1,0,1,0
10542,57578,51221,0,0,deny,66,66,0,1,0,1,0
10543,37522,22114,0,0,deny,62,62,0,1,0,1,0
10544,9505,443,9745,443,allow,3613,433,3180,11,16,6,5
10545,49068,443,37354,443,allow,98965,16634,82331,187,30,82,105
10546,50411,8080,50411,8080,allow,1626,798,828,11,61,6,5
10547,56088,53,17141,53,allow,774,101,673,2,30,1,1
10548,56582,53,45513,53,allow,98,98,0,1,30,1,0
10549,64426,53,47787,53,allow,289,101,188,4,50,2,2
10550,50592,443,1677,443,allow,9646,3396,6250,23,79,12,11
10551,9513,443,25594,443,allow,3615,435,3180,11,16,6,5
10552,52160,49212,45447,49212,allow,316,136,180,6,6,3,3
10553,56611,53,8939,53,allow,91,91,0,1,30,1,0
10554,62052,443,44827,443,allow,11674,2699,8975,27,48,14,13
10555,52147,30265,24438,30265,allow,70,70,0,2,8,2,0
10556,65343,53,12324,53,allow,194,99,95,2,30,1,1
10557,41892,443,2330,443,allow,2594,1280,1314,17,17,9,8
10558,41890,443,5361,443,allow,7014,1958,5056,31,18,19,12
10559,65082,53,15912,53,allow,182,93,89,2,31,1,1
10560,50109,53,61948,53,allow,768,99,669,2,30,1,1
10561,54998,53,17431,53,allow,711,87,624,2,30,1,1
10562,55797,53,14709,53,allow,735,88,647,2,30,1,1
10563,59959,80,18461,80,allow,1052,612,440,10,16,5,5
10564,64886,53,27053,53,allow,295,101,194,4,31,2,2
10565,19054,3389,19054,3389,allow,3564,1850,1714,18,35,10,8
10566,34779,443,25876,443,allow,34914,5279,29635,47,543,18,29
10567,53975,443,8391,443,allow,9782,1996,7786,30,31,14,16
10568,45390,80,63396,80,allow,16713,1698,15015,31,32,17,14
10569,54819,3389,54819,3389,allow,3327,1438,1889,15,17,8,7
10570,38635,443,21019,443,allow,4089,1965,2124,25,83,13,12
10571,55714,18904,51148,18904,allow,320,140,180,6,6,3,3
10572,34354,443,64555,443,allow,3603,562,3041,10,15,6,4
10573,9518,443,46388,443,allow,3613,433,3180,11,16,6,5
10574,52776,443,19615,443,allow,10091,2314,7777,33,17,18,15
10575,52121,58933,11142,58933,allow,66,66,0,1,5,1,0
10576,49932,53,49932,53,allow,404,259,145,3,32,2,1
10577,27316,443,39777,443,allow,9439,1890,7549,29,67,14,15
10578,51930,80,17993,80,allow,1669,865,804,13,76,8,5
10579,56712,53,57306,53,allow,170,87,83,2,31,1,1
10580,50520,80,14281,80,allow,1615,793,822,13,91,7,6
10581,49516,53,27772,53,allow,182,93,89,2,31,1,1
10582,34338,443,58177,443,allow,4542,2358,2184,20,20,11,9
10583,49339,443,48962,443,allow,3191,2313,878,17,42,10,7
10584,55434,53,17321,53,allow,1335,87,1248,4,38,2,2
10585,52151,30692,2893,30692,allow,70,70,0,2,8,2,0
10586,55423,53,7848,53,allow,170,87,83,2,30,1,1
10587,53905,50130,9021,50130,allow,552,306,246,9,16,5,4
10588,50623,443,54546,443,allow,13392,11220,2172,31,53,19,12
10589,55569,443,6204,443,allow,8049,1560,6489,19,151,9,10
10590,51814,443,41543,443,allow,6133,1655,4478,12,120,5,7
10591,50408,53,52200,53,allow,182,93,89,2,30,1,1
10592,51807,443,44757,443,allow,3561,1098,2463,10,121,5,5
10593,65228,53,60799,53,allow,267,93,174,4,47,2,2
10594,61527,443,62594,443,allow,17161,1619,15542,18,143,4,14
10595,56640,53,60510,53,allow,733,93,640,2,31,1,1
10596,51806,443,40388,443,allow,3182,1568,1614,8,121,4,4
10597,37567,443,40594,443,allow,149229,139639,9590,226,256,124,102
10598,55195,443,24998,443,allow,3543,1855,1688,20,122,10,10
10599,44131,443,6596,443,allow,6582,1943,4639,14,122,7,7
10600,64842,53,17214,53,allow,802,104,698,2,31,1,1
10601,55790,53,7477,53,allow,170,87,83,2,31,1,1
10602,55163,443,13789,443,allow,2329,505,1824,14,124,7,7
10603,58102,443,20475,443,allow,14197,9283,4914,28,122,15,13
10604,19473,6881,31231,6881,allow,490,149,341,2,1200,1,1
10605,49256,53,34162,53,allow,174,89,85,2,31,1,1
10606,56273,53,26440,53,allow,182,93,89,2,31,1,1
10607,58383,53,25867,53,allow,357,87,270,2,31,1,1
10608,54979,53,3280,53,allow,97,97,0,1,61,1,0
10609,56830,53,57872,53,allow,190,97,93,2,31,1,1
10610,56524,443,60258,443,allow,759397,22470,736927,766,108,270,496
10611,54444,443,16103,443,allow,6275,3787,2488,17,147,8,9
10612,54403,443,27679,443,allow,3486,924,2562,13,122,6,7
10613,57470,16414,19962,16414,allow,726,726,0,12,1200,12,0
10614,30960,45750,9630,45750,allow,66,66,0,1,3600,1,0
10615,14447,25174,0,0,deny,62,62,0,1,0,1,0
10616,26651,25174,0,0,deny,62,62,0,1,0,1,0
10617,53142,445,0,0,drop,70,70,0,1,0,1,0
10618,14447,25174,0,0,deny,146,146,0,1,0,1,0
10619,58608,62413,0,0,deny,66,66,0,1,0,1,0
10620,49754,35440,0,0,deny,62,62,0,1,0,1,0
10621,53138,445,0,0,drop,70,70,0,1,0,1,0
10622,53133,445,0,0,drop,70,70,0,1,0,1,0
10623,53132,445,0,0,drop,70,70,0,1,0,1,0
10624,39393,22114,0,0,deny,146,146,0,1,0,1,0
10625,61002,26314,0,0,deny,143,143,0,1,0,1,0
10626,64759,445,0,0,drop,70,70,0,1,0,1,0
10627,63538,80,37199,80,allow,578,518,60,2,5,1,1
10628,54145,7000,54145,7000,allow,3370,1595,1775,16,15,9,7
10629,65266,53,11513,53,allow,754,94,660,2,30,1,1
10630,23844,26467,0,0,deny,62,62,0,1,0,1,0
10631,52112,22114,0,0,deny,66,66,0,1,0,1,0
10632,53123,445,0,0,drop,70,70,0,1,0,1,0
10633,53120,445,0,0,drop,70,70,0,1,0,1,0
10634,53119,445,0,0,drop,70,70,0,1,0,1,0
10635,56388,22114,0,0,deny,66,66,0,1,0,1,0
10636,59966,37965,0,0,deny,66,66,0,1,0,1,0
10637,58897,23,0,0,deny,60,60,0,1,0,1,0
10638,18116,37807,0,0,deny,62,62,0,1,0,1,0
10639,64755,445,0,0,drop,70,70,0,1,0,1,0
10640,64908,445,0,0,drop,66,66,0,1,0,1,0
10641,11754,25174,0,0,deny,62,62,0,1,0,1,0
10642,19209,62413,0,0,deny,146,146,0,1,0,1,0
10643,1024,25174,0,0,deny,62,62,0,1,0,1,0
10644,49370,11392,0,0,deny,62,62,0,1,0,1,0
10645,12348,50265,0,0,deny,62,62,0,1,0,1,0
10646,64744,445,0,0,drop,70,70,0,1,0,1,0
10647,64746,445,0,0,drop,70,70,0,1,0,1,0
10648,64743,445,0,0,drop,70,70,0,1,0,1,0
10649,46116,57470,0,0,deny,74,74,0,1,0,1,0
10650,64740,445,0,0,drop,70,70,0,1,0,1,0
10651,64739,445,0,0,drop,70,70,0,1,0,1,0
10652,1794,22114,0,0,deny,146,146,0,1,0,1,0
10653,53117,445,0,0,drop,70,70,0,1,0,1,0
10654,38549,22114,0,0,deny,62,62,0,1,0,1,0
10655,51754,18375,0,0,deny,66,66,0,1,0,1,0
10656,53116,445,0,0,drop,70,70,0,1,0,1,0
10657,7619,50584,0,0,deny,62,62,0,1,0,1,0
10658,55079,25174,0,0,deny,62,62,0,1,0,1,0
10659,18570,2323,0,0,deny,60,60,0,1,0,1,0
10660,7435,62609,0,0,deny,148,148,0,1,0,1,0
10661,64892,445,0,0,drop,66,66,0,1,0,1,0
10662,64890,445,0,0,drop,66,66,0,1,0,1,0
10663,55406,25174,0,0,deny,66,66,0,1,0,1,0
10664,37826,23,0,0,deny,60,60,0,1,0,1,0
10665,31066,57470,0,0,deny,74,74,0,1,0,1,0
10666,8760,22114,0,0,deny,66,66,0,1,0,1,0
10667,55620,30188,0,0,deny,66,66,0,1,0,1,0
10668,64733,445,0,0,drop,70,70,0,1,0,1,0
10669,64989,50265,0,0,deny,66,66,0,1,0,1,0
10670,52827,25174,0,0,deny,62,62,0,1,0,1,0
10671,25579,23,0,0,deny,60,60,0,1,0,1,0
10672,12596,53,12596,53,allow,197,90,107,2,30,1,1
10673,45412,53,45412,53,allow,220,90,130,2,30,1,1
10674,58748,443,1980,443,allow,522925,36953,485972,799,229,304,495
10675,60801,40010,50650,40010,allow,316,136,180,6,6,3,3
10676,52150,37603,39264,37603,allow,70,70,0,2,7,2,0
10677,52123,46261,33776,46261,allow,70,70,0,1,4,1,0
10678,52120,42751,45034,42751,allow,70,70,0,1,5,1,0
10679,54573,80,38100,80,allow,2091,823,1268,12,45,7,5
10680,49991,53,62734,53,allow,257,102,155,2,29,1,1
10681,50433,53,63561,53,allow,193,102,91,2,29,1,1
10682,55760,443,34599,443,allow,4344,2974,1370,22,94,12,10
10683,46542,443,1363,443,allow,5916,1144,4772,20,17,11,9
10684,61808,443,61318,443,allow,8189,3146,5043,26,30,14,12
10685,50081,443,6983,443,allow,18754,5240,13514,31,16,15,16
10686,53907,45622,15618,45622,allow,70,70,0,1,4,1,0
10687,59250,443,54786,443,allow,12632,3678,8954,42,27,23,19
10688,50129,443,27980,443,allow,29436,9695,19741,54,34,30,24
10689,58894,443,56665,443,allow,354,294,60,2,4,1,1
10690,64040,12226,50739,12226,allow,70,70,0,1,4,1,0
10691,52098,80,42506,80,allow,1955,913,1042,10,15,6,4
10692,53901,44425,38536,44425,allow,1686,890,796,10,15,6,4
10693,65228,53,63836,53,allow,267,93,174,4,46,2,2
10694,64674,53,13295,53,allow,183,94,89,2,29,1,1
10695,53119,53,39459,53,allow,326,102,224,2,29,1,1
10696,54818,3389,54818,3389,allow,3409,1454,1955,16,16,8,8
10697,64986,53,51778,53,allow,734,94,640,2,29,1,1
10698,57106,53,23546,53,allow,214,94,120,2,29,1,1
10699,41008,53,32302,53,allow,168,78,90,2,29,1,1
10700,64488,53,18852,53,allow,291,102,189,2,29,1,1
10701,65196,53,56319,53,allow,172,94,78,2,29,1,1
10702,64674,53,50248,53,allow,183,94,89,2,29,1,1
10703,50148,53,50148,53,allow,198,90,108,2,29,1,1
10704,50433,53,29987,53,allow,193,102,91,2,30,1,1
10705,50559,53,33553,53,allow,178,94,84,2,29,1,1
10706,55340,53,25572,53,allow,324,110,214,2,29,1,1
10707,65365,53,21509,53,allow,178,94,84,2,29,1,1
10708,49708,53,32399,53,allow,178,94,84,2,30,1,1
10709,55417,53,4838,53,allow,199,102,97,2,30,1,1
10710,49364,53,30235,53,allow,183,94,89,2,30,1,1
10711,46484,22,46484,22,allow,7922,3413,4509,55,38,26,29
10712,64270,53,47275,53,allow,455,102,353,4,33,2,2
10713,56712,53,17239,53,allow,177,94,83,2,30,1,1
10714,65104,53,20417,53,allow,198,94,104,2,30,1,1
10715,49364,53,20144,53,allow,183,94,89,2,30,1,1
10716,64705,53,6395,53,allow,213,102,111,2,30,1,1
10717,56611,53,54736,53,allow,181,94,87,2,32,1,1
10718,41482,443,54813,443,allow,1062197,37438,1024759,1129,31,416,713
10719,50376,443,64568,443,allow,7738,879,6859,19,27,10,9
10720,65343,53,45519,53,allow,328,99,229,4,45,2,2
10721,55843,53,63569,53,allow,177,94,83,2,30,1,1
10722,9510,443,20445,443,allow,3615,435,3180,11,15,6,5
10723,49518,53,62825,53,allow,266,110,156,2,30,1,1
10724,55423,53,51640,53,allow,177,94,83,2,30,1,1
10725,49413,53,49413,53,allow,225,90,135,2,30,1,1
10726,64258,53,3209,53,allow,260,86,174,2,30,1,1
10727,55487,53,39202,53,allow,195,102,93,2,30,1,1
10728,56997,53,32024,53,allow,273,102,171,2,30,1,1
10729,64125,53,26967,53,allow,199,102,97,2,30,1,1
10730,64718,53,58761,53,allow,266,110,156,2,30,1,1
10731,26940,53,26940,53,allow,197,90,107,2,30,1,1
10732,50579,53,23674,53,allow,179,94,85,2,30,1,1
10733,40216,443,24772,443,allow,10196,2175,8021,25,186,14,11
10734,49932,53,55615,53,allow,195,102,93,2,30,1,1
10735,56712,53,47464,53,allow,177,94,83,2,30,1,1
10736,55417,53,14562,53,allow,199,102,97,2,30,1,1
10737,50404,8080,50404,8080,allow,11938,4533,7405,33,98,20,13
10738,55944,53,13576,53,allow,194,94,100,2,30,1,1
10739,65324,53,23853,53,allow,748,94,654,2,30,1,1
10740,40781,443,52827,443,allow,448,78,370,7,20,2,5
10741,57260,53,31217,53,allow,211,102,109,2,30,1,1
10742,58000,17,58000,17,allow,66,66,0,1,30,1,0
10743,36712,53,0,0,allow,139,70,69,2,30,1,1
10744,49312,53,27461,53,allow,772,102,670,2,30,1,1
10745,49708,53,64935,53,allow,178,94,84,2,30,1,1
10746,52122,43073,59163,43073,allow,70,70,0,1,5,1,0
10747,56532,53,29846,53,allow,291,88,203,4,50,2,2
10748,51852,443,17719,443,allow,1382291,55962,1326329,1491,24,582,909
10749,59522,443,54778,443,allow,8743,2676,6067,30,25,16,14
10750,55217,443,55217,443,allow,3239,740,2499,15,40,8,7
10751,58418,443,64364,443,allow,15305,3334,11971,45,198,21,24
10752,45376,80,8854,80,allow,2259,1068,1191,12,31,8,4
10753,65228,53,34659,53,allow,267,93,174,4,46,2,2
10754,35311,80,30298,80,allow,947,376,571,8,14,5,3
10755,53246,5222,38090,5222,allow,10577,3496,7081,68,616,36,32
10756,32100,53,32100,53,allow,200,90,110,2,29,1,1
10757,60482,2924,18303,2924,allow,320,140,180,6,7,3,3
10758,64674,53,62663,53,allow,183,94,89,2,29,1,1
10759,60877,443,6098,443,allow,8536,2392,6144,29,45,17,12
10760,3851,53,3851,53,allow,235,90,145,2,33,1,1
10761,49515,53,58908,53,allow,195,102,93,2,29,1,1
10762,46324,443,40837,443,allow,24465,3945,20520,39,18,18,21
10763,44718,80,25526,80,allow,4336,2408,1928,18,21,10,8
10764,56738,53,54145,53,allow,264,87,177,4,36,2,2
10765,50424,53,64071,53,allow,195,102,93,2,29,1,1
10766,63877,53,63877,53,allow,247,98,149,2,32,1,1
10767,52149,52188,59594,52188,allow,70,70,0,2,8,2,0
10768,64897,53,12641,53,allow,266,110,156,2,30,1,1
10769,51716,5223,22569,5223,allow,4524,1489,3035,26,1327,15,11
10770,51385,443,10522,443,allow,8388,760,7628,20,145,6,14
10771,60873,443,24507,443,allow,10707,2969,7738,32,47,18,14
10772,65269,53,18855,53,allow,226,102,124,2,30,1,1
10773,56830,53,55667,53,allow,195,102,93,2,30,1,1
10774,58473,443,15678,443,allow,3120,1862,1258,18,15,11,7
10775,55423,53,64857,53,allow,177,94,83,2,30,1,1
10776,60367,53,22365,53,allow,233,110,123,2,30,1,1
10777,58396,80,29243,80,allow,1088,599,489,13,315,7,6
10778,56326,53,18129,53,allow,177,94,83,2,29,1,1
10779,52221,53,60196,53,allow,164,78,86,2,29,1,1
10780,10034,53,10034,53,allow,215,98,117,2,29,1,1
10781,50424,53,47336,53,allow,195,102,93,2,30,1,1
10782,11906,53,11906,53,allow,220,90,130,2,30,1,1
10783,51197,443,47968,443,allow,3211,781,2430,17,135,8,9
10784,64125,53,18557,53,allow,199,102,97,2,30,1,1
10785,55843,53,38678,53,allow,177,94,83,2,30,1,1
10786,65331,53,20706,53,allow,767,102,665,2,29,1,1
10787,49575,53,46030,53,allow,775,102,673,2,29,1,1
10788,45395,53,0,0,allow,86,86,0,1,30,1,0
10789,55291,53,55867,53,allow,243,94,149,2,31,1,1
10790,49516,53,32390,53,allow,183,94,89,2,31,1,1
10791,64886,53,36555,53,allow,199,102,97,2,30,1,1
10792,65092,53,7341,53,allow,197,102,95,2,30,1,1
10793,55908,53,13210,53,allow,389,110,279,2,30,1,1
10794,49752,53,13383,53,allow,199,86,113,2,31,1,1
10795,49852,53,14933,53,allow,230,102,128,2,31,1,1
10796,50378,443,14135,443,allow,7738,879,6859,19,27,10,9
10797,64987,53,8755,53,allow,357,107,250,4,36,2,2
10798,9500,443,23639,443,allow,3614,434,3180,11,15,6,5
10799,62499,443,53888,443,allow,1332,876,456,11,26,6,5
10800,49482,53,61985,53,allow,460,84,376,4,46,2,2
10801,63672,53,63672,53,allow,198,90,108,2,30,1,1
10802,4773,53,4773,53,allow,197,90,107,2,30,1,1
10803,49516,53,40491,53,allow,183,94,89,2,30,1,1
10804,49926,53,10749,53,allow,266,110,156,2,30,1,1
10805,57505,443,24632,443,allow,3640,606,3034,13,120,6,7
10806,65287,53,18878,53,allow,180,94,86,2,31,1,1
10807,50675,80,44462,80,allow,1658,1247,411,8,15,5,3
10808,50377,443,39949,443,allow,7738,879,6859,19,27,10,9
10809,49297,80,62329,80,allow,16249,1328,14921,28,45,14,14
10810,56582,53,45398,53,allow,196,102,94,2,33,1,1
10811,55702,80,29070,80,allow,70,70,0,1,5,1,0
10812,49183,53,29082,53,allow,451,91,360,4,36,2,2
10813,52089,443,10472,443,allow,15525,1642,13883,32,16,16,16
10814,9506,443,29564,443,allow,3614,434,3180,11,15,6,5
10815,64426,53,6048,53,allow,289,101,188,4,50,2,2
10816,22078,53,22078,53,allow,229,98,131,2,30,1,1
10817,65413,53,65505,53,allow,266,110,156,2,30,1,1
10818,65082,53,43263,53,allow,183,94,89,2,30,1,1
10819,65098,53,11310,53,allow,260,94,166,2,30,1,1
10820,56427,53,1277,53,allow,178,94,84,2,30,1,1
10821,9520,443,43478,443,allow,3614,434,3180,11,15,6,5
10822,52148,29104,12286,29104,allow,70,70,0,2,8,2,0
10823,52119,49239,52121,49239,allow,160,70,90,2,5,1,1
10824,50624,80,47844,80,allow,12701,9788,2913,29,52,16,13
10825,49708,53,16944,53,allow,178,94,84,2,30,1,1
10826,30353,53,30353,53,allow,200,90,110,2,30,1,1
10827,48070,53,48070,53,allow,197,90,107,2,30,1,1
10828,55487,53,11679,53,allow,195,102,93,2,30,1,1
10829,34517,53,34517,53,allow,200,82,118,2,30,1,1
10830,59002,53,19057,53,allow,238,94,144,2,30,1,1
10831,59045,53,10960,53,allow,231,110,121,2,30,1,1
10832,33281,53,7345,53,allow,86,86,0,1,30,1,0
10833,64576,443,9952,443,allow,7069,1210,5859,13,120,6,7
10834,55163,53,20116,53,allow,197,102,95,2,31,1,1
10835,64958,53,42023,53,allow,197,102,95,2,31,1,1
10836,57470,29633,40389,29633,allow,1660,677,983,20,1595,10,10
10837,54550,443,8260,443,allow,3296,1329,1967,14,135,7,7
10838,52118,33515,33825,33515,allow,70,70,0,1,5,1,0
10839,50593,80,24582,80,allow,2365,1068,1297,13,79,7,6
10840,65228,53,51061,53,allow,267,93,174,4,46,2,2
10841,65218,53,49451,53,allow,193,102,91,2,30,1,1
10842,55866,53,10182,53,allow,257,94,163,2,30,1,1
10843,49932,53,14546,53,allow,195,102,93,2,30,1,1
10844,49727,53,64244,53,allow,280,110,170,2,31,1,1
10845,49942,53,37670,53,allow,196,94,102,2,31,1,1
10846,49709,53,49112,53,allow,466,93,373,4,50,2,2
10847,62498,443,43471,443,allow,14786,3978,10808,32,26,15,17
10848,50583,80,63777,80,allow,2226,1077,1149,13,79,7,6
10849,53900,45682,23799,45682,allow,492,306,186,8,15,5,3
10850,64037,18592,48496,18592,allow,70,70,0,1,5,1,0
10851,50578,80,29631,80,allow,1791,900,891,14,79,7,7
10852,51466,443,58507,443,allow,7638,1758,5880,24,17,13,11
10853,49256,53,11555,53,allow,179,94,85,2,30,1,1
10854,15986,8000,55850,8000,allow,212,150,62,2,30,1,1
10855,55812,53,26314,53,allow,215,94,121,2,30,1,1
10856,65493,53,48274,53,allow,266,110,156,2,30,1,1
10857,65257,53,51798,53,allow,266,110,156,2,30,1,1
10858,53107,445,0,0,drop,70,70,0,1,0,1,0
10859,53106,445,0,0,drop,70,70,0,1,0,1,0
10860,53104,445,0,0,drop,70,70,0,1,0,1,0
10861,53102,445,0,0,drop,70,70,0,1,0,1,0
10862,64887,445,0,0,drop,66,66,0,1,0,1,0
10863,56534,60043,0,0,deny,145,145,0,1,0,1,0
10864,64725,445,0,0,drop,70,70,0,1,0,1,0
10865,6712,5060,0,0,deny,410,410,0,1,0,1,0
10866,49393,30188,0,0,deny,66,66,0,1,0,1,0
10867,64723,445,0,0,drop,70,70,0,1,0,1,0
10868,12226,37965,0,0,deny,62,62,0,1,0,1,0
10869,39941,2767,0,0,deny,62,62,0,1,0,1,0
10870,58504,57470,0,0,deny,62,62,0,1,0,1,0
10871,64873,445,0,0,drop,66,66,0,1,0,1,0
10872,64879,445,0,0,drop,66,66,0,1,0,1,0
10873,64876,445,0,0,drop,66,66,0,1,0,1,0
10874,64882,445,0,0,drop,66,66,0,1,0,1,0
10875,64878,445,0,0,drop,66,66,0,1,0,1,0
10876,64874,445,0,0,drop,66,66,0,1,0,1,0
10877,64881,445,0,0,drop,66,66,0,1,0,1,0
10878,42228,51050,0,0,deny,66,66,0,1,0,1,0
10879,5831,22114,0,0,deny,62,62,0,1,0,1,0
10880,53090,445,0,0,drop,70,70,0,1,0,1,0
10881,54666,36237,0,0,deny,62,62,0,1,0,1,0
10882,63334,37807,0,0,deny,66,66,0,1,0,1,0
10883,53086,445,0,0,drop,70,70,0,1,0,1,0
10884,53085,445,0,0,drop,70,70,0,1,0,1,0
10885,53083,445,0,0,drop,70,70,0,1,0,1,0
10886,64719,445,0,0,drop,70,70,0,1,0,1,0
10887,64717,445,0,0,drop,70,70,0,1,0,1,0
10888,10126,57470,0,0,deny,62,62,0,1,0,1,0
10889,57782,57470,0,0,deny,66,66,0,1,0,1,0
10890,39570,62413,0,0,deny,146,146,0,1,0,1,0
10891,443,46223,0,0,deny,66,66,0,1,0,1,0
10892,59326,57470,0,0,deny,74,74,0,1,0,1,0
10893,49160,44512,0,0,deny,146,146,0,1,0,1,0
10894,64713,445,0,0,drop,70,70,0,1,0,1,0
10895,56562,44847,0,0,deny,66,66,0,1,0,1,0
10896,64712,445,0,0,drop,70,70,0,1,0,1,0
10897,53077,445,0,0,drop,70,70,0,1,0,1,0
10898,53078,445,0,0,drop,70,70,0,1,0,1,0
10899,53076,445,0,0,drop,70,70,0,1,0,1,0
10900,64863,445,0,0,drop,66,66,0,1,0,1,0
10901,3559,51050,0,0,deny,146,146,0,1,0,1,0
10902,53074,445,0,0,drop,70,70,0,1,0,1,0
10903,64862,445,0,0,drop,66,66,0,1,0,1,0
10904,16119,57470,0,0,deny,145,145,0,1,0,1,0
10905,62550,51505,0,0,deny,62,62,0,1,0,1,0
10906,64858,445,0,0,drop,66,66,0,1,0,1,0
10907,64860,445,0,0,drop,66,66,0,1,0,1,0
10908,64856,445,0,0,drop,66,66,0,1,0,1,0
10909,31281,30188,0,0,deny,62,62,0,1,0,1,0
10910,17289,25174,0,0,deny,146,146,0,1,0,1,0
10911,64707,445,0,0,drop,70,70,0,1,0,1,0
10912,6832,51505,0,0,deny,66,66,0,1,0,1,0
10913,51413,54751,0,0,deny,136,136,0,1,0,1,0
10914,28305,25773,0,0,reset-both,148,148,0,1,0,1,0
10915,64847,22114,0,0,deny,66,66,0,1,0,1,0
10916,40155,25174,0,0,deny,66,66,0,1,0,1,0
10917,61382,25174,0,0,deny,62,62,0,1,0,1,0
10918,6881,6881,0,0,deny,62,62,0,1,0,1,0
10919,53068,445,0,0,drop,70,70,0,1,0,1,0
10920,38755,22114,0,0,deny,66,66,0,1,0,1,0
10921,53061,445,0,0,drop,70,70,0,1,0,1,0
10922,53060,445,0,0,drop,70,70,0,1,0,1,0
10923,22547,48817,0,0,deny,72,72,0,1,0,1,0
10924,50077,443,55619,443,allow,1786,172,1614,7,0,3,4
10925,62400,35993,0,0,deny,66,66,0,1,0,1,0
10926,15333,60043,0,0,deny,62,62,0,1,0,1,0
10927,56639,48817,0,0,deny,66,66,0,1,0,1,0
10928,45964,2228,0,0,deny,60,60,0,1,0,1,0
10929,53071,25174,0,0,deny,66,66,0,1,0,1,0
10930,3524,25174,0,0,deny,66,66,0,1,0,1,0
10931,64846,445,0,0,drop,66,66,0,1,0,1,0
10932,61898,50584,0,0,deny,66,66,0,1,0,1,0
10933,19330,25174,0,0,deny,146,146,0,1,0,1,0
10934,15499,22114,0,0,deny,146,146,0,1,0,1,0
10935,64694,445,0,0,drop,70,70,0,1,0,1,0
10936,49160,46824,0,0,deny,146,146,0,1,0,1,0
10937,13285,29892,0,0,deny,145,145,0,1,0,1,0
10938,25565,42779,0,0,deny,60,60,0,1,0,1,0
10939,36154,47807,0,0,deny,146,146,0,1,0,1,0
10940,60337,30188,0,0,deny,66,66,0,1,0,1,0
10941,59803,22114,0,0,deny,62,62,0,1,0,1,0
10942,62043,25174,0,0,deny,62,62,0,1,0,1,0
10943,64691,445,0,0,drop,70,70,0,1,0,1,0
10944,64838,445,0,0,drop,66,66,0,1,0,1,0
10945,53048,445,0,0,drop,70,70,0,1,0,1,0
10946,44334,26467,0,0,deny,62,62,0,1,0,1,0
10947,60049,25174,0,0,deny,66,66,0,1,0,1,0
10948,64835,445,0,0,drop,66,66,0,1,0,1,0
10949,54280,3385,0,0,deny,60,60,0,1,0,1,0
10950,51414,50584,0,0,deny,66,66,0,1,0,1,0
10951,3478,45401,0,0,deny,109,109,0,1,0,1,0
10952,64686,445,0,0,drop,70,70,0,1,0,1,0
10953,64685,445,0,0,drop,70,70,0,1,0,1,0
10954,64828,445,0,0,drop,66,66,0,1,0,1,0
10955,27055,25174,0,0,deny,62,62,0,1,0,1,0
10956,57293,25174,0,0,deny,146,146,0,1,0,1,0
10957,64683,445,0,0,drop,70,70,0,1,0,1,0
10958,25009,35440,0,0,deny,66,66,0,1,0,1,0
10959,64819,445,0,0,drop,66,66,0,1,0,1,0
10960,49514,52255,0,0,deny,162,162,0,1,0,1,0
10961,32132,25174,0,0,deny,62,62,0,1,0,1,0
10962,61406,1,0,0,deny,78,78,0,1,0,1,0
10963,20619,25174,0,0,deny,66,66,0,1,0,1,0
10964,52640,64147,0,0,deny,62,62,0,1,0,1,0
10965,6486,64147,0,0,deny,66,66,0,1,0,1,0
10966,54189,22114,0,0,deny,66,66,0,1,0,1,0
10967,53036,445,0,0,drop,70,70,0,1,0,1,0
10968,58079,50584,0,0,deny,66,66,0,1,0,1,0
10969,64676,445,0,0,drop,70,70,0,1,0,1,0
10970,10144,62609,0,0,deny,148,148,0,1,0,1,0
10971,53038,445,0,0,drop,70,70,0,1,0,1,0
10972,53034,445,0,0,drop,70,70,0,1,0,1,0
10973,64812,445,0,0,drop,66,66,0,1,0,1,0
10974,64809,445,0,0,drop,66,66,0,1,0,1,0
10975,64808,445,0,0,drop,66,66,0,1,0,1,0
10976,64811,445,0,0,drop,66,66,0,1,0,1,0
10977,64804,445,0,0,drop,66,66,0,1,0,1,0
10978,64807,445,0,0,drop,66,66,0,1,0,1,0
10979,64805,445,0,0,drop,66,66,0,1,0,1,0
10980,64806,445,0,0,drop,66,66,0,1,0,1,0
10981,54542,25604,0,0,deny,66,66,0,1,0,1,0
10982,64674,445,0,0,drop,70,70,0,1,0,1,0
10983,25457,25604,0,0,deny,62,62,0,1,0,1,0
10984,16052,25174,0,0,deny,146,146,0,1,0,1,0
10985,6122,23,0,0,deny,60,60,0,1,0,1,0
10986,34932,38608,0,0,deny,62,62,0,1,0,1,0
10987,64673,445,0,0,drop,70,70,0,1,0,1,0
10988,30583,25174,0,0,deny,66,66,0,1,0,1,0
10989,64672,445,0,0,drop,70,70,0,1,0,1,0
10990,64671,445,0,0,drop,70,70,0,1,0,1,0
10991,57013,53,60365,53,allow,172,88,84,2,30,1,1
10992,65176,53,35365,53,allow,182,93,89,2,30,1,1
10993,56070,53,35943,53,allow,770,101,669,2,30,1,1
10994,53437,443,53437,443,allow,4198,2498,1700,25,102,12,13
10995,53250,443,53250,443,allow,1464,757,707,18,121,9,9
10996,48173,443,63016,443,allow,4342,2152,2190,19,255,10,9
10997,64788,53,47380,53,allow,168,86,82,2,30,1,1
10998,56414,53,17231,53,allow,88,88,0,1,30,1,0
10999,64622,53,5676,53,allow,738,86,652,2,30,1,1
11000,53251,443,53251,443,allow,1404,697,707,17,121,8,9
11001,61797,23,61797,23,allow,60,60,0,1,5,1,0
11002,50320,80,20341,80,allow,50565,32661,17904,77,167,39,38
11003,50595,80,62524,80,allow,2049,1065,984,15,78,8,7
11004,55985,53,19393,53,allow,738,86,652,2,30,1,1
11005,56273,53,59580,53,allow,182,93,89,2,30,1,1
11006,39932,80,45032,80,allow,3472,2124,1348,14,21,8,6
11007,49332,443,62500,443,allow,27727,1971,25756,51,80,21,30
11008,53249,443,53249,443,allow,1404,697,707,17,121,8,9
11009,57395,53,14755,53,allow,262,88,174,4,59,2,2
11010,56878,53,24786,53,allow,168,86,82,2,31,1,1
11011,56018,53,52062,53,allow,762,97,665,2,30,1,1
11012,56540,443,45404,443,allow,103117,6206,96911,127,106,54,73
11013,53248,443,53248,443,allow,1588,817,771,20,121,10,10
11014,48174,443,2102,443,allow,3889,1992,1897,19,255,10,9
11015,54144,7000,54144,7000,allow,3018,1627,1391,16,15,9,7
11016,26941,443,39877,443,allow,8466,3146,5320,30,20,15,15
11017,49932,53,48698,53,allow,190,97,93,2,30,1,1
11018,57887,53,44516,53,allow,174,81,93,2,30,1,1
11019,50622,80,45334,80,allow,11907,10409,1498,28,52,16,12
11020,49333,443,11751,443,allow,30571,1990,28581,53,80,21,32
11021,50285,443,10190,443,allow,18009,7378,10631,58,62,33,25
11022,36883,80,30047,80,allow,114410,3755,110655,128,38,47,81
11023,65422,443,52517,443,allow,2494,1643,851,17,23,9,8
11024,57356,53,43032,53,allow,780,93,687,2,30,1,1
11025,56415,53,6839,53,allow,198,101,97,2,30,1,1
11026,57287,53,44650,53,allow,752,93,659,2,30,1,1
11027,54652,53,54652,53,allow,216,98,118,2,30,1,1
11028,44355,80,33572,80,allow,26085,2508,23577,52,38,29,23
11029,42020,80,16578,80,allow,42657,2962,39695,68,38,36,32
11030,53213,443,51742,443,allow,8451,2320,6131,25,104,13,12
11031,50588,80,47890,80,allow,9116,7610,1506,22,78,12,10
11032,9416,443,41034,443,allow,6090,773,5317,17,25,9,8
11033,59007,443,65066,443,allow,2608,1523,1085,19,15,10,9
11034,53233,443,53233,443,allow,4114,2535,1579,25,139,13,12
11035,50621,80,31852,80,allow,11975,10368,1607,27,52,16,11
11036,53246,443,53246,443,allow,1419,788,631,15,121,8,7
11037,50665,443,26812,443,allow,374,192,182,7,28,4,3
11038,26989,80,26989,80,allow,256062,8754,247308,297,18,124,173
11039,52115,10012,62951,10012,allow,66,66,0,1,5,1,0
11040,34043,443,15753,443,allow,7280,4154,3126,30,735,16,14
11041,53247,443,53247,443,allow,1528,757,771,19,121,9,10
11042,65218,53,51807,53,allow,186,95,91,2,30,1,1
11043,52164,443,52164,443,allow,20480,2066,18414,37,17,19,18
11044,11295,40040,53425,40040,allow,213,89,124,4,54,2,2
11045,45908,33330,45908,33330,allow,124,60,64,3,5,2,1
11046,58369,53,5499,53,allow,174,81,93,2,30,1,1
11047,41889,443,23289,443,allow,6516,1722,4794,26,17,15,11
11048,56289,53,51620,53,allow,749,89,660,2,30,1,1
11049,7275,13487,0,0,allow,66,66,0,1,91,1,0
11050,6881,51413,17965,51413,allow,150,150,0,1,1200,1,0
11051,55370,53,18357,53,allow,747,93,654,2,31,1,1
11052,55970,53,19238,53,allow,760,97,663,2,31,1,1
11053,55284,443,12539,443,allow,2895,726,2169,10,121,5,5
11054,50479,443,34516,443,allow,5491,2608,2883,17,122,8,9
11055,56964,53,51072,53,allow,174,89,85,2,31,1,1
11056,55492,53,58378,53,allow,760,96,664,2,31,1,1
11057,56217,53,54817,53,allow,182,93,89,2,31,1,1
11058,51566,443,53596,443,allow,3051,990,2061,14,135,7,7
11059,55566,443,9542,443,allow,8426,4752,3674,37,122,18,19
11060,44513,443,46778,443,allow,3698,1302,2396,13,136,6,7
11061,34170,80,19669,80,allow,1298,473,825,16,392,5,11
11062,55163,53,35742,53,allow,194,99,95,2,31,1,1
11063,49695,53,13184,53,allow,772,103,669,2,31,1,1
11064,64958,53,26216,53,allow,194,99,95,2,31,1,1
11065,65287,53,9876,53,allow,176,90,86,2,31,1,1
11066,56562,53,48636,53,allow,182,93,89,2,31,1,1
11067,57129,53,40985,53,allow,793,101,692,2,31,1,1
11068,6355,25174,0,0,deny,146,146,0,1,0,1,0
11069,64665,445,0,0,drop,70,70,0,1,0,1,0
11070,64666,445,0,0,drop,70,70,0,1,0,1,0
11071,55439,37965,0,0,deny,66,66,0,1,0,1,0
11072,49418,22114,0,0,deny,66,66,0,1,0,1,0
11073,54473,37807,0,0,deny,66,66,0,1,0,1,0
11074,53032,445,0,0,drop,70,70,0,1,0,1,0
11075,53028,445,0,0,drop,70,70,0,1,0,1,0
11076,53026,445,0,0,drop,70,70,0,1,0,1,0
11077,53021,445,0,0,drop,70,70,0,1,0,1,0
11078,64653,445,0,0,drop,70,70,0,1,0,1,0
11079,64652,445,0,0,drop,70,70,0,1,0,1,0
11080,64650,445,0,0,drop,70,70,0,1,0,1,0
11081,64792,445,0,0,drop,66,66,0,1,0,1,0
11082,64790,445,0,0,drop,66,66,0,1,0,1,0
11083,64789,445,0,0,drop,66,66,0,1,0,1,0
11084,64642,445,0,0,drop,70,70,0,1,0,1,0
11085,64643,445,0,0,drop,70,70,0,1,0,1,0
11086,23218,62413,0,0,deny,66,66,0,1,0,1,0
11087,43260,41615,0,0,deny,145,145,0,1,0,1,0
11088,58101,46314,0,0,deny,72,72,0,1,0,1,0
11089,53015,445,0,0,drop,70,70,0,1,0,1,0
11090,37308,43890,0,0,deny,62,62,0,1,0,1,0
11091,64808,27098,0,0,deny,66,66,0,1,0,1,0
11092,62580,23,0,0,deny,60,60,0,1,0,1,0
11093,53010,445,0,0,drop,70,70,0,1,0,1,0
11094,53007,445,0,0,drop,70,70,0,1,0,1,0
11095,53004,445,0,0,drop,70,70,0,1,0,1,0
11096,55985,44847,0,0,deny,62,62,0,1,0,1,0
11097,11228,25174,0,0,deny,66,66,0,1,0,1,0
11098,36339,50584,0,0,deny,146,146,0,1,0,1,0
11099,13021,25174,0,0,deny,146,146,0,1,0,1,0
11100,59032,25174,0,0,deny,66,66,0,1,0,1,0
11101,64631,445,0,0,drop,70,70,0,1,0,1,0
11102,13418,22,0,0,deny,60,60,0,1,0,1,0
11103,61550,5529,0,0,deny,145,145,0,1,0,1,0
11104,11235,30188,0,0,deny,66,66,0,1,0,1,0
11105,52231,50934,0,0,deny,62,62,0,1,0,1,0
11106,29884,25174,0,0,deny,62,62,0,1,0,1,0
11107,34112,44847,0,0,deny,62,62,0,1,0,1,0
11108,50765,22114,0,0,deny,66,66,0,1,0,1,0
11109,52996,445,0,0,drop,70,70,0,1,0,1,0
11110,52994,445,0,0,drop,70,70,0,1,0,1,0
11111,52990,445,0,0,drop,70,70,0,1,0,1,0
11112,6121,51505,0,0,deny,66,66,0,1,0,1,0
11113,64627,445,0,0,drop,70,70,0,1,0,1,0
11114,44919,26467,0,0,deny,62,62,0,1,0,1,0
11115,1480,12447,0,0,deny,66,66,0,1,0,1,0
11116,5213,44847,0,0,deny,62,62,0,1,0,1,0
11117,64778,445,0,0,drop,66,66,0,1,0,1,0
11118,61057,25174,0,0,deny,62,62,0,1,0,1,0
11119,64617,445,0,0,drop,70,70,0,1,0,1,0
11120,64618,445,0,0,drop,70,70,0,1,0,1,0
11121,64615,445,0,0,drop,70,70,0,1,0,1,0
11122,55451,56205,0,0,deny,66,66,0,1,0,1,0
11123,65231,50584,0,0,deny,62,62,0,1,0,1,0
11124,47403,57470,0,0,deny,109,109,0,1,0,1,0
11125,64613,445,0,0,drop,70,70,0,1,0,1,0
11126,64611,445,0,0,drop,70,70,0,1,0,1,0
11127,59097,2767,0,0,deny,66,66,0,1,0,1,0
11128,59807,53,15491,53,allow,263,94,169,2,30,1,1
11129,52098,443,38562,443,allow,3015,2037,978,15,15,9,6
11130,53433,443,53433,443,allow,15095,2556,12539,37,102,15,22
11131,49874,53,62950,53,allow,196,94,102,2,30,1,1
11132,46751,53,46751,53,allow,220,90,130,2,30,1,1
11133,64788,53,23511,53,allow,168,86,82,2,30,1,1
11134,38626,443,25389,443,allow,97751,9140,88611,115,82,39,76
11135,22075,53,22075,53,allow,404,259,145,3,33,2,1
11136,53167,22083,1777,22083,allow,70,70,0,2,8,2,0
11137,64038,28187,42501,28187,allow,70,70,0,1,4,1,0
11138,57999,80,9823,80,allow,5434,3724,1710,26,76,14,12
11139,54530,443,34587,443,allow,6202,3033,3169,28,167,13,15
11140,49256,53,36401,53,allow,179,94,85,2,29,1,1
11141,49729,53,55522,53,allow,210,102,108,2,30,1,1
11142,55790,53,39330,53,allow,177,94,83,2,30,1,1
11143,38562,443,38562,443,allow,4611,1704,2907,19,28,11,8
11144,50385,80,53379,80,allow,28942,2526,26416,39,25,16,23
11145,55179,443,6638,443,allow,5839,1984,3855,19,18,11,8
11146,64426,53,39298,53,allow,669,200,469,6,49,3,3
11147,60985,443,55270,443,allow,11535,4866,6669,34,50,20,14
11148,35017,443,23449,443,allow,826,362,464,13,30,6,7
11149,53245,443,53245,443,allow,1220,659,561,13,120,7,6
11150,37646,443,54992,443,allow,11821,3643,8178,30,45,17,13
11151,53282,443,7574,443,allow,604924,37384,567540,846,154,315,531
11152,40335,443,28601,443,allow,4397,2104,2293,29,85,11,18
11153,49934,53,18444,53,allow,478,107,371,4,39,2,2
11154,64032,12343,46737,12343,allow,630,508,122,9,15,7,2
11155,60483,57723,53854,57723,allow,320,140,180,6,6,3,3
11156,52146,18174,42084,18174,allow,70,70,0,2,7,2,0
11157,53435,443,53435,443,allow,2503,1457,1046,21,102,10,11
11158,56427,53,25251,53,allow,178,94,84,2,29,1,1
11159,49532,53,58267,53,allow,334,92,242,4,49,2,2
11160,56534,53,14913,53,allow,177,94,83,2,29,1,1
11161,64886,53,49173,53,allow,199,102,97,2,29,1,1
11162,56830,53,25316,53,allow,195,102,93,2,29,1,1
11163,64886,53,44785,53,allow,199,102,97,2,29,1,1
11164,56081,53,46764,53,allow,186,102,84,2,29,1,1
11165,56712,53,4358,53,allow,177,94,83,2,30,1,1
11166,65176,53,65083,53,allow,183,94,89,2,30,1,1
11167,55991,53,30604,53,allow,183,94,89,2,30,1,1
11168,51994,80,37899,80,allow,366,240,126,7,26,5,2
11169,52148,80,52148,80,allow,62796,1961,60835,72,141,26,46
11170,58832,443,61522,443,allow,274798,9459,265339,343,201,136,207
11171,65488,53,3940,53,allow,266,110,156,2,30,1,1
11172,57013,53,17393,53,allow,178,94,84,2,30,1,1
11173,55700,53,12317,53,allow,337,110,227,2,30,1,1
11174,55588,53,33689,53,allow,168,86,82,2,31,1,1
11175,52153,12673,40206,12673,allow,316,136,180,6,6,3,3
11176,33525,53,64644,53,allow,179,86,93,2,30,1,1
11177,59019,53,48512,53,allow,179,86,93,2,30,1,1
11178,64324,53,5232,53,allow,344,105,239,4,33,2,2
11179,65460,53,23650,53,allow,184,94,90,2,30,1,1
11180,54710,443,54710,443,allow,32709,8467,24242,54,20,29,25
11181,52143,33283,63927,33283,allow,70,70,0,2,8,2,0
11182,56661,53,2934,53,allow,288,93,195,4,32,2,2
11183,52005,80,9480,80,allow,46046,2705,43341,60,15,29,31
11184,37629,443,33990,443,allow,172,172,0,2,5,2,0
11185,45694,80,47472,80,allow,154671,9533,145138,227,38,121,106
11186,60797,28080,55300,28080,allow,70,70,0,1,5,1,0
11187,65249,53,14438,53,allow,1579,94,1485,4,36,2,2
11188,52114,64853,36038,64853,allow,70,70,0,1,5,1,0
11189,60872,443,60963,443,allow,10306,3254,7052,32,47,18,14
11190,53122,80,53122,80,allow,19237,829,18408,29,15,13,16
11191,38627,443,6493,443,allow,32864,2590,30274,41,82,14,27
11192,24566,53,24566,53,allow,216,90,126,2,30,1,1
11193,49980,53,10608,53,allow,503,103,400,4,47,2,2
11194,13003,3389,13003,3389,allow,3424,1710,1714,16,33,8,8
11195,56937,8200,55532,8200,allow,78,78,0,1,30,1,0
11196,64110,53,20636,53,allow,215,102,113,2,30,1,1
11197,49358,443,12762,443,allow,137147,82203,54944,174,105,103,71
11198,49776,53,49776,53,allow,256,114,142,2,30,1,1
11199,56565,53,34463,53,allow,164,86,78,2,30,1,1
11200,1876,53,51383,53,allow,404,261,143,3,30,2,1
11201,56830,53,56847,53,allow,195,102,93,2,30,1,1
11202,50378,53,48801,53,allow,184,94,90,2,30,1,1
11203,53466,443,35377,443,allow,7866,2625,5241,25,120,11,14
11204,49225,443,22877,443,allow,11707,2326,9381,28,19,14,14
11205,49422,53,49422,53,allow,247,98,149,2,32,1,1
11206,56661,53,16607,53,allow,288,93,195,4,32,2,2
11207,47042,80,50684,80,allow,1122,682,440,11,15,6,5
11208,60984,443,58411,443,allow,12163,4876,7287,35,50,20,15
11209,38619,443,65221,443,allow,469799,14616,455183,474,129,155,319
11210,57254,443,6263,443,allow,3948,1290,2658,13,120,6,7
11211,51973,80,57539,80,allow,426,240,186,8,26,5,3
11212,56556,443,40496,443,allow,8908,1849,7059,31,105,17,14
11213,41474,443,57047,443,allow,2767442,82304,2685138,2961,85,1088,1873
11214,31089,53,31089,53,allow,197,90,107,2,30,1,1
11215,56406,53,15140,53,allow,213,102,111,2,30,1,1
11216,57183,53,32090,53,allow,178,94,84,2,30,1,1
11217,52176,443,22865,443,allow,8048,1360,6688,24,23,12,12
11218,50620,80,32710,80,allow,16709,10372,6337,31,52,16,15
11219,50586,80,48187,80,allow,6718,3126,3592,16,78,8,8
11220,50596,80,46998,80,allow,1598,937,661,13,78,7,6
11221,50579,80,47300,80,allow,1827,989,838,13,78,7,6
11222,50590,80,16341,80,allow,1507,951,556,13,78,7,6
11223,56661,53,21967,53,allow,288,93,195,4,32,2,2
11224,52144,15208,25879,15208,allow,70,70,0,2,8,2,0
11225,52003,80,9765,80,allow,88807,5957,82850,113,15,54,59
11226,53434,443,53434,443,allow,2511,1464,1047,21,102,10,11
11227,50668,80,30546,80,allow,24370,5713,18657,37,26,17,20
11228,64865,53,49871,53,allow,305,97,208,4,53,2,2
11229,57395,53,40276,53,allow,262,88,174,4,58,2,2
11230,55524,53,55524,53,allow,197,90,107,2,29,1,1
11231,58414,53,7367,53,allow,245,118,127,2,29,1,1
11232,54961,53,50012,53,allow,211,102,109,2,29,1,1
11233,53911,1025,4663,1025,allow,70,70,0,1,4,1,0
11234,55690,443,36462,443,allow,914,444,470,14,29,7,7
11235,56534,53,47047,53,allow,177,94,83,2,29,1,1
11236,65092,53,28213,53,allow,197,102,95,2,29,1,1
11237,65087,53,28763,53,allow,229,94,135,2,30,1,1
11238,44176,443,60900,443,allow,3327,1940,1387,19,22,10,9
11239,41473,443,44182,443,allow,4987881,144889,4842992,5257,85,1888,3369
11240,53897,46913,50139,46913,allow,552,306,246,9,15,5,4
11241,62497,443,15059,443,allow,10393,7059,3334,27,26,15,12
11242,41283,53,41283,53,allow,247,98,149,2,31,1,1
11243,55790,53,54535,53,allow,177,94,83,2,30,1,1
11244,49656,443,43316,443,allow,19544,4428,15116,79,119,39,40
11245,65482,53,62841,53,allow,374,91,283,4,33,2,2
11246,57395,53,64683,53,allow,262,88,174,4,58,2,2
11247,52116,64692,3805,64692,allow,70,70,0,1,5,1,0
11248,59748,53,55446,53,allow,230,110,120,2,29,1,1
11249,56415,53,33684,53,allow,199,102,97,2,29,1,1
11250,59582,53,61781,53,allow,256,102,154,2,29,1,1
11251,55626,53,3780,53,allow,319,126,193,2,29,1,1
11252,51971,80,56168,80,allow,426,240,186,8,26,5,3
11253,53715,53,53715,53,allow,216,98,118,2,29,1,1
11254,52149,80,52149,80,allow,2928,694,2234,13,141,6,7
11255,65266,53,53450,53,allow,233,102,131,2,29,1,1
11256,56081,53,27644,53,allow,186,102,84,2,29,1,1
11257,64058,53,58322,53,allow,280,110,170,2,30,1,1
11258,56415,53,13196,53,allow,199,102,97,2,29,1,1
11259,57177,443,54507,443,allow,1610,771,839,22,120,11,11
11260,65176,53,64926,53,allow,183,94,89,2,29,1,1
11261,64424,53,20113,53,allow,194,94,100,2,30,1,1
11262,49165,53,42494,53,allow,257,126,131,2,30,1,1
11263,58555,443,6848,443,allow,15546,2361,13185,39,123,18,21
11264,50051,53,51528,53,allow,766,102,664,2,30,1,1
11265,55991,53,7983,53,allow,183,94,89,2,30,1,1
11266,53438,443,53438,443,allow,2511,1465,1046,21,102,10,11
11267,33876,53,33876,53,allow,404,259,145,3,32,2,1
11268,64749,53,28339,53,allow,199,94,105,2,33,1,1
11269,55230,53,65301,53,allow,467,96,371,4,44,2,2
11270,57984,80,44496,80,allow,5474,3658,1816,27,76,14,13
11271,64237,53,55167,53,allow,199,86,113,2,30,1,1
11272,65161,53,65161,53,allow,256,114,142,2,30,1,1
11273,56415,53,9528,53,allow,199,102,97,2,30,1,1
11274,33651,53,33651,53,allow,197,90,107,2,30,1,1
11275,49218,53,31585,53,allow,179,86,93,2,30,1,1
11276,55914,53,21562,53,allow,212,102,110,2,30,1,1
11277,55163,53,9459,53,allow,197,102,95,2,30,1,1
11278,46658,53,46658,53,allow,216,98,118,2,30,1,1
11279,55792,53,55035,53,allow,199,102,97,2,30,1,1
11280,49790,53,8407,53,allow,229,110,119,2,30,1,1
11281,55790,53,27986,53,allow,177,94,83,2,30,1,1
11282,64958,53,60361,53,allow,197,102,95,2,30,1,1
11283,41810,443,22241,443,allow,7474,2385,5089,15,121,7,8
11284,53548,443,18610,443,allow,6812,1127,5685,24,255,11,13
11285,52117,20600,3356,20600,allow,70,70,0,1,5,1,0
11286,62045,443,52563,443,allow,10467,4259,6208,65,56,38,27
11287,64407,53,28727,53,allow,291,94,197,2,30,1,1
11288,49759,53,39321,53,allow,201,86,115,2,30,1,1
11289,65184,53,30460,53,allow,225,102,123,2,30,1,1
11290,56273,53,28560,53,allow,183,94,89,2,30,1,1
11291,65287,53,16028,53,allow,180,94,86,2,30,1,1
11292,56068,53,21388,53,allow,214,102,112,2,30,1,1
11293,53436,443,53436,443,allow,2505,1460,1045,21,102,10,11
11294,37924,80,11096,80,allow,214,140,74,4,15,3,1
11295,51972,80,30646,80,allow,426,240,186,8,26,5,3
11296,54143,7000,54143,7000,allow,770727,19843,750884,802,16,295,507
11297,49430,443,49430,443,allow,4377,1470,2907,19,30,11,8
11298,57395,53,28814,53,allow,262,88,174,4,59,2,2
11299,64922,53,12906,53,allow,255,102,153,2,30,1,1
11300,64530,53,5563,53,allow,264,110,154,2,30,1,1
11301,56565,53,24401,53,allow,164,86,78,2,30,1,1
11302,56911,53,22477,53,allow,211,78,133,2,30,1,1
11303,57013,53,1233,53,allow,178,94,84,2,30,1,1
11304,49256,53,62875,53,allow,179,94,85,2,30,1,1
11305,49932,53,43257,53,allow,195,102,93,2,30,1,1
11306,51463,53,6551,53,allow,417,86,331,2,31,1,1
11307,56217,53,61344,53,allow,183,94,89,2,31,1,1
11308,50109,53,52643,53,allow,198,110,88,2,31,1,1
11309,49334,53,44213,53,allow,194,102,92,2,31,1,1
11310,64467,53,16595,53,allow,184,94,90,2,31,1,1
11311,57183,53,6659,53,allow,178,94,84,2,31,1,1
11312,55163,53,4604,53,allow,197,102,95,2,31,1,1
11313,56195,53,13348,53,allow,194,94,100,2,30,1,1
11314,56648,53,16460,53,allow,199,102,97,2,31,1,1
11315,64995,53,32873,53,allow,210,110,100,2,31,1,1
11316,56622,53,41480,53,allow,179,94,85,2,31,1,1
11317,46440,443,14076,443,allow,8465,3202,5263,23,120,10,13
11318,53246,443,25270,443,allow,6574,1935,4639,14,121,7,7
11319,36972,443,35947,443,allow,7557,3602,3955,20,150,12,8
11320,56964,53,57920,53,allow,179,94,85,2,30,1,1
11321,64467,53,4748,53,allow,184,94,90,2,30,1,1
11322,55633,53,30545,53,allow,195,102,93,2,30,1,1
11323,49993,53,3383,53,allow,211,102,109,2,30,1,1
11324,39890,123,28941,123,allow,184,94,90,2,30,1,1
11325,65059,53,30320,53,allow,168,86,82,2,31,1,1
11326,56878,53,49284,53,allow,168,86,82,2,31,1,1
11327,56225,53,55911,53,allow,183,94,89,2,31,1,1
11328,56414,53,33736,53,allow,178,94,84,2,31,1,1
11329,21133,51413,27138,51413,allow,460,150,310,2,1199,1,1
11330,43261,53,43261,53,allow,247,98,149,2,34,1,1
11331,57432,53,57432,53,allow,247,98,149,2,34,1,1
11332,65218,53,25461,53,allow,833,290,543,8,88,4,4
11333,60886,443,45692,443,allow,12652,6172,6480,44,16,26,18
11334,37628,443,18772,443,allow,70,70,0,2,5,2,0
11335,9486,443,47731,443,allow,3642,421,3221,12,16,6,6
11336,41475,443,20491,443,allow,1251209,30056,1221153,1238,85,386,852
11337,59488,80,65175,80,allow,1114,534,580,12,16,7,5
11338,61387,43890,0,0,deny,66,66,0,1,0,1,0
11339,28436,22114,0,0,deny,146,146,0,1,0,1,0
11340,52989,445,0,0,drop,70,70,0,1,0,1,0
11341,22542,30188,0,0,deny,62,62,0,1,0,1,0
11342,52988,445,0,0,drop,70,70,0,1,0,1,0
11343,64727,25174,0,0,deny,66,66,0,1,0,1,0
11344,59153,35440,0,0,deny,66,66,0,1,0,1,0
11345,47632,25174,0,0,deny,62,62,0,1,0,1,0
11346,7891,25174,0,0,deny,66,66,0,1,0,1,0
11347,9329,2323,0,0,deny,60,60,0,1,0,1,0
11348,64763,445,0,0,drop,66,66,0,1,0,1,0
11349,64765,445,0,0,drop,66,66,0,1,0,1,0
11350,64605,445,0,0,drop,70,70,0,1,0,1,0
11351,25889,11446,0,0,deny,66,66,0,1,0,1,0
11352,51042,22114,0,0,deny,66,66,0,1,0,1,0
11353,50946,44847,0,0,deny,66,66,0,1,0,1,0
11354,14489,25174,0,0,deny,146,146,0,1,0,1,0
11355,64343,6004,0,0,deny,66,66,0,1,0,1,0
11356,47342,20541,0,0,deny,66,66,0,1,0,1,0
11357,59326,57470,0,0,deny,74,74,0,1,0,1,0
11358,52977,445,0,0,drop,70,70,0,1,0,1,0
11359,52978,445,0,0,drop,70,70,0,1,0,1,0
11360,52974,445,0,0,drop,70,70,0,1,0,1,0
11361,52976,445,0,0,drop,70,70,0,1,0,1,0
11362,63743,25174,0,0,deny,62,62,0,1,0,1,0
11363,3090,1,0,0,deny,66,66,0,1,0,1,0
11364,64597,445,0,0,drop,70,70,0,1,0,1,0
11365,31619,51221,0,0,deny,62,62,0,1,0,1,0
11366,34166,22114,0,0,deny,146,146,0,1,0,1,0
11367,64596,445,0,0,drop,70,70,0,1,0,1,0
11368,64758,445,0,0,drop,66,66,0,1,0,1,0
11369,54142,20541,0,0,deny,62,62,0,1,0,1,0
11370,64751,445,0,0,drop,66,66,0,1,0,1,0
11371,64746,445,0,0,drop,66,66,0,1,0,1,0
11372,64749,445,0,0,drop,66,66,0,1,0,1,0
11373,64748,445,0,0,drop,66,66,0,1,0,1,0
11374,64744,445,0,0,drop,66,66,0,1,0,1,0
11375,64745,445,0,0,drop,66,66,0,1,0,1,0
11376,64742,445,0,0,drop,66,66,0,1,0,1,0
11377,64591,445,0,0,drop,70,70,0,1,0,1,0
11378,52962,445,0,0,drop,70,70,0,1,0,1,0
11379,64589,445,0,0,drop,70,70,0,1,0,1,0
11380,2919,37965,0,0,deny,62,62,0,1,0,1,0
11381,60308,37965,0,0,deny,66,66,0,1,0,1,0
11382,26921,26467,0,0,deny,62,62,0,1,0,1,0
11383,52959,445,0,0,drop,70,70,0,1,0,1,0
11384,52958,445,0,0,drop,70,70,0,1,0,1,0
11385,52955,445,0,0,drop,70,70,0,1,0,1,0
11386,46275,64147,0,0,deny,62,62,0,1,0,1,0
11387,64772,64147,0,0,deny,66,66,0,1,0,1,0
11388,61730,25320,0,0,deny,66,66,0,1,0,1,0
11389,55069,44847,0,0,deny,66,66,0,1,0,1,0
11390,25619,25174,0,0,deny,146,146,0,1,0,1,0
11391,64585,445,0,0,drop,70,70,0,1,0,1,0
11392,59782,26467,0,0,deny,62,62,0,1,0,1,0
11393,56826,22114,0,0,deny,66,66,0,1,0,1,0
11394,36858,50265,0,0,deny,146,146,0,1,0,1,0
11395,14208,51221,0,0,deny,66,66,0,1,0,1,0
11396,64583,445,0,0,drop,70,70,0,1,0,1,0
11397,27841,35894,0,0,deny,62,62,0,1,0,1,0
11398,13528,51221,0,0,deny,62,62,0,1,0,1,0
11399,4138,55777,0,0,deny,66,66,0,1,0,1,0
11400,65025,57866,0,0,deny,62,62,0,1,0,1,0
11401,31845,55777,0,0,deny,62,62,0,1,0,1,0
11402,52951,445,0,0,drop,70,70,0,1,0,1,0
11403,52949,445,0,0,drop,70,70,0,1,0,1,0
11404,52950,445,0,0,drop,70,70,0,1,0,1,0
11405,64737,445,0,0,drop,66,66,0,1,0,1,0
11406,52946,445,0,0,drop,70,70,0,1,0,1,0
11407,49929,26467,0,0,deny,66,66,0,1,0,1,0
11408,64733,445,0,0,drop,66,66,0,1,0,1,0
11409,3981,23117,0,0,deny,66,66,0,1,0,1,0
11410,36548,25174,0,0,deny,146,146,0,1,0,1,0
11411,60479,25174,0,0,deny,66,66,0,1,0,1,0
11412,64730,445,0,0,drop,66,66,0,1,0,1,0
11413,64729,445,0,0,drop,66,66,0,1,0,1,0
11414,64579,445,0,0,drop,70,70,0,1,0,1,0
11415,64727,445,0,0,drop,66,66,0,1,0,1,0
11416,5955,55160,0,0,deny,74,74,0,1,0,1,0
11417,443,56513,0,0,deny,78,78,0,1,0,1,0
11418,17280,22114,0,0,deny,62,62,0,1,0,1,0
11419,26879,37965,0,0,deny,62,62,0,1,0,1,0
11420,443,54154,0,0,deny,60,60,0,1,0,1,0
11421,64295,26467,0,0,deny,66,66,0,1,0,1,0
11422,52941,445,0,0,drop,70,70,0,1,0,1,0
11423,443,28553,0,0,deny,74,74,0,1,0,1,0
11424,52932,445,0,0,drop,70,70,0,1,0,1,0
11425,52931,445,0,0,drop,70,70,0,1,0,1,0
11426,64016,25174,0,0,deny,62,62,0,1,0,1,0
11427,52430,22114,0,0,deny,62,62,0,1,0,1,0
11428,57420,22114,0,0,deny,62,62,0,1,0,1,0
11429,56614,25174,0,0,deny,66,66,0,1,0,1,0
11430,55587,43890,0,0,deny,66,66,0,1,0,1,0
11431,64566,445,0,0,drop,70,70,0,1,0,1,0
11432,64716,445,0,0,drop,66,66,0,1,0,1,0
11433,35356,25174,0,0,deny,146,146,0,1,0,1,0
11434,59214,57866,0,0,deny,66,66,0,1,0,1,0
11435,26802,50584,0,0,deny,62,62,0,1,0,1,0
11436,64563,445,0,0,drop,70,70,0,1,0,1,0
11437,57131,35776,0,0,deny,145,145,0,1,0,1,0
11438,18113,22114,0,0,deny,146,146,0,1,0,1,0
11439,53097,25174,0,0,deny,62,62,0,1,0,1,0
11440,56406,22114,0,0,deny,62,62,0,1,0,1,0
11441,64708,445,0,0,drop,66,66,0,1,0,1,0
11442,28570,25174,0,0,deny,146,146,0,1,0,1,0
11443,52918,445,0,0,drop,70,70,0,1,0,1,0
11444,15701,37965,0,0,deny,146,146,0,1,0,1,0
11445,56387,25174,0,0,deny,62,62,0,1,0,1,0
11446,62575,12207,0,0,deny,66,66,0,1,0,1,0
11447,63587,22114,0,0,deny,146,146,0,1,0,1,0
11448,55312,64147,0,0,deny,66,66,0,1,0,1,0
11449,64705,445,0,0,drop,66,66,0,1,0,1,0
11450,64559,445,0,0,drop,70,70,0,1,0,1,0
11451,64557,445,0,0,drop,70,70,0,1,0,1,0
11452,8999,8055,0,0,deny,146,146,0,1,0,1,0
11453,53161,51221,0,0,deny,66,66,0,1,0,1,0
11454,38330,44847,0,0,deny,66,66,0,1,0,1,0
11455,64555,445,0,0,drop,70,70,0,1,0,1,0
11456,53381,25174,0,0,deny,66,66,0,1,0,1,0
11457,61660,64097,0,0,deny,62,62,0,1,0,1,0
11458,64698,445,0,0,drop,66,66,0,1,0,1,0
11459,4232,50584,0,0,deny,66,66,0,1,0,1,0
11460,58007,62413,0,0,deny,66,66,0,1,0,1,0
11461,64689,445,0,0,drop,66,66,0,1,0,1,0
11462,15806,11392,0,0,deny,66,66,0,1,0,1,0
11463,49684,80,60336,80,allow,13889,4084,9805,27,16,13,14
11464,52108,20175,4699,20175,allow,66,66,0,1,5,1,0
11465,37642,443,20516,443,allow,69348,4180,65168,86,45,37,49
11466,60389,80,65223,80,allow,2499,531,1968,11,125,6,5
11467,56480,80,24972,80,allow,289731,8487,281244,294,136,104,190
11468,56482,80,53743,80,allow,180583,6825,173758,188,136,68,120
11469,44977,443,32272,443,allow,4848,1030,3818,16,26,9,7
11470,56922,53,43765,53,allow,86,86,0,1,30,1,0
11471,60388,80,7152,80,allow,2424,529,1895,11,125,6,5
11472,50375,443,2479,443,allow,5419,705,4714,16,25,8,8
11473,50367,443,43632,443,allow,1630,916,714,12,25,7,5
11474,50366,443,19959,443,allow,1755,986,769,13,25,8,5
11475,55390,443,55390,443,allow,164571,13257,151314,206,19,95,111
11476,65073,80,65073,80,allow,169702,10513,159189,187,23,72,115
11477,56481,80,14814,80,allow,71347,4788,66559,83,136,34,49
11478,58874,443,22621,443,allow,4738,1023,3715,18,66,10,8
11479,64473,7000,64473,7000,allow,3434,1595,1839,17,15,9,8
11480,45079,443,33534,443,allow,7298,2661,4637,21,18,11,10
11481,49627,53,55437,53,allow,760,97,663,2,30,1,1
11482,64051,19548,46632,19548,allow,66,66,0,2,8,2,0
11483,52142,54954,50454,54954,allow,70,70,0,2,8,2,0
11484,64056,51266,62758,51266,allow,66,66,0,2,8,2,0
11485,37640,443,4915,443,allow,11442,3116,8326,32,46,19,13
11486,60498,443,60498,443,allow,8233,948,7285,18,30,10,8
11487,36951,443,31916,443,allow,70,70,0,1,5,1,0
11488,37632,443,56701,443,allow,11338,2980,8358,31,46,18,13
11489,56478,80,51578,80,allow,73400,4542,68858,87,136,37,50
11490,41895,443,48920,443,allow,282,60,222,5,14,2,3
11491,51979,80,40174,80,allow,366,240,126,7,25,5,2
11492,60478,30889,28285,30889,allow,1303,903,400,12,16,7,5
11493,55991,53,53761,53,allow,182,93,89,2,30,1,1
11494,64945,53,11913,53,allow,760,97,663,2,30,1,1
11495,56483,80,37968,80,allow,82266,4947,77319,94,136,37,57
11496,50604,443,49840,443,allow,7470,2479,4991,20,135,9,11
11497,51980,80,2288,80,allow,366,240,126,7,25,5,2
11498,49951,80,49951,80,allow,24361943,451235,23910708,22804,63,6533,16271
11499,34346,443,57407,443,allow,3497,1845,1652,18,15,9,9
11500,54142,7000,54142,7000,allow,4067,1750,2317,16,16,9,7
11501,43357,443,31552,443,allow,6392,1099,5293,18,33,10,8
11502,53906,12051,58772,12051,allow,164,70,94,2,5,1,1
11503,57183,53,27398,53,allow,172,88,84,2,30,1,1
11504,52109,60841,45067,60841,allow,156,66,90,2,5,1,1
11505,52110,35411,30183,35411,allow,66,66,0,1,5,1,0
11506,49328,443,21805,443,allow,74569,3173,71396,97,80,36,61
11507,64432,53,46411,53,allow,168,86,82,2,30,1,1
11508,56622,53,20942,53,allow,174,89,85,2,31,1,1
11509,55594,53,44459,53,allow,752,93,659,2,31,1,1
11510,50022,53,60834,53,allow,174,89,85,2,31,1,1
11511,56258,53,50751,53,allow,772,103,669,2,30,1,1
11512,64467,53,11977,53,allow,184,94,90,2,30,1,1
11513,64702,53,11324,53,allow,760,97,663,2,31,1,1
11514,64580,53,16498,53,allow,176,90,86,2,31,1,1
11515,56125,53,8463,53,allow,168,86,82,2,31,1,1
11516,56239,53,24103,53,allow,176,90,86,2,31,1,1
11517,56648,53,6533,53,allow,198,101,97,2,31,1,1
11518,57040,53,44476,53,allow,174,89,85,2,31,1,1
11519,56153,53,6546,53,allow,742,88,654,2,31,1,1
11520,54340,443,13340,443,allow,3176,752,2424,10,121,5,5
11521,63601,443,6476,443,allow,26835,2611,24224,36,121,14,22
11522,54329,443,7872,443,allow,7827,2416,5411,18,136,8,10
11523,46525,5228,57899,5228,allow,1410,933,477,11,3601,6,5
11524,64995,53,18804,53,allow,204,104,100,2,31,1,1
11525,56198,53,15932,53,allow,789,110,679,2,31,1,1
11526,64839,53,19060,53,allow,208,106,102,2,31,1,1
11527,56143,53,31546,53,allow,748,106,642,2,31,1,1
11528,60896,53,29321,53,allow,168,78,90,2,31,1,1
11529,56820,53,32969,53,allow,186,95,91,2,31,1,1
11530,55662,53,51499,53,allow,753,93,660,2,31,1,1
11531,57836,443,52669,443,allow,15844,1691,14153,18,138,5,13
11532,65412,53,28937,53,allow,782,105,677,2,31,1,1
11533,56827,53,43714,53,allow,190,97,93,2,31,1,1
11534,65409,53,26325,53,allow,753,93,660,2,31,1,1
11535,65531,53,43079,53,allow,186,95,91,2,31,1,1
11536,56792,53,2003,53,allow,782,105,677,2,31,1,1
11537,56928,53,48986,53,allow,172,88,84,2,31,1,1
11538,50550,443,16736,443,allow,4551,2140,2411,14,135,6,8
11539,51683,5228,43500,5228,allow,9476,2759,6717,27,3601,15,12
11540,56468,53,40699,53,allow,1421,97,1324,4,55,2,2
11541,57440,53,36326,53,allow,198,101,97,2,31,1,1
11542,40458,53,17783,53,allow,168,78,90,2,31,1,1
11543,49900,443,9178,443,allow,6300,2644,3656,16,121,8,8
11544,57470,39541,8082,39541,allow,792,792,0,13,1200,13,0
11545,49485,56972,0,0,deny,66,66,0,1,0,1,0
11546,37014,25174,0,0,deny,66,66,0,1,0,1,0
11547,57251,37965,0,0,deny,62,62,0,1,0,1,0
11548,48978,25174,0,0,deny,66,66,0,1,0,1,0
11549,42981,44847,0,0,deny,62,62,0,1,0,1,0
11550,62250,23117,0,0,deny,66,66,0,1,0,1,0
11551,64548,445,0,0,drop,70,70,0,1,0,1,0
11552,59282,51050,0,0,deny,62,62,0,1,0,1,0
11553,64546,445,0,0,drop,70,70,0,1,0,1,0
11554,52907,445,0,0,drop,70,70,0,1,0,1,0
11555,52906,445,0,0,drop,70,70,0,1,0,1,0
11556,64675,445,0,0,drop,66,66,0,1,0,1,0
11557,64678,445,0,0,drop,66,66,0,1,0,1,0
11558,64679,445,0,0,drop,66,66,0,1,0,1,0
11559,64681,445,0,0,drop,66,66,0,1,0,1,0
11560,64683,445,0,0,drop,66,66,0,1,0,1,0
11561,64682,445,0,0,drop,66,66,0,1,0,1,0
11562,64680,445,0,0,drop,66,66,0,1,0,1,0
11563,64677,445,0,0,drop,66,66,0,1,0,1,0
11564,48676,53395,0,0,deny,60,60,0,1,0,1,0
11565,44285,25174,0,0,deny,146,146,0,1,0,1,0
11566,60113,22114,0,0,deny,66,66,0,1,0,1,0
11567,59303,21247,0,0,deny,62,62,0,1,0,1,0
11568,64545,445,0,0,drop,70,70,0,1,0,1,0
11569,26884,37965,0,0,deny,66,66,0,1,0,1,0
11570,64544,445,0,0,drop,70,70,0,1,0,1,0
11571,64543,445,0,0,drop,70,70,0,1,0,1,0
11572,49689,22114,0,0,deny,62,62,0,1,0,1,0
11573,64539,445,0,0,drop,70,70,0,1,0,1,0
11574,64538,445,0,0,drop,70,70,0,1,0,1,0
11575,12830,25174,0,0,deny,62,62,0,1,0,1,0
11576,51930,57470,0,0,deny,66,66,0,1,0,1,0
11577,7588,1962,0,0,deny,60,60,0,1,0,1,0
11578,2780,23117,0,0,deny,66,66,0,1,0,1,0
11579,54011,44847,0,0,deny,66,66,0,1,0,1,0
11580,64525,445,0,0,drop,70,70,0,1,0,1,0
11581,64524,445,0,0,drop,70,70,0,1,0,1,0
11582,64520,445,0,0,drop,70,70,0,1,0,1,0
11583,52904,445,0,0,drop,70,70,0,1,0,1,0
11584,52903,445,0,0,drop,70,70,0,1,0,1,0
11585,52891,445,0,0,drop,70,70,0,1,0,1,0
11586,52889,445,0,0,drop,70,70,0,1,0,1,0
11587,3764,9694,0,0,deny,66,66,0,1,0,1,0
11588,64515,445,0,0,drop,70,70,0,1,0,1,0
11589,64514,445,0,0,drop,70,70,0,1,0,1,0
11590,16620,25174,0,0,deny,62,62,0,1,0,1,0
11591,64662,445,0,0,drop,66,66,0,1,0,1,0
11592,64661,445,0,0,drop,66,66,0,1,0,1,0
11593,64660,445,0,0,drop,66,66,0,1,0,1,0
11594,4111,25174,0,0,deny,62,62,0,1,0,1,0
11595,38053,50584,0,0,deny,62,62,0,1,0,1,0
11596,57550,50584,0,0,deny,66,66,0,1,0,1,0
11597,64363,22114,0,0,deny,66,66,0,1,0,1,0
11598,19594,23117,0,0,deny,66,66,0,1,0,1,0
11599,58266,443,20650,443,allow,5619,1387,4232,18,205,10,8
11600,50527,53,64659,53,allow,969,86,883,2,30,1,1
11601,29268,53,40863,53,allow,220,78,142,2,30,1,1
11602,50202,53,17431,53,allow,166,86,80,2,30,1,1
11603,48372,8100,19668,8100,allow,234,234,0,4,11,4,0
11604,53902,55298,56516,55298,allow,70,70,0,1,4,1,0
11605,55792,53,52460,53,allow,199,102,97,2,29,1,1
11606,57183,53,22943,53,allow,178,94,84,2,29,1,1
11607,56562,53,61427,53,allow,183,94,89,2,30,1,1
11608,38624,443,30332,443,allow,6385,1090,5295,18,33,10,8
11609,56562,53,42626,53,allow,183,94,89,2,30,1,1
11610,33906,80,51887,80,allow,1248,660,588,8,15,4,4
11611,64031,25933,32039,25933,allow,436,254,182,7,14,4,3
11612,40865,8100,38607,8100,allow,234,234,0,4,11,4,0
11613,41313,53,41313,53,allow,404,259,145,3,32,2,1
11614,40651,443,45721,443,allow,41517,28432,13085,89,601,47,42
11615,53904,1024,55644,1024,allow,70,70,0,1,4,1,0
11616,41472,443,61400,443,allow,680618,28384,652234,828,84,356,472
11617,53903,51339,10537,51339,allow,70,70,0,1,4,1,0
11618,14442,443,28353,443,allow,2601,1455,1146,18,15,8,10
11619,57605,443,60913,443,allow,2614,1689,925,18,20,10,8
11620,59254,443,5881,443,allow,8332,1024,7308,21,25,11,10
11621,52113,19619,19801,19619,allow,70,70,0,1,4,1,0
11622,55404,53,35517,53,allow,326,102,224,2,29,1,1
11623,57419,53,24851,53,allow,326,110,216,2,29,1,1
11624,55633,53,59677,53,allow,195,102,93,2,30,1,1
11625,49826,53,41958,53,allow,279,95,184,4,59,2,2
11626,57013,53,50114,53,allow,178,94,84,2,29,1,1
11627,49808,53,25125,53,allow,268,102,166,2,29,1,1
11628,56535,443,1772,443,allow,185925,12445,173480,210,105,82,128
11629,62917,993,58803,993,allow,9056,4223,4833,82,35,42,40
11630,49227,2710,36226,2710,allow,70,70,0,2,8,2,0
11631,37999,49152,14143,49152,allow,156,156,0,3,8,3,0
11632,60869,443,60836,443,allow,10630,3315,7315,27,46,15,12
11633,56013,443,56013,443,allow,4599,1692,2907,19,26,11,8
11634,51967,80,56439,80,allow,426,240,186,8,25,5,3
11635,51975,80,44833,80,allow,426,240,186,8,25,5,3
11636,41471,443,22977,443,allow,1973617,48070,1925547,1945,84,606,1339
11637,57440,53,5992,53,allow,199,102,97,2,30,1,1
11638,55900,53,13889,53,allow,194,102,92,2,30,1,1
11639,56835,53,43767,53,allow,213,102,111,2,30,1,1
11640,40597,443,45954,443,allow,11101,4498,6603,35,430,20,15
11641,54787,443,54787,443,allow,18160,6539,11621,37,19,22,15
11642,58392,53,58392,53,allow,404,259,145,3,33,2,1
11643,53128,443,20598,443,allow,14603,4208,10395,39,48,20,19
11644,51480,3027,51480,3027,allow,156,156,0,3,8,3,0
11645,58879,443,43164,443,allow,10439,1785,8654,25,85,10,15
11646,51579,443,8189,443,allow,1522,1210,312,9,28,4,5
11647,52140,53155,1111,53155,allow,70,70,0,2,8,2,0
11648,50369,443,20659,443,allow,8048,1189,6859,19,25,10,9
11649,60868,443,49136,443,allow,9660,2402,7258,27,46,15,12
11650,51962,80,39391,80,allow,422,240,182,8,25,5,3
11651,58004,80,58289,80,allow,14922,10566,4356,39,75,20,19
11652,35811,443,26946,443,allow,13562,3104,10458,38,201,22,16
11653,46512,443,4517,443,allow,22641,10532,12109,62,200,35,27
11654,56494,80,51723,80,allow,44136,2908,41228,56,135,25,31
11655,56488,80,17378,80,allow,64702,3709,60993,76,135,30,46
11656,49750,5223,50752,5223,allow,46785,27735,19050,232,5491,123,109
11657,56225,53,43887,53,allow,183,94,89,2,30,1,1
11658,43862,443,61828,443,allow,6600,1174,5426,23,62,13,10
11659,49773,53,20298,53,allow,994,86,908,2,30,1,1
11660,51968,80,1754,80,allow,366,240,126,7,25,5,2
11661,56827,53,56181,53,allow,195,102,93,2,30,1,1
11662,51976,80,64058,80,allow,366,240,126,7,25,5,2
11663,33462,53,33462,53,allow,256,114,142,2,30,1,1
11664,55991,53,41227,53,allow,183,94,89,2,30,1,1
11665,64904,53,1451,53,allow,211,102,109,2,30,1,1
11666,50202,53,23143,53,allow,166,86,80,2,30,1,1
11667,65059,53,35510,53,allow,168,86,82,2,30,1,1
11668,48856,53,0,0,allow,86,86,0,1,30,1,0
11669,40403,53,40667,53,allow,199,94,105,2,30,1,1
11670,57002,53,39237,53,allow,211,94,117,2,30,1,1
11671,50109,53,42164,53,allow,198,110,88,2,30,1,1
11672,56532,443,14584,443,allow,198167,11702,186465,220,105,84,136
11673,56125,53,57582,53,allow,168,86,82,2,30,1,1
11674,41176,443,1178,443,allow,31541,25324,6217,49,91,29,20
11675,64432,53,45713,53,allow,168,86,82,2,30,1,1
11676,35809,443,51066,443,allow,13084,2704,10380,36,201,21,15
11677,56356,53,61835,53,allow,184,102,82,2,30,1,1
11678,65070,80,65070,80,allow,145038,9857,135181,162,23,62,100
11679,50337,53,50337,53,allow,260,106,154,2,30,1,1
11680,56683,443,65170,443,allow,268,120,148,5,11,3,2
11681,51969,80,59733,80,allow,366,240,126,7,25,5,2
11682,53892,25933,31211,25933,allow,552,306,246,9,15,5,4
11683,51974,80,51357,80,allow,426,240,186,8,25,5,3
11684,51977,80,40997,80,allow,366,240,126,7,25,5,2
11685,57994,80,57049,80,allow,2494,1540,954,21,75,11,10
11686,65071,80,65071,80,allow,296372,11959,284413,311,23,113,198
11687,65067,80,65067,80,allow,342198,13793,328405,355,23,126,229
11688,64030,53,64891,53,allow,222,78,144,2,30,1,1
11689,56622,53,24570,53,allow,179,94,85,2,30,1,1
11690,35117,443,10765,443,allow,8866,4928,3938,26,121,13,13
11691,57996,80,13904,80,allow,5411,3618,1793,27,75,14,13
11692,49296,53,40688,53,allow,322,98,224,4,32,2,2
11693,42342,443,63705,443,allow,494,198,296,8,17,4,4
11694,58001,80,18559,80,allow,20532,14664,5868,47,75,24,23
11695,58003,80,63884,80,allow,14987,10571,4416,40,75,20,20
11696,62041,443,33913,443,allow,29329,6712,22617,54,60,23,31
11697,58681,443,24073,443,allow,22576,10533,12043,61,200,35,26
11698,35742,443,2430,443,allow,5612,1251,4361,22,65,12,10
11699,51970,80,32175,80,allow,366,240,126,7,25,5,2
11700,51964,80,61928,80,allow,306,120,186,6,25,3,3
11701,56487,80,45530,80,allow,42070,2703,39367,53,135,22,31
11702,56491,80,30431,80,allow,37154,2381,34773,50,135,23,27
11703,65109,53,18311,53,allow,753,94,659,2,30,1,1
11704,48209,53,48209,53,allow,628,82,546,2,30,1,1
11705,5431,53,64205,53,allow,220,78,142,2,30,1,1
11706,49681,443,34762,443,allow,7383,2461,4922,18,135,8,10
11707,51985,80,32955,80,allow,1479,822,657,11,25,7,4
11708,1294,53,1294,53,allow,216,82,134,2,32,1,1
11709,37627,443,10583,443,allow,70,70,0,2,5,2,0
11710,9461,443,60064,443,allow,2581,1602,979,17,20,9,8
11711,58000,80,21507,80,allow,48253,13664,34589,66,75,25,41
11712,57995,80,53962,80,allow,4065,2650,1415,25,75,13,12
11713,34331,443,59493,443,allow,9415,3998,5417,23,301,11,12
11714,50380,443,13367,443,allow,306,180,126,6,25,4,2
11715,51961,80,32070,80,allow,26804,11349,15455,45,26,25,20
11716,58008,80,56721,80,allow,2549,1595,954,21,75,11,10
11717,35338,443,31577,443,allow,571121,38361,532760,718,69,342,376
11718,56531,443,49300,443,allow,215863,14423,201440,245,105,95,150
11719,50336,80,50336,80,allow,2143,676,1467,12,25,7,5
11720,56534,443,29507,443,allow,265430,17951,247479,305,105,122,183
11721,60497,443,60497,443,allow,12727,948,11779,21,30,10,11
11722,51993,80,56681,80,allow,482,300,182,9,25,6,3
11723,51991,80,57002,80,allow,482,300,182,9,25,6,3
11724,47834,443,47834,443,allow,4716,1809,2907,19,26,11,8
11725,33150,53,63816,53,allow,816,228,588,8,29,4,4
11726,49330,443,57448,443,allow,137414,6004,131410,170,80,59,111
11727,64615,53,56632,53,allow,395,89,306,4,32,2,2
11728,60601,443,55669,443,allow,6180,926,5254,18,36,10,8
11729,56562,53,4746,53,allow,183,94,89,2,29,1,1
11730,38000,49152,22175,49152,allow,156,156,0,3,8,3,0
11731,64055,45105,11907,45105,allow,66,66,0,2,7,2,0
11732,56217,53,16338,53,allow,183,94,89,2,29,1,1
11733,64053,47783,54848,47783,allow,66,66,0,2,7,2,0
11734,56004,443,46384,443,allow,130,70,60,3,4,2,1
11735,55404,443,49426,443,allow,70,70,0,1,5,1,0
11736,50374,443,56948,443,allow,5359,705,4654,15,25,8,7
11737,64432,53,49029,53,allow,168,86,82,2,30,1,1
11738,50373,443,34130,443,allow,5422,707,4715,16,25,8,8
11739,56484,80,16261,80,allow,97842,4441,93401,109,135,41,68
11740,56489,80,59923,80,allow,118508,4979,113529,128,135,48,80
11741,56486,80,1722,80,allow,46682,3447,43235,61,135,27,34
11742,56492,80,31421,80,allow,74105,3416,70689,84,135,32,52
11743,62921,993,3682,993,allow,8856,4253,4603,79,27,42,37
11744,56477,80,20829,80,allow,95037,3407,91630,103,135,38,65
11745,65287,53,49493,53,allow,180,94,86,2,30,1,1
11746,56217,53,53375,53,allow,183,94,89,2,30,1,1
11747,50022,53,3051,53,allow,179,94,85,2,30,1,1
11748,44846,53,44846,53,allow,86,86,0,1,30,1,0
11749,49631,53,24676,53,allow,184,102,82,2,30,1,1
11750,56333,53,59595,53,allow,209,110,99,2,31,1,1
11751,57130,443,51431,443,allow,10724,3758,6966,38,403,13,25
11752,38011,443,62208,443,allow,14337,3375,10962,47,121,23,24
11753,37427,443,40807,443,allow,26069,12062,14007,46,123,21,25
11754,14697,8000,41154,8000,allow,274,150,124,4,60,2,2
11755,49334,53,34104,53,allow,194,102,92,2,30,1,1
11756,64958,53,14759,53,allow,197,102,95,2,30,1,1
11757,56733,53,5625,53,allow,183,94,89,2,30,1,1
11758,64995,53,14595,53,allow,210,110,100,2,30,1,1
11759,65240,53,39958,53,allow,199,94,105,2,30,1,1
11760,64580,53,3526,53,allow,180,94,86,2,30,1,1
11761,57440,53,58703,53,allow,199,102,97,2,30,1,1
11762,59833,53,25424,53,allow,195,94,101,2,30,1,1
11763,56922,53,63628,53,allow,168,86,82,2,31,1,1
11764,51963,80,35774,80,allow,422,240,182,8,25,5,3
11765,56485,80,57235,80,allow,46400,3639,42761,59,135,25,34
11766,51978,80,26908,80,allow,4612,3409,1203,14,25,9,5
11767,37222,443,57670,443,allow,4713,895,3818,18,16,10,8
11768,56495,80,7502,80,allow,32396,2695,29701,46,135,22,24
11769,56493,80,12499,80,allow,65864,3286,62578,76,135,30,46
11770,55337,443,55337,443,allow,7710,3932,3778,23,18,14,9
11771,54636,443,3394,443,allow,311000,8576,302424,319,175,103,216
11772,49826,53,26730,53,allow,650,286,364,8,84,4,4
11773,56837,53,1718,53,allow,227,110,117,2,30,1,1
11774,64340,53,7157,53,allow,266,110,156,2,30,1,1
11775,65136,53,36348,53,allow,438,180,258,6,30,3,3
11776,56648,53,49574,53,allow,199,102,97,2,30,1,1
11777,56622,53,6660,53,allow,340,107,233,4,30,2,2
11778,56572,53,50763,53,allow,438,180,258,6,30,3,3
11779,61948,53,63047,53,allow,205,86,119,2,30,1,1
11780,28679,3389,28679,3389,allow,3910,1805,2105,20,19,12,8
11781,59248,443,51315,443,allow,8332,1024,7308,21,25,11,10
11782,37630,443,19874,443,allow,10000,2634,7366,28,46,16,12
11783,35810,443,44672,443,allow,13706,3115,10591,40,201,22,18
11784,45397,443,38399,443,allow,970804,44459,926345,1113,200,446,667
11785,51965,80,11220,80,allow,306,120,186,6,25,3,3
11786,60871,443,24250,443,allow,8338,3198,5140,28,46,16,12
11787,64587,443,60822,443,allow,24686,1935,22751,36,18,17,19
11788,65072,80,65072,80,allow,250600,11390,239210,268,23,98,170
11789,33640,53,0,0,allow,139,70,69,2,30,1,1
11790,34062,443,2265,443,allow,3208,2015,1193,19,34,11,8
11791,55290,53,19726,53,allow,198,94,104,2,30,1,1
11792,49818,53,62354,53,allow,751,94,657,2,30,1,1
11793,55570,53,7060,53,allow,889,404,485,10,30,5,5
11794,55995,53,56863,53,allow,182,94,88,2,30,1,1
11795,49815,53,3379,53,allow,789,110,679,2,31,1,1
11796,56536,443,5996,443,allow,210110,14803,195307,246,105,103,143
11797,56533,443,15782,443,allow,306579,19447,287132,335,105,129,206
11798,42672,443,42672,443,allow,4378,1471,2907,19,30,11,8
11799,58005,80,36908,80,allow,14927,10571,4356,39,75,20,19
11800,50368,443,46131,443,allow,8048,1189,6859,19,25,10,9
11801,62924,993,52929,993,allow,9376,4359,5017,86,19,44,42
11802,51966,80,49895,80,allow,366,240,126,7,25,5,2
11803,56490,80,11731,80,allow,43084,3056,40028,60,135,27,33
11804,64946,53,5511,53,allow,452,118,334,2,30,1,1
11805,64580,53,18330,53,allow,180,94,86,2,30,1,1
11806,49561,53,14887,53,allow,211,94,117,2,30,1,1
11807,49381,53,1330,53,allow,209,110,99,2,30,1,1
11808,49295,53,60068,53,allow,172,94,78,2,30,1,1
11809,56356,53,24415,53,allow,184,102,82,2,30,1,1
11810,57440,53,28373,53,allow,199,102,97,2,30,1,1
11811,49257,53,41185,53,allow,166,86,80,2,30,1,1
11812,49492,53,44432,53,allow,199,102,97,2,30,1,1
11813,44846,53,44846,53,allow,653,349,304,5,30,3,2
11814,65107,53,32581,53,allow,266,110,156,2,30,1,1
11815,50250,53,63565,53,allow,178,94,84,2,31,1,1
11816,57040,53,36140,53,allow,179,94,85,2,31,1,1
11817,49532,53,28306,53,allow,730,102,628,2,31,1,1
11818,63463,443,46376,443,allow,3182,1568,1614,8,120,4,4
11819,52520,443,9446,443,allow,4463,1215,3248,16,121,8,8
11820,41098,443,2984,443,allow,3384,762,2622,15,135,7,8
11821,50265,58840,23141,58840,allow,132,132,0,3,1200,3,0
11822,49538,53,45151,53,allow,748,94,654,2,30,1,1
11823,55900,53,53468,53,allow,194,102,92,2,30,1,1
11824,49889,53,48150,53,allow,197,102,95,2,31,1,1
11825,56239,53,30874,53,allow,180,94,86,2,31,1,1
11826,50523,53,7142,53,allow,168,86,82,2,31,1,1
11827,64422,53,12114,53,allow,180,94,86,2,31,1,1
11828,60191,53,31189,53,allow,196,94,102,2,31,1,1
11829,49492,53,34957,53,allow,199,102,97,2,31,1,1
11830,57204,53,62909,53,allow,195,102,93,2,31,1,1
11831,44974,443,22658,443,allow,17760,13913,3847,54,167,25,29
11832,63464,443,53137,443,allow,5614,2964,2650,19,120,9,10
11833,62066,443,9765,443,allow,3150,831,2319,13,135,6,7
11834,38721,443,64394,443,allow,10216,3380,6836,26,120,12,14
11835,6881,35179,42052,35179,allow,228,118,110,2,1199,1,1
11836,49660,443,16842,443,allow,3721,1477,2244,15,121,8,7
11837,53212,443,49183,443,allow,4681,2403,2278,19,135,10,9
11838,50265,25490,26928,25490,allow,1766,1332,434,22,1200,15,7
11839,50265,5554,7404,5554,allow,472,150,322,2,1200,1,1
11840,6881,50239,58874,50239,allow,3514,1874,1640,15,1200,8,7
11841,64116,53,6578,53,allow,267,94,173,4,59,2,2
11842,49631,53,37899,53,allow,184,102,82,2,30,1,1
11843,64229,53,36573,53,allow,266,110,156,2,31,1,1
11844,57281,443,25432,443,allow,212477,8324,204153,232,122,79,153
11845,55106,443,7279,443,allow,3411,887,2524,12,120,6,6
11846,50265,49754,28018,49754,allow,402,132,270,6,1209,3,3
11847,55555,53,4576,53,allow,194,102,92,2,31,1,1
11848,55996,443,19878,443,allow,5323,2482,2841,31,19,15,16
11849,36628,80,65040,80,allow,78,78,0,1,5,1,0
11850,64580,53,58707,53,allow,425,90,335,4,43,2,2
11851,53917,35885,30826,35885,allow,70,70,0,2,8,2,0
11852,56473,80,3557,80,allow,48910,2361,46549,63,135,29,34
11853,34416,443,60300,443,allow,10255,2803,7452,35,26,18,17
11854,65280,53,19530,53,allow,166,86,80,2,31,1,1
11855,64033,29834,16078,29834,allow,70,70,0,1,5,1,0
11856,5588,5588,0,0,allow,3562,1936,1626,48,195,24,24
11857,60899,25174,0,0,deny,66,66,0,1,0,1,0
11858,57348,25174,0,0,deny,62,62,0,1,0,1,0
11859,49993,37965,0,0,deny,66,66,0,1,0,1,0
11860,27922,25174,0,0,deny,62,62,0,1,0,1,0
11861,52886,445,0,0,drop,70,70,0,1,0,1,0
11862,9212,51505,0,0,deny,62,62,0,1,0,1,0
11863,52885,445,0,0,drop,70,70,0,1,0,1,0
11864,52881,445,0,0,drop,70,70,0,1,0,1,0
11865,52876,445,0,0,drop,70,70,0,1,0,1,0
11866,45218,25174,0,0,deny,62,62,0,1,0,1,0
11867,64503,445,0,0,drop,70,70,0,1,0,1,0
11868,26311,23,0,0,deny,60,60,0,1,0,1,0
11869,28649,43890,0,0,deny,66,66,0,1,0,1,0
11870,10003,64147,0,0,deny,62,62,0,1,0,1,0
11871,11136,19910,0,0,deny,62,62,0,1,0,1,0
11872,55155,2767,0,0,deny,66,66,0,1,0,1,0
11873,17262,25174,0,0,deny,62,62,0,1,0,1,0
11874,6666,3389,0,0,deny,60,60,0,1,0,1,0
11875,1280,25174,0,0,deny,66,66,0,1,0,1,0
11876,59810,6004,0,0,deny,66,66,0,1,0,1,0
11877,35058,23,0,0,deny,60,60,0,1,0,1,0
11878,27046,51505,0,0,deny,66,66,0,1,0,1,0
11879,64499,445,0,0,drop,70,70,0,1,0,1,0
11880,59436,22114,0,0,deny,66,66,0,1,0,1,0
11881,52869,445,0,0,drop,70,70,0,1,0,1,0
11882,52867,445,0,0,drop,70,70,0,1,0,1,0
11883,52866,445,0,0,drop,70,70,0,1,0,1,0
11884,65389,26467,0,0,deny,62,62,0,1,0,1,0
11885,2332,35440,0,0,deny,62,62,0,1,0,1,0
11886,62579,57866,0,0,deny,62,62,0,1,0,1,0
11887,26698,25174,0,0,deny,66,66,0,1,0,1,0
11888,64490,445,0,0,drop,70,70,0,1,0,1,0
11889,64489,445,0,0,drop,70,70,0,1,0,1,0
11890,64487,445,0,0,drop,70,70,0,1,0,1,0
11891,64551,2310,0,0,deny,143,143,0,1,0,1,0
11892,33973,50265,0,0,deny,62,62,0,1,0,1,0
11893,64651,445,0,0,drop,66,66,0,1,0,1,0
11894,2049,32480,0,0,deny,66,66,0,1,0,1,0
11895,64486,445,0,0,drop,70,70,0,1,0,1,0
11896,53160,25174,0,0,deny,62,62,0,1,0,1,0
11897,64483,445,0,0,drop,70,70,0,1,0,1,0
11898,50394,25174,0,0,deny,62,62,0,1,0,1,0
11899,39063,44847,0,0,deny,66,66,0,1,0,1,0
11900,5912,22114,0,0,deny,62,62,0,1,0,1,0
11901,61465,22114,0,0,deny,62,62,0,1,0,1,0
11902,14331,23,0,0,deny,60,60,0,1,0,1,0
11903,22220,25174,0,0,deny,62,62,0,1,0,1,0
11904,52861,445,0,0,drop,70,70,0,1,0,1,0
11905,25237,25174,0,0,deny,146,146,0,1,0,1,0
11906,52859,445,0,0,drop,70,70,0,1,0,1,0
11907,31609,25174,0,0,deny,62,62,0,1,0,1,0
11908,6889,11119,0,0,deny,143,143,0,1,0,1,0
11909,56528,64147,0,0,deny,62,62,0,1,0,1,0
11910,64476,445,0,0,drop,70,70,0,1,0,1,0
11911,9512,443,14359,443,allow,3614,434,3180,11,1,6,5
11912,17004,64147,0,0,deny,66,66,0,1,0,1,0
11913,7686,25174,0,0,deny,146,146,0,1,0,1,0
11914,64632,445,0,0,drop,66,66,0,1,0,1,0
11915,64633,445,0,0,drop,66,66,0,1,0,1,0
11916,60159,22114,0,0,deny,62,62,0,1,0,1,0
11917,54518,25174,0,0,deny,62,62,0,1,0,1,0
11918,36302,25174,0,0,deny,146,146,0,1,0,1,0
11919,15319,51505,0,0,deny,66,66,0,1,0,1,0
11920,64469,445,0,0,drop,70,70,0,1,0,1,0
11921,38859,22114,0,0,deny,66,66,0,1,0,1,0
11922,50708,22114,0,0,deny,62,62,0,1,0,1,0
11923,52851,445,0,0,drop,70,70,0,1,0,1,0
11924,52849,445,0,0,drop,70,70,0,1,0,1,0
11925,52850,445,0,0,drop,70,70,0,1,0,1,0
11926,52841,445,0,0,drop,70,70,0,1,0,1,0
11927,64468,445,0,0,drop,70,70,0,1,0,1,0
11928,2278,25174,0,0,deny,146,146,0,1,0,1,0
11929,27995,22114,0,0,deny,146,146,0,1,0,1,0
11930,1143,25174,0,0,deny,62,62,0,1,0,1,0
11931,64024,22114,0,0,deny,62,62,0,1,0,1,0
11932,51635,50265,0,0,deny,66,66,0,1,0,1,0
11933,64629,445,0,0,drop,66,66,0,1,0,1,0
11934,1117,37965,0,0,deny,62,62,0,1,0,1,0
11935,2864,25174,0,0,deny,66,66,0,1,0,1,0
11936,64462,445,0,0,drop,70,70,0,1,0,1,0
11937,64624,445,0,0,drop,66,66,0,1,0,1,0
11938,64622,445,0,0,drop,66,66,0,1,0,1,0
11939,64623,445,0,0,drop,66,66,0,1,0,1,0
11940,64618,445,0,0,drop,66,66,0,1,0,1,0
11941,64617,445,0,0,drop,66,66,0,1,0,1,0
11942,64614,445,0,0,drop,66,66,0,1,0,1,0
11943,64612,445,0,0,drop,66,66,0,1,0,1,0
11944,64461,445,0,0,drop,70,70,0,1,0,1,0
11945,45964,2225,0,0,deny,60,60,0,1,0,1,0
11946,52834,445,0,0,drop,70,70,0,1,0,1,0
11947,17101,25174,0,0,deny,66,66,0,1,0,1,0
11948,50615,80,48256,80,allow,190675,79205,111470,237,41,104,133
11949,52831,445,0,0,drop,70,70,0,1,0,1,0
11950,52830,445,0,0,drop,70,70,0,1,0,1,0
11951,52827,445,0,0,drop,70,70,0,1,0,1,0
11952,64457,445,0,0,drop,70,70,0,1,0,1,0
11953,50052,65008,0,0,deny,60,60,0,1,0,1,0
11954,2938,64147,0,0,deny,62,62,0,1,0,1,0
11955,2064,22114,0,0,deny,146,146,0,1,0,1,0
11956,64455,445,0,0,drop,70,70,0,1,0,1,0
11957,7288,25174,0,0,deny,62,62,0,1,0,1,0
11958,23719,22114,0,0,deny,62,62,0,1,0,1,0
11959,443,46569,0,0,deny,66,66,0,1,0,1,0
11960,443,46080,0,0,deny,66,66,0,1,0,1,0
11961,0,0,0,0,allow,600,306,294,6,0,3,3
11962,11228,23,0,0,deny,60,60,0,1,0,1,0
11963,56999,25174,0,0,deny,62,62,0,1,0,1,0
11964,16168,23,0,0,deny,60,60,0,1,0,1,0
11965,52823,445,0,0,drop,70,70,0,1,0,1,0
11966,52822,445,0,0,drop,70,70,0,1,0,1,0
11967,52821,445,0,0,drop,70,70,0,1,0,1,0
11968,55146,1433,0,0,deny,60,60,0,1,0,1,0
11969,64605,445,0,0,drop,66,66,0,1,0,1,0
11970,52818,445,0,0,drop,70,70,0,1,0,1,0
11971,64451,445,0,0,deny,70,70,0,1,0,1,0
11972,64603,445,0,0,drop,66,66,0,1,0,1,0
11973,59048,57470,0,0,deny,66,66,0,1,0,1,0
11974,24351,57470,0,0,deny,62,62,0,1,0,1,0
11975,22783,64147,0,0,deny,62,62,0,1,0,1,0
11976,63867,35993,0,0,deny,66,66,0,1,0,1,0
11977,12694,22114,0,0,deny,66,66,0,1,0,1,0
11978,64601,445,0,0,drop,66,66,0,1,0,1,0
11979,64602,445,0,0,drop,66,66,0,1,0,1,0
11980,6587,22114,0,0,deny,146,146,0,1,0,1,0
11981,64599,445,0,0,drop,66,66,0,1,0,1,0
11982,2707,37,0,0,deny,60,60,0,1,0,1,0
11983,59523,37965,0,0,deny,62,62,0,1,0,1,0
11984,40108,23,0,0,deny,60,60,0,1,0,1,0
11985,52813,445,0,0,drop,70,70,0,1,0,1,0
11986,52806,445,0,0,drop,70,70,0,1,0,1,0
11987,52804,445,0,0,drop,70,70,0,1,0,1,0
11988,22528,25174,0,0,deny,62,62,0,1,0,1,0
11989,49834,23,0,0,deny,60,60,0,1,0,1,0
11990,64438,445,0,0,drop,70,70,0,1,0,1,0
11991,15585,64147,0,0,deny,66,66,0,1,0,1,0
11992,53563,35440,0,0,deny,66,66,0,1,0,1,0
11993,22036,44847,0,0,deny,62,62,0,1,0,1,0
11994,64680,22114,0,0,deny,146,146,0,1,0,1,0
11995,19875,30170,0,0,deny,145,145,0,1,0,1,0
11996,64586,445,0,0,drop,66,66,0,1,0,1,0
11997,1660,8696,0,0,deny,62,62,0,1,0,1,0
11998,51544,50584,0,0,deny,62,62,0,1,0,1,0
11999,64435,445,0,0,drop,70,70,0,1,0,1,0
12000,10312,23117,0,0,deny,62,62,0,1,0,1,0
12001,60527,35440,0,0,deny,66,66,0,1,0,1,0
12002,1130,37965,0,0,deny,145,145,0,1,0,1,0
12003,49336,25174,0,0,deny,66,66,0,1,0,1,0
12004,57578,51221,0,0,deny,66,66,0,1,0,1,0
12005,57585,51221,0,0,deny,62,62,0,1,0,1,0
12006,37522,22114,0,0,deny,62,62,0,1,0,1,0
12007,64579,445,0,0,drop,66,66,0,1,0,1,0
12008,56770,53,63283,53,allow,208,106,102,2,30,1,1
12009,51099,80,52841,80,allow,3422,1962,1460,33,131,18,15
12010,38468,53,0,0,allow,82,82,0,2,40,2,0
12011,52102,19604,31294,19604,allow,66,66,0,1,5,1,0
12012,59644,443,54066,443,allow,8362065,55143,8306922,6375,152,332,6043
12013,50293,80,34278,80,allow,134242,13446,120796,154,161,58,96
12014,50328,80,59408,80,allow,55878,5841,50037,70,94,29,41
12015,49889,53,17299,53,allow,194,99,95,2,30,1,1
12016,55216,53,63091,53,allow,174,89,85,2,30,1,1
12017,60857,443,19971,443,allow,18385,7771,10614,47,48,27,20
12018,52104,51756,50928,51756,allow,66,66,0,1,5,1,0
12019,52106,41632,33294,41632,allow,66,66,0,1,5,1,0
12020,9483,80,46807,80,allow,1579,421,1158,9,15,4,5
12021,49826,53,60102,53,allow,466,192,274,6,83,3,3
12022,60006,443,38577,443,allow,185169,75281,109888,426,111,209,217
12023,50298,80,48126,80,allow,166956,16834,150122,187,161,72,115
12024,56479,80,1802,80,allow,460182,11717,448465,462,135,162,300
12025,53894,2944,38557,2944,allow,70,70,0,1,5,1,0
12026,61583,80,61583,80,allow,12301,1642,10659,20,20,9,11
12027,64664,80,64664,80,allow,1921,1472,449,10,20,6,4
12028,65280,53,4153,53,allow,164,84,80,2,31,1,1
12029,49492,53,11177,53,allow,198,101,97,2,31,1,1
12030,55955,53,2221,53,allow,814,110,704,2,30,1,1
12031,58931,443,42670,443,allow,1413,876,537,12,28,6,6
12032,51135,443,24290,443,allow,6678,1212,5466,22,256,12,10
12033,58932,443,14070,443,allow,1413,876,537,12,28,6,6
12034,51658,80,20246,80,allow,44842,2446,42396,73,255,34,39
12035,41734,443,42617,443,allow,153,93,60,2,5,1,1
12036,51997,443,19517,443,allow,2648,1797,851,19,22,11,8
12037,64034,17935,37819,17935,allow,66,66,0,1,5,1,0
12038,9482,443,2770,443,allow,5657,487,5170,14,15,7,7
12039,2267,53,13184,53,allow,826,826,0,8,44,8,0
12040,51996,443,3596,443,allow,2648,1797,851,19,22,11,8
12041,61123,80,61123,80,allow,21678,2120,19558,33,20,16,17
12042,52141,1033,19443,1033,allow,316,136,180,6,7,3,3
12043,51098,80,4123,80,allow,3378,1918,1460,33,131,18,15
12044,36953,443,22801,443,allow,70,70,0,1,5,1,0
12045,57422,53,50721,53,allow,747,90,657,2,30,1,1
12046,51899,80,55362,80,allow,1758,989,769,13,76,8,5
12047,56678,53,61385,53,allow,760,97,663,2,30,1,1
12048,49815,53,0,0,allow,166,73,93,2,30,1,1
12049,56064,53,20414,53,allow,710,89,621,2,30,1,1
12050,56333,53,63639,53,allow,202,103,99,2,31,1,1
12051,53896,48027,30657,48027,allow,70,70,0,1,5,1,0
12052,51652,80,52729,80,allow,32942,2548,30394,58,255,28,30
12053,50116,22,50116,22,allow,184,120,64,4,10,3,1
12054,50297,80,4817,80,allow,145266,14613,130653,165,161,63,102
12055,51097,80,51452,80,allow,3374,1914,1460,33,131,18,15
12056,53124,80,20707,80,allow,4198,3534,664,13,19,8,5
12057,49683,80,8217,80,allow,1548,847,701,10,15,5,5
12058,61908,7000,61908,7000,allow,4131,1750,2381,17,15,9,8
12059,53886,49618,46889,49618,allow,492,306,186,8,16,5,3
12060,49791,53,6212,53,allow,777,87,690,2,30,1,1
12061,44925,443,50958,443,allow,153,93,60,2,5,1,1
12062,49257,53,65016,53,allow,164,84,80,2,30,1,1
12063,50250,53,19188,53,allow,172,88,84,2,30,1,1
12064,56770,443,57005,443,allow,124,64,60,2,16,1,1
12065,64422,53,42337,53,allow,176,90,86,2,30,1,1
12066,55687,53,59046,53,allow,186,95,91,2,31,1,1
12067,64937,53,42639,53,allow,204,104,100,2,31,1,1
12068,55418,53,39604,53,allow,168,86,82,2,31,1,1
12069,54339,443,11466,443,allow,3149,769,2380,10,120,5,5
12070,57204,53,25182,53,allow,190,97,93,2,30,1,1
12071,64116,53,5820,53,allow,184,94,90,2,31,1,1
12072,25808,53,25808,53,allow,218,99,119,2,31,1,1
12073,65466,53,3496,53,allow,733,86,647,2,31,1,1
12074,50403,53,23748,53,allow,168,86,82,2,31,1,1
12075,56955,53,57810,53,allow,182,93,89,2,31,1,1
12076,65186,53,43195,53,allow,733,85,648,2,31,1,1
12077,37694,5228,64819,5228,allow,6930,1665,5265,18,3601,9,9
12078,55352,53,6913,53,allow,216,110,106,2,31,1,1
12079,55332,53,16316,53,allow,206,105,101,2,31,1,1
12080,56314,53,18925,53,allow,733,86,647,2,31,1,1
12081,49972,53,57217,53,allow,216,110,106,2,31,1,1
12082,55555,53,39560,53,allow,188,96,92,2,31,1,1
12083,49296,53,29013,53,allow,186,95,91,2,31,1,1
12084,55022,53,10600,53,allow,190,97,93,2,31,1,1
12085,58905,443,41213,443,allow,13055,5677,7378,29,122,15,14
12086,58717,443,32923,443,allow,280,140,140,5,130,3,2
12087,57407,53,20489,53,allow,755,94,661,2,31,1,1
12088,55707,53,37897,53,allow,170,87,83,2,31,1,1
12089,56422,53,35743,53,allow,190,97,93,2,31,1,1
12090,49546,53,57576,53,allow,208,106,102,2,31,1,1
12091,64299,53,27762,53,allow,164,84,80,2,31,1,1
12092,49210,53,34070,53,allow,182,93,89,2,31,1,1
12093,64856,53,10911,53,allow,755,93,662,2,31,1,1
12094,38102,5228,57941,5228,allow,4235,1797,2438,38,4443,13,25
12095,35556,443,35556,443,allow,7201,1167,6034,16,131,8,8
12096,47276,443,16535,443,allow,7613,2230,5383,22,360,11,11
12097,55007,53,10621,53,allow,164,84,80,2,31,1,1
12098,56036,53,20624,53,allow,762,98,664,2,31,1,1
12099,49982,53,52781,53,allow,206,105,101,2,31,1,1
12100,64615,53,39093,53,allow,190,97,93,2,31,1,1
12101,65065,53,49362,53,allow,754,94,660,2,31,1,1
12102,37299,443,19605,443,allow,10790,5444,5346,21,122,10,11
12103,56312,53,11008,53,allow,190,97,93,2,31,1,1
12104,54054,5228,24551,5228,allow,8767,2486,6281,45,6062,24,21
12105,39735,443,13542,443,allow,280,140,140,5,130,3,2
12106,6881,6881,62439,6881,allow,502,150,352,2,1200,1,1
12107,6882,3800,7427,3800,allow,150,150,0,2,1201,2,0
12108,47561,26467,0,0,deny,62,62,0,1,0,1,0
12109,52790,445,0,0,drop,70,70,0,1,0,1,0
12110,58608,62413,0,0,deny,66,66,0,1,0,1,0
12111,8508,23,0,0,deny,60,60,0,1,0,1,0
12112,45941,23386,0,0,deny,60,60,0,1,0,1,0
12113,45941,23386,0,0,deny,60,60,0,1,0,1,0
12114,42231,57470,0,0,deny,78,78,0,1,0,1,0
12115,64430,445,0,0,drop,70,70,0,1,0,1,0
12116,64429,445,0,0,drop,70,70,0,1,0,1,0
12117,55425,37965,0,0,deny,66,66,0,1,0,1,0
12118,1847,64147,0,0,deny,62,62,0,1,0,1,0
12119,64576,445,0,0,drop,66,66,0,1,0,1,0
12120,51046,53,51046,53,allow,244,106,138,2,30,1,1
12121,53885,50379,49864,50379,allow,492,306,186,8,15,5,3
12122,53887,6881,31498,6881,allow,552,306,246,9,15,5,4
12123,59052,53,59052,53,allow,235,90,145,2,32,1,1
12124,51015,80,51015,80,allow,1905,1456,449,10,20,6,4
12125,64878,53,35842,53,allow,511,92,419,4,45,2,2
12126,49237,53,49518,53,allow,216,110,106,2,30,1,1
12127,55808,53,53764,53,allow,730,102,628,2,30,1,1
12128,60666,123,38509,123,allow,184,94,90,2,30,1,1
12129,56638,443,50177,443,allow,44984,28294,16690,77,40,40,37
12130,50356,80,58294,80,allow,1578,756,822,13,34,7,6
12131,52139,38259,57318,38259,allow,70,70,0,2,7,2,0
12132,53895,36849,47178,36849,allow,70,70,0,1,4,1,0
12133,45295,443,2561,443,allow,6864,1633,5231,20,315,10,10
12134,57498,443,57498,443,allow,4546,1639,2907,19,27,11,8
12135,56474,80,38347,80,allow,8790,1387,7403,17,134,9,8
12136,56476,80,31067,80,allow,5342,1304,4038,14,134,8,6
12137,56472,80,20215,80,allow,45108,2309,42799,60,134,28,32
12138,55995,53,15590,53,allow,182,94,88,2,29,1,1
12139,64029,38651,25596,38651,allow,70,70,0,1,4,1,0
12140,64422,53,60156,53,allow,180,94,86,2,29,1,1
12141,52107,11191,10065,11191,allow,70,70,0,1,4,1,0
12142,47073,7275,39561,7275,allow,416,210,206,7,15,4,3
12143,55187,53,45900,53,allow,172,94,78,2,29,1,1
12144,58273,53,40385,53,allow,202,86,116,2,30,1,1
12145,64741,53,9431,53,allow,715,94,621,2,29,1,1
12146,49295,53,61148,53,allow,164,86,78,2,29,1,1
12147,49257,53,51275,53,allow,166,86,80,2,29,1,1
12148,57204,53,62842,53,allow,195,102,93,2,29,1,1
12149,55187,53,40713,53,allow,172,94,78,2,30,1,1
12150,50523,53,12561,53,allow,168,86,82,2,29,1,1
12151,60021,443,37470,443,allow,346221,14712,331509,474,107,211,263
12152,60027,443,20291,443,allow,8216,2269,5947,42,106,25,17
12153,62937,80,62937,80,allow,1918,1469,449,10,20,6,4
12154,52218,80,52218,80,allow,1921,1472,449,10,20,6,4
12155,61422,80,46677,80,allow,214,140,74,4,41,3,1
12156,49167,80,49167,80,allow,1915,1466,449,10,20,6,4
12157,54634,443,32455,443,allow,225732,7330,218402,246,174,86,160
12158,64633,53,20577,53,allow,255,102,153,2,30,1,1
12159,49417,53,32052,53,allow,211,110,101,2,30,1,1
12160,57033,53,53118,53,allow,216,110,106,2,30,1,1
12161,57129,53,59540,53,allow,265,94,171,2,30,1,1
12162,56928,53,10586,53,allow,178,94,84,2,30,1,1
12163,55332,53,34862,53,allow,211,110,101,2,30,1,1
12164,50025,53,41046,53,allow,369,150,219,2,30,1,1
12165,38706,443,10577,443,allow,90545,3481,87064,96,16,31,65
12166,60007,443,8441,443,allow,7040,1933,5107,32,110,19,13
12167,40042,80,40042,80,allow,1919,1470,449,10,20,6,4
12168,55709,30217,33191,30217,allow,70,70,0,2,8,2,0
12169,57312,53,15531,53,allow,212,110,102,2,30,1,1
12170,61430,80,6930,80,allow,214,140,74,4,41,3,1
12171,61423,80,2681,80,allow,214,140,74,4,41,3,1
12172,48646,80,48646,80,allow,1916,1467,449,10,20,6,4
12173,52248,443,56929,443,allow,190,70,120,4,15,2,2
12174,58720,443,50201,443,allow,32598,22046,10552,83,60,49,34
12175,35921,443,62122,443,allow,9667,4709,4958,27,88,14,13
12176,52138,25621,30366,25621,allow,70,70,0,2,8,2,0
12177,64052,38119,11965,38119,allow,312,132,180,6,6,3,3
12178,56950,53,63422,53,allow,211,102,109,2,30,1,1
12179,61864,80,52616,80,allow,9747,537,9210,14,16,6,8
12180,51650,80,8862,80,allow,2681,1044,1637,22,255,12,10
12181,57425,53,41826,53,allow,168,86,82,2,30,1,1
12182,49237,53,48024,53,allow,216,110,106,2,30,1,1
12183,49257,53,43950,53,allow,579,181,398,6,84,3,3
12184,44871,53,32671,53,allow,168,78,90,2,30,1,1
12185,64228,53,55912,53,allow,266,110,156,2,30,1,1
12186,49305,53,20734,53,allow,571,181,390,6,73,3,3
12187,55216,53,56986,53,allow,179,94,85,2,30,1,1
12188,49592,53,33191,53,allow,177,94,83,2,30,1,1
12189,65171,53,41753,53,allow,752,110,642,2,30,1,1
12190,49624,53,59918,53,allow,293,126,167,2,30,1,1
12191,49261,53,20112,53,allow,453,186,267,6,30,3,3
12192,56239,53,14198,53,allow,180,94,86,2,30,1,1
12193,56955,53,15071,53,allow,183,94,89,2,30,1,1
12194,57425,53,32563,53,allow,168,86,82,2,30,1,1
12195,56929,53,55156,53,allow,784,94,690,2,30,1,1
12196,55352,53,47404,53,allow,216,110,106,2,30,1,1
12197,56333,53,40833,53,allow,209,110,99,2,30,1,1
12198,65204,443,43176,443,allow,1786,172,1614,7,120,3,4
12199,57022,53,55045,53,allow,369,150,219,2,30,1,1
12200,49615,53,23958,53,allow,199,102,97,2,30,1,1
12201,39827,53,39827,53,allow,247,98,149,2,33,1,1
12202,61427,80,27068,80,allow,214,140,74,4,41,3,1
12203,61425,80,54723,80,allow,214,140,74,4,41,3,1
12204,61424,80,26157,80,allow,214,140,74,4,41,3,1
12205,38707,443,59526,443,allow,774099,15769,758330,743,16,223,520
12206,50629,80,50629,80,allow,6210,2976,3234,16,20,9,7
12207,50319,53,7677,53,allow,814,110,704,2,30,1,1
12208,49408,53,3483,53,allow,252,102,150,2,30,1,1
12209,49417,53,14090,53,allow,211,110,101,2,30,1,1
12210,56770,53,41386,53,allow,212,110,102,2,30,1,1
12211,56827,53,18397,53,allow,195,102,93,2,30,1,1
12212,64023,12954,37073,12954,allow,504,382,122,8,15,6,2
12213,49991,80,45821,80,allow,2668,543,2125,12,28,6,6
12214,35060,80,35060,80,allow,1918,1469,449,10,20,6,4
12215,58394,53,41554,53,allow,274,94,180,2,30,1,1
12216,64839,53,42360,53,allow,212,110,102,2,30,1,1
12217,55216,53,52646,53,allow,179,94,85,2,30,1,1
12218,55923,53,7980,53,allow,177,94,83,2,30,1,1
12219,55923,53,53051,53,allow,177,94,83,2,30,1,1
12220,64243,53,38194,53,allow,257,102,155,2,30,1,1
12221,56125,53,3352,53,allow,168,86,82,2,30,1,1
12222,64737,53,22713,53,allow,285,94,191,2,31,1,1
12223,43639,443,43639,443,allow,4683,1776,2907,19,29,11,8
12224,57905,80,48820,80,allow,12974,3246,9728,29,29,16,13
12225,57983,443,38369,443,allow,7966,3102,4864,18,75,10,8
12226,52105,1024,64532,1024,allow,70,70,0,1,4,1,0
12227,56632,53,56632,53,allow,235,90,145,2,33,1,1
12228,64054,54778,50482,54778,allow,312,132,180,6,6,3,3
12229,64467,53,41082,53,allow,548,194,354,6,63,3,3
12230,52136,42939,50885,42939,allow,70,70,0,2,8,2,0
12231,2267,53,49774,53,allow,826,826,0,8,44,8,0
12232,64422,53,39408,53,allow,180,94,86,2,31,1,1
12233,61426,80,34225,80,allow,214,140,74,4,41,3,1
12234,60867,443,23930,443,allow,14125,3827,10298,33,45,18,15
12235,45882,443,31867,443,allow,6617,1852,4765,23,132,13,10
12236,53695,443,14454,443,allow,4045,439,3606,11,15,5,6
12237,61429,80,5078,80,allow,214,140,74,4,41,3,1
12238,36351,80,36351,80,allow,1920,1471,449,10,20,6,4
12239,49969,53,54536,53,allow,356,105,251,4,49,2,2
12240,56475,80,2240,80,allow,36057,2080,33977,45,134,19,26
12241,56125,53,44434,53,allow,168,86,82,2,29,1,1
12242,49889,53,36232,53,allow,197,102,95,2,29,1,1
12243,44299,80,44299,80,allow,1915,1466,449,10,20,6,4
12244,52137,1026,43020,1026,allow,196,136,60,4,8,3,1
12245,40105,80,32685,80,allow,9656,3195,6461,19,23,12,7
12246,33196,443,16510,443,allow,6989,5073,1916,24,111,14,10
12247,60011,443,4713,443,allow,11061,2230,8831,40,109,23,17
12248,53899,45682,35205,45682,allow,70,70,0,1,4,1,0
12249,56827,53,30639,53,allow,195,102,93,2,29,1,1
12250,53898,12172,38766,12172,allow,70,70,0,1,4,1,0
12251,58177,443,64098,443,allow,810,340,470,13,34,6,7
12252,58982,5222,15289,5222,allow,16545,8556,7989,69,69,30,39
12253,55057,53,53863,53,allow,211,110,101,2,30,1,1
12254,59402,53,5852,53,allow,203,86,117,2,30,1,1
12255,55372,53,41205,53,allow,271,93,178,4,43,2,2
12256,64995,53,32224,53,allow,210,110,100,2,30,1,1
12257,61428,80,48945,80,allow,214,140,74,4,41,3,1
12258,64937,53,47101,53,allow,210,110,100,2,30,1,1
12259,47928,443,47928,443,allow,4564,1657,2907,19,27,11,8
12260,56360,53,26019,53,allow,184,102,82,2,30,1,1
12261,34692,80,34692,80,allow,3530,2851,679,13,20,8,5
12262,60037,443,34987,443,allow,376301,13445,362856,452,102,198,254
12263,50027,53,20964,53,allow,264,110,154,2,30,1,1
12264,57033,53,22099,53,allow,216,110,106,2,30,1,1
12265,37492,53,45298,53,allow,199,94,105,2,30,1,1
12266,55739,53,43741,53,allow,215,102,113,2,30,1,1
12267,55057,53,26203,53,allow,211,110,101,2,30,1,1
12268,56648,53,44024,53,allow,199,102,97,2,30,1,1
12269,49615,53,57263,53,allow,199,102,97,2,30,1,1
12270,64324,53,8144,53,allow,179,94,85,2,30,1,1
12271,56955,53,64522,53,allow,183,94,89,2,30,1,1
12272,55352,53,35227,53,allow,216,110,106,2,30,1,1
12273,55991,53,9133,53,allow,199,102,97,2,30,1,1
12274,49176,53,17276,53,allow,264,110,154,2,30,1,1
12275,55887,443,44668,443,allow,3954,778,3176,17,121,8,9
12276,55352,53,46162,53,allow,216,110,106,2,30,1,1
12277,55216,53,32573,53,allow,179,94,85,2,30,1,1
12278,55022,53,7516,53,allow,195,102,93,2,30,1,1
12279,55837,53,32132,53,allow,195,102,93,2,30,1,1
12280,55991,53,22499,53,allow,199,102,97,2,30,1,1
12281,55068,443,46144,443,allow,5611,3720,1891,28,54,16,12
12282,61421,80,3203,80,allow,214,140,74,4,41,3,1
12283,35917,443,52534,443,allow,13480,8545,4935,35,94,19,16
12284,55892,80,55892,80,allow,1917,1468,449,10,20,6,4
12285,4296,53,43153,53,allow,217,86,131,2,30,1,1
12286,49592,53,47137,53,allow,177,94,83,2,30,1,1
12287,49333,53,61415,53,allow,392,102,290,2,30,1,1
12288,64191,53,17402,53,allow,264,110,154,2,30,1,1
12289,55687,53,38089,53,allow,193,102,91,2,30,1,1
12290,49615,53,49539,53,allow,199,102,97,2,30,1,1
12291,55555,53,24469,53,allow,194,102,92,2,30,1,1
12292,64026,80,47805,80,allow,314,192,122,6,15,4,2
12293,52213,80,42925,80,allow,5022,1422,3600,16,135,8,8
12294,52103,7172,60174,7172,allow,70,70,0,1,5,1,0
12295,64942,53,56338,53,allow,803,390,413,9,71,5,4
12296,61431,80,8546,80,allow,214,140,74,4,41,3,1
12297,58738,443,24230,443,allow,12382,9652,2730,43,58,26,17
12298,56529,80,56529,80,allow,1915,1466,449,10,20,6,4
12299,60030,443,28456,443,allow,711172,27430,683742,812,104,342,470
12300,53889,19002,16357,19002,allow,552,306,246,9,15,5,4
12301,64116,53,45149,53,allow,267,94,173,4,59,2,2
12302,65531,53,44923,53,allow,193,102,91,2,30,1,1
12303,56820,53,40391,53,allow,193,102,91,2,30,1,1
12304,56360,53,60818,53,allow,184,102,82,2,30,1,1
12305,40290,53,7159,53,allow,168,78,90,2,30,1,1
12306,64731,53,48863,53,allow,779,86,693,2,30,1,1
12307,49739,53,37326,53,allow,757,102,655,2,30,1,1
12308,56113,53,45666,53,allow,211,102,109,2,30,1,1
12309,50007,53,39028,53,allow,216,110,106,2,30,1,1
12310,56239,53,49542,53,allow,180,94,86,2,30,1,1
12311,50007,53,43367,53,allow,216,110,106,2,30,1,1
12312,64251,53,54906,53,allow,451,118,333,2,30,1,1
12313,52661,53,0,0,allow,86,86,0,1,30,1,0
12314,53120,80,53120,80,allow,26927,1133,25794,36,15,16,20
12315,36402,80,36402,80,allow,1917,1468,449,10,20,6,4
12316,40471,80,40471,80,allow,1917,1468,449,10,20,6,4
12317,60864,80,22050,80,allow,10629,1104,9525,23,46,12,11
12318,36306,80,36306,80,allow,1917,1468,449,10,20,6,4
12319,44673,80,44673,80,allow,1916,1467,449,10,20,6,4
12320,60008,443,9561,443,allow,7060,1850,5210,35,110,21,14
12321,65416,53,16237,53,allow,213,102,111,2,30,1,1
12322,50007,53,59429,53,allow,216,110,106,2,30,1,1
12323,63638,53,10182,53,allow,286,78,208,2,30,1,1
12324,56362,53,52775,53,allow,453,186,267,6,30,3,3
12325,55332,53,52188,53,allow,211,110,101,2,30,1,1
12326,56312,53,62526,53,allow,195,102,93,2,30,1,1
12327,55610,53,39164,53,allow,199,102,97,2,30,1,1
12328,16776,53,16776,53,allow,197,90,107,2,30,1,1
12329,56596,53,50700,53,allow,199,102,97,2,30,1,1
12330,57204,53,65520,53,allow,195,102,93,2,30,1,1
12331,55332,53,45716,53,allow,211,110,101,2,30,1,1
12332,55638,53,1033,53,allow,78,78,0,1,30,1,0
12333,49402,53,15984,53,allow,185,102,83,2,31,1,1
12334,56312,53,52964,53,allow,195,102,93,2,31,1,1
12335,49492,53,41002,53,allow,199,102,97,2,31,1,1
12336,49262,443,12479,443,allow,4353,1227,3126,12,135,6,6
12337,39277,443,14513,443,allow,6891,1421,5470,20,127,12,8
12338,55707,53,31512,53,allow,177,94,83,2,30,1,1
12339,65143,53,8081,53,allow,199,102,97,2,30,1,1
12340,62524,53,62524,53,allow,212,90,122,2,30,1,1
12341,49972,53,10685,53,allow,216,110,106,2,31,1,1
12342,64116,53,50037,53,allow,184,94,90,2,31,1,1
12343,55620,53,6956,53,allow,178,94,84,2,31,1,1
12344,63993,53,47498,53,allow,338,110,228,2,31,1,1
12345,49841,53,34208,53,allow,264,110,154,2,31,1,1
12346,57312,53,30289,53,allow,212,110,102,2,31,1,1
12347,34658,80,20483,80,allow,6094,954,5140,15,3601,8,7
12348,56422,53,25062,53,allow,195,102,93,2,31,1,1
12349,57132,53,52410,53,allow,216,110,106,2,31,1,1
12350,64929,53,16910,53,allow,168,86,82,2,31,1,1
12351,49296,53,53194,53,allow,193,102,91,2,31,1,1
12352,47376,443,12829,443,allow,2944,778,2166,10,120,5,5
12353,60569,443,44105,443,allow,10385,4932,5453,21,135,9,12
12354,33156,3478,41500,3478,allow,338,110,228,2,300,1,1
12355,57470,8621,39581,8621,allow,469,150,319,2,1199,1,1
12356,64615,53,57777,53,allow,195,102,93,2,31,1,1
12357,37222,443,49931,443,allow,2394,1365,1029,18,275,9,9
12358,46046,443,33761,443,allow,11019,4673,6346,32,423,17,15
12359,32900,443,53581,443,allow,14739,1296,13443,30,306,9,21
12360,28592,53,28592,53,allow,216,90,126,2,31,1,1
12361,55195,443,41833,443,allow,907774,32911,874863,898,460,195,703
12362,37965,17336,18530,17336,allow,481,150,331,2,1199,1,1
12363,39566,443,50145,443,allow,9748,5209,4539,22,121,11,11
12364,52145,36670,58227,36670,allow,316,136,180,6,6,3,3
12365,64047,16221,34665,16221,allow,66,66,0,2,8,2,0
12366,64048,44918,64560,44918,allow,66,66,0,2,8,2,0
12367,52135,46475,48450,46475,allow,70,70,0,2,8,2,0
12368,50684,80,2387,80,allow,132,132,0,2,8,2,0
12369,52099,28401,35047,28401,allow,70,70,0,1,5,1,0
12370,49889,53,3966,53,allow,310,99,211,4,40,2,2
12371,51103,443,36898,443,allow,20280,13177,7103,82,1176,46,36
12372,55372,53,7749,53,allow,271,93,178,4,43,2,2
12373,49826,53,43562,53,allow,466,192,274,6,83,3,3
12374,56910,53,59135,53,allow,211,78,133,2,30,1,1
12375,64427,445,0,0,drop,70,70,0,1,0,1,0
12376,64568,445,0,0,drop,66,66,0,1,0,1,0
12377,42490,1433,0,0,deny,60,60,0,1,0,1,0
12378,53207,50584,0,0,deny,66,66,0,1,0,1,0
12379,64567,445,0,0,drop,66,66,0,1,0,1,0
12380,54221,57470,0,0,deny,66,66,0,1,0,1,0
12381,35194,57470,0,0,deny,74,74,0,1,0,1,0
12382,60180,31573,0,0,deny,62,62,0,1,0,1,0
12383,56388,22114,0,0,deny,66,66,0,1,0,1,0
12384,64418,445,0,0,drop,70,70,0,1,0,1,0
12385,23844,26467,0,0,deny,62,62,0,1,0,1,0
12386,64416,445,0,0,drop,70,70,0,1,0,1,0
12387,23843,26467,0,0,deny,62,62,0,1,0,1,0
12388,52782,445,0,0,drop,70,70,0,1,0,1,0
12389,52778,445,0,0,drop,70,70,0,1,0,1,0
12390,52779,445,0,0,drop,70,70,0,1,0,1,0
12391,64415,445,0,0,drop,70,70,0,1,0,1,0
12392,64553,445,0,0,drop,66,66,0,1,0,1,0
12393,64552,445,0,0,drop,66,66,0,1,0,1,0
12394,64548,445,0,0,drop,66,66,0,1,0,1,0
12395,64554,445,0,0,drop,66,66,0,1,0,1,0
12396,64551,445,0,0,drop,66,66,0,1,0,1,0
12397,64549,445,0,0,drop,66,66,0,1,0,1,0
12398,64547,445,0,0,drop,66,66,0,1,0,1,0
12399,64550,445,0,0,drop,66,66,0,1,0,1,0
12400,64414,445,0,0,drop,70,70,0,1,0,1,0
12401,64413,445,0,0,drop,70,70,0,1,0,1,0
12402,53373,64147,0,0,deny,62,62,0,1,0,1,0
12403,64407,445,0,0,drop,70,70,0,1,0,1,0
12404,64410,445,0,0,drop,70,70,0,1,0,1,0
12405,53413,35440,0,0,deny,146,146,0,1,0,1,0
12406,28476,25174,0,0,deny,146,146,0,1,0,1,0
12407,59528,50584,0,0,deny,146,146,0,1,0,1,0
12408,51754,18375,0,0,deny,66,66,0,1,0,1,0
12409,64077,25174,0,0,deny,62,62,0,1,0,1,0
12410,44886,23,0,0,deny,60,60,0,1,0,1,0
12411,55620,30188,0,0,deny,66,66,0,1,0,1,0
12412,64395,445,0,0,drop,70,70,0,1,0,1,0
12413,64394,445,0,0,drop,70,70,0,1,0,1,0
12414,64389,445,0,0,drop,70,70,0,1,0,1,0
12415,58715,64097,0,0,deny,62,62,0,1,0,1,0
12416,48706,23393,0,0,deny,60,60,0,1,0,1,0
12417,54883,51505,0,0,deny,66,66,0,1,0,1,0
12418,64385,445,0,0,drop,70,70,0,1,0,1,0
12419,64384,445,0,0,drop,70,70,0,1,0,1,0
12420,5228,3434,0,0,deny,345,345,0,1,0,1,0
12421,7048,25174,0,0,deny,62,62,0,1,0,1,0
12422,52772,445,0,0,drop,70,70,0,1,0,1,0
12423,52770,445,0,0,drop,70,70,0,1,0,1,0
12424,52768,445,0,0,drop,70,70,0,1,0,1,0
12425,52762,445,0,0,drop,70,70,0,1,0,1,0
12426,55406,25174,0,0,deny,66,66,0,1,0,1,0
12427,53015,64147,0,0,deny,62,62,0,1,0,1,0
12428,55713,25174,0,0,deny,146,146,0,1,0,1,0
12429,64531,445,0,0,drop,66,66,0,1,0,1,0
12430,64532,445,0,0,drop,66,66,0,1,0,1,0
12431,64534,445,0,0,drop,66,66,0,1,0,1,0
12432,30650,25174,0,0,deny,62,62,0,1,0,1,0
12433,12348,50265,0,0,deny,62,62,0,1,0,1,0
12434,64989,50265,0,0,deny,66,66,0,1,0,1,0
12435,13062,52274,0,0,deny,66,66,0,1,0,1,0
12436,30697,57866,0,0,deny,62,62,0,1,0,1,0
12437,1024,25174,0,0,deny,146,146,0,1,0,1,0
12438,59096,57866,0,0,deny,66,66,0,1,0,1,0
12439,38549,22114,0,0,deny,62,62,0,1,0,1,0
12440,58143,57866,0,0,deny,66,66,0,1,0,1,0
12441,49393,30188,0,0,deny,66,66,0,1,0,1,0
12442,52759,445,0,0,drop,70,70,0,1,0,1,0
12443,64373,445,0,0,drop,70,70,0,1,0,1,0
12444,39941,2767,0,0,deny,62,62,0,1,0,1,0
12445,63213,57866,0,0,deny,66,66,0,1,0,1,0
12446,52750,445,0,0,drop,70,70,0,1,0,1,0
12447,52749,445,0,0,drop,70,70,0,1,0,1,0
12448,52748,445,0,0,drop,70,70,0,1,0,1,0
12449,60311,30627,0,0,deny,66,66,0,1,0,1,0
12450,1024,44847,0,0,deny,62,62,0,1,0,1,0
12451,65233,23117,0,0,deny,62,62,0,1,0,1,0
12452,10082,64147,0,0,deny,62,62,0,1,0,1,0
12453,49630,22,49630,22,deny,295,126,169,4,1,2,2
12454,64369,445,0,0,drop,70,70,0,1,0,1,0
12455,443,22238,0,0,deny,112,112,0,1,0,1,0
12456,46808,25174,0,0,deny,62,62,0,1,0,1,0
12457,1024,64147,0,0,deny,62,62,0,1,0,1,0
12458,25237,25174,0,0,deny,62,62,0,1,0,1,0
12459,64358,445,0,0,drop,70,70,0,1,0,1,0
12460,64359,445,0,0,drop,70,70,0,1,0,1,0
12461,52739,445,0,0,drop,70,70,0,1,0,1,0
12462,64360,445,0,0,drop,70,70,0,1,0,1,0
12463,52740,445,0,0,drop,70,70,0,1,0,1,0
12464,52734,445,0,0,drop,70,70,0,1,0,1,0
12465,37011,25174,0,0,deny,62,62,0,1,0,1,0
12466,58627,64097,0,0,deny,62,62,0,1,0,1,0
12467,64356,445,0,0,drop,70,70,0,1,0,1,0
12468,50084,26672,0,0,deny,62,62,0,1,0,1,0
12469,35657,48637,0,0,deny,62,62,0,1,0,1,0
12470,64353,445,0,0,drop,70,70,0,1,0,1,0
12471,64519,445,0,0,drop,66,66,0,1,0,1,0
12472,45013,50584,0,0,deny,146,146,0,1,0,1,0
12473,61369,64147,0,0,deny,66,66,0,1,0,1,0
12474,58338,3353,0,0,deny,60,60,0,1,0,1,0
12475,6832,51505,0,0,deny,66,66,0,1,0,1,0
12476,52733,445,0,0,drop,70,70,0,1,0,1,0
12477,52731,445,0,0,drop,70,70,0,1,0,1,0
12478,64346,445,0,0,drop,70,70,0,1,0,1,0
12479,40254,25174,0,0,deny,146,146,0,1,0,1,0
12480,62400,35993,0,0,deny,66,66,0,1,0,1,0
12481,64505,445,0,0,drop,66,66,0,1,0,1,0
12482,64507,445,0,0,drop,66,66,0,1,0,1,0
12483,43679,44847,0,0,deny,62,62,0,1,0,1,0
12484,2437,23117,0,0,deny,62,62,0,1,0,1,0
12485,64339,445,0,0,drop,70,70,0,1,0,1,0
12486,46604,57866,0,0,deny,66,66,0,1,0,1,0
12487,53071,25174,0,0,deny,66,66,0,1,0,1,0
12488,64336,445,0,0,drop,70,70,0,1,0,1,0
12489,45964,2225,0,0,deny,60,60,0,1,0,1,0
12490,58716,9694,0,0,deny,62,62,0,1,0,1,0
12491,3524,25174,0,0,deny,66,66,0,1,0,1,0
12492,61898,50584,0,0,deny,66,66,0,1,0,1,0
12493,56578,25174,0,0,deny,66,66,0,1,0,1,0
12494,19204,57866,0,0,deny,66,66,0,1,0,1,0
12495,52720,445,0,0,drop,70,70,0,1,0,1,0
12496,52719,445,0,0,drop,70,70,0,1,0,1,0
12497,52718,445,0,0,drop,70,70,0,1,0,1,0
12498,52711,445,0,0,drop,70,70,0,1,0,1,0
12499,57471,62413,0,0,deny,66,66,0,1,0,1,0
12500,3800,48817,0,0,deny,146,146,0,1,0,1,0
12501,51414,22,0,0,deny,60,60,0,1,0,1,0
12502,59803,22114,0,0,deny,62,62,0,1,0,1,0
12503,64498,445,0,0,drop,66,66,0,1,0,1,0
12504,64333,445,0,0,drop,70,70,0,1,0,1,0
12505,7905,22114,0,0,deny,66,66,0,1,0,1,0
12506,64331,445,0,0,drop,70,70,0,1,0,1,0
12507,7619,50584,0,0,deny,62,62,0,1,0,1,0
12508,0,0,0,0,allow,600,306,294,6,0,3,3
12509,12545,25174,0,0,deny,62,62,0,1,0,1,0
12510,50593,64147,0,0,deny,66,66,0,1,0,1,0
12511,64494,445,0,0,drop,66,66,0,1,0,1,0
12512,64493,445,0,0,drop,66,66,0,1,0,1,0
12513,64492,445,0,0,drop,66,66,0,1,0,1,0
12514,64491,445,0,0,drop,66,66,0,1,0,1,0
12515,64488,445,0,0,drop,66,66,0,1,0,1,0
12516,64486,445,0,0,drop,66,66,0,1,0,1,0
12517,64483,445,0,0,drop,66,66,0,1,0,1,0
12518,55116,7574,0,0,deny,62,62,0,1,0,1,0
12519,52706,445,0,0,drop,70,70,0,1,0,1,0
12520,64327,445,0,0,drop,70,70,0,1,0,1,0
12521,52703,445,0,0,drop,70,70,0,1,0,1,0
12522,52701,445,0,0,drop,70,70,0,1,0,1,0
12523,52699,445,0,0,drop,70,70,0,1,0,1,0
12524,51414,50584,0,0,deny,66,66,0,1,0,1,0
12525,15333,60043,0,0,deny,62,62,0,1,0,1,0
12526,52492,37965,0,0,deny,66,66,0,1,0,1,0
12527,36561,2767,0,0,deny,62,62,0,1,0,1,0
12528,64326,445,0,0,drop,70,70,0,1,0,1,0
12529,52699,25174,0,0,deny,66,66,0,1,0,1,0
12530,1865,25174,0,0,deny,62,62,0,1,0,1,0
12531,42796,22114,0,0,deny,62,62,0,1,0,1,0
12532,63786,25174,0,0,deny,66,66,0,1,0,1,0
12533,64321,445,0,0,drop,70,70,0,1,0,1,0
12534,52696,445,0,0,drop,70,70,0,1,0,1,0
12535,52695,445,0,0,drop,70,70,0,1,0,1,0
12536,52691,445,0,0,drop,70,70,0,1,0,1,0
12537,443,59493,0,0,deny,60,60,0,1,0,1,0
12538,20619,25174,0,0,deny,66,66,0,1,0,1,0
12539,64476,445,0,0,drop,66,66,0,1,0,1,0
12540,52690,445,0,0,drop,70,70,0,1,0,1,0
12541,26531,37965,0,0,deny,62,62,0,1,0,1,0
12542,64474,445,0,0,drop,66,66,0,1,0,1,0
12543,23940,41615,0,0,deny,146,146,0,1,0,1,0
12544,55082,25174,0,0,deny,66,66,0,1,0,1,0
12545,58091,51505,0,0,deny,66,66,0,1,0,1,0
12546,64472,445,0,0,drop,66,66,0,1,0,1,0
12547,64470,445,0,0,drop,66,66,0,1,0,1,0
12548,43076,23,0,0,deny,60,60,0,1,0,1,0
12549,49036,44847,0,0,deny,62,62,0,1,0,1,0
12550,63173,36237,0,0,deny,66,66,0,1,0,1,0
12551,64469,445,0,0,drop,66,66,0,1,0,1,0
12552,54140,17372,0,0,deny,66,66,0,1,0,1,0
12553,24311,22617,0,0,deny,60,60,0,1,0,1,0
12554,58021,22114,0,0,deny,66,66,0,1,0,1,0
12555,36551,23,0,0,deny,60,60,0,1,0,1,0
12556,22571,51505,0,0,deny,66,66,0,1,0,1,0
12557,56496,53,60823,53,allow,186,95,91,2,30,1,1
12558,56596,53,26887,53,allow,198,101,97,2,30,1,1
12559,9280,443,36215,443,allow,4612,830,3782,16,27,9,7
12560,60481,40075,20355,40075,allow,70,70,0,1,5,1,0
12561,61441,443,10709,443,allow,7832,1143,6689,19,31,9,10
12562,47038,443,65328,443,allow,2809,1884,925,19,24,11,8
12563,57312,53,16678,53,allow,1385,85,1300,4,42,2,2
12564,53893,11344,38662,11344,allow,70,70,0,1,5,1,0
12565,5588,5588,0,0,allow,3562,1936,1626,48,193,24,24
12566,47438,80,47438,80,allow,2886,1481,1405,10,15,6,4
12567,35088,443,54099,443,allow,800,452,348,12,94,7,5
12568,34340,443,16904,443,allow,3497,1845,1652,18,16,9,9
12569,56062,53,16578,53,allow,744,89,655,2,31,1,1
12570,55963,53,27489,53,allow,755,93,662,2,30,1,1
12571,47747,443,43132,443,allow,4187,1350,2837,18,321,8,10
12572,9294,443,62511,443,allow,6356,979,5377,19,27,10,9
12573,59392,443,2075,443,allow,105190,30835,74355,372,589,169,203
12574,52131,28980,48915,28980,allow,70,70,0,2,8,2,0
12575,52133,15015,56839,15015,allow,70,70,0,2,8,2,0
12576,53915,1026,52746,1026,allow,70,70,0,2,8,2,0
12577,37027,443,52306,443,allow,90706,5324,85382,128,262,66,62
12578,65140,53,64543,53,allow,198,101,97,2,30,1,1
12579,41151,443,41151,443,allow,4713,1806,2907,19,30,11,8
12580,57794,53,57794,53,allow,825,99,726,2,30,1,1
12581,46216,443,9972,443,allow,161,101,60,2,5,1,1
12582,60479,53928,56520,53928,allow,70,70,0,1,5,1,0
12583,59404,443,36010,443,allow,11018,5022,5996,84,588,43,41
12584,42783,443,65446,443,allow,13510,5888,7622,65,86,33,32
12585,39038,443,14810,443,allow,3970,2230,1740,17,114,10,7
12586,56752,443,27500,443,allow,11771,2624,9147,50,20,25,25
12587,51073,443,23186,443,allow,7343,2672,4671,20,76,12,8
12588,60982,443,39893,443,allow,18274,7660,10614,46,48,26,20
12589,32346,53,32346,53,allow,194,87,107,2,30,1,1
12590,50421,53,19651,53,allow,762,98,664,2,30,1,1
12591,64324,53,12173,53,allow,174,89,85,2,30,1,1
12592,55563,53,57917,53,allow,763,101,662,2,30,1,1
12593,34914,53,34914,53,allow,825,99,726,2,30,1,1
12594,33812,443,2950,443,allow,16120,8754,7366,36,327,21,15
12595,51449,443,58167,443,allow,21779,7983,13796,44,97,25,19
12596,57132,53,28118,53,allow,216,110,106,2,31,1,1
12597,55841,53,55031,53,allow,265,86,179,4,59,2,2
12598,41000,443,31779,443,allow,10675,5079,5596,88,588,47,41
12599,40906,443,50326,443,allow,8138,2333,5805,26,106,14,12
12600,37031,443,21372,443,allow,43818,31519,12299,85,259,49,36
12601,54805,443,42817,443,allow,19635,9923,9712,165,588,72,93
12602,59405,443,49077,443,allow,10726,4848,5878,79,588,40,39
12603,59570,443,28825,443,allow,24203,14278,9925,168,320,74,94
12604,35542,23,35542,23,allow,124,60,64,2,5,1,1
12605,54872,53,11458,53,allow,578,286,292,9,15,5,4
12606,57211,443,58131,443,allow,25881,12394,13487,221,579,105,116
12607,52130,1035,4806,1035,allow,70,70,0,2,8,2,0
12608,58857,443,61452,443,allow,674,130,544,11,129,3,8
12609,55372,53,64639,53,allow,271,93,178,4,43,2,2
12610,49394,443,40363,443,allow,7129,1853,5276,27,316,13,14
12611,57312,53,43620,53,allow,208,106,102,2,30,1,1
12612,52775,123,25733,123,allow,184,94,90,2,30,1,1
12613,65045,53,47072,53,allow,755,94,661,2,30,1,1
12614,65481,53,28484,53,allow,168,86,82,2,31,1,1
12615,37965,46405,21208,46405,allow,1217,594,623,16,1764,10,6
12616,443,60746,0,0,allow,60,60,0,1,90,1,0
12617,55941,53,18127,53,allow,184,94,90,2,30,1,1
12618,50293,53,25447,53,allow,740,93,647,2,31,1,1
12619,56028,53,49252,53,allow,770,102,668,2,31,1,1
12620,64929,53,46254,53,allow,168,86,82,2,31,1,1
12621,56586,53,7577,53,allow,754,94,660,2,31,1,1
12622,49953,53,38496,53,allow,757,98,659,2,31,1,1
12623,56293,53,53120,53,allow,164,84,80,2,31,1,1
12624,56697,53,7977,53,allow,711,87,624,2,31,1,1
12625,62763,443,43714,443,allow,7755,4481,3274,17,135,9,8
12626,48817,48489,48817,48489,allow,480,149,331,2,1200,1,1
12627,56437,53,21787,53,allow,731,91,640,2,31,1,1
12628,56199,53,15227,53,allow,256,93,163,2,31,1,1
12629,56965,53,30276,53,allow,182,93,89,2,31,1,1
12630,55376,53,64673,53,allow,198,101,97,2,31,1,1
12631,64403,53,35591,53,allow,186,95,91,2,31,1,1
12632,49611,53,60181,53,allow,170,87,83,2,31,1,1
12633,57969,53,57969,53,allow,194,87,107,2,31,1,1
12634,49699,53,23875,53,allow,202,103,99,2,31,1,1
12635,43394,53,50886,53,allow,168,78,90,2,31,1,1
12636,48589,443,15567,443,allow,15400,9133,6267,40,272,22,18
12637,56696,53,25639,53,allow,757,98,659,2,31,1,1
12638,57450,53,43406,53,allow,916,86,830,2,31,1,1
12639,56207,53,7940,53,allow,761,100,661,2,31,1,1
12640,64543,53,58923,53,allow,761,100,661,2,31,1,1
12641,49764,53,33834,53,allow,198,101,97,2,31,1,1
12642,55218,80,61870,80,allow,2568,1705,863,12,186,7,5
12643,43480,443,57887,443,allow,58423,25600,32823,86,138,40,46
12644,43268,443,16959,443,allow,8954,2755,6199,23,143,10,13
12645,55620,53,33396,53,allow,172,88,84,2,31,1,1
12646,56054,53,43314,53,allow,740,93,647,2,31,1,1
12647,50444,53,27303,53,allow,256,93,163,2,31,1,1
12648,65447,53,45832,53,allow,756,95,661,2,31,1,1
12649,56447,53,59083,53,allow,758,96,662,2,31,1,1
12650,57007,53,30076,53,allow,182,93,89,2,31,1,1
12651,64950,53,22680,53,allow,182,93,89,2,31,1,1
12652,57352,53,8029,53,allow,192,98,94,2,31,1,1
12653,64677,53,37767,53,allow,182,93,89,2,31,1,1
12654,59559,443,47582,443,allow,3255,1089,2166,10,122,5,5
12655,36229,62413,0,0,deny,146,146,0,1,0,1,0
12656,18655,44847,0,0,deny,66,66,0,1,0,1,0
12657,52685,445,0,0,drop,70,70,0,1,0,1,0
12658,6881,6881,0,0,deny,62,62,0,1,0,1,0
12659,64308,445,0,0,drop,70,70,0,1,0,1,0
12660,52680,445,0,0,drop,70,70,0,1,0,1,0
12661,52679,445,0,0,drop,70,70,0,1,0,1,0
12662,12226,37965,0,0,deny,62,62,0,1,0,1,0
12663,55439,37965,0,0,deny,66,66,0,1,0,1,0
12664,8889,64500,0,0,deny,60,60,0,1,0,1,0
12665,64305,445,0,0,drop,70,70,0,1,0,1,0
12666,10547,57470,0,0,deny,62,62,0,1,0,1,0
12667,44040,443,39447,443,allow,11774,5465,6309,75,585,38,37
12668,60477,30889,23604,30889,allow,70,70,0,1,5,1,0
12669,49418,22114,0,0,deny,66,66,0,1,0,1,0
12670,64457,445,0,0,drop,66,66,0,1,0,1,0
12671,26962,26467,0,0,deny,66,66,0,1,0,1,0
12672,19175,50584,0,0,deny,146,146,0,1,0,1,0
12673,35937,25174,0,0,deny,66,66,0,1,0,1,0
12674,37308,43890,0,0,deny,62,62,0,1,0,1,0
12675,43207,26467,0,0,deny,62,62,0,1,0,1,0
12676,64450,445,0,0,drop,66,66,0,1,0,1,0
12677,64300,445,0,0,drop,70,70,0,1,0,1,0
12678,52662,445,0,0,drop,70,70,0,1,0,1,0
12679,64299,445,0,0,drop,70,70,0,1,0,1,0
12680,45461,25174,0,0,deny,62,62,0,1,0,1,0
12681,23218,62413,0,0,deny,66,66,0,1,0,1,0
12682,64297,445,0,0,drop,70,70,0,1,0,1,0
12683,64448,445,0,0,drop,66,66,0,1,0,1,0
12684,56793,56205,0,0,deny,66,66,0,1,0,1,0
12685,59032,25174,0,0,deny,66,66,0,1,0,1,0
12686,443,21255,0,0,deny,66,66,0,1,0,1,0
12687,49546,53,5497,53,allow,212,110,102,2,30,1,1
12688,56293,53,25636,53,allow,166,86,80,2,30,1,1
12689,52182,443,4685,443,allow,237151,13019,224132,251,42,90,161
12690,34053,443,6934,443,allow,5987,1678,4309,21,199,12,9
12691,49738,53,39292,53,allow,228,86,142,2,29,1,1
12692,50069,53,45809,53,allow,764,102,662,2,29,1,1
12693,44543,443,30865,443,allow,13478,2683,10795,36,104,19,17
12694,49611,53,44019,53,allow,177,94,83,2,30,1,1
12695,50658,80,54358,80,allow,5018,4314,704,11,30,6,5
12696,34059,80,37168,80,allow,1151,711,440,10,15,5,5
12697,65471,53,5865,53,allow,441,90,351,4,48,2,2
12698,53890,23310,38031,23310,allow,70,70,0,1,4,1,0
12699,64045,7426,45943,7426,allow,66,66,0,2,7,2,0
12700,52100,54130,1109,54130,allow,70,70,0,1,4,1,0
12701,56730,443,7897,443,allow,347884,9284,338600,360,31,125,235
12702,60800,40010,5284,40010,allow,316,136,180,6,5,3,3
12703,55372,53,13857,53,allow,271,93,178,4,42,2,2
12704,53275,443,20326,443,allow,364,142,222,6,10,3,3
12705,18963,80,18963,80,allow,1501,652,849,9,15,5,4
12706,57396,443,32290,443,allow,152,78,74,2,4,1,1
12707,9312,443,24938,443,allow,4618,840,3778,16,26,9,7
12708,63974,53,39548,53,allow,212,102,110,2,29,1,1
12709,57312,53,15136,53,allow,212,110,102,2,29,1,1
12710,65143,53,22648,53,allow,822,102,720,2,29,1,1
12711,1848,53,1848,53,allow,832,106,726,2,29,1,1
12712,49972,53,25100,53,allow,328,110,218,4,57,2,2
12713,55514,53,45295,53,allow,779,86,693,2,29,1,1
12714,57235,53,60743,53,allow,757,102,655,2,29,1,1
12715,12230,53,12230,53,allow,216,90,126,2,29,1,1
12716,65140,53,46396,53,allow,199,102,97,2,29,1,1
12717,55007,53,23960,53,allow,166,86,80,2,29,1,1
12718,55991,53,2664,53,allow,199,102,97,2,30,1,1
12719,49982,53,16411,53,allow,211,110,101,2,30,1,1
12720,55610,53,5256,53,allow,822,102,720,2,29,1,1
12721,56909,53,4449,53,allow,260,86,174,2,30,1,1
12722,56333,53,31573,53,allow,209,110,99,2,30,1,1
12723,49210,53,10205,53,allow,183,94,89,2,30,1,1
12724,55707,53,50329,53,allow,177,94,83,2,29,1,1
12725,39416,443,62311,443,allow,11188,5277,5911,95,587,44,51
12726,48287,443,53104,443,allow,416,210,206,7,96,4,3
12727,60402,80,24295,80,allow,1135,736,399,7,95,4,3
12728,55469,53,31769,53,allow,193,102,91,2,30,1,1
12729,64314,53,48605,53,allow,264,110,154,2,30,1,1
12730,55941,53,54126,53,allow,184,94,90,2,30,1,1
12731,65511,443,62661,443,allow,430254,12640,417614,442,16,155,287
12732,58431,443,11477,443,allow,5771,3201,2570,22,161,10,12
12733,9299,443,15796,443,allow,4216,771,3445,16,26,9,7
12734,60476,55100,33461,55100,allow,70,70,0,1,5,1,0
12735,38772,443,61255,443,allow,410,210,200,7,86,4,3
12736,9279,443,53983,443,allow,4275,760,3515,15,27,8,7
12737,9307,443,6375,443,allow,4458,1022,3436,16,26,9,7
12738,49385,53,7961,53,allow,214,102,112,2,30,1,1
12739,55599,53,58938,53,allow,258,118,140,2,30,1,1
12740,50096,53,56974,53,allow,733,94,639,2,30,1,1
12741,52096,55854,62191,55854,allow,70,70,0,1,5,1,0
12742,9300,443,62109,443,allow,4216,771,3445,16,26,9,7
12743,55555,53,26797,53,allow,194,102,92,2,30,1,1
12744,9322,443,10424,443,allow,4106,703,3403,15,26,8,7
12745,56689,443,17106,443,allow,4857,3938,919,18,81,11,7
12746,55707,53,50594,53,allow,177,94,83,2,30,1,1
12747,56550,123,27975,123,allow,184,94,90,2,30,1,1
12748,64793,53,53457,53,allow,184,94,90,2,30,1,1
12749,65009,53,23695,53,allow,152,78,74,2,30,1,1
12750,55469,53,3156,53,allow,193,102,91,2,30,1,1
12751,49982,53,19488,53,allow,211,110,101,2,30,1,1
12752,64908,53,55022,53,allow,232,94,138,2,30,1,1
12753,56551,53,16307,53,allow,458,188,270,6,30,3,3
12754,49210,53,44765,53,allow,183,94,89,2,30,1,1
12755,56757,53,22580,53,allow,322,118,204,2,30,1,1
12756,49874,53,37266,53,allow,173,94,79,2,30,1,1
12757,49699,53,53158,53,allow,209,110,99,2,30,1,1
12758,55376,53,17349,53,allow,199,102,97,2,30,1,1
12759,43750,443,22954,443,allow,248384,70243,178141,544,588,246,298
12760,41011,443,63172,443,allow,175097,9838,165259,244,106,120,124
12761,49767,53,45579,53,allow,341,102,239,4,37,2,2
12762,9311,443,26204,443,allow,4082,958,3124,14,26,8,6
12763,9313,443,38695,443,allow,4618,840,3778,16,26,9,7
12764,64813,7000,64813,7000,allow,1300,676,624,14,15,7,7
12765,65510,443,47071,443,allow,92101,4799,87302,107,16,43,64
12766,50403,53,33399,53,allow,168,86,82,2,30,1,1
12767,56422,53,30231,53,allow,195,102,93,2,30,1,1
12768,59962,53,13839,53,allow,316,94,222,2,30,1,1
12769,65498,53,49564,53,allow,749,94,655,2,30,1,1
12770,55941,53,34210,53,allow,184,94,90,2,30,1,1
12771,39345,80,26537,80,allow,918,461,457,9,16,6,3
12772,48286,443,64439,443,allow,9590,3002,6588,25,96,14,11
12773,61314,443,62611,443,allow,3320,2053,1267,27,318,14,13
12774,41583,443,3597,443,allow,4168,2503,1665,20,255,11,9
12775,49568,443,58538,443,allow,7180,4959,2221,34,81,18,16
12776,49402,53,17640,53,allow,177,94,83,2,30,1,1
12777,55620,53,62411,53,allow,178,94,84,2,30,1,1
12778,56496,53,41605,53,allow,193,102,91,2,30,1,1
12779,56955,53,35942,53,allow,183,94,89,2,30,1,1
12780,56652,53,11062,53,allow,177,94,83,2,30,1,1
12781,65277,53,40483,53,allow,167,86,81,2,30,1,1
12782,65102,53,35796,53,allow,183,94,89,2,30,1,1
12783,50066,443,28197,443,allow,7144,2505,4639,14,120,7,7
12784,50075,443,63297,443,allow,4701,2758,1943,41,93,22,19
12785,55841,53,44587,53,allow,265,86,179,4,58,2,2
12786,57385,443,20044,443,allow,8747,3323,5424,45,110,25,20
12787,57443,443,31881,443,allow,8287,2469,5818,31,18,14,17
12788,49546,53,2512,53,allow,357,106,251,4,36,2,2
12789,51242,80,19033,80,allow,3506,2280,1226,24,50,13,11
12790,56313,443,7717,443,allow,37465,18615,18850,299,588,135,164
12791,55838,443,50460,443,allow,11446,4102,7344,32,20,16,16
12792,58461,443,33796,443,allow,6100,1233,4867,21,17,11,10
12793,53166,39564,27898,39564,allow,70,70,0,2,8,2,0
12794,60020,443,30222,443,allow,495428,22440,472988,692,106,316,376
12795,9302,443,20327,443,allow,4216,771,3445,16,26,9,7
12796,52134,18470,2197,18470,allow,70,70,0,2,7,2,0
12797,64049,1029,38472,1029,allow,66,66,0,2,7,2,0
12798,52097,23279,1789,23279,allow,70,70,0,1,5,1,0
12799,53716,443,22368,443,allow,7055,1261,5794,21,82,10,11
12800,52132,55014,54625,55014,allow,70,70,0,2,7,2,0
12801,53916,23505,33630,23505,allow,70,70,0,2,7,2,0
12802,50079,443,3173,443,allow,32829,8718,24111,41,17,18,23
12803,64299,53,26079,53,allow,268,84,184,4,42,2,2
12804,57511,123,47594,123,allow,184,94,90,2,29,1,1
12805,55687,53,45230,53,allow,193,102,91,2,29,1,1
12806,9298,443,38844,443,allow,4216,771,3445,16,26,9,7
12807,33401,51505,0,0,deny,66,66,0,1,0,1,0
12808,60976,22114,0,0,deny,66,66,0,1,0,1,0
12809,52091,11392,0,0,deny,66,66,0,1,0,1,0
12810,52231,50934,0,0,deny,62,62,0,1,0,1,0
12811,30304,26467,0,0,deny,62,62,0,1,0,1,0
12812,64441,445,0,0,drop,66,66,0,1,0,1,0
12813,55553,53,13806,53,allow,199,94,105,2,29,1,1
12814,5588,5588,0,0,allow,3498,1872,1626,48,193,24,24
12815,65264,53,51558,53,allow,198,94,104,2,29,1,1
12816,64937,53,29678,53,allow,210,110,100,2,29,1,1
12817,58763,53,58763,53,allow,228,90,138,2,29,1,1
12818,64299,53,64888,53,allow,166,86,80,2,29,1,1
12819,64324,53,40799,53,allow,179,94,85,2,29,1,1
12820,55837,53,36982,53,allow,195,102,93,2,29,1,1
12821,55687,53,12551,53,allow,193,102,91,2,29,1,1
12822,53754,53,53754,53,allow,257,114,143,2,30,1,1
12823,55022,53,15240,53,allow,195,102,93,2,30,1,1
12824,49296,53,40772,53,allow,193,102,91,2,30,1,1
12825,65140,53,14372,53,allow,199,102,97,2,30,1,1
12826,64299,53,64359,53,allow,166,86,80,2,30,1,1
12827,16071,53,16071,53,allow,832,106,726,2,30,1,1
12828,64615,53,10268,53,allow,195,102,93,2,30,1,1
12829,56422,53,39106,53,allow,195,102,93,2,30,1,1
12830,55376,53,1208,53,allow,199,102,97,2,30,1,1
12831,65481,53,17512,53,allow,168,86,82,2,30,1,1
12832,64403,53,23409,53,allow,193,102,91,2,30,1,1
12833,56574,53,9941,53,allow,275,94,181,2,30,1,1
12834,56037,53,29985,53,allow,168,94,74,2,31,1,1
12835,50122,53,55627,53,allow,811,94,717,2,31,1,1
12836,64716,53,43003,53,allow,195,102,93,2,31,1,1
12837,56664,443,64784,443,allow,9160636,285656,8874980,9685,189,3160,6525
12838,50584,51413,3341,51413,allow,475,150,325,2,1200,1,1
12839,4544,3478,63036,3478,allow,338,110,228,2,299,1,1
12840,8916,443,25420,443,allow,7685,1016,6669,29,413,11,18
12841,47674,443,2134,443,allow,7576,2983,4593,33,42,18,15
12842,55085,80,12175,80,allow,306,180,126,6,85,4,2
12843,55841,53,22596,53,allow,265,86,179,4,59,2,2
12844,59762,53,43399,53,allow,401,86,315,2,30,1,1
12845,65277,53,55975,53,allow,167,86,81,2,30,1,1
12846,56596,53,51860,53,allow,199,102,97,2,30,1,1
12847,53900,53,54773,53,allow,270,168,102,3,30,2,1
12848,56496,53,56369,53,allow,193,102,91,2,30,1,1
12849,65102,53,65408,53,allow,183,94,89,2,30,1,1
12850,57335,443,56068,443,allow,56199,3856,52343,81,216,39,42
12851,49210,53,33969,53,allow,410,93,317,4,30,2,2
12852,64198,53,39637,53,allow,321,102,219,2,30,1,1
12853,55254,53,52828,53,allow,287,102,185,2,30,1,1
12854,49410,53,14771,53,allow,167,86,81,2,30,1,1
12855,57352,53,35179,53,allow,196,102,94,2,30,1,1
12856,49410,53,35309,53,allow,167,86,81,2,31,1,1
12857,65481,53,51485,53,allow,168,86,82,2,31,1,1
12858,54117,443,30153,443,allow,661695,28430,633265,779,118,335,444
12859,50073,443,27421,443,allow,22729,6539,16190,54,93,27,27
12860,35128,443,23671,443,allow,9120,5103,4017,38,587,22,16
12861,37655,443,5274,443,allow,17842,11204,6638,43,174,24,19
12862,51824,443,65512,443,allow,10841,6594,4247,75,585,37,38
12863,53165,18504,45814,18504,allow,70,70,0,2,8,2,0
12864,9297,443,46735,443,allow,4216,771,3445,16,26,9,7
12865,51667,25826,2987,25826,allow,9440,9440,0,11,30,11,0
12866,49972,53,55153,53,allow,216,110,106,2,30,1,1
12867,65124,53,53068,53,allow,243,102,141,2,30,1,1
12868,55418,53,32806,53,allow,168,86,82,2,30,1,1
12869,50191,53,9113,53,allow,734,94,640,2,30,1,1
12870,55941,53,27410,53,allow,184,94,90,2,30,1,1
12871,49699,53,49094,53,allow,209,110,99,2,30,1,1
12872,62578,53,27363,53,allow,343,168,175,3,30,2,1
12873,65440,53,2075,53,allow,189,102,87,2,30,1,1
12874,51104,443,47911,443,allow,5220,3063,2157,14,135,7,7
12875,42611,443,22505,443,allow,5559,1639,3920,21,186,12,9
12876,37569,443,62296,443,allow,97539,6936,90603,160,597,74,86
12877,49281,443,26289,443,allow,7655,2377,5278,20,135,11,9
12878,9291,443,14472,443,allow,3944,902,3042,14,26,8,6
12879,61811,443,37922,443,allow,214,140,74,4,15,3,1
12880,9277,443,3010,443,allow,4230,760,3470,14,27,8,6
12881,50470,53,11331,53,allow,770,102,668,2,30,1,1
12882,56149,53,56149,53,allow,832,106,726,2,30,1,1
12883,65085,53,45076,53,allow,258,102,156,2,30,1,1
12884,53182,443,14179,443,allow,16255,8279,7976,42,422,21,21
12885,54757,443,1080,443,allow,6954,1758,5196,29,361,15,14
12886,49764,53,36622,53,allow,199,102,97,2,31,1,1
12887,65140,53,62512,53,allow,199,102,97,2,31,1,1
12888,45355,443,7242,443,allow,410,210,200,7,92,4,3
12889,52098,29067,64917,29067,allow,70,70,0,1,5,1,0
12890,36414,80,15964,80,allow,5046,4132,914,31,15,16,15
12891,9310,443,7475,443,allow,4458,1022,3436,16,26,9,7
12892,27153,80,27153,80,allow,6397,947,5450,15,18,8,7
12893,55841,53,32658,53,allow,265,86,179,4,58,2,2
12894,49546,53,28213,53,allow,212,110,102,2,30,1,1
12895,64937,53,12503,53,allow,210,110,100,2,30,1,1
12896,57132,53,39108,53,allow,216,110,106,2,30,1,1
12897,55467,53,65023,53,allow,198,94,104,2,30,1,1
12898,64929,53,59059,53,allow,168,86,82,2,30,1,1
12899,56652,53,9807,53,allow,177,94,83,2,30,1,1
12900,65009,53,11589,53,allow,152,78,74,2,30,1,1
12901,64959,53,50159,53,allow,173,94,79,2,30,1,1
12902,44847,42103,11973,42103,allow,502,150,352,2,1200,1,1
12903,56995,53,4474,53,allow,167,86,81,2,30,1,1
12904,56293,53,1963,53,allow,166,86,80,2,30,1,1
12905,57431,53,4214,53,allow,733,94,639,2,30,1,1
12906,65440,53,49659,53,allow,181,94,87,2,30,1,1
12907,64959,53,35711,53,allow,173,94,79,2,30,1,1
12908,56731,53,12750,53,allow,165,86,79,2,30,1,1
12909,45473,53,13745,53,allow,168,78,90,2,31,1,1
12910,42993,443,7986,443,allow,10692,4532,6160,31,134,16,15
12911,56496,53,28777,53,allow,193,102,91,2,30,1,1
12912,43570,53,0,0,allow,86,86,0,1,30,1,0
12913,11964,53,13321,53,allow,268,94,174,2,30,1,1
12914,56965,53,26904,53,allow,183,94,89,2,30,1,1
12915,56364,53,33489,53,allow,308,94,214,2,30,1,1
12916,64677,53,58771,53,allow,183,94,89,2,30,1,1
12917,56995,53,60804,53,allow,167,86,81,2,30,1,1
12918,56396,53,48729,53,allow,338,110,228,2,30,1,1
12919,56026,53,14279,53,allow,189,102,87,2,30,1,1
12920,56472,53,36068,53,allow,167,86,81,2,31,1,1
12921,49978,53,17082,53,allow,195,102,93,2,31,1,1
12922,49978,53,55753,53,allow,195,102,93,2,30,1,1
12923,56026,53,37730,53,allow,181,94,87,2,31,1,1
12924,58070,443,16488,443,allow,5041,2002,3039,14,120,7,7
12925,45822,443,11470,443,allow,4201,2089,2112,11,120,6,5
12926,46857,443,55410,443,allow,280,140,140,5,129,3,2
12927,55877,64536,41597,64536,allow,469,150,319,2,1200,1,1
12928,57377,443,22825,443,allow,11247,3991,7256,30,149,14,16
12929,58602,443,31018,443,allow,3182,1568,1614,8,121,4,4
12930,64636,53,17069,53,allow,166,86,80,2,31,1,1
12931,49487,53,26714,53,allow,183,94,89,2,31,1,1
12932,55227,53,15557,53,allow,183,102,81,2,31,1,1
12933,59068,443,48115,443,allow,11182,6150,5032,65,1775,41,24
12934,53553,53,53553,53,allow,229,98,131,2,30,1,1
12935,49646,53,51164,53,allow,353,118,235,2,30,1,1
12936,35691,123,42659,123,allow,184,94,90,2,30,1,1
12937,41073,53,41073,53,allow,197,90,107,2,30,1,1
12938,39267,123,6756,123,allow,184,94,90,2,30,1,1
12939,55620,53,36114,53,allow,178,94,84,2,31,1,1
12940,64677,53,61310,53,allow,183,94,89,2,31,1,1
12941,56491,53,20777,53,allow,165,86,79,2,31,1,1
12942,65168,53,7392,53,allow,185,102,83,2,31,1,1
12943,56731,53,43957,53,allow,173,94,79,2,31,1,1
12944,55376,53,7206,53,allow,199,102,97,2,31,1,1
12945,49348,53,24608,53,allow,194,102,92,2,31,1,1
12946,64929,53,8681,53,allow,168,86,82,2,31,1,1
12947,57352,53,29825,53,allow,196,102,94,2,31,1,1
12948,57132,53,11896,53,allow,216,110,106,2,31,1,1
12949,49699,53,28371,53,allow,209,110,99,2,31,1,1
12950,49487,53,10311,53,allow,183,94,89,2,31,1,1
12951,49359,80,26843,80,allow,60,60,0,2,154,2,0
12952,54124,443,47726,443,allow,13210,3034,10176,47,153,19,28
12953,53031,443,28915,443,allow,2399,1799,600,15,120,10,5
12954,65375,53,14200,53,allow,196,94,102,2,31,1,1
12955,37850,443,54127,443,allow,3595,1468,2127,13,135,6,7
12956,41325,443,52651,443,allow,9669,2488,7181,26,149,11,15
12957,53910,1024,52372,1024,allow,70,70,0,2,8,2,0
12958,42263,443,45775,443,allow,224,164,60,3,5,2,1
12959,51628,443,50977,443,allow,5678,3121,2557,39,256,18,21
12960,55022,53,45433,53,allow,195,102,93,2,30,1,1
12961,52127,44198,39130,44198,allow,70,70,0,2,8,2,0
12962,52128,21294,46936,21294,allow,70,70,0,2,8,2,0
12963,53883,24830,60159,24830,allow,164,70,94,2,5,1,1
12964,41587,5222,51042,5222,allow,208,60,148,4,14,2,2
12965,40439,443,42690,443,allow,8126,1627,6499,29,165,16,13
12966,50077,443,29789,443,allow,8172,1833,6339,25,93,14,11
12967,50078,443,13152,443,allow,12035,9784,2251,41,92,22,19
12968,56472,53,13780,53,allow,167,86,81,2,31,1,1
12969,57075,53,41557,53,allow,443,182,261,6,31,3,3
12970,53888,39204,51033,39204,allow,70,70,0,1,5,1,0
12971,36400,443,31590,443,allow,53365,28404,24961,565,753,302,263
12972,54125,443,18046,443,allow,170665,9296,161369,227,116,102,125
12973,53347,443,16972,443,allow,21456,6153,15303,120,491,46,74
12974,55556,53,8408,53,allow,183,94,89,2,30,1,1
12975,50288,53,30921,53,allow,764,102,662,2,30,1,1
12976,65286,53,2453,53,allow,369,102,267,2,30,1,1
12977,49611,53,24146,53,allow,177,94,83,2,30,1,1
12978,64693,53,60951,53,allow,766,102,664,2,30,1,1
12979,43390,53,0,0,allow,184,86,98,2,30,1,1
12980,56965,53,44831,53,allow,183,94,89,2,30,1,1
12981,6666,138,0,0,deny,60,60,0,1,0,1,0
12982,9552,57470,0,0,deny,62,62,0,1,0,1,0
12983,4111,25174,0,0,deny,146,146,0,1,0,1,0
12984,64437,445,0,0,drop,66,66,0,1,0,1,0
12985,50765,22114,0,0,deny,66,66,0,1,0,1,0
12986,64290,445,0,0,drop,70,70,0,1,0,1,0
12987,51578,44847,0,0,deny,66,66,0,1,0,1,0
12988,52358,30188,0,0,deny,66,66,0,1,0,1,0
12989,64288,445,0,0,drop,70,70,0,1,0,1,0
12990,1480,12447,0,0,deny,66,66,0,1,0,1,0
12991,6881,6881,0,0,deny,146,146,0,1,0,1,0
12992,61057,25174,0,0,deny,62,62,0,1,0,1,0
12993,1035,57470,0,0,deny,72,72,0,1,0,1,0
12994,64287,445,0,0,drop,70,70,0,1,0,1,0
12995,59493,44847,0,0,deny,66,66,0,1,0,1,0
12996,46116,57470,0,0,deny,74,74,0,1,0,1,0
12997,64286,445,0,0,drop,70,70,0,1,0,1,0
12998,64285,445,0,0,drop,70,70,0,1,0,1,0
12999,11136,15503,0,0,deny,62,62,0,1,0,1,0
13000,64280,445,0,0,drop,70,70,0,1,0,1,0
13001,64279,445,0,0,drop,70,70,0,1,0,1,0
13002,52655,445,0,0,drop,70,70,0,1,0,1,0
13003,52650,445,0,0,drop,70,70,0,1,0,1,0
13004,52651,445,0,0,drop,70,70,0,1,0,1,0
13005,6881,6881,0,0,deny,62,62,0,1,0,1,0
13006,64422,445,0,0,drop,66,66,0,1,0,1,0
13007,64420,445,0,0,drop,66,66,0,1,0,1,0
13008,64423,445,0,0,drop,66,66,0,1,0,1,0
13009,64424,445,0,0,drop,66,66,0,1,0,1,0
13010,64421,445,0,0,drop,66,66,0,1,0,1,0
13011,64419,445,0,0,drop,66,66,0,1,0,1,0
13012,64418,445,0,0,drop,66,66,0,1,0,1,0
13013,64417,445,0,0,drop,66,66,0,1,0,1,0
13014,59097,2767,0,0,deny,66,66,0,1,0,1,0
13015,61387,43890,0,0,deny,66,66,0,1,0,1,0
13016,56326,56205,0,0,deny,66,66,0,1,0,1,0
13017,59736,51505,0,0,deny,146,146,0,1,0,1,0
13018,64727,25174,0,0,deny,66,66,0,1,0,1,0
13019,64267,445,0,0,drop,70,70,0,1,0,1,0
13020,64266,445,0,0,drop,70,70,0,1,0,1,0
13021,64264,445,0,0,drop,70,70,0,1,0,1,0
13022,22490,25174,0,0,deny,62,62,0,1,0,1,0
13023,64256,445,0,0,drop,70,70,0,1,0,1,0
13024,64257,445,0,0,drop,70,70,0,1,0,1,0
13025,26265,37965,0,0,deny,66,66,0,1,0,1,0
13026,23091,11119,0,0,deny,148,148,0,1,0,1,0
13027,47632,25174,0,0,deny,62,62,0,1,0,1,0
13028,52647,445,0,0,drop,70,70,0,1,0,1,0
13029,52641,445,0,0,drop,70,70,0,1,0,1,0
13030,52637,445,0,0,drop,70,70,0,1,0,1,0
13031,52636,445,0,0,drop,70,70,0,1,0,1,0
13032,34932,38608,0,0,deny,62,62,0,1,0,1,0
13033,64343,6004,0,0,deny,66,66,0,1,0,1,0
13034,6843,42873,0,0,deny,62,62,0,1,0,1,0
13035,49160,57470,0,0,deny,146,146,0,1,0,1,0
13036,2707,37,0,0,deny,60,60,0,1,0,1,0
13037,64404,445,0,0,drop,66,66,0,1,0,1,0
13038,64403,445,0,0,drop,66,66,0,1,0,1,0
13039,64402,445,0,0,drop,66,66,0,1,0,1,0
13040,63743,25174,0,0,deny,62,62,0,1,0,1,0
13041,64245,445,0,0,drop,70,70,0,1,0,1,0
13042,1024,25174,0,0,deny,62,62,0,1,0,1,0
13043,25889,11446,0,0,deny,66,66,0,1,0,1,0
13044,22948,26467,0,0,deny,62,62,0,1,0,1,0
13045,52630,445,0,0,drop,70,70,0,1,0,1,0
13046,51062,1433,0,0,deny,60,60,0,1,0,1,0
13047,52625,445,0,0,drop,70,70,0,1,0,1,0
13048,52626,445,0,0,drop,70,70,0,1,0,1,0
13049,52622,445,0,0,drop,70,70,0,1,0,1,0
13050,64587,43890,0,0,deny,62,62,0,1,0,1,0
13051,55985,44847,0,0,deny,62,62,0,1,0,1,0
13052,50328,22114,0,0,deny,62,62,0,1,0,1,0
13053,64241,445,0,0,drop,70,70,0,1,0,1,0
13054,1620,53567,0,0,deny,62,62,0,1,0,1,0
13055,54236,36829,0,0,deny,62,62,0,1,0,1,0
13056,64230,445,0,0,drop,70,70,0,1,0,1,0
13057,64231,445,0,0,drop,70,70,0,1,0,1,0
13058,64229,445,0,0,drop,70,70,0,1,0,1,0
13059,55600,22,0,0,deny,60,60,0,1,0,1,0
13060,56826,22114,0,0,deny,66,66,0,1,0,1,0
13061,64228,445,0,0,drop,70,70,0,1,0,1,0
13062,25067,22114,0,0,deny,146,146,0,1,0,1,0
13063,64225,445,0,0,drop,70,70,0,1,0,1,0
13064,58646,44847,0,0,deny,66,66,0,1,0,1,0
13065,52613,445,0,0,drop,70,70,0,1,0,1,0
13066,52612,445,0,0,drop,70,70,0,1,0,1,0
13067,52607,445,0,0,drop,70,70,0,1,0,1,0
13068,55429,25174,0,0,deny,66,66,0,1,0,1,0
13069,44154,22114,0,0,deny,62,62,0,1,0,1,0
13070,64393,445,0,0,drop,66,66,0,1,0,1,0
13071,45452,443,54388,443,allow,16362,3716,12646,79,601,38,41
13072,16158,50584,0,0,deny,66,66,0,1,0,1,0
13073,54758,35993,0,0,deny,66,66,0,1,0,1,0
13074,55341,39004,0,0,deny,74,74,0,1,0,1,0
13075,56205,51505,0,0,deny,66,66,0,1,0,1,0
13076,60479,25174,0,0,deny,66,66,0,1,0,1,0
13077,49841,1433,0,0,deny,60,60,0,1,0,1,0
13078,2427,25174,0,0,deny,146,146,0,1,0,1,0
13079,49929,26467,0,0,deny,66,66,0,1,0,1,0
13080,64219,445,0,0,drop,70,70,0,1,0,1,0
13081,45964,2225,0,0,deny,60,60,0,1,0,1,0
13082,52605,445,0,0,drop,70,70,0,1,0,1,0
13083,52166,26467,0,0,deny,66,66,0,1,0,1,0
13084,64295,26467,0,0,deny,66,66,0,1,0,1,0
13085,52603,445,0,0,drop,70,70,0,1,0,1,0
13086,28192,50584,0,0,deny,66,66,0,1,0,1,0
13087,13285,29892,0,0,deny,145,145,0,1,0,1,0
13088,59782,26467,0,0,deny,62,62,0,1,0,1,0
13089,52459,33890,0,0,deny,60,60,0,1,0,1,0
13090,0,0,0,0,allow,480,244,236,4,0,2,2
13091,48271,25174,0,0,deny,146,146,0,1,0,1,0
13092,58022,8010,0,0,deny,60,60,0,1,0,1,0
13093,6882,55839,0,0,deny,146,146,0,1,0,1,0
13094,6126,25174,0,0,deny,66,66,0,1,0,1,0
13095,64211,445,0,0,drop,70,70,0,1,0,1,0
13096,64376,445,0,0,drop,66,66,0,1,0,1,0
13097,64375,445,0,0,drop,66,66,0,1,0,1,0
13098,64016,25174,0,0,deny,62,62,0,1,0,1,0
13099,31539,37965,0,0,deny,62,62,0,1,0,1,0
13100,64210,445,0,0,drop,70,70,0,1,0,1,0
13101,56872,21247,0,0,deny,70,70,0,1,0,1,0
13102,45964,2228,0,0,deny,60,60,0,1,0,1,0
13103,56614,25174,0,0,deny,66,66,0,1,0,1,0
13104,55587,43890,0,0,deny,66,66,0,1,0,1,0
13105,52593,445,0,0,drop,70,70,0,1,0,1,0
13106,52594,445,0,0,drop,70,70,0,1,0,1,0
13107,52590,445,0,0,drop,70,70,0,1,0,1,0
13108,52584,445,0,0,drop,70,70,0,1,0,1,0
13109,64205,445,0,0,drop,70,70,0,1,0,1,0
13110,64203,445,0,0,drop,70,70,0,1,0,1,0
13111,62189,64147,0,0,deny,62,62,0,1,0,1,0
13112,64369,445,0,0,drop,66,66,0,1,0,1,0
13113,26921,26467,0,0,deny,62,62,0,1,0,1,0
13114,63855,25174,0,0,deny,62,62,0,1,0,1,0
13115,64366,445,0,0,drop,66,66,0,1,0,1,0
13116,64364,445,0,0,drop,66,66,0,1,0,1,0
13117,64357,445,0,0,drop,66,66,0,1,0,1,0
13118,64361,445,0,0,drop,66,66,0,1,0,1,0
13119,64355,445,0,0,drop,66,66,0,1,0,1,0
13120,64356,445,0,0,drop,66,66,0,1,0,1,0
13121,64353,445,0,0,drop,66,66,0,1,0,1,0
13122,64199,445,0,0,drop,70,70,0,1,0,1,0
13123,54883,60043,0,0,deny,62,62,0,1,0,1,0
13124,8889,52294,0,0,deny,60,60,0,1,0,1,0
13125,57131,35776,0,0,deny,145,145,0,1,0,1,0
13126,6842,42873,0,0,deny,62,62,0,1,0,1,0
13127,52578,445,0,0,drop,70,70,0,1,0,1,0
13128,51414,22,0,0,deny,60,60,0,1,0,1,0
13129,57991,22114,0,0,deny,66,66,0,1,0,1,0
13130,52575,445,0,0,drop,70,70,0,1,0,1,0
13131,52572,445,0,0,drop,70,70,0,1,0,1,0
13132,52573,445,0,0,drop,70,70,0,1,0,1,0
13133,64198,445,0,0,drop,70,70,0,1,0,1,0
13134,29178,35440,0,0,deny,66,66,0,1,0,1,0
13135,31619,51221,0,0,deny,62,62,0,1,0,1,0
13136,53161,51221,0,0,deny,66,66,0,1,0,1,0
13137,61550,5529,0,0,deny,145,145,0,1,0,1,0
13138,64733,35440,0,0,deny,66,66,0,1,0,1,0
13139,58007,62413,0,0,deny,66,66,0,1,0,1,0
13140,51232,23,0,0,deny,60,60,0,1,0,1,0
13141,49653,80,62428,80,allow,372,192,180,7,42,4,3
13142,49659,80,54132,80,allow,1937,885,1052,13,42,7,6
13143,49635,80,43715,80,allow,318,192,126,6,42,4,2
13144,49618,80,5688,80,allow,314,192,122,6,42,4,2
13145,49655,80,40166,80,allow,499,192,307,6,42,4,2
13146,62912,443,19185,443,allow,10829,2227,8602,35,47,20,15
13147,52094,55986,33027,55986,allow,66,66,0,1,5,1,0
13148,49646,80,33279,80,allow,318,192,126,6,42,4,2
13149,50827,443,49837,443,allow,7298,2661,4637,21,17,11,10
13150,50999,443,57620,443,allow,6765,1108,5657,17,18,10,7
13151,43326,443,43455,443,allow,8065,2689,5376,27,315,14,13
13152,56472,53,9100,53,allow,166,85,81,2,31,1,1
13153,49978,53,13448,53,allow,190,97,93,2,30,1,1
13154,49619,80,12609,80,allow,318,192,126,6,42,4,2
13155,49487,53,6709,53,allow,182,93,89,2,30,1,1
13156,55538,53,15605,53,allow,168,86,82,2,30,1,1
13157,49407,80,43999,80,allow,4878,1570,3308,19,165,10,9
13158,64716,53,37975,53,allow,190,97,93,2,31,1,1
13159,49616,80,21429,80,allow,314,192,122,6,42,4,2
13160,49622,80,33304,80,allow,454,262,192,8,42,5,3
13161,49634,80,5183,80,allow,318,192,126,6,42,4,2
13162,49617,80,31416,80,allow,314,192,122,6,42,4,2
13163,52124,11296,17277,11296,allow,70,70,0,2,8,2,0
13164,50998,443,9197,443,allow,6765,1108,5657,17,18,10,7
13165,52129,55550,12680,55550,allow,70,70,0,2,8,2,0
13166,52095,48896,29371,48896,allow,66,66,0,1,5,1,0
13167,55700,443,30597,443,allow,10286,1326,8960,25,1017,8,17
13168,34320,443,18156,443,allow,5823,1597,4226,21,19,11,10
13169,49891,53,30480,53,allow,788,108,680,2,31,1,1
13170,49348,53,25745,53,allow,188,96,92,2,31,1,1
13171,55703,13836,54739,13836,allow,70,70,0,2,8,2,0
13172,65516,53,4200,53,allow,290,94,196,4,41,2,2
13173,46215,443,1828,443,allow,161,101,60,2,5,1,1
13174,49569,80,41314,80,allow,454,262,192,8,44,5,3
13175,49621,80,15641,80,allow,318,192,126,6,42,4,2
13176,49563,80,12092,80,allow,318,192,126,6,45,4,2
13177,49620,80,21542,80,allow,318,192,126,6,42,4,2
13178,49652,80,63583,80,allow,372,192,180,7,42,4,3
13179,49647,80,48193,80,allow,318,192,126,6,42,4,2
13180,49556,80,42311,80,allow,7002,5717,1285,15,45,9,6
13181,49623,80,12161,80,allow,454,262,192,8,42,5,3
13182,49671,80,23759,80,allow,2122,1018,1104,13,41,7,6
13183,51987,80,37675,80,allow,2175,1532,643,10,22,7,3
13184,56543,53,18371,53,allow,756,95,661,2,30,1,1
13185,62030,53,0,0,allow,229,85,144,2,31,1,1
13186,49332,443,44143,443,allow,142684,5997,136687,134,48,31,103
13187,8282,17435,17967,17435,allow,73,73,0,1,30,1,0
13188,56314,53,2805,53,allow,182,93,89,2,30,1,1
13189,39626,443,37265,443,allow,5518,1323,4195,25,271,14,11
13190,58249,443,60364,443,allow,4220,2048,2172,11,122,6,5
13191,65239,53,46235,53,allow,198,101,97,2,31,1,1
13192,19008,31652,0,0,allow,74,74,0,1,91,1,0
13193,43411,443,13391,443,allow,2895,726,2169,10,121,5,5
13194,40009,443,48154,443,allow,21785,5577,16208,35,362,16,19
13195,56575,53,50705,53,allow,732,89,643,2,31,1,1
13196,62007,24184,0,0,allow,66,66,0,1,91,1,0
13197,42076,443,12944,443,allow,4295,2123,2172,11,121,6,5
13198,48737,443,47925,443,allow,5220,2290,2930,15,121,7,8
13199,56925,53,7944,53,allow,192,98,94,2,30,1,1
13200,55106,53,52896,53,allow,184,94,90,2,31,1,1
13201,56612,53,25509,53,allow,274,87,187,4,31,2,2
13202,26661,53,26661,53,allow,217,87,130,2,31,1,1
13203,56592,53,10104,53,allow,200,102,98,2,31,1,1
13204,53288,443,63225,443,allow,4448,1654,2794,13,121,6,7
13205,48817,41768,48817,41768,allow,511,152,359,2,1200,1,1
13206,64306,53,29347,53,allow,216,110,106,2,31,1,1
13207,48810,443,34983,443,allow,6478,2684,3794,18,122,8,10
13208,40204,40014,35119,40014,allow,141,79,62,2,31,1,1
13209,49154,443,24167,443,allow,3163100,158133,3004967,3863,264,1464,2399
13210,15503,50321,53712,50321,allow,490,149,341,2,1200,1,1
13211,3981,23117,0,0,deny,66,66,0,1,0,1,0
13212,64193,445,0,0,drop,70,70,0,1,0,1,0
13213,5060,37965,0,0,deny,66,66,0,1,0,1,0
13214,4232,50584,0,0,deny,66,66,0,1,0,1,0
13215,52569,445,0,0,drop,70,70,0,1,0,1,0
13216,52565,445,0,0,drop,70,70,0,1,0,1,0
13217,52564,445,0,0,drop,70,70,0,1,0,1,0
13218,48978,25174,0,0,deny,66,66,0,1,0,1,0
13219,64347,445,0,0,drop,66,66,0,1,0,1,0
13220,6881,6881,0,0,deny,146,146,0,1,0,1,0
13221,3103,50584,0,0,deny,62,62,0,1,0,1,0
13222,52562,445,0,0,drop,70,70,0,1,0,1,0
13223,29145,8168,0,0,deny,62,62,0,1,0,1,0
13224,1253,25174,0,0,deny,146,146,0,1,0,1,0
13225,64344,445,0,0,drop,66,66,0,1,0,1,0
13226,45964,9666,0,0,deny,60,60,0,1,0,1,0
13227,1108,47807,0,0,deny,159,159,0,1,0,1,0
13228,51783,50584,0,0,deny,66,66,0,1,0,1,0
13229,49593,80,60078,80,allow,7098,5692,1406,17,41,9,8
13230,60011,443,31949,443,allow,6053,2582,3471,30,80,15,15
13231,49600,80,7933,80,allow,312,192,120,6,41,4,2
13232,49569,53,19473,53,allow,198,102,96,2,30,1,1
13233,57232,53,10597,53,allow,821,102,719,2,30,1,1
13234,35194,57470,0,0,deny,74,74,0,1,0,1,0
13235,64341,445,0,0,drop,66,66,0,1,0,1,0
13236,64342,445,0,0,drop,66,66,0,1,0,1,0
13237,43260,41615,0,0,deny,145,145,0,1,0,1,0
13238,44856,51505,0,0,deny,62,62,0,1,0,1,0
13239,64340,445,0,0,drop,66,66,0,1,0,1,0
13240,55408,64147,0,0,deny,66,66,0,1,0,1,0
13241,63741,50584,0,0,deny,62,62,0,1,0,1,0
13242,56406,22114,0,0,deny,62,62,0,1,0,1,0
13243,45535,25174,0,0,deny,62,62,0,1,0,1,0
13244,35207,22114,0,0,deny,146,146,0,1,0,1,0
13245,49689,22114,0,0,deny,62,62,0,1,0,1,0
13246,6943,21162,0,0,deny,100,100,0,1,0,1,0
13247,64180,445,0,0,drop,70,70,0,1,0,1,0
13248,6943,1970,0,0,deny,100,100,0,1,0,1,0
13249,6943,52290,0,0,deny,100,100,0,1,0,1,0
13250,6943,14984,0,0,deny,100,100,0,1,0,1,0
13251,52558,445,0,0,drop,70,70,0,1,0,1,0
13252,6943,59353,0,0,deny,100,100,0,1,0,1,0
13253,6943,57099,0,0,deny,100,100,0,1,0,1,0
13254,12830,25174,0,0,deny,62,62,0,1,0,1,0
13255,46532,17372,0,0,deny,145,145,0,1,0,1,0
13256,52553,445,0,0,drop,70,70,0,1,0,1,0
13257,52549,445,0,0,drop,70,70,0,1,0,1,0
13258,64177,445,0,0,drop,70,70,0,1,0,1,0
13259,51728,44847,0,0,deny,62,62,0,1,0,1,0
13260,37887,22114,0,0,deny,66,66,0,1,0,1,0
13261,64329,445,0,0,drop,66,66,0,1,0,1,0
13262,33556,25174,0,0,deny,62,62,0,1,0,1,0
13263,43815,50584,0,0,deny,62,62,0,1,0,1,0
13264,55106,53,41822,53,allow,177,94,83,2,30,1,1
13265,64306,53,23219,53,allow,216,110,106,2,30,1,1
13266,51000,443,65422,443,allow,6544,939,5605,17,17,10,7
13267,43864,443,38853,443,allow,4922,2860,2062,25,39,14,11
13268,54118,443,28446,443,allow,115373,6904,108469,171,117,87,84
13269,53913,28402,62039,28402,allow,70,70,0,2,7,2,0
13270,65516,53,26663,53,allow,290,94,196,4,40,2,2
13271,38633,443,38633,443,allow,4378,1471,2907,19,29,11,8
13272,56782,53,44895,53,allow,197,102,95,2,30,1,1
13273,51230,443,29300,443,allow,33489,19602,13887,98,43,51,47
13274,49657,443,35292,443,allow,2800,1557,1243,33,53,19,14
13275,53884,48754,22273,48754,allow,70,70,0,1,4,1,0
13276,64025,26826,1858,26826,allow,70,70,0,1,4,1,0
13277,39378,443,56513,443,allow,494,342,152,4,5,2,2
13278,60786,443,40740,443,allow,12106,2192,9914,38,38,19,19
13279,64022,60918,60664,60918,allow,70,70,0,1,4,1,0
13280,50824,80,46115,80,allow,36051,11695,24356,109,265,55,54
13281,35098,443,17186,443,allow,7703,1606,6097,23,80,13,10
13282,49644,80,40102,80,allow,318,192,126,6,41,4,2
13283,49874,53,61806,53,allow,165,86,79,2,29,1,1
13284,65041,53,3296,53,allow,200,94,106,2,29,1,1
13285,65501,53,16521,53,allow,443,182,261,6,29,3,3
13286,55556,53,62239,53,allow,183,94,89,2,29,1,1
13287,56037,53,56792,53,allow,168,94,74,2,29,1,1
13288,54979,53,30018,53,allow,207,97,110,3,64,2,1
13289,55106,53,22662,53,allow,184,94,90,2,30,1,1
13290,49663,80,43225,80,allow,8935,3175,5760,17,41,8,9
13291,49633,80,21073,80,allow,318,192,126,6,41,4,2
13292,49564,80,48576,80,allow,318,192,126,6,45,4,2
13293,37711,443,32947,443,allow,8060,2166,5894,23,255,12,11
13294,50376,53,42212,53,allow,819,102,717,2,30,1,1
13295,42053,443,49116,443,allow,2351,1546,805,20,40,11,9
13296,56925,53,48692,53,allow,196,102,94,2,30,1,1
13297,57007,53,5847,53,allow,183,94,89,2,30,1,1
13298,49764,53,54622,53,allow,199,102,97,2,30,1,1
13299,49480,80,65349,80,allow,6811,3791,3020,23,115,13,10
13300,55538,53,6885,53,allow,168,86,82,2,30,1,1
13301,49679,80,26556,80,allow,7256,1682,5574,14,40,6,8
13302,55707,53,54526,53,allow,811,94,717,2,30,1,1
13303,49666,80,13546,80,allow,7270,3119,4151,14,41,7,7
13304,65351,53,49727,53,allow,228,110,118,2,30,1,1
13305,49606,80,25049,80,allow,454,262,192,8,41,5,3
13306,49594,80,30490,80,allow,25430,15577,9853,37,41,19,18
13307,52126,56057,15046,56057,allow,70,70,0,2,8,2,0
13308,40204,40029,46066,40029,allow,148,86,62,2,30,1,1
13309,58424,443,34481,443,allow,6020,2493,3527,29,80,14,15
13310,54627,443,30890,443,allow,182017,6621,175396,189,181,55,134
13311,51599,443,24581,443,allow,25546,5284,20262,48,149,26,22
13312,55700,26957,2984,26957,allow,70,70,0,1,5,1,0
13313,54635,443,11319,443,allow,11955,1861,10094,30,172,14,16
13314,49664,80,19625,80,allow,7561,3181,4380,16,41,8,8
13315,35214,8635,35214,8635,allow,138,78,60,2,5,1,1
13316,36404,80,8914,80,allow,534,460,74,6,15,5,1
13317,49679,443,62696,443,allow,7938,1721,6217,25,172,12,13
13318,49277,80,11702,80,allow,13670,11470,2200,39,231,20,19
13319,49668,80,43673,80,allow,318,192,126,6,41,4,2
13320,65516,53,20089,53,allow,506,204,302,6,57,3,3
13321,54625,53,52244,53,allow,168,78,90,2,30,1,1
13322,49575,80,43723,80,allow,318,192,126,6,43,4,2
13323,49584,80,44285,80,allow,318,192,126,6,42,4,2
13324,65481,53,60374,53,allow,168,86,82,2,30,1,1
13325,56965,53,39310,53,allow,183,94,89,2,30,1,1
13326,56491,53,2856,53,allow,165,86,79,2,30,1,1
13327,38211,443,38211,443,allow,4653,1746,2907,19,26,11,8
13328,64403,53,33316,53,allow,193,102,91,2,30,1,1
13329,49487,53,55528,53,allow,183,94,89,2,30,1,1
13330,64950,53,55366,53,allow,183,94,89,2,30,1,1
13331,56314,53,10977,53,allow,183,94,89,2,30,1,1
13332,49764,53,50844,53,allow,199,102,97,2,30,1,1
13333,55947,53,4712,53,allow,94,94,0,1,30,1,0
13334,57007,53,38539,53,allow,183,94,89,2,30,1,1
13335,56592,53,38145,53,allow,200,102,98,2,30,1,1
13336,64636,53,38894,53,allow,182,102,80,2,30,1,1
13337,57232,53,8301,53,allow,198,102,96,2,30,1,1
13338,37698,443,12829,443,allow,1781,1062,719,16,275,8,8
13339,65239,53,27517,53,allow,199,102,97,2,30,1,1
13340,56925,53,20388,53,allow,196,102,94,2,30,1,1
13341,60863,443,21124,443,allow,24452,12758,11694,39,129,23,16
13342,51819,80,5456,80,allow,5368,946,4422,16,77,9,7
13343,49665,80,35482,80,allow,8457,3062,5395,16,41,7,9
13344,49604,80,21319,80,allow,454,262,192,8,41,5,3
13345,49607,80,52438,80,allow,378,192,186,7,41,4,3
13346,49643,80,57400,80,allow,312,192,120,6,41,4,2
13347,49649,80,26716,80,allow,378,192,186,7,41,4,3
13348,61594,53,61594,53,allow,235,90,145,2,33,1,1
13349,52093,40828,29609,40828,allow,160,70,90,2,5,1,1
13350,50827,80,8180,80,allow,35970,11674,24296,108,265,55,53
13351,49673,80,41313,80,allow,318,192,126,6,41,4,2
13352,56791,53,55367,53,allow,250,87,163,4,58,2,2
13353,60824,53,60824,53,allow,220,90,130,2,30,1,1
13354,49569,53,26958,53,allow,821,102,719,2,30,1,1
13355,50825,80,41226,80,allow,35970,11674,24296,108,265,55,53
13356,53163,32834,49682,32834,allow,70,70,0,1,5,1,0
13357,51263,443,57364,443,allow,162,102,60,2,5,1,1
13358,49682,443,37715,443,allow,9766,1633,8133,27,172,13,14
13359,42993,443,2255,443,allow,14451,3012,11439,33,32,18,15
13360,35078,443,15189,443,allow,7222,1768,5454,22,81,13,9
13361,49567,80,10114,80,allow,2855,1388,1467,12,44,7,5
13362,55639,53,59060,53,allow,196,102,94,2,30,1,1
13363,64893,53,6270,53,allow,326,134,192,2,30,1,1
13364,55452,53,61292,53,allow,184,94,90,2,30,1,1
13365,55084,443,30495,443,allow,6936,819,6117,20,85,11,9
13366,46413,443,45352,443,allow,8106,4839,3267,61,449,32,29
13367,37991,443,2941,443,allow,9566,2592,6974,29,134,16,13
13368,54127,443,25652,443,allow,148422,10568,137854,223,115,114,109
13369,43347,443,49384,443,allow,9118,1699,7419,24,131,14,10
13370,58736,53,58736,53,allow,235,90,145,2,32,1,1
13371,51372,80,40252,80,allow,882,527,355,10,255,6,4
13372,54126,443,11328,443,allow,147104,9481,137623,217,115,111,106
13373,65427,53,25865,53,allow,677,188,489,6,57,3,3
13374,38460,443,18587,443,allow,14768,3347,11421,69,1902,32,37
13375,50074,443,37111,443,allow,1625,838,787,18,92,10,8
13376,51464,443,62248,443,allow,7269,1978,5291,28,39,14,14
13377,53539,443,34866,443,allow,2385,1462,923,18,200,10,8
13378,65516,53,41111,53,allow,290,94,196,4,40,2,2
13379,56782,53,33216,53,allow,197,102,95,2,33,1,1
13380,40288,80,46706,80,allow,1195,763,432,10,32,6,4
13381,33047,443,1345,443,allow,204,70,134,4,25,2,2
13382,59533,443,28553,443,allow,448,78,370,6,24,1,5
13383,49645,80,12574,80,allow,318,192,126,6,41,4,2
13384,49614,80,63774,80,allow,374,192,182,7,41,4,3
13385,49599,80,35878,80,allow,312,192,120,6,41,4,2
13386,49651,80,24642,80,allow,318,192,126,6,41,4,2
13387,49642,80,32526,80,allow,312,192,120,6,41,4,2
13388,49609,80,50781,80,allow,318,192,126,6,41,4,2
13389,51829,80,1041,80,allow,1484,928,556,13,76,8,5
13390,49608,80,48854,80,allow,318,192,126,6,41,4,2
13391,49667,80,7772,80,allow,27534,4859,22675,34,41,14,20
13392,49560,80,60008,80,allow,318,192,126,6,45,4,2
13393,49672,80,15007,80,allow,3749,2453,1296,15,41,9,6
13394,49662,80,35388,80,allow,6753,3135,3618,17,41,8,9
13395,49592,80,33337,80,allow,4173,2324,1849,14,42,8,6
13396,56596,53,55954,53,allow,199,102,97,2,29,1,1
13397,64403,53,2916,53,allow,193,102,91,2,29,1,1
13398,56312,53,29568,53,allow,195,102,93,2,29,1,1
13399,49603,80,3315,80,allow,378,192,186,7,41,4,3
13400,49548,53,2066,53,allow,263,102,161,2,29,1,1
13401,56314,53,50014,53,allow,183,94,89,2,30,1,1
13402,55538,53,33092,53,allow,250,86,164,4,30,2,2
13403,58346,53,2203,53,allow,209,102,107,2,30,1,1
13404,60187,53,13355,53,allow,168,78,90,2,30,1,1
13405,64581,53,40086,53,allow,214,110,104,2,30,1,1
13406,55818,443,58281,443,allow,5100,2001,3099,15,119,7,8
13407,56791,53,43251,53,allow,250,87,163,4,58,2,2
13408,49348,53,2617,53,allow,194,102,92,2,30,1,1
13409,64076,53,25451,53,allow,255,102,153,2,30,1,1
13410,49477,53,4842,53,allow,178,94,84,2,31,1,1
13411,49466,53,63344,53,allow,807,94,713,2,30,1,1
13412,42155,443,26461,443,allow,70,70,0,1,5,1,0
13413,58095,80,30247,80,allow,4468,1145,3323,15,16,9,6
13414,49648,80,25450,80,allow,318,192,126,6,41,4,2
13415,49576,80,3769,80,allow,318,192,126,6,43,4,2
13416,49605,80,22223,80,allow,454,262,192,8,41,5,3
13417,49582,80,49496,80,allow,25980,10637,15343,40,42,17,23
13418,49624,80,29847,80,allow,3314,1478,1836,16,41,9,7
13419,49611,80,38044,80,allow,378,192,186,7,41,4,3
13420,49610,80,55235,80,allow,378,192,186,7,41,4,3
13421,49601,80,15488,80,allow,378,192,186,7,41,4,3
13422,50376,53,40722,53,allow,196,102,94,2,30,1,1
13423,55639,53,11030,53,allow,819,102,717,2,30,1,1
13424,49611,53,5356,53,allow,177,94,83,2,30,1,1
13425,55692,53,51127,53,allow,198,102,96,2,30,1,1
13426,40476,443,53143,443,allow,17360,5578,11782,71,281,39,32
13427,50826,80,48832,80,allow,35970,11674,24296,108,265,55,53
13428,50823,80,36399,80,allow,35970,11674,24296,108,265,55,53
13429,49580,443,38727,443,allow,442,262,180,8,42,5,3
13430,49596,80,27800,80,allow,312,192,120,6,41,4,2
13431,49598,80,32079,80,allow,372,192,180,7,41,4,3
13432,49597,80,58897,80,allow,372,192,180,7,41,4,3
13433,54967,80,54666,80,allow,1848,851,997,10,515,6,4
13434,49650,80,5839,80,allow,318,192,126,6,41,4,2
13435,49602,80,16412,80,allow,378,192,186,7,41,4,3
13436,64950,53,1692,53,allow,183,94,89,2,30,1,1
13437,65168,53,17811,53,allow,185,102,83,2,30,1,1
13438,57007,53,22368,53,allow,183,94,89,2,30,1,1
13439,54943,443,33087,443,allow,7118,2618,4500,21,30,12,9
13440,55106,53,58487,53,allow,177,94,83,2,30,1,1
13441,55538,53,2707,53,allow,168,86,82,2,30,1,1
13442,57231,53,57692,53,allow,168,86,82,2,32,1,1
13443,52125,49224,18364,49224,allow,70,70,0,2,8,2,0
13444,49732,80,36115,80,allow,5236,1070,4166,13,145,6,7
13445,49613,80,63557,80,allow,374,192,182,7,41,4,3
13446,49615,80,42615,80,allow,374,192,182,7,41,4,3
13447,9472,443,45589,443,allow,5699,505,5194,14,15,7,7
13448,49562,80,14517,80,allow,318,192,126,6,45,4,2
13449,49612,80,44677,80,allow,378,192,186,7,41,4,3
13450,56314,53,22045,53,allow,183,94,89,2,30,1,1
13451,55227,53,7352,53,allow,183,102,81,2,30,1,1
13452,56293,53,53658,53,allow,166,86,80,2,30,1,1
13453,49477,53,20665,53,allow,178,94,84,2,30,1,1
13454,64716,53,1067,53,allow,195,102,93,2,30,1,1
13455,49635,53,16265,53,allow,458,188,270,6,30,3,3
13456,55021,443,43787,443,allow,6724,3642,3082,18,133,10,8
13457,55692,53,9187,53,allow,198,102,96,2,31,1,1
13458,33340,443,55389,443,allow,3598,1118,2480,14,120,7,7
13459,64306,53,34963,53,allow,216,110,106,2,31,1,1
13460,65212,53,6232,53,allow,196,102,94,2,31,1,1
13461,53035,443,43721,443,allow,3473,881,2592,13,121,6,7
13462,64086,443,16892,443,allow,3289,1031,2258,13,121,6,7
13463,64716,53,18562,53,allow,195,102,93,2,31,1,1
13464,55032,53,18500,53,allow,458,188,270,6,31,3,3
13465,56612,53,30112,53,allow,274,87,187,4,31,2,2
13466,49591,53,7823,53,allow,402,118,284,2,30,1,1
13467,56226,53,8376,53,allow,284,96,188,4,31,2,2
13468,64987,53,57288,53,allow,196,102,94,2,31,1,1
13469,56612,53,25011,53,allow,274,87,187,4,31,2,2
13470,38851,443,9016,443,allow,5993,2348,3645,15,120,8,7
13471,46159,443,16876,443,allow,4168,1128,3040,14,121,7,7
13472,55631,443,58192,443,allow,6897,2509,4388,16,121,8,8
13473,8915,443,26790,443,allow,7182,1016,6166,28,412,11,17
13474,56490,443,62341,443,allow,11756,4004,7752,26,121,12,14
13475,41365,443,33138,443,allow,27475,5634,21841,76,145,35,41
13476,55697,53,64657,53,allow,193,102,91,2,31,1,1
13477,43596,80,25616,80,allow,1947,1182,765,10,515,6,4
13478,49782,443,62911,443,allow,70,70,0,1,5,1,0
13479,49658,443,46695,443,allow,11880,2839,9041,30,48,16,14
13480,46412,53,4555,53,allow,164,78,86,2,31,1,1
13481,9267,80,6787,80,allow,318,192,126,6,27,4,2
13482,51535,443,59853,443,allow,122,62,60,2,16,1,1
13483,50023,53,26218,53,allow,166,86,80,2,31,1,1
13484,54965,80,28312,80,allow,3419,2046,1373,12,515,7,5
13485,52091,4789,61902,4789,allow,70,70,0,1,5,1,0
13486,55661,53,42015,53,allow,213,102,111,2,30,1,1
13487,56925,53,23020,53,allow,196,102,94,2,30,1,1
13488,55718,27025,38370,27025,allow,1778,1386,392,8,30,4,4
13489,56082,53,20820,53,allow,184,94,90,2,30,1,1
13490,64632,53,26914,53,allow,224,94,130,2,30,1,1
13491,57300,53,58923,53,allow,184,94,90,2,31,1,1
13492,57550,50584,0,0,deny,66,66,0,1,0,1,0
13493,36258,23,0,0,deny,60,60,0,1,0,1,0
13494,64172,445,0,0,drop,70,70,0,1,0,1,0
13495,35626,22114,0,0,deny,62,62,0,1,0,1,0
13496,27679,37965,0,0,deny,62,62,0,1,0,1,0
13497,64171,445,0,0,drop,70,70,0,1,0,1,0
13498,2707,37,0,0,deny,60,60,0,1,0,1,0
13499,50106,30317,0,0,deny,62,62,0,1,0,1,0
13500,28156,50584,0,0,deny,146,146,0,1,0,1,0
13501,64321,445,0,0,drop,66,66,0,1,0,1,0
13502,62799,25174,0,0,deny,62,62,0,1,0,1,0
13503,52534,445,0,0,drop,70,70,0,1,0,1,0
13504,64169,445,0,0,drop,70,70,0,1,0,1,0
13505,36258,23,0,0,deny,60,60,0,1,0,1,0
13506,36258,23,0,0,deny,60,60,0,1,0,1,0
13507,62194,50584,0,0,deny,66,66,0,1,0,1,0
13508,39583,37965,0,0,deny,66,66,0,1,0,1,0
13509,45218,25174,0,0,deny,62,62,0,1,0,1,0
13510,54917,60043,0,0,deny,66,66,0,1,0,1,0
13511,64318,445,0,0,drop,66,66,0,1,0,1,0
13512,63116,22114,0,0,deny,146,146,0,1,0,1,0
13513,38776,25174,0,0,deny,146,146,0,1,0,1,0
13514,26802,50584,0,0,deny,62,62,0,1,0,1,0
13515,42722,56448,0,0,deny,74,74,0,1,0,1,0
13516,64312,445,0,0,drop,66,66,0,1,0,1,0
13517,64162,445,0,0,drop,70,70,0,1,0,1,0
13518,443,63113,0,0,deny,100,100,0,1,0,1,0
13519,64303,445,0,0,drop,66,66,0,1,0,1,0
13520,64160,445,0,0,drop,70,70,0,1,0,1,0
13521,27046,51505,0,0,deny,66,66,0,1,0,1,0
13522,1041,25174,0,0,deny,146,146,0,1,0,1,0
13523,52494,36237,0,0,deny,146,146,0,1,0,1,0
13524,26698,25174,0,0,deny,66,66,0,1,0,1,0
13525,64159,445,0,0,drop,70,70,0,1,0,1,0
13526,20586,25174,0,0,deny,62,62,0,1,0,1,0
13527,64158,445,0,0,drop,70,70,0,1,0,1,0
13528,64157,445,0,0,drop,70,70,0,1,0,1,0
13529,65159,37965,0,0,deny,74,74,0,1,0,1,0
13530,64151,445,0,0,drop,70,70,0,1,0,1,0
13531,64152,445,0,0,drop,70,70,0,1,0,1,0
13532,6666,443,0,0,deny,60,60,0,1,0,1,0
13533,39195,25174,0,0,deny,146,146,0,1,0,1,0
13534,22856,22114,0,0,deny,62,62,0,1,0,1,0
13535,2707,37,0,0,deny,60,60,0,1,0,1,0
13536,61465,22114,0,0,deny,62,62,0,1,0,1,0
13537,52526,445,0,0,drop,70,70,0,1,0,1,0
13538,52523,445,0,0,drop,70,70,0,1,0,1,0
13539,52522,445,0,0,drop,70,70,0,1,0,1,0
13540,30303,30303,0,0,deny,181,181,0,1,0,1,0
13541,64291,445,0,0,drop,66,66,0,1,0,1,0
13542,64295,445,0,0,drop,66,66,0,1,0,1,0
13543,64296,445,0,0,drop,66,66,0,1,0,1,0
13544,64294,445,0,0,drop,66,66,0,1,0,1,0
13545,64289,445,0,0,drop,66,66,0,1,0,1,0
13546,64290,445,0,0,drop,66,66,0,1,0,1,0
13547,64292,445,0,0,drop,66,66,0,1,0,1,0
13548,64288,445,0,0,drop,66,66,0,1,0,1,0
13549,52537,57866,0,0,deny,62,62,0,1,0,1,0
13550,64139,445,0,0,drop,70,70,0,1,0,1,0
13551,64138,445,0,0,deny,70,70,0,1,0,1,0
13552,42981,44847,0,0,deny,62,62,0,1,0,1,0
13553,64135,445,0,0,drop,70,70,0,1,0,1,0
13554,51455,53733,0,0,deny,66,66,0,1,0,1,0
13555,64129,445,0,0,drop,70,70,0,1,0,1,0
13556,64128,445,0,0,drop,70,70,0,1,0,1,0
13557,60579,25174,0,0,deny,66,66,0,1,0,1,0
13558,15819,3389,0,0,deny,60,60,0,1,0,1,0
13559,31609,25174,0,0,deny,62,62,0,1,0,1,0
13560,51425,37450,0,0,deny,62,62,0,1,0,1,0
13561,32171,50265,0,0,deny,145,145,0,1,0,1,0
13562,61185,54532,0,0,deny,62,62,0,1,0,1,0
13563,26263,8168,0,0,deny,62,62,0,1,0,1,0
13564,52625,25174,0,0,deny,66,66,0,1,0,1,0
13565,15319,51505,0,0,deny,66,66,0,1,0,1,0
13566,52518,445,0,0,drop,70,70,0,1,0,1,0
13567,52515,445,0,0,drop,70,70,0,1,0,1,0
13568,52509,445,0,0,drop,70,70,0,1,0,1,0
13569,52506,445,0,0,drop,70,70,0,1,0,1,0
13570,50512,1212,0,0,deny,145,145,0,1,0,1,0
13571,31172,22114,0,0,deny,62,62,0,1,0,1,0
13572,22679,2323,0,0,deny,60,60,0,1,0,1,0
13573,6929,35440,0,0,deny,62,62,0,1,0,1,0
13574,38859,22114,0,0,deny,66,66,0,1,0,1,0
13575,64276,445,0,0,drop,66,66,0,1,0,1,0
13576,64273,445,0,0,drop,66,66,0,1,0,1,0
13577,64274,445,0,0,drop,66,66,0,1,0,1,0
13578,64117,445,0,0,drop,70,70,0,1,0,1,0
13579,59734,5900,0,0,deny,60,60,0,1,0,1,0
13580,6666,2222,0,0,deny,60,60,0,1,0,1,0
13581,63136,25174,0,0,deny,66,66,0,1,0,1,0
13582,52502,445,0,0,drop,70,70,0,1,0,1,0
13583,52498,445,0,0,drop,70,70,0,1,0,1,0
13584,52497,445,0,0,drop,70,70,0,1,0,1,0
13585,52496,445,0,0,drop,70,70,0,1,0,1,0
13586,5790,43890,0,0,deny,62,62,0,1,0,1,0
13587,17101,25174,0,0,deny,66,66,0,1,0,1,0
13588,64113,445,0,0,drop,70,70,0,1,0,1,0
13589,10704,25174,0,0,deny,62,62,0,1,0,1,0
13590,10909,30975,0,0,deny,148,148,0,1,0,1,0
13591,51635,50265,0,0,deny,66,66,0,1,0,1,0
13592,33973,50265,0,0,deny,62,62,0,1,0,1,0
13593,64102,445,0,0,drop,70,70,0,1,0,1,0
13594,64101,445,0,0,drop,70,70,0,1,0,1,0
13595,64104,445,0,0,drop,70,70,0,1,0,1,0
13596,13588,15503,0,0,deny,62,62,0,1,0,1,0
13597,64100,445,0,0,drop,70,70,0,1,0,1,0
13598,5955,55160,0,0,deny,74,74,0,1,0,1,0
13599,64097,445,0,0,drop,70,70,0,1,0,1,0
13600,0,0,0,0,deny,70,70,0,1,0,1,0
13601,52485,445,0,0,drop,70,70,0,1,0,1,0
13602,52482,445,0,0,drop,70,70,0,1,0,1,0
13603,52480,445,0,0,drop,70,70,0,1,0,1,0
13604,56999,25174,0,0,deny,62,62,0,1,0,1,0
13605,64263,445,0,0,drop,66,66,0,1,0,1,0
13606,1026,64147,0,0,deny,145,145,0,1,0,1,0
13607,59937,18375,0,0,deny,66,66,0,1,0,1,0
13608,9087,37965,0,0,deny,62,62,0,1,0,1,0
13609,64090,445,0,0,drop,70,70,0,1,0,1,0
13610,30729,22114,0,0,deny,66,66,0,1,0,1,0
13611,52477,445,0,0,drop,70,70,0,1,0,1,0
13612,27110,22114,0,0,deny,60,60,0,1,0,1,0
13613,52474,445,0,0,drop,70,70,0,1,0,1,0
13614,59060,50584,0,0,deny,66,66,0,1,0,1,0
13615,33886,65504,0,0,deny,162,162,0,1,0,1,0
13616,64083,445,0,0,drop,70,70,0,1,0,1,0
13617,54914,51505,0,0,deny,66,66,0,1,0,1,0
13618,51615,25174,0,0,deny,66,66,0,1,0,1,0
13619,14777,25174,0,0,deny,62,62,0,1,0,1,0
13620,64080,445,0,0,drop,70,70,0,1,0,1,0
13621,59692,57470,0,0,deny,78,78,0,1,0,1,0
13622,64246,445,0,0,drop,66,66,0,1,0,1,0
13623,64248,445,0,0,drop,66,66,0,1,0,1,0
13624,22528,25174,0,0,deny,62,62,0,1,0,1,0
13625,50236,25174,0,0,deny,66,66,0,1,0,1,0
13626,53563,35440,0,0,deny,66,66,0,1,0,1,0
13627,2346,25174,0,0,deny,66,66,0,1,0,1,0
13628,15585,64147,0,0,deny,66,66,0,1,0,1,0
13629,64077,445,0,0,drop,70,70,0,1,0,1,0
13630,22036,44847,0,0,deny,62,62,0,1,0,1,0
13631,2938,64147,0,0,deny,62,62,0,1,0,1,0
13632,64075,445,0,0,drop,70,70,0,1,0,1,0
13633,52460,445,0,0,drop,70,70,0,1,0,1,0
13634,52462,445,0,0,drop,70,70,0,1,0,1,0
13635,52461,445,0,0,drop,70,70,0,1,0,1,0
13636,52454,445,0,0,drop,70,70,0,1,0,1,0
13637,60261,25174,0,0,deny,66,66,0,1,0,1,0
13638,54976,15503,0,0,deny,66,66,0,1,0,1,0
13639,64239,445,0,0,drop,66,66,0,1,0,1,0
13640,57300,53,43157,53,allow,184,94,90,2,30,1,1
13641,26944,443,13934,443,allow,6861,2224,4637,19,19,9,10
13642,56226,53,12248,53,allow,284,96,188,4,33,2,2
13643,49328,443,48321,443,allow,77821,4380,73441,82,53,23,59
13644,64987,53,14036,53,allow,192,98,94,2,30,1,1
13645,40422,53,0,0,allow,82,82,0,1,30,1,0
13646,55348,53,40546,53,allow,184,80,104,2,30,1,1
13647,64835,53,7153,53,allow,174,89,85,2,30,1,1
13648,46830,80,6947,80,allow,1764,751,1013,10,16,6,4
13649,33933,80,56054,80,allow,1988,1072,916,12,515,7,5
13650,49213,443,9169,443,allow,157994,4952,153042,186,255,68,118
13651,34326,443,28311,443,allow,5692,1597,4095,19,18,11,8
13652,55551,53,54639,53,allow,788,108,680,2,30,1,1
13653,50023,53,38403,53,allow,164,84,80,2,31,1,1
13654,46963,443,17005,443,allow,70,70,0,1,5,1,0
13655,51574,443,46080,443,allow,400,70,330,6,25,1,5
13656,49622,443,38378,443,allow,11139,3031,8108,30,176,14,16
13657,65212,53,35167,53,allow,192,98,94,2,31,1,1
13658,58528,443,58528,443,allow,4672,1765,2907,19,29,11,8
13659,52568,80,52568,80,allow,16474,1881,14593,28,143,12,16
13660,45482,80,16084,80,allow,1130,624,506,11,15,5,6
13661,56337,53,29643,53,allow,268,89,179,4,45,2,2
13662,53164,48198,7411,48198,allow,320,140,180,6,7,3,3
13663,52121,58933,17101,58933,allow,70,70,0,2,8,2,0
13664,56202,53,48899,53,allow,749,94,655,2,30,1,1
13665,55452,53,54913,53,allow,184,94,90,2,30,1,1
13666,50236,443,50711,443,allow,6661,1489,5172,26,270,13,13
13667,54054,443,10549,443,allow,34629391,1109219,33520172,36863,278,12240,24623
13668,41603,443,56421,443,allow,16028,3246,12782,37,272,19,18
13669,51576,443,46569,443,allow,400,70,330,6,25,1,5
13670,55697,53,39982,53,allow,186,95,91,2,31,1,1
13671,49331,443,35944,443,allow,78663,4968,73695,85,47,24,61
13672,49327,443,21395,443,allow,116686,4968,111718,116,53,31,85
13673,9270,80,20221,80,allow,318,192,126,6,26,4,2
13674,55692,53,35310,53,allow,196,100,96,2,30,1,1
13675,55222,53,19882,53,allow,178,91,87,2,30,1,1
13676,55927,53,11810,53,allow,711,87,624,2,30,1,1
13677,40544,53,0,0,allow,82,82,0,1,30,1,0
13678,30960,45755,44633,45755,allow,462,462,0,8,3631,8,0
13679,64974,53,44237,53,allow,212,108,104,2,31,1,1
13680,57301,53,33321,53,allow,170,87,83,2,31,1,1
13681,49234,53,17547,53,allow,166,85,81,2,31,1,1
13682,48817,29614,48817,29614,allow,506,152,354,2,1201,1,1
13683,49477,53,35970,53,allow,172,88,84,2,30,1,1
13684,50095,53,54067,53,allow,146,75,71,2,31,1,1
13685,56489,443,54085,443,allow,75930,4291,71639,90,120,32,58
13686,58795,443,24808,443,allow,10273,2573,7700,24,305,8,16
13687,57596,443,20240,443,allow,8154,1791,6363,21,187,11,10
13688,55726,27015,8012,27015,allow,628,462,166,4,31,2,2
13689,48817,23944,48817,23944,allow,513,152,361,2,1201,1,1
13690,39434,5228,17809,5228,allow,3505,2006,1499,30,3744,15,15
13691,64071,445,0,0,drop,70,70,0,1,0,1,0
13692,6881,6881,0,0,deny,146,146,0,1,0,1,0
13693,64236,445,0,0,drop,66,66,0,1,0,1,0
13694,64229,445,0,0,drop,66,66,0,1,0,1,0
13695,64235,445,0,0,drop,66,66,0,1,0,1,0
13696,64232,445,0,0,drop,66,66,0,1,0,1,0
13697,64233,445,0,0,drop,66,66,0,1,0,1,0
13698,64227,445,0,0,drop,66,66,0,1,0,1,0
13699,64226,445,0,0,drop,66,66,0,1,0,1,0
13700,64070,445,0,0,drop,70,70,0,1,0,1,0
13701,63545,25174,0,0,deny,62,62,0,1,0,1,0
13702,52450,445,0,0,drop,70,70,0,1,0,1,0
13703,52447,445,0,0,drop,70,70,0,1,0,1,0
13704,52445,445,0,0,drop,70,70,0,1,0,1,0
13705,52443,445,0,0,drop,70,70,0,1,0,1,0
13706,56127,37965,0,0,deny,62,62,0,1,0,1,0
13707,58900,37807,0,0,deny,62,62,0,1,0,1,0
13708,35194,57470,0,0,deny,74,74,0,1,0,1,0
13709,37672,5223,1351,5223,allow,110,110,0,1,5,1,0
13710,52572,80,52572,80,allow,1680,696,984,11,142,6,5
13711,51398,53,51398,53,allow,197,90,107,2,30,1,1
13712,64835,53,59630,53,allow,179,94,85,2,30,1,1
13713,64065,445,0,0,drop,70,70,0,1,0,1,0
13714,54221,57470,0,0,deny,66,66,0,1,0,1,0
13715,1537,22114,0,0,deny,62,62,0,1,0,1,0
13716,37592,36829,0,0,deny,146,146,0,1,0,1,0
13717,52112,22114,0,0,deny,66,66,0,1,0,1,0
13718,52437,445,0,0,drop,70,70,0,1,0,1,0
13719,52438,445,0,0,drop,70,70,0,1,0,1,0
13720,52435,445,0,0,drop,70,70,0,1,0,1,0
13721,18116,37807,0,0,deny,66,66,0,1,0,1,0
13722,64220,445,0,0,drop,66,66,0,1,0,1,0
13723,52434,445,0,0,drop,70,70,0,1,0,1,0
13724,64216,445,0,0,drop,66,66,0,1,0,1,0
13725,41861,5223,49797,5223,allow,5169,1103,4066,26,214,10,16
13726,48798,443,34647,443,allow,55560,11338,44222,90,23,41,49
13727,52097,443,17045,443,allow,7246,3017,4229,21,15,11,10
13728,50669,443,61553,443,allow,2985,1505,1480,16,20,9,7
13729,59485,80,39693,80,allow,882,527,355,10,255,6,4
13730,56592,53,12698,53,allow,200,102,98,2,29,1,1
13731,49367,53,30708,53,allow,389,94,295,4,55,2,2
13732,64040,12226,39321,12226,allow,66,66,0,2,7,2,0
13733,40204,40005,24841,40005,allow,148,86,62,2,30,1,1
13734,64483,53,37576,53,allow,300,90,210,4,30,2,2
13735,38863,443,38863,443,allow,36313,5931,30382,72,108,36,36
13736,62722,443,49389,443,allow,3491257,62261,3428996,3146,155,768,2378
13737,55452,53,8362,53,allow,184,94,90,2,29,1,1
13738,65239,53,58774,53,allow,199,102,97,2,29,1,1
13739,55692,53,4863,53,allow,198,102,96,2,29,1,1
13740,56354,53,44261,53,allow,182,102,80,2,29,1,1
13741,64452,53,37833,53,allow,322,102,220,2,29,1,1
13742,55106,53,60018,53,allow,184,94,90,2,29,1,1
13743,53907,45622,50876,45622,allow,70,70,0,2,7,2,0
13744,49978,53,38632,53,allow,195,102,93,2,29,1,1
13745,64462,53,49415,53,allow,179,94,85,2,30,1,1
13746,55697,53,51781,53,allow,193,102,91,2,30,1,1
13747,49397,53,53029,53,allow,373,98,275,4,43,2,2
13748,56337,53,25650,53,allow,268,89,179,4,45,2,2
13749,34787,443,34308,443,allow,13074,2439,10635,46,279,22,24
13750,52867,53,61685,53,allow,184,86,98,2,30,1,1
13751,56878,53,29099,53,allow,94,94,0,1,30,1,0
13752,49234,53,44202,53,allow,167,86,81,2,30,1,1
13753,55828,53,56117,53,allow,177,94,83,2,30,1,1
13754,49556,53,62658,53,allow,300,100,200,4,44,2,2
13755,55702,80,56730,80,allow,70,70,0,2,8,2,0
13756,60912,443,25198,443,allow,9959,2430,7529,27,46,16,11
13757,59486,80,17490,80,allow,882,527,355,10,255,6,4
13758,56612,53,15256,53,allow,274,87,187,4,30,2,2
13759,56773,443,51568,443,allow,7941,1952,5989,20,15,11,9
13760,50621,443,42624,443,allow,10905,4352,6553,30,18,18,12
13761,42811,443,38598,443,allow,2766,1907,859,17,25,10,7
13762,59821,80,19887,80,allow,1052,612,440,10,15,5,5
13763,56337,53,46173,53,allow,268,89,179,4,45,2,2
13764,52119,49239,18789,49239,allow,258,70,188,4,8,2,2
13765,57300,53,21469,53,allow,184,94,90,2,30,1,1
13766,52122,43073,9475,43073,allow,70,70,0,2,8,2,0
13767,65470,53,21136,53,allow,226,94,132,2,30,1,1
13768,55222,53,4063,53,allow,181,94,87,2,30,1,1
13769,60988,443,42425,443,allow,8019,3298,4721,30,40,17,13
13770,64671,53,7191,53,allow,294,102,192,2,30,1,1
13771,56873,53,25069,53,allow,184,94,90,2,30,1,1
13772,37319,443,50657,443,allow,70,70,0,1,5,1,0
13773,55452,53,7661,53,allow,184,94,90,2,30,1,1
13774,41322,443,6156,443,allow,994089,30018,964071,1058,350,373,685
13775,40249,443,14843,443,allow,70,70,0,1,5,1,0
13776,51304,443,20155,443,allow,7134,3081,4053,24,121,11,13
13777,52571,80,52571,80,allow,10947,876,10071,21,142,9,12
13778,55208,443,24176,443,allow,7224,114,7110,9,122,2,7
13779,56029,53,2806,53,allow,346,94,252,2,30,1,1
13780,64987,53,4145,53,allow,196,102,94,2,30,1,1
13781,56774,443,5880,443,allow,7889,1900,5989,20,15,11,9
13782,37321,443,3162,443,allow,70,70,0,1,5,1,0
13783,56675,80,35224,80,allow,156,156,0,3,8,3,0
13784,52100,443,58970,443,allow,190,70,120,4,15,2,2
13785,51576,443,34580,443,allow,3323,2023,1300,17,255,9,8
13786,64356,53,40978,53,allow,243,94,149,2,30,1,1
13787,50030,53,18076,53,allow,209,110,99,2,30,1,1
13788,51033,443,39133,443,allow,14697,3801,10896,52,120,24,28
13789,37675,53,37675,53,allow,197,90,107,2,30,1,1
13790,46190,80,10092,80,allow,5443,2529,2914,14,515,8,6
13791,52573,80,52573,80,allow,3487,696,2791,13,142,6,7
13792,10063,443,38761,443,allow,822903,35544,787359,1068,153,463,605
13793,64420,53,21949,53,allow,362,94,268,2,30,1,1
13794,56592,53,24895,53,allow,200,102,98,2,30,1,1
13795,52780,443,29664,443,allow,122,62,60,2,15,1,1
13796,53085,443,17021,443,allow,16024,3168,12856,56,76,31,25
13797,38922,443,18971,443,allow,346170,16091,330079,454,16,225,229
13798,52247,443,52247,443,allow,948720,23674,925046,988,26,349,639
13799,49348,53,28507,53,allow,312,96,216,4,35,2,2
13800,52088,35605,27322,35605,allow,70,70,0,1,5,1,0
13801,57906,80,15891,80,allow,318,192,126,6,26,4,2
13802,62721,443,47170,443,allow,5718309,117049,5601260,5287,155,1390,3897
13803,50672,80,6037,80,allow,1718,1247,471,9,14,5,4
13804,65425,53,21278,53,allow,473,94,379,4,36,2,2
13805,58831,443,40650,443,allow,9378,2858,6520,48,196,21,27
13806,60798,40010,54476,40010,allow,316,136,180,6,6,3,3
13807,52123,46261,34015,46261,allow,70,70,0,2,7,2,0
13808,47051,443,3373,443,allow,3304,2161,1143,21,16,11,10
13809,37320,443,60186,443,allow,70,70,0,1,5,1,0
13810,39888,443,38398,443,allow,1964,1171,793,20,25,11,9
13811,56226,53,44944,53,allow,284,96,188,4,33,2,2
13812,64677,53,11788,53,allow,334,93,241,4,50,2,2
13813,50023,53,49657,53,allow,166,86,80,2,29,1,1
13814,55222,53,13241,53,allow,181,94,87,2,29,1,1
13815,55222,53,63142,53,allow,181,94,87,2,29,1,1
13816,64581,53,16875,53,allow,214,110,104,2,29,1,1
13817,56497,53,23071,53,allow,214,110,104,2,30,1,1
13818,46056,443,52673,443,allow,80200,69062,11138,193,89,100,93
13819,50473,123,38470,123,allow,184,94,90,2,30,1,1
13820,57352,53,7772,53,allow,196,102,94,2,29,1,1
13821,44256,3389,44256,3389,allow,4145,1976,2169,22,18,13,9
13822,55966,53,61391,53,allow,86,86,0,1,29,1,0
13823,57590,80,57590,80,allow,1165239,13055,1152184,977,149,193,784
13824,56082,53,33966,53,allow,807,94,713,2,29,1,1
13825,61113,27045,31501,27045,allow,1680,1386,294,7,30,4,3
13826,56497,53,5207,53,allow,214,110,104,2,30,1,1
13827,34316,53,37625,53,allow,168,78,90,2,29,1,1
13828,49466,53,52804,53,allow,184,94,90,2,29,1,1
13829,56472,53,54930,53,allow,167,86,81,2,30,1,1
13830,65444,53,41449,53,allow,227,110,117,2,29,1,1
13831,49202,53,57613,53,allow,226,86,140,2,30,1,1
13832,57065,53,13982,53,allow,182,102,80,2,29,1,1
13833,64835,53,38888,53,allow,179,94,85,2,30,1,1
13834,63943,53,31455,53,allow,254,110,144,2,30,1,1
13835,59638,53,40619,53,allow,714,454,260,2,30,1,1
13836,49886,53,51424,53,allow,311,102,209,2,30,1,1
13837,64974,53,31114,53,allow,214,110,104,2,30,1,1
13838,65031,53,34987,53,allow,184,94,90,2,30,1,1
13839,49267,53,44367,53,allow,184,94,90,2,31,1,1
13840,57470,1337,44694,1337,allow,594,594,0,10,1199,10,0
13841,64974,53,53114,53,allow,214,110,104,2,30,1,1
13842,50023,53,60476,53,allow,166,86,80,2,31,1,1
13843,64602,53,49677,53,allow,184,94,90,2,30,1,1
13844,64181,53,18587,53,allow,194,102,92,2,31,1,1
13845,6881,12676,29408,12676,allow,509,150,359,2,1199,1,1
13846,57470,35988,31535,35988,allow,132,132,0,3,1199,3,0
13847,51221,57073,10928,57073,allow,481,150,331,2,1200,1,1
13848,35052,443,8505,443,allow,4652,3109,1543,25,95,14,11
13849,57266,443,58500,443,allow,10174,2163,8011,25,81,14,11
13850,55106,53,36714,53,allow,314,94,220,4,33,2,2
13851,56772,443,38284,443,allow,7889,1900,5989,20,15,11,9
13852,55884,53,55884,53,allow,197,90,107,2,30,1,1
13853,64835,53,41380,53,allow,179,94,85,2,30,1,1
13854,39622,53,25768,53,allow,168,78,90,2,30,1,1
13855,55828,53,14283,53,allow,177,94,83,2,30,1,1
13856,64433,53,21792,53,allow,257,94,163,2,30,1,1
13857,53036,443,2888,443,allow,3039,1089,1950,9,120,5,4
13858,55031,5222,39174,5222,allow,6192,3767,2425,53,64,29,24
13859,60684,80,43634,80,allow,1737,796,941,12,16,7,5
13860,56676,80,29076,80,allow,78,78,0,2,6,2,0
13861,32945,80,47829,80,allow,234,234,0,4,12,4,0
13862,49046,5222,3706,5222,allow,6910,3381,3529,50,323,26,24
13863,49477,53,9524,53,allow,271,88,183,4,59,2,2
13864,55369,53,62193,53,allow,376,94,282,2,30,1,1
13865,64225,53,35755,53,allow,322,118,204,2,30,1,1
13866,56937,53,62951,53,allow,181,94,87,2,30,1,1
13867,40204,40016,39697,40016,allow,140,78,62,2,30,1,1
13868,56937,53,52000,53,allow,181,94,87,2,33,1,1
13869,52120,42751,65345,42751,allow,70,70,0,2,8,2,0
13870,52089,16543,15795,16543,allow,70,70,0,1,5,1,0
13871,56337,53,7280,53,allow,268,89,179,4,44,2,2
13872,52570,80,52570,80,allow,3886,696,3190,13,142,6,7
13873,48872,443,20108,443,allow,8143,3033,5110,26,18,14,12
13874,65212,53,45804,53,allow,196,102,94,2,30,1,1
13875,54962,53,47568,53,allow,241,102,139,2,31,1,1
13876,49849,53,37502,53,allow,196,102,94,2,31,1,1
13877,55697,53,14156,53,allow,193,102,91,2,31,1,1
13878,31683,53,31683,53,allow,197,90,107,2,30,1,1
13879,20953,53,20953,53,allow,295,90,205,2,30,1,1
13880,48817,45919,48817,45919,allow,334,158,176,2,1200,1,1
13881,61833,443,42241,443,allow,3429,784,2645,18,135,8,10
13882,55804,80,55804,80,allow,424,198,226,7,143,4,3
13883,10151,40231,24979,40231,allow,481,150,331,2,1200,1,1
13884,65031,53,49062,53,allow,184,94,90,2,31,1,1
13885,50020,443,25948,443,allow,9175,2213,6962,37,121,19,18
13886,60217,443,8028,443,allow,6075,3806,2269,18,120,10,8
13887,57470,1337,52453,1337,allow,594,594,0,10,1199,10,0
13888,64462,53,60220,53,allow,329,94,235,4,31,2,2
13889,55763,8060,47887,8060,allow,70,70,0,1,5,1,0
13890,43546,443,49269,443,allow,5948,1664,4284,21,247,12,9
13891,50666,80,35544,80,allow,2937,1241,1696,12,22,7,5
13892,35423,443,35423,443,allow,4555,1648,2907,20,29,12,8
13893,49772,53,54364,53,allow,181,94,87,2,31,1,1
13894,41243,443,21826,443,allow,3697,2379,1318,26,16,14,12
13895,46507,443,10914,443,allow,7068,2016,5052,32,18,17,15
13896,50364,443,37739,443,allow,1727,926,801,15,30,7,8
13897,50384,80,18722,80,allow,2537,783,1754,13,20,7,6
13898,46715,443,4396,443,allow,2945,779,2166,10,121,5,5
13899,47454,443,6613,443,allow,21782,2823,18959,42,16,20,22
13900,52253,443,52253,443,allow,429263,14390,414873,449,24,159,290
13901,49706,53,17646,53,allow,296,102,194,4,42,2,2
13902,53911,1025,45349,1025,allow,130,70,60,3,6,2,1
13903,64038,28187,34899,28187,allow,66,66,0,2,8,2,0
13904,64306,53,2693,53,allow,216,110,106,2,30,1,1
13905,64214,445,0,0,drop,66,66,0,1,0,1,0
13906,64212,445,0,0,drop,66,66,0,1,0,1,0
13907,30303,30303,0,0,deny,181,181,0,1,0,1,0
13908,64211,445,0,0,drop,66,66,0,1,0,1,0
13909,2427,25174,0,0,deny,62,62,0,1,0,1,0
13910,49370,11392,0,0,deny,66,66,0,1,0,1,0
13911,64052,445,0,0,drop,70,70,0,1,0,1,0
13912,52430,445,0,0,drop,70,70,0,1,0,1,0
13913,64049,445,0,0,drop,70,70,0,1,0,1,0
13914,6881,6881,0,0,deny,146,146,0,1,0,1,0
13915,55079,25174,0,0,deny,66,66,0,1,0,1,0
13916,30644,25174,0,0,deny,62,62,0,1,0,1,0
13917,52420,445,0,0,drop,70,70,0,1,0,1,0
13918,52415,445,0,0,drop,70,70,0,1,0,1,0
13919,58715,64097,0,0,deny,62,62,0,1,0,1,0
13920,61635,37965,0,0,deny,66,66,0,1,0,1,0
13921,54883,51505,0,0,deny,66,66,0,1,0,1,0
13922,59587,25174,0,0,deny,62,62,0,1,0,1,0
13923,25063,64147,0,0,deny,62,62,0,1,0,1,0
13924,64200,445,0,0,drop,66,66,0,1,0,1,0
13925,7041,37965,0,0,deny,62,62,0,1,0,1,0
13926,50235,5900,0,0,deny,60,60,0,1,0,1,0
13927,46116,57470,0,0,deny,74,74,0,1,0,1,0
13928,64045,445,0,0,drop,70,70,0,1,0,1,0
13929,51966,25174,0,0,deny,62,62,0,1,0,1,0
13930,30697,57866,0,0,deny,62,62,0,1,0,1,0
13931,64043,445,0,0,drop,70,70,0,1,0,1,0
13932,64041,445,0,0,drop,70,70,0,1,0,1,0
13933,59096,57866,0,0,deny,66,66,0,1,0,1,0
13934,58143,57866,0,0,deny,66,66,0,1,0,1,0
13935,64192,445,0,0,drop,66,66,0,1,0,1,0
13936,60869,48817,0,0,deny,62,62,0,1,0,1,0
13937,52406,445,0,0,drop,70,70,0,1,0,1,0
13938,63213,57866,0,0,deny,66,66,0,1,0,1,0
13939,41898,22114,0,0,deny,146,146,0,1,0,1,0
13940,64190,445,0,0,drop,66,66,0,1,0,1,0
13941,54666,36237,0,0,deny,66,66,0,1,0,1,0
13942,48706,23393,0,0,deny,60,60,0,1,0,1,0
13943,39959,23117,0,0,deny,146,146,0,1,0,1,0
13944,64034,445,0,0,drop,70,70,0,1,0,1,0
13945,28110,22,0,0,deny,60,60,0,1,0,1,0
13946,64183,445,0,0,drop,66,66,0,1,0,1,0
13947,64032,445,0,0,drop,70,70,0,1,0,1,0
13948,5830,22114,0,0,deny,66,66,0,1,0,1,0
13949,1024,44847,0,0,deny,62,62,0,1,0,1,0
13950,64172,445,0,0,drop,66,66,0,1,0,1,0
13951,42030,25,0,0,deny,74,74,0,1,0,1,0
13952,64031,445,0,0,drop,70,70,0,1,0,1,0
13953,25202,25174,0,0,deny,62,62,0,1,0,1,0
13954,4793,50584,0,0,deny,62,62,0,1,0,1,0
13955,64030,445,0,0,drop,70,70,0,1,0,1,0
13956,57164,50584,0,0,deny,62,62,0,1,0,1,0
13957,37011,25174,0,0,deny,62,62,0,1,0,1,0
13958,64029,445,0,0,drop,70,70,0,1,0,1,0
13959,64023,445,0,0,drop,70,70,0,1,0,1,0
13960,64024,445,0,0,drop,70,70,0,1,0,1,0
13961,25523,35974,0,0,deny,62,62,0,1,0,1,0
13962,29291,40108,0,0,deny,150,150,0,1,0,1,0
13963,29291,62609,0,0,deny,150,150,0,1,0,1,0
13964,48839,37807,0,0,deny,146,146,0,1,0,1,0
13965,29291,48983,0,0,deny,150,150,0,1,0,1,0
13966,18086,25174,0,0,deny,62,62,0,1,0,1,0
13967,62550,51505,0,0,deny,66,66,0,1,0,1,0
13968,52398,445,0,0,drop,70,70,0,1,0,1,0
13969,52397,445,0,0,drop,70,70,0,1,0,1,0
13970,52395,445,0,0,drop,70,70,0,1,0,1,0
13971,27969,25174,0,0,deny,62,62,0,1,0,1,0
13972,64011,445,0,0,drop,70,70,0,1,0,1,0
13973,64010,445,0,0,drop,70,70,0,1,0,1,0
13974,64160,445,0,0,drop,66,66,0,1,0,1,0
13975,64164,445,0,0,drop,66,66,0,1,0,1,0
13976,64163,445,0,0,drop,66,66,0,1,0,1,0
13977,64166,445,0,0,drop,66,66,0,1,0,1,0
13978,64167,445,0,0,drop,66,66,0,1,0,1,0
13979,64165,445,0,0,drop,66,66,0,1,0,1,0
13980,64161,445,0,0,drop,66,66,0,1,0,1,0
13981,64159,445,0,0,drop,66,66,0,1,0,1,0
13982,64007,445,0,0,drop,70,70,0,1,0,1,0
13983,53015,64147,0,0,deny,62,62,0,1,0,1,0
13984,64001,445,0,0,drop,70,70,0,1,0,1,0
13985,64000,445,0,0,drop,70,70,0,1,0,1,0
13986,61369,64147,0,0,deny,66,66,0,1,0,1,0
13987,34811,56205,0,0,deny,62,62,0,1,0,1,0
13988,61382,25174,0,0,deny,66,66,0,1,0,1,0
13989,6889,8970,0,0,reset-both,143,143,0,1,0,1,0
13990,48125,7558,0,0,deny,60,60,0,1,0,1,0
13991,5222,64493,0,0,deny,1514,1514,0,1,0,1,0
13992,38755,22114,0,0,deny,66,66,0,1,0,1,0
13993,63032,22114,0,0,deny,66,66,0,1,0,1,0
13994,43679,44847,0,0,deny,62,62,0,1,0,1,0
13995,52389,445,0,0,drop,70,70,0,1,0,1,0
13996,52387,445,0,0,drop,70,70,0,1,0,1,0
13997,52386,445,0,0,drop,70,70,0,1,0,1,0
13998,52378,445,0,0,drop,70,70,0,1,0,1,0
13999,46604,57866,0,0,deny,66,66,0,1,0,1,0
14000,63989,445,0,0,drop,70,70,0,1,0,1,0
14001,58716,9694,0,0,deny,62,62,0,1,0,1,0
14002,64144,445,0,0,drop,66,66,0,1,0,1,0
14003,64145,445,0,0,drop,66,66,0,1,0,1,0
14004,64146,445,0,0,drop,66,66,0,1,0,1,0
14005,58926,25174,0,0,deny,146,146,0,1,0,1,0
14006,19204,57866,0,0,deny,66,66,0,1,0,1,0
14007,56578,25174,0,0,deny,66,66,0,1,0,1,0
14008,28385,50584,0,0,deny,62,62,0,1,0,1,0
14009,7905,22114,0,0,deny,66,66,0,1,0,1,0
14010,62242,44512,0,0,deny,66,66,0,1,0,1,0
14011,57471,62413,0,0,deny,66,66,0,1,0,1,0
14012,52374,445,0,0,drop,70,70,0,1,0,1,0
14013,19882,22114,0,0,deny,146,146,0,1,0,1,0
14014,63985,445,0,0,drop,70,70,0,1,0,1,0
14015,52373,445,0,0,drop,70,70,0,1,0,1,0
14016,52371,445,0,0,drop,70,70,0,1,0,1,0
14017,52369,445,0,0,drop,70,70,0,1,0,1,0
14018,39661,23,0,0,deny,60,60,0,1,0,1,0
14019,45964,2225,0,0,deny,60,60,0,1,0,1,0
14020,63975,445,0,0,drop,70,70,0,1,0,1,0
14021,63973,445,0,0,drop,70,70,0,1,0,1,0
14022,63974,445,0,0,drop,70,70,0,1,0,1,0
14023,55056,44512,0,0,deny,62,62,0,1,0,1,0
14024,46808,25174,0,0,deny,62,62,0,1,0,1,0
14025,63972,445,0,0,drop,70,70,0,1,0,1,0
14026,36561,2767,0,0,deny,62,62,0,1,0,1,0
14027,63969,445,0,0,drop,70,70,0,1,0,1,0
14028,1024,64147,0,0,deny,62,62,0,1,0,1,0
14029,50593,64147,0,0,deny,66,66,0,1,0,1,0
14030,52699,25174,0,0,deny,66,66,0,1,0,1,0
14031,32132,25174,0,0,deny,66,66,0,1,0,1,0
14032,27055,25174,0,0,deny,146,146,0,1,0,1,0
14033,52357,445,0,0,drop,70,70,0,1,0,1,0
14034,52354,445,0,0,drop,70,70,0,1,0,1,0
14035,52352,445,0,0,drop,70,70,0,1,0,1,0
14036,27038,51505,0,0,deny,62,62,0,1,0,1,0
14037,63786,25174,0,0,deny,66,66,0,1,0,1,0
14038,49514,65504,0,0,deny,162,162,0,1,0,1,0
14039,58744,1433,0,0,deny,60,60,0,1,0,1,0
14040,51413,1,0,0,deny,72,72,0,1,0,1,0
14041,51966,25174,0,0,deny,146,146,0,1,0,1,0
14042,26531,25174,0,0,deny,62,62,0,1,0,1,0
14043,64132,445,0,0,drop,66,66,0,1,0,1,0
14044,19875,30170,0,0,deny,145,145,0,1,0,1,0
14045,10072,25174,0,0,deny,146,146,0,1,0,1,0
14046,63963,445,0,0,drop,70,70,0,1,0,1,0
14047,55082,25174,0,0,deny,66,66,0,1,0,1,0
14048,43345,51505,0,0,deny,146,146,0,1,0,1,0
14049,10082,64147,0,0,deny,62,62,0,1,0,1,0
14050,49651,37965,0,0,deny,74,74,0,1,0,1,0
14051,11552,44847,0,0,deny,146,146,0,1,0,1,0
14052,29016,25174,0,0,deny,146,146,0,1,0,1,0
14053,8889,25033,0,0,deny,60,60,0,1,0,1,0
14054,50321,48817,0,0,deny,143,143,0,1,0,1,0
14055,52349,445,0,0,drop,70,70,0,1,0,1,0
14056,443,21745,0,0,deny,66,66,0,1,0,1,0
14057,63173,36237,0,0,deny,66,66,0,1,0,1,0
14058,63955,445,0,0,drop,70,70,0,1,0,1,0
14059,49036,44847,0,0,deny,62,62,0,1,0,1,0
14060,52348,445,0,0,drop,70,70,0,1,0,1,0
14061,63953,445,0,0,drop,70,70,0,1,0,1,0
14062,22571,51505,0,0,deny,66,66,0,1,0,1,0
14063,57761,30317,0,0,deny,66,66,0,1,0,1,0
14064,18655,44847,0,0,deny,66,66,0,1,0,1,0
14065,49250,53,20588,53,allow,731,85,646,2,30,1,1
14066,64602,53,34002,53,allow,184,94,90,2,30,1,1
14067,56491,53,1431,53,allow,711,87,624,2,30,1,1
14068,65031,53,50837,53,allow,184,94,90,2,30,1,1
14069,9243,80,7873,80,allow,318,192,126,6,26,4,2
14070,56485,80,20851,80,allow,569,365,204,6,16,3,3
14071,52115,10012,9221,10012,allow,70,70,0,2,8,2,0
14072,48984,15000,36697,15000,allow,130,70,60,2,5,1,1
14073,64462,53,6951,53,allow,174,89,85,2,30,1,1
14074,50861,3389,50861,3389,allow,4241,2521,1720,18,32,10,8
14075,9244,80,12299,80,allow,318,192,126,6,26,4,2
14076,9260,80,58390,80,allow,318,192,126,6,26,4,2
14077,49556,53,40428,53,allow,300,100,200,4,44,2,2
14078,49365,80,10585,80,allow,2361,1586,775,11,166,7,4
14079,59271,443,60275,443,allow,26414,4349,22065,41,149,17,24
14080,55687,53,17643,53,allow,731,85,646,2,31,1,1
14081,63834,27037,35809,27037,allow,1130,924,206,5,30,3,2
14082,49267,53,65415,53,allow,184,94,90,2,30,1,1
14083,50898,80,8835,80,allow,21445,1605,19840,36,255,19,17
14084,58842,443,11917,443,allow,8912,1537,7375,27,638,10,17
14085,9264,80,28949,80,allow,318,192,126,6,26,4,2
14086,35939,443,12067,443,allow,9111,2919,6192,27,19,14,13
14087,9469,80,38587,80,allow,1641,483,1158,10,15,5,5
14088,53680,443,32656,443,allow,7035,2364,4671,18,75,10,8
14089,40906,8434,40906,8434,allow,156,156,0,3,8,3,0
14090,53260,443,37700,443,allow,572,292,280,9,33,5,4
14091,55858,80,7371,80,allow,104399,8436,95963,122,21,49,73
14092,41906,443,20652,443,allow,181961,40579,141382,247,238,101,146
14093,54445,443,28246,443,allow,2782,1778,1004,20,33,10,10
14094,65318,53,17829,53,allow,184,94,90,2,31,1,1
14095,9262,80,26310,80,allow,378,192,186,7,26,4,3
14096,9468,80,22561,80,allow,1835,421,1414,9,15,4,5
14097,9263,80,41010,80,allow,318,192,126,6,26,4,2
14098,50353,80,65364,80,allow,8007,830,7177,17,30,8,9
14099,51656,53,51656,53,allow,198,89,109,2,30,1,1
14100,48655,80,39370,80,allow,956,541,415,11,315,6,5
14101,56248,53,47475,53,allow,767,102,665,2,30,1,1
14102,56873,53,29966,53,allow,184,94,90,2,30,1,1
14103,55503,53,13265,53,allow,200,102,98,2,30,1,1
14104,57237,53,56776,53,allow,701,88,613,2,30,1,1
14105,51401,443,31981,443,allow,6537,3702,2835,34,170,17,17
14106,47087,443,29605,443,allow,7187,2550,4637,20,18,10,10
14107,49706,53,30583,53,allow,296,102,194,4,41,2,2
14108,58835,443,12321,443,allow,9823,2600,7223,46,195,23,23
14109,49364,80,47748,80,allow,2168,1031,1137,8,166,5,3
14110,53906,12051,34312,12051,allow,258,70,188,4,9,2,2
14111,64181,53,25731,53,allow,188,96,92,2,31,1,1
14112,54446,443,54881,443,allow,2782,1778,1004,20,33,10,10
14113,49675,5900,49675,5900,allow,124,60,64,2,5,1,1
14114,56281,443,8565,443,allow,22352,9825,12527,111,370,55,56
14115,9261,80,32507,80,allow,378,192,186,7,26,4,3
14116,9259,80,48036,80,allow,318,192,126,6,26,4,2
14117,9265,80,10244,80,allow,318,192,126,6,26,4,2
14118,9245,80,28513,80,allow,378,192,186,7,26,4,3
14119,49772,53,60667,53,allow,178,91,87,2,30,1,1
14120,49849,53,14013,53,allow,192,98,94,2,31,1,1
14121,56519,53,63557,53,allow,166,85,81,2,31,1,1
14122,49986,18242,0,0,allow,66,66,0,1,90,1,0
14123,41254,443,60907,443,allow,12757,4053,8704,39,522,14,25
14124,19473,28867,41961,28867,allow,480,149,331,2,1200,1,1
14125,43185,443,5462,443,allow,6951,1333,5618,26,271,14,12
14126,49564,53,46836,53,allow,186,95,91,2,31,1,1
14127,53476,443,9051,443,allow,3182,1568,1614,8,121,4,4
14128,52982,25174,0,0,deny,146,146,0,1,0,1,0
14129,44334,26467,0,0,deny,62,62,0,1,0,1,0
14130,57434,50584,0,0,deny,146,146,0,1,0,1,0
14131,58091,51505,0,0,deny,66,66,0,1,0,1,0
14132,64118,445,0,0,drop,66,66,0,1,0,1,0
14133,64116,445,0,0,drop,66,66,0,1,0,1,0
14134,63948,445,0,0,drop,70,70,0,1,0,1,0
14135,63947,445,0,0,drop,70,70,0,1,0,1,0
14136,54473,37807,0,0,deny,66,66,0,1,0,1,0
14137,63364,57470,0,0,deny,62,62,0,1,0,1,0
14138,2543,25174,0,0,deny,62,62,0,1,0,1,0
14139,52339,445,0,0,drop,70,70,0,1,0,1,0
14140,65318,53,18281,53,allow,184,94,90,2,30,1,1
14141,60474,8999,5230,8999,allow,70,70,0,1,5,1,0
14142,52334,445,0,0,drop,70,70,0,1,0,1,0
14143,52332,445,0,0,drop,70,70,0,1,0,1,0
14144,52327,445,0,0,drop,70,70,0,1,0,1,0
14145,26881,25174,0,0,deny,62,62,0,1,0,1,0
14146,38581,22114,0,0,deny,62,62,0,1,0,1,0
14147,63943,445,0,0,drop,70,70,0,1,0,1,0
14148,22636,30188,0,0,deny,62,62,0,1,0,1,0
14149,64114,445,0,0,drop,66,66,0,1,0,1,0
14150,45461,25174,0,0,deny,62,62,0,1,0,1,0
14151,36151,22,0,0,deny,60,60,0,1,0,1,0
14152,63941,445,0,0,drop,70,70,0,1,0,1,0
14153,34146,1433,0,0,deny,60,60,0,1,0,1,0
14154,64100,445,0,0,drop,66,66,0,1,0,1,0
14155,64102,445,0,0,drop,66,66,0,1,0,1,0
14156,64101,445,0,0,drop,66,66,0,1,0,1,0
14157,64106,445,0,0,drop,66,66,0,1,0,1,0
14158,64103,445,0,0,drop,66,66,0,1,0,1,0
14159,64105,445,0,0,drop,66,66,0,1,0,1,0
14160,64097,445,0,0,drop,66,66,0,1,0,1,0
14161,60793,53733,0,0,deny,66,66,0,1,0,1,0
14162,2437,23117,0,0,deny,62,62,0,1,0,1,0
14163,52323,445,0,0,drop,70,70,0,1,0,1,0
14164,11228,25174,0,0,deny,66,66,0,1,0,1,0
14165,2437,23117,0,0,deny,146,146,0,1,0,1,0
14166,48266,80,46749,80,allow,130,70,60,2,15,1,1
14167,42107,443,39392,443,allow,13704,2379,11325,47,279,22,25
14168,59685,443,54976,443,allow,7747,1533,6214,27,31,13,14
14169,46438,53,32231,53,allow,222,78,144,2,30,1,1
14170,54695,80,64600,80,allow,2001,1107,894,13,150,7,6
14171,55707,26816,41675,26816,allow,320,140,180,6,6,3,3
14172,37368,80,60512,80,allow,554,258,296,9,13,5,4
14173,56769,443,25443,443,allow,7941,1952,5989,20,15,11,9
14174,9253,443,42267,443,allow,6135,770,5365,17,26,9,8
14175,50667,80,4915,80,allow,3778,2082,1696,12,21,7,5
14176,49655,443,10531,443,allow,31956,13344,18612,64,65,36,28
14177,33202,80,39571,80,allow,1114,534,580,12,15,7,5
14178,49556,53,1572,53,allow,300,100,200,4,43,2,2
14179,49368,443,28033,443,allow,5224,1560,3664,15,165,9,6
14180,64037,18592,23660,18592,allow,66,66,0,2,7,2,0
14181,64862,53,23535,53,allow,223,94,129,2,29,1,1
14182,64462,53,14604,53,allow,179,94,85,2,29,1,1
14183,57301,53,42748,53,allow,177,94,83,2,29,1,1
14184,56771,443,16357,443,allow,7941,1952,5989,20,15,11,9
14185,57300,53,9339,53,allow,184,94,90,2,29,1,1
14186,37680,443,37680,443,allow,4592,1685,2907,19,29,11,8
14187,49234,53,62807,53,allow,167,86,81,2,29,1,1
14188,57301,53,40888,53,allow,177,94,83,2,29,1,1
14189,4650,53,4650,53,allow,300,90,210,2,29,1,1
14190,55503,53,12220,53,allow,200,102,98,2,30,1,1
14191,65148,53,60062,53,allow,498,204,294,6,29,3,3
14192,65078,53,48280,53,allow,339,110,229,2,29,1,1
14193,49772,53,62355,53,allow,181,94,87,2,29,1,1
14194,56873,53,37492,53,allow,184,94,90,2,30,1,1
14195,64037,53,2722,53,allow,215,94,121,2,29,1,1
14196,64602,53,19507,53,allow,184,94,90,2,30,1,1
14197,38279,80,49834,80,allow,122,62,60,2,15,1,1
14198,58152,443,52749,443,allow,5584,1168,4416,19,17,11,8
14199,37671,53,37671,53,allow,180,82,98,2,30,1,1
14200,49518,53,40851,53,allow,167,86,81,2,30,1,1
14201,49849,53,11014,53,allow,196,102,94,2,30,1,1
14202,52117,20600,30733,20600,allow,70,70,0,2,8,2,0
14203,49518,53,65191,53,allow,167,86,81,2,30,1,1
14204,52086,27156,8001,27156,allow,136,136,0,3,14,3,0
14205,9257,443,25692,443,allow,6327,833,5494,19,26,10,9
14206,39831,443,37659,443,allow,7656,4286,3370,38,86,19,19
14207,47825,443,54151,443,allow,932130,36511,895619,1142,167,465,677
14208,60797,28080,22385,28080,allow,70,70,0,2,8,2,0
14209,56770,443,17971,443,allow,7889,1900,5989,20,15,11,9
14210,9250,443,1319,443,allow,6331,837,5494,19,26,10,9
14211,36008,80,27818,80,allow,1614,1300,314,10,15,5,5
14212,54353,443,50678,443,allow,9976,3230,6746,22,56,13,9
14213,9237,80,59192,80,allow,378,192,186,7,26,4,3
14214,49693,53,17140,53,allow,196,94,102,2,30,1,1
14215,64942,53,4876,53,allow,284,102,182,4,37,2,2
14216,46503,443,50192,443,allow,6492,1764,4728,56,996,20,36
14217,55503,53,55222,53,allow,200,102,98,2,30,1,1
14218,49631,443,24213,443,allow,6304,1793,4511,29,255,15,14
14219,56731,443,8891,443,allow,7828,2313,5515,31,64,17,14
14220,49210,443,19575,443,allow,9530,2183,7347,45,256,21,24
14221,64738,53,34025,53,allow,402,118,284,2,30,1,1
14222,56843,53,63293,53,allow,177,94,83,2,30,1,1
14223,50095,53,10662,53,allow,168,86,82,2,30,1,1
14224,57301,53,28379,53,allow,177,94,83,2,30,1,1
14225,49267,53,55947,53,allow,184,94,90,2,30,1,1
14226,38402,443,34859,443,allow,8119,1962,6157,24,360,11,13
14227,50095,53,20934,53,allow,168,86,82,2,30,1,1
14228,55807,80,55807,80,allow,424,198,226,7,142,4,3
14229,55806,80,55806,80,allow,424,198,226,7,142,4,3
14230,9249,443,2759,443,allow,6132,767,5365,17,26,9,8
14231,9239,80,63339,80,allow,318,192,126,6,26,4,2
14232,52114,64853,12974,64853,allow,70,70,0,2,8,2,0
14233,54162,443,34813,443,allow,2680,1488,1192,19,41,10,9
14234,54160,443,65221,443,allow,9464,1751,7713,29,48,13,16
14235,64181,53,43777,53,allow,194,102,92,2,30,1,1
14236,49267,53,29003,53,allow,184,94,90,2,30,1,1
14237,64388,53,41426,53,allow,258,110,148,2,30,1,1
14238,56843,53,57824,53,allow,177,94,83,2,30,1,1
14239,47725,443,52489,443,allow,502,250,252,9,32,5,4
14240,60794,20010,2485,20010,allow,70,70,0,1,5,1,0
14241,9234,80,38036,80,allow,318,192,126,6,26,4,2
14242,37708,443,23854,443,allow,8604,2228,6376,36,739,19,17
14243,33640,443,55083,443,allow,10558,2530,8028,25,186,14,11
14244,51155,443,21340,443,allow,54411,4588,49823,74,131,30,44
14245,49556,53,59272,53,allow,300,100,200,4,44,2,2
14246,49626,443,38035,443,allow,8266,1963,6303,28,175,14,14
14247,64974,53,23445,53,allow,506,108,398,4,36,2,2
14248,52116,64692,45907,64692,allow,70,70,0,2,8,2,0
14249,50365,80,49822,80,allow,300,180,120,6,29,4,2
14250,55454,53,51580,53,allow,168,86,82,2,33,1,1
14251,52087,52766,15525,52766,allow,136,136,0,3,14,3,0
14252,44383,443,25298,443,allow,14780,11289,3491,59,219,32,27
14253,45101,443,3854,443,allow,7912,2739,5173,26,516,14,12
14254,62170,443,62170,443,allow,28026,5723,22303,62,20,32,30
14255,9467,443,18809,443,allow,5960,438,5522,16,15,6,10
14256,39127,6555,15189,6555,allow,922,428,494,10,15,5,5
14257,34225,443,33698,443,allow,256793,17776,239017,327,23,146,181
14258,50294,80,24616,80,allow,1515,481,1034,11,15,6,5
14259,60995,443,11816,443,allow,7583,2669,4914,31,17,16,15
14260,53964,443,36020,443,allow,374,254,120,4,5,2,2
14261,46550,443,47907,443,allow,3322,1760,1562,19,255,10,9
14262,33270,80,23251,80,allow,1614,1300,314,10,15,5,5
14263,57341,53,40485,53,allow,296,97,199,4,41,2,2
14264,41034,443,11072,443,allow,6055,2800,3255,38,279,19,19
14265,49706,53,34052,53,allow,296,102,194,4,41,2,2
14266,52118,33515,33207,33515,allow,70,70,0,2,7,2,0
14267,9235,80,17442,80,allow,318,192,126,6,26,4,2
14268,56672,80,18882,80,allow,234,234,0,4,11,4,0
14269,50283,53,31898,53,allow,767,102,665,2,29,1,1
14270,9238,80,17779,80,allow,378,192,186,7,26,4,3
14271,48437,443,48848,443,allow,934,420,514,15,30,7,8
14272,50095,53,59595,53,allow,250,86,164,4,30,2,2
14273,65212,53,30386,53,allow,196,102,94,2,30,1,1
14274,50629,443,10461,443,allow,1048,1048,0,9,17,9,0
14275,49594,53,49594,53,allow,199,90,109,2,30,1,1
14276,50638,443,50638,443,allow,4544,1637,2907,19,26,11,8
14277,57807,443,57807,443,allow,4434,1527,2907,19,29,11,8
14278,56873,53,11452,53,allow,184,94,90,2,29,1,1
14279,57321,53,25115,53,allow,498,204,294,6,29,3,3
14280,49179,53,18943,53,allow,309,118,191,2,30,1,1
14281,6881,13487,50124,13487,allow,228,118,110,2,1199,1,1
14282,56849,443,44408,443,allow,7374,2085,5289,33,270,18,15
14283,64194,443,64194,443,allow,27723,5572,22151,59,46,31,28
14284,60180,443,13880,443,allow,3667,2243,1424,22,80,11,11
14285,9246,80,48818,80,allow,318,192,126,6,26,4,2
14286,9251,443,22776,443,allow,6132,767,5365,17,26,9,8
14287,55503,53,54842,53,allow,200,102,98,2,30,1,1
14288,53950,123,31431,123,allow,184,94,90,2,30,1,1
14289,49564,53,39263,53,allow,193,102,91,2,30,1,1
14290,50116,80,62862,80,allow,10094,1100,8994,20,33,10,10
14291,52085,29894,54507,29894,allow,136,136,0,3,14,3,0
14292,54163,443,60868,443,allow,2430,1416,1014,18,34,9,9
14293,53866,8999,60577,8999,allow,372,186,186,6,15,3,3
14294,60711,443,10147,443,allow,10569,3485,7084,27,515,15,12
14295,9256,443,44390,443,allow,6327,833,5494,19,26,10,9
14296,53459,443,23457,443,allow,88210,4564,83646,115,46,50,65
14297,65318,53,11252,53,allow,184,94,90,2,30,1,1
14298,49234,53,17767,53,allow,167,86,81,2,30,1,1
14299,58124,123,43315,123,allow,184,94,90,2,30,1,1
14300,49577,53,36536,53,allow,242,94,148,2,30,1,1
14301,59637,53,37515,53,allow,273,94,179,2,30,1,1
14302,57987,443,16754,443,allow,3264,1175,2089,14,120,7,7
14303,39817,443,13115,443,allow,516080,28328,487752,660,95,305,355
14304,56628,443,8752,443,allow,6654,3821,2833,60,3037,30,30
14305,64120,443,47176,443,allow,3767437,87322,3680115,3675,52,1230,2445
14306,49665,53,16462,53,allow,168,86,82,2,32,1,1
14307,50241,443,61373,443,allow,27900,6291,21609,46,515,23,23
14308,9254,443,60082,443,allow,6135,770,5365,17,26,9,8
14309,60059,53,45306,53,allow,168,78,90,2,30,1,1
14310,65033,53,12694,53,allow,214,94,120,2,30,1,1
14311,6881,25649,11591,25649,allow,509,150,359,2,1200,1,1
14312,49849,53,61078,53,allow,196,102,94,2,31,1,1
14313,63654,443,35757,443,allow,9152483,314975,8837508,9599,206,3195,6404
14314,59189,443,26773,443,allow,9050,4611,4439,37,222,20,17
14315,6881,6881,6157,6881,allow,253,118,135,2,1200,1,1
14316,9289,443,57036,443,allow,9051,3480,5571,31,23,17,14
14317,53902,55298,4313,55298,allow,70,70,0,2,8,2,0
14318,53904,1024,57585,1024,allow,70,70,0,2,8,2,0
14319,34680,9595,34680,9595,allow,152,66,86,2,10,1,1
14320,38101,443,19198,443,allow,350,210,140,6,15,4,2
14321,35430,443,18104,443,allow,6267,1810,4457,25,18,14,11
14322,33688,80,62587,80,allow,1638,1324,314,10,16,5,5
14323,53932,80,32355,80,allow,1134,465,669,9,18,6,3
14324,63810,27064,25460,27064,allow,1778,1386,392,8,31,4,4
14325,52113,19619,23788,19619,allow,70,70,0,2,8,2,0
14326,56768,443,55318,443,allow,7889,1900,5989,20,16,11,9
14327,56581,80,13177,80,allow,1630,918,712,12,17,7,5
14328,40842,80,63836,80,allow,1712,786,926,12,17,7,5
14329,9290,443,4925,443,allow,8041,2882,5159,29,23,16,13
14330,9287,443,31377,443,allow,5539,1486,4053,21,23,11,10
14331,49706,53,42213,53,allow,296,102,194,4,41,2,2
14332,64942,53,36365,53,allow,284,102,182,4,38,2,2
14333,52084,30863,5581,30863,allow,70,70,0,1,5,1,0
14334,65031,53,9401,53,allow,184,94,90,2,30,1,1
14335,49881,53,28896,53,allow,213,102,111,2,30,1,1
14336,64602,53,4497,53,allow,184,94,90,2,30,1,1
14337,57073,443,48824,443,allow,7731,2016,5715,38,271,20,18
14338,65314,53,60905,53,allow,402,118,284,2,30,1,1
14339,64181,53,17159,53,allow,194,102,92,2,31,1,1
14340,1111,25174,0,0,deny,62,62,0,1,0,1,0
14341,56793,56205,0,0,deny,66,66,0,1,0,1,0
14342,52319,445,0,0,drop,70,70,0,1,0,1,0
14343,52317,445,0,0,drop,70,70,0,1,0,1,0
14344,52315,445,0,0,drop,70,70,0,1,0,1,0
14345,60976,22114,0,0,deny,66,66,0,1,0,1,0
14346,33401,51505,0,0,deny,66,66,0,1,0,1,0
14347,63937,445,0,0,drop,70,70,0,1,0,1,0
14348,34348,22114,0,0,deny,146,146,0,1,0,1,0
14349,52091,11392,0,0,deny,66,66,0,1,0,1,0
14350,34112,44847,0,0,deny,66,66,0,1,0,1,0
14351,12545,25174,0,0,deny,62,62,0,1,0,1,0
14352,64103,50265,0,0,deny,66,66,0,1,0,1,0
14353,515,10214,0,0,deny,62,62,0,1,0,1,0
14354,52313,445,0,0,drop,70,70,0,1,0,1,0
14355,52311,445,0,0,drop,70,70,0,1,0,1,0
14356,52307,445,0,0,drop,70,70,0,1,0,1,0
14357,52358,30188,0,0,deny,66,66,0,1,0,1,0
14358,61550,5529,0,0,deny,145,145,0,1,0,1,0
14359,5213,44847,0,0,deny,66,66,0,1,0,1,0
14360,64092,445,0,0,drop,66,66,0,1,0,1,0
14361,45218,25174,0,0,deny,146,146,0,1,0,1,0
14362,52306,445,0,0,drop,70,70,0,1,0,1,0
14363,23119,41615,0,0,deny,148,148,0,1,0,1,0
14364,59524,25174,0,0,deny,62,62,0,1,0,1,0
14365,1035,57470,0,0,deny,72,72,0,1,0,1,0
14366,64088,445,0,0,drop,66,66,0,1,0,1,0
14367,33871,34476,0,0,deny,137,137,0,1,0,1,0
14368,63062,11392,0,0,deny,62,62,0,1,0,1,0
14369,44919,26467,0,0,deny,62,62,0,1,0,1,0
14370,59493,44847,0,0,deny,66,66,0,1,0,1,0
14371,64085,445,0,0,drop,66,66,0,1,0,1,0
14372,64084,445,0,0,drop,66,66,0,1,0,1,0
14373,12531,22114,0,0,deny,62,62,0,1,0,1,0
14374,55451,56205,0,0,deny,66,66,0,1,0,1,0
14375,41490,25174,0,0,deny,146,146,0,1,0,1,0
14376,65231,50584,0,0,deny,66,66,0,1,0,1,0
14377,63924,445,0,0,drop,70,70,0,1,0,1,0
14378,45964,3111,0,0,deny,60,60,0,1,0,1,0
14379,64082,445,0,0,drop,66,66,0,1,0,1,0
14380,50512,24748,0,0,deny,145,145,0,1,0,1,0
14381,46116,57470,0,0,deny,74,74,0,1,0,1,0
14382,34485,81,0,0,deny,60,60,0,1,0,1,0
14383,28795,37965,0,0,deny,62,62,0,1,0,1,0
14384,1865,25174,0,0,deny,62,62,0,1,0,1,0
14385,63921,445,0,0,drop,70,70,0,1,0,1,0
14386,56326,56205,0,0,deny,66,66,0,1,0,1,0
14387,58021,22114,0,0,deny,66,66,0,1,0,1,0
14388,22542,30188,0,0,deny,146,146,0,1,0,1,0
14389,42796,22114,0,0,deny,62,62,0,1,0,1,0
14390,52305,445,0,0,drop,70,70,0,1,0,1,0
14391,52292,445,0,0,drop,70,70,0,1,0,1,0
14392,52291,445,0,0,drop,70,70,0,1,0,1,0
14393,63916,445,0,0,drop,70,70,0,1,0,1,0
14394,64072,445,0,0,drop,66,66,0,1,0,1,0
14395,51042,22114,0,0,deny,66,66,0,1,0,1,0
14396,63915,445,0,0,drop,70,70,0,1,0,1,0
14397,63213,35440,0,0,deny,146,146,0,1,0,1,0
14398,35524,34962,0,0,deny,159,159,0,1,0,1,0
14399,63913,445,0,0,drop,70,70,0,1,0,1,0
14400,63389,3389,63389,3389,reset-both,293,223,70,4,0,3,1
14401,53904,443,54254,443,allow,495,421,74,4,0,3,1
14402,24227,48817,0,0,deny,160,160,0,1,0,1,0
14403,80,56289,0,0,deny,578,578,0,1,0,1,0
14404,1024,25174,0,0,deny,62,62,0,1,0,1,0
14405,64064,445,0,0,drop,66,66,0,1,0,1,0
14406,52278,445,0,0,drop,70,70,0,1,0,1,0
14407,54142,20541,0,0,deny,66,66,0,1,0,1,0
14408,56949,22,0,0,deny,60,60,0,1,0,1,0
14409,1918,25174,0,0,deny,66,66,0,1,0,1,0
14410,64062,445,0,0,drop,66,66,0,1,0,1,0
14411,63906,445,0,0,drop,70,70,0,1,0,1,0
14412,6247,51221,0,0,deny,62,62,0,1,0,1,0
14413,63904,445,0,0,drop,70,70,0,1,0,1,0
14414,58022,88,0,0,deny,60,60,0,1,0,1,0
14415,2383,37965,0,0,deny,62,62,0,1,0,1,0
14416,57496,25174,0,0,deny,62,62,0,1,0,1,0
14417,53073,32468,0,0,deny,62,62,0,1,0,1,0
14418,64055,445,0,0,drop,66,66,0,1,0,1,0
14419,63903,445,0,0,drop,70,70,0,1,0,1,0
14420,64052,445,0,0,drop,66,66,0,1,0,1,0
14421,63902,445,0,0,drop,70,70,0,1,0,1,0
14422,63901,445,0,0,drop,70,70,0,1,0,1,0
14423,63899,445,0,0,drop,70,70,0,1,0,1,0
14424,63895,445,0,0,drop,70,70,0,1,0,1,0
14425,55429,25174,0,0,deny,66,66,0,1,0,1,0
14426,65025,57866,0,0,deny,66,66,0,1,0,1,0
14427,54758,35993,0,0,deny,66,66,0,1,0,1,0
14428,44154,22114,0,0,deny,62,62,0,1,0,1,0
14429,58646,44847,0,0,deny,66,66,0,1,0,1,0
14430,56205,51505,0,0,deny,66,66,0,1,0,1,0
14431,63883,445,0,0,drop,70,70,0,1,0,1,0
14432,63882,445,0,0,drop,70,70,0,1,0,1,0
14433,63877,445,0,0,drop,70,70,0,1,0,1,0
14434,63873,445,0,0,drop,70,70,0,1,0,1,0
14435,63872,445,0,0,drop,70,70,0,1,0,1,0
14436,52270,445,0,0,drop,70,70,0,1,0,1,0
14437,52269,445,0,0,drop,70,70,0,1,0,1,0
14438,52266,445,0,0,drop,70,70,0,1,0,1,0
14439,45726,64147,0,0,deny,62,62,0,1,0,1,0
14440,22574,44847,0,0,deny,62,62,0,1,0,1,0
14441,64035,445,0,0,drop,66,66,0,1,0,1,0
14442,64038,445,0,0,drop,66,66,0,1,0,1,0
14443,64037,445,0,0,drop,66,66,0,1,0,1,0
14444,64034,445,0,0,drop,66,66,0,1,0,1,0
14445,64039,445,0,0,drop,66,66,0,1,0,1,0
14446,64036,445,0,0,drop,66,66,0,1,0,1,0
14447,64033,445,0,0,drop,66,66,0,1,0,1,0
14448,5955,55160,0,0,deny,74,74,0,1,0,1,0
14449,80,61486,0,0,deny,66,66,0,1,0,1,0
14450,26879,37965,0,0,deny,62,62,0,1,0,1,0
14451,63861,445,0,0,drop,70,70,0,1,0,1,0
14452,6126,25174,0,0,deny,66,66,0,1,0,1,0
14453,52264,445,0,0,drop,70,70,0,1,0,1,0
14454,52263,445,0,0,drop,70,70,0,1,0,1,0
14455,52254,445,0,0,drop,70,70,0,1,0,1,0
14456,52253,445,0,0,drop,70,70,0,1,0,1,0
14457,64017,445,0,0,drop,66,66,0,1,0,1,0
14458,64019,445,0,0,drop,66,66,0,1,0,1,0
14459,64016,445,0,0,drop,66,66,0,1,0,1,0
14460,43025,23,0,0,deny,60,60,0,1,0,1,0
14461,48301,25174,0,0,deny,62,62,0,1,0,1,0
14462,10406,35440,0,0,deny,146,146,0,1,0,1,0
14463,10910,57866,0,0,deny,62,62,0,1,0,1,0
14464,63857,445,0,0,drop,70,70,0,1,0,1,0
14465,54726,30041,0,0,deny,62,62,0,1,0,1,0
14466,52247,445,0,0,drop,70,70,0,1,0,1,0
14467,53097,25174,0,0,deny,66,66,0,1,0,1,0
14468,52683,22114,0,0,deny,62,62,0,1,0,1,0
14469,52240,445,0,0,drop,70,70,0,1,0,1,0
14470,52236,445,0,0,drop,70,70,0,1,0,1,0
14471,52238,445,0,0,drop,70,70,0,1,0,1,0
14472,63855,25174,0,0,deny,62,62,0,1,0,1,0
14473,56387,25174,0,0,deny,66,66,0,1,0,1,0
14474,13235,44847,0,0,deny,62,62,0,1,0,1,0
14475,39313,37965,0,0,deny,62,62,0,1,0,1,0
14476,39453,15503,0,0,deny,74,74,0,1,0,1,0
14477,45964,2228,0,0,deny,60,60,0,1,0,1,0
14478,63846,445,0,0,drop,70,70,0,1,0,1,0
14479,63848,445,0,0,drop,70,70,0,1,0,1,0
14480,63847,445,0,0,drop,70,70,0,1,0,1,0
14481,63843,445,0,0,drop,70,70,0,1,0,1,0
14482,41463,20005,0,0,deny,60,60,0,1,0,1,0
14483,63841,445,0,0,drop,70,70,0,1,0,1,0
14484,35111,22114,0,0,deny,66,66,0,1,0,1,0
14485,64733,35440,0,0,deny,66,66,0,1,0,1,0
14486,51866,22114,0,0,deny,62,62,0,1,0,1,0
14487,61660,64097,0,0,deny,62,62,0,1,0,1,0
14488,28825,23,0,0,deny,60,60,0,1,0,1,0
14489,52228,445,0,0,drop,70,70,0,1,0,1,0
14490,52226,445,0,0,drop,70,70,0,1,0,1,0
14491,29178,35440,0,0,deny,66,66,0,1,0,1,0
14492,47178,53,0,0,allow,82,82,0,2,40,2,0
14493,52108,20175,5769,20175,allow,70,70,0,2,8,2,0
14494,52109,60841,37568,60841,allow,258,70,188,4,8,2,2
14495,53454,443,37572,443,allow,10416,3195,7221,32,46,18,14
14496,52472,443,52472,443,allow,4400,1493,2907,19,31,11,8
14497,63385,443,63385,443,allow,4659,1752,2907,19,30,11,8
14498,61792,443,46504,443,allow,12526,7202,5324,28,99,15,13
14499,9448,443,19728,443,allow,5691,503,5188,14,15,7,7
14500,52076,28895,29171,28895,allow,66,66,0,1,5,1,0
14501,9451,443,45125,443,allow,5699,505,5194,14,15,7,7
14502,40517,53,18726,53,allow,284,79,205,2,30,1,1
14503,64850,53,13429,53,allow,166,85,81,2,31,1,1
14504,38728,443,11034,443,allow,560,280,280,9,27,5,4
14505,62249,443,58132,443,allow,9251,6353,2898,25,120,13,12
14506,61433,443,33532,443,allow,41274,18956,22318,90,171,43,47
14507,36828,80,12290,80,allow,5189,2979,2210,19,136,12,7
14508,47613,53,0,0,allow,82,82,0,1,30,1,0
14509,9460,80,52623,80,allow,1641,483,1158,10,15,5,5
14510,53162,60352,6170,60352,allow,70,70,0,1,5,1,0
14511,58872,443,51853,443,allow,342665,10261,332404,369,90,117,252
14512,52106,41632,7529,41632,allow,70,70,0,2,9,2,0
14513,53876,53380,47868,53380,allow,70,70,0,1,5,1,0
14514,60518,80,21543,80,allow,1915,797,1118,8,16,5,3
14515,52079,1024,39803,1024,allow,66,66,0,1,5,1,0
14516,26227,23,26227,23,allow,146,60,86,2,10,1,1
14517,54104,80,15819,80,allow,214,140,74,4,15,3,1
14518,9454,443,57468,443,allow,5699,505,5194,14,15,7,7
14519,52376,443,24814,443,allow,33906,25094,8812,63,447,36,27
14520,21478,53,21478,53,allow,625,79,546,2,30,1,1
14521,51661,443,59276,443,allow,11558,3964,7594,37,17,15,22
14522,52110,35411,42303,35411,allow,70,70,0,2,8,2,0
14523,50401,443,63156,443,allow,256,136,120,5,9,3,2
14524,53878,55950,30797,55950,allow,70,70,0,1,5,1,0
14525,53875,43611,37582,43611,allow,70,70,0,1,5,1,0
14526,9450,443,24290,443,allow,5691,503,5188,14,15,7,7
14527,9447,443,13084,443,allow,5691,503,5188,14,15,7,7
14528,46570,443,45902,443,allow,8897,2184,6713,24,516,13,11
14529,58953,443,9937,443,allow,4051,2587,1464,18,16,9,9
14530,54314,53,25378,53,allow,284,79,205,2,30,1,1
14531,56782,53,53429,53,allow,194,99,95,2,30,1,1
14532,64942,53,24439,53,allow,522,190,332,5,48,3,2
14533,30960,45763,2134,45763,allow,330,330,0,6,3609,6,0
14534,30960,45752,44974,45752,allow,462,462,0,8,3631,8,0
14535,58930,60038,0,0,allow,66,66,0,1,91,1,0
14536,5060,37965,0,0,deny,66,66,0,1,0,1,0
14537,15806,11392,0,0,deny,66,66,0,1,0,1,0
14538,31539,37965,0,0,deny,62,62,0,1,0,1,0
14539,63834,445,0,0,drop,70,70,0,1,0,1,0
14540,13525,51505,0,0,deny,62,62,0,1,0,1,0
14541,64005,445,0,0,drop,66,66,0,1,0,1,0
14542,54796,22114,0,0,deny,62,62,0,1,0,1,0
14543,3169,22114,0,0,deny,62,62,0,1,0,1,0
14544,57251,37965,0,0,deny,62,62,0,1,0,1,0
14545,51783,50584,0,0,deny,66,66,0,1,0,1,0
14546,59282,51050,0,0,deny,66,66,0,1,0,1,0
14547,58247,57866,0,0,deny,66,66,0,1,0,1,0
14548,57599,80,57241,80,allow,1526,972,554,10,75,6,4
14549,56388,443,22343,443,allow,11093,2322,8771,40,17,23,17
14550,9458,443,4963,443,allow,5695,505,5190,14,15,7,7
14551,64017,80,54075,80,allow,314,192,122,6,15,4,2
14552,12942,10387,0,0,deny,159,159,0,1,0,1,0
14553,56403,51505,0,0,deny,62,62,0,1,0,1,0
14554,62217,37807,0,0,deny,62,62,0,1,0,1,0
14555,63827,445,0,0,drop,70,70,0,1,0,1,0
14556,41694,26296,0,0,deny,145,145,0,1,0,1,0
14557,60113,22114,0,0,deny,66,66,0,1,0,1,0
14558,63824,445,0,0,drop,70,70,0,1,0,1,0
14559,26884,37965,0,0,deny,66,66,0,1,0,1,0
14560,52221,445,0,0,drop,70,70,0,1,0,1,0
14561,27081,10197,0,0,deny,62,62,0,1,0,1,0
14562,59303,21247,0,0,deny,66,66,0,1,0,1,0
14563,16057,51050,0,0,deny,62,62,0,1,0,1,0
14564,60117,50934,0,0,deny,62,62,0,1,0,1,0
14565,52220,445,0,0,drop,70,70,0,1,0,1,0
14566,30332,48817,0,0,deny,145,145,0,1,0,1,0
14567,63819,445,0,0,drop,70,70,0,1,0,1,0
14568,42957,64147,0,0,deny,145,145,0,1,0,1,0
14569,63817,445,0,0,drop,70,70,0,1,0,1,0
14570,63988,445,0,0,drop,66,66,0,1,0,1,0
14571,63989,445,0,0,drop,66,66,0,1,0,1,0
14572,1036,64147,0,0,deny,62,62,0,1,0,1,0
14573,44856,51505,0,0,deny,62,62,0,1,0,1,0
14574,37887,22114,0,0,deny,66,66,0,1,0,1,0
14575,63813,445,0,0,drop,70,70,0,1,0,1,0
14576,44679,80,35749,80,allow,3180,2317,863,12,11,7,5
14577,43815,50584,0,0,deny,62,62,0,1,0,1,0
14578,64595,64147,0,0,deny,62,62,0,1,0,1,0
14579,52210,445,0,0,drop,70,70,0,1,0,1,0
14580,52206,445,0,0,drop,70,70,0,1,0,1,0
14581,52204,445,0,0,drop,70,70,0,1,0,1,0
14582,52198,445,0,0,drop,70,70,0,1,0,1,0
14583,18750,57866,0,0,deny,62,62,0,1,0,1,0
14584,63030,25174,0,0,deny,62,62,0,1,0,1,0
14585,68,67,0,0,deny,346,346,0,1,0,1,0
14586,34066,36829,0,0,deny,146,146,0,1,0,1,0
14587,46734,50265,0,0,deny,74,74,0,1,0,1,0
14588,63812,445,0,0,drop,70,70,0,1,0,1,0
14589,63984,445,0,0,drop,66,66,0,1,0,1,0
14590,16620,25174,0,0,deny,62,62,0,1,0,1,0
14591,42722,56448,0,0,deny,74,74,0,1,0,1,0
14592,1638,22114,0,0,deny,62,62,0,1,0,1,0
14593,63979,445,0,0,drop,66,66,0,1,0,1,0
14594,63976,445,0,0,drop,66,66,0,1,0,1,0
14595,63967,445,0,0,drop,66,66,0,1,0,1,0
14596,63972,445,0,0,drop,66,66,0,1,0,1,0
14597,63971,445,0,0,drop,66,66,0,1,0,1,0
14598,63968,445,0,0,drop,66,66,0,1,0,1,0
14599,63969,445,0,0,drop,66,66,0,1,0,1,0
14600,62194,50584,0,0,deny,66,66,0,1,0,1,0
14601,39583,37965,0,0,deny,66,66,0,1,0,1,0
14602,49993,37965,0,0,deny,66,66,0,1,0,1,0
14603,47783,50432,0,0,deny,62,62,0,1,0,1,0
14604,52196,445,0,0,drop,70,70,0,1,0,1,0
14605,11382,43890,0,0,deny,62,62,0,1,0,1,0
14606,46537,25174,0,0,deny,62,62,0,1,0,1,0
14607,52191,445,0,0,drop,70,70,0,1,0,1,0
14608,52187,445,0,0,drop,70,70,0,1,0,1,0
14609,52189,445,0,0,drop,70,70,0,1,0,1,0
14610,13518,25174,0,0,deny,146,146,0,1,0,1,0
14611,63807,445,0,0,drop,70,70,0,1,0,1,0
14612,11136,19910,0,0,deny,62,62,0,1,0,1,0
14613,55931,53,3407,53,allow,168,78,90,2,30,1,1
14614,64588,53,5541,53,allow,264,102,162,2,30,1,1
14615,52359,443,35892,443,allow,13972,2550,11422,29,954,11,18
14616,56470,28678,7618,28678,allow,1806,1806,0,22,224,22,0
14617,57206,443,4994,443,allow,1798,1223,575,13,28,8,5
14618,65318,53,63246,53,allow,294,94,200,4,51,2,2
14619,56289,53,22157,53,allow,351,110,241,2,29,1,1
14620,56767,443,38617,443,allow,7941,1952,5989,20,15,11,9
14621,35978,443,55185,443,allow,2959,793,2166,10,120,5,5
14622,61807,443,12289,443,allow,6244,1855,4389,16,75,9,7
14623,55144,443,25818,443,allow,6918,2826,4092,26,21,16,10
14624,52082,14804,24933,14804,allow,70,70,0,1,4,1,0
14625,50864,80,3838,80,allow,1888,1814,74,10,15,9,1
14626,56674,80,12315,80,allow,156,156,0,3,8,3,0
14627,60929,28678,34471,28678,allow,1806,1806,0,22,224,22,0
14628,49564,53,13171,53,allow,193,102,91,2,29,1,1
14629,14441,443,20256,443,allow,2629,1470,1159,18,15,8,10
14630,56853,53,24934,53,allow,167,86,81,2,29,1,1
14631,55958,53,30538,53,allow,275,86,189,2,29,1,1
14632,56519,53,20744,53,allow,167,86,81,2,29,1,1
14633,56853,53,30375,53,allow,167,86,81,2,29,1,1
14634,60708,53,53667,53,allow,291,86,205,2,29,1,1
14635,56765,443,7248,443,allow,7940,1951,5989,20,15,11,9
14636,58885,443,39873,443,allow,354,294,60,2,15,1,1
14637,56766,443,55432,443,allow,7888,1899,5989,20,15,11,9
14638,10007,443,53248,443,allow,3811,1846,1965,20,330,9,11
14639,55346,53,15239,53,allow,199,94,105,2,30,1,1
14640,65400,53,61482,53,allow,211,102,109,2,30,1,1
14641,55805,80,55805,80,allow,424,198,226,7,141,4,3
14642,52080,9554,43185,9554,allow,70,70,0,1,5,1,0
14643,51243,80,3228,80,allow,1451,949,502,12,46,7,5
14644,60607,53,60607,53,allow,832,106,726,2,30,1,1
14645,60852,443,55582,443,allow,7471,2914,4557,26,47,15,11
14646,64810,53,30848,53,allow,257,126,131,2,30,1,1
14647,55360,80,13495,80,allow,130,70,60,2,15,1,1
14648,37306,53,55019,53,allow,168,78,90,2,30,1,1
14649,9449,443,11942,443,allow,5693,499,5194,14,15,7,7
14650,49570,443,32958,443,allow,6360,2483,3877,20,16,10,10
14651,54071,53,10458,53,allow,207,86,121,2,30,1,1
14652,58316,443,4061,443,allow,7493,1658,5835,22,255,12,10
14653,38705,443,49826,443,allow,1248170,26899,1221271,1212,16,382,830
14654,56890,443,61166,443,allow,6935,1415,5520,22,186,12,10
14655,49658,53,43401,53,allow,211,102,109,2,30,1,1
14656,57343,443,46945,443,allow,1607664,53945,1553719,1792,39,700,1092
14657,55337,443,21717,443,allow,24341,15170,9171,78,461,39,39
14658,47637,443,16997,443,allow,280,140,140,5,151,3,2
14659,35973,443,21497,443,allow,4665045,113088,4551957,4511,421,1285,3226
14660,48778,80,16126,80,allow,130,70,60,2,15,1,1
14661,33028,80,50046,80,allow,130,70,60,2,15,1,1
14662,49207,443,35553,443,allow,9852,2190,7662,49,257,22,27
14663,28036,443,58065,443,allow,5780,4574,1206,20,16,11,9
14664,36829,443,57108,443,allow,560,280,280,9,27,5,4
14665,38606,53,21514,53,allow,168,78,90,2,30,1,1
14666,48817,50321,48817,50321,allow,334,158,176,2,1203,1,1
14667,50265,443,33031,443,allow,23684,13193,10491,84,63,44,40
14668,49836,53,59050,53,allow,327,102,225,2,30,1,1
14669,65168,53,46023,53,allow,239,94,145,2,30,1,1
14670,60862,443,5299,443,allow,12604,6376,6228,27,133,16,11
14671,50286,443,48730,443,allow,6414386,102255,6312131,5812,182,1634,4178
14672,48992,80,47525,80,allow,1114,534,580,12,16,7,5
14673,22,44840,22,44840,allow,1427,1170,257,8,15,4,4
14674,53903,51339,21513,51339,allow,70,70,0,2,7,2,0
14675,39437,80,3186,80,allow,2088,472,1616,15,155,3,12
14676,55103,53,23177,53,allow,392,92,300,4,55,2,2
14677,56782,53,51814,53,allow,197,102,95,2,33,1,1
14678,9459,443,54316,443,allow,5695,505,5190,14,15,7,7
14679,49279,80,12266,80,allow,254,128,126,5,15,3,2
14680,9453,443,40885,443,allow,5693,499,5194,14,15,7,7
14681,9452,443,55218,443,allow,5693,499,5194,14,15,7,7
14682,56519,53,14326,53,allow,167,86,81,2,29,1,1
14683,21133,54508,26359,54508,allow,323,150,173,2,1199,1,1
14684,57231,53,46027,53,allow,168,86,82,2,30,1,1
14685,9457,443,13669,443,allow,5316,488,4828,14,15,7,7
14686,57202,443,8164,443,allow,1728,1153,575,12,28,7,5
14687,51613,443,47721,443,allow,5052,2873,2179,26,15,14,12
14688,56519,53,28431,53,allow,167,86,81,2,30,1,1
14689,52083,26607,58147,26607,allow,70,70,0,1,4,1,0
14690,57203,443,49091,443,allow,1798,1223,575,13,28,8,5
14691,56672,53,64193,53,allow,177,94,83,2,30,1,1
14692,50442,80,50442,80,allow,52791,4087,48704,66,24,26,40
14693,49564,53,61434,53,allow,193,102,91,2,30,1,1
14694,54497,443,48697,443,allow,8318,2068,6250,32,270,16,16
14695,52925,443,2164,443,allow,114867,4243,110624,128,120,44,84
14696,64850,53,27196,53,allow,167,86,81,2,30,1,1
14697,49661,53,62903,53,allow,344,102,242,2,30,1,1
14698,60376,443,21896,443,allow,9379,2092,7287,21,126,9,12
14699,54761,5228,49627,5228,allow,12683,1205,11478,27,182,8,19
14700,35642,80,28559,80,allow,1849,1015,834,11,150,6,5
14701,35136,443,3606,443,allow,25542,17843,7699,58,59,34,24
14702,61279,443,14356,443,allow,7424,3871,3553,26,160,12,14
14703,51598,443,10892,443,allow,14194,4643,9551,34,30,19,15
14704,53159,58710,30090,58710,allow,698,320,378,10,18,6,4
14705,59274,443,55424,443,allow,8640,2329,6311,19,76,10,9
14706,35999,443,44617,443,allow,670261,26523,643738,728,188,262,466
14707,58954,443,36028,443,allow,5166,700,4466,16,15,7,9
14708,55363,53,15445,53,allow,228,110,118,2,30,1,1
14709,65375,443,53764,443,allow,2458316,102393,2355923,2942,241,1261,1681
14710,50040,53,62872,53,allow,322,102,220,2,30,1,1
14711,64850,53,29250,53,allow,167,86,81,2,30,1,1
14712,64962,53,48454,53,allow,226,94,132,2,30,1,1
14713,56672,53,51134,53,allow,177,94,83,2,30,1,1
14714,36430,443,61120,443,allow,3777,1509,2268,18,120,9,9
14715,40781,443,17024,443,allow,14327,1918,12409,37,270,17,20
14716,53865,64000,37089,64000,allow,492,306,186,8,15,5,3
14717,44636,443,35730,443,allow,6297,1831,4466,20,16,9,11
14718,53161,30013,56221,30013,allow,70,70,0,1,5,1,0
14719,57584,443,14480,443,allow,8937,3934,5003,18,120,9,9
14720,63355,443,59950,443,allow,2870,343,2527,11,120,5,6
14721,55039,443,64407,443,allow,10961,2666,8295,35,237,16,19
14722,56275,443,61048,443,allow,513682,20015,493667,523,226,126,397
14723,50265,7205,64572,7205,allow,1488,930,558,21,1200,12,9
14724,36628,80,54402,80,allow,78,78,0,2,8,2,0
14725,53867,60272,36955,60272,allow,70,70,0,1,5,1,0
14726,55294,3389,55294,3389,allow,4470,2381,2089,23,19,13,10
14727,44162,80,44162,80,allow,457843,10253,447590,452,26,152,300
14728,64593,53,46361,53,allow,258,102,156,2,30,1,1
14729,52042,80,17014,80,allow,70,70,0,2,8,2,0
14730,53871,43266,32431,43266,allow,70,70,0,1,5,1,0
14731,56764,443,62218,443,allow,8006,1986,6020,20,16,11,9
14732,56044,80,25395,80,allow,1515,481,1034,11,16,6,5
14733,42927,443,28678,443,allow,6921,1769,5152,22,24,13,9
14734,64033,29834,57709,29834,allow,66,66,0,2,8,2,0
14735,53872,24710,13948,24710,allow,70,70,0,1,5,1,0
14736,36278,7000,36278,7000,allow,3578,1967,1611,16,16,8,8
14737,42162,80,42162,80,allow,2941,1499,1442,10,16,6,4
14738,64850,53,55584,53,allow,167,86,81,2,30,1,1
14739,59355,51505,0,0,deny,66,66,0,1,0,1,0
14740,56323,57470,0,0,deny,74,74,0,1,0,1,0
14741,37034,25174,0,0,deny,62,62,0,1,0,1,0
14742,51726,64147,0,0,deny,62,62,0,1,0,1,0
14743,2332,35440,0,0,deny,66,66,0,1,0,1,0
14744,52184,445,0,0,drop,70,70,0,1,0,1,0
14745,52183,445,0,0,drop,70,70,0,1,0,1,0
14746,52179,445,0,0,drop,70,70,0,1,0,1,0
14747,52503,50584,0,0,deny,62,62,0,1,0,1,0
14748,10003,64147,0,0,deny,62,62,0,1,0,1,0
14749,63962,445,0,0,drop,66,66,0,1,0,1,0
14750,20586,25174,0,0,deny,62,62,0,1,0,1,0
14751,52178,445,0,0,drop,70,70,0,1,0,1,0
14752,58103,10197,0,0,deny,66,66,0,1,0,1,0
14753,30800,25174,0,0,deny,146,146,0,1,0,1,0
14754,63959,445,0,0,drop,66,66,0,1,0,1,0
14755,63794,445,0,0,drop,70,70,0,1,0,1,0
14756,63957,445,0,0,drop,66,66,0,1,0,1,0
14757,63955,445,0,0,drop,66,66,0,1,0,1,0
14758,59535,25174,0,0,deny,62,62,0,1,0,1,0
14759,54173,23,0,0,deny,60,60,0,1,0,1,0
14760,6666,138,0,0,deny,60,60,0,1,0,1,0
14761,63953,445,0,0,drop,66,66,0,1,0,1,0
14762,63791,445,0,0,drop,70,70,0,1,0,1,0
14763,53902,443,2298,443,allow,499,425,74,4,0,3,1
14764,44714,25174,0,0,deny,146,146,0,1,0,1,0
14765,51455,53733,0,0,deny,66,66,0,1,0,1,0
14766,52494,36237,0,0,deny,62,62,0,1,0,1,0
14767,62579,57866,0,0,deny,66,66,0,1,0,1,0
14768,37666,48817,0,0,deny,146,146,0,1,0,1,0
14769,60579,25174,0,0,deny,66,66,0,1,0,1,0
14770,52176,445,0,0,drop,70,70,0,1,0,1,0
14771,1238,51505,0,0,deny,62,62,0,1,0,1,0
14772,45941,23386,0,0,deny,60,60,0,1,0,1,0
14773,52165,445,0,0,drop,70,70,0,1,0,1,0
14774,52164,445,0,0,drop,70,70,0,1,0,1,0
14775,63787,445,0,0,drop,70,70,0,1,0,1,0
14776,65331,53,50741,53,allow,732,89,643,2,0,1,1
14777,54754,50432,0,0,deny,66,66,0,1,0,1,0
14778,50620,50584,0,0,deny,62,62,0,1,0,1,0
14779,52625,25174,0,0,deny,66,66,0,1,0,1,0
14780,63785,445,0,0,drop,70,70,0,1,0,1,0
14781,60159,22114,0,0,deny,66,66,0,1,0,1,0
14782,31172,22114,0,0,deny,62,62,0,1,0,1,0
14783,63943,445,0,0,drop,66,66,0,1,0,1,0
14784,63783,445,0,0,drop,70,70,0,1,0,1,0
14785,6666,16010,0,0,deny,60,60,0,1,0,1,0
14786,46512,63836,0,0,deny,148,148,0,1,0,1,0
14787,64024,22114,0,0,deny,66,66,0,1,0,1,0
14788,26527,25174,0,0,deny,62,62,0,1,0,1,0
14789,53901,443,43794,443,allow,499,425,74,4,0,3,1
14790,53903,443,40208,443,allow,499,425,74,4,0,3,1
14791,53900,443,15989,443,allow,499,425,74,4,0,3,1
14792,53897,443,53988,443,allow,499,425,74,4,0,3,1
14793,53898,443,56204,443,allow,499,425,74,4,0,3,1
14794,53899,443,57181,443,allow,499,425,74,4,0,3,1
14795,53890,443,45559,443,allow,499,425,74,4,0,3,1
14796,53895,443,53348,443,allow,499,425,74,4,0,3,1
14797,53896,443,17824,443,allow,499,425,74,4,0,3,1
14798,53894,443,56603,443,allow,499,425,74,4,0,3,1
14799,53893,443,15377,443,allow,499,425,74,4,0,3,1
14800,53885,443,38826,443,allow,499,425,74,4,0,3,1
14801,53891,443,8709,443,allow,499,425,74,4,0,3,1
14802,53892,443,6388,443,allow,499,425,74,4,0,3,1
14803,53886,443,40309,443,allow,499,425,74,4,0,3,1
14804,53887,443,39424,443,allow,499,425,74,4,0,3,1
14805,53888,443,38577,443,allow,499,425,74,4,0,3,1
14806,53889,443,11378,443,allow,499,425,74,4,0,3,1
14807,63136,25174,0,0,deny,66,66,0,1,0,1,0
14808,47424,25174,0,0,deny,62,62,0,1,0,1,0
14809,63935,445,0,0,drop,66,66,0,1,0,1,0
14810,52155,445,0,0,drop,70,70,0,1,0,1,0
14811,63776,445,0,0,drop,70,70,0,1,0,1,0
14812,56897,11446,0,0,deny,62,62,0,1,0,1,0
14813,63932,445,0,0,drop,66,66,0,1,0,1,0
14814,63774,445,0,0,drop,70,70,0,1,0,1,0
14815,49918,26296,0,0,deny,146,146,0,1,0,1,0
14816,10704,25174,0,0,deny,62,62,0,1,0,1,0
14817,33556,25174,0,0,deny,62,62,0,1,0,1,0
14818,36011,25174,0,0,deny,66,66,0,1,0,1,0
14819,63773,445,0,0,drop,70,70,0,1,0,1,0
14820,59018,22114,0,0,deny,62,62,0,1,0,1,0
14821,6356,26467,0,0,deny,62,62,0,1,0,1,0
14822,7288,25174,0,0,deny,66,66,0,1,0,1,0
14823,63772,445,0,0,drop,70,70,0,1,0,1,0
14824,63771,445,0,0,drop,70,70,0,1,0,1,0
14825,63926,445,0,0,drop,66,66,0,1,0,1,0
14826,5955,55160,0,0,deny,74,74,0,1,0,1,0
14827,63766,445,0,0,drop,70,70,0,1,0,1,0
14828,63765,445,0,0,drop,70,70,0,1,0,1,0
14829,17982,11392,0,0,deny,62,62,0,1,0,1,0
14830,54526,44847,0,0,deny,62,62,0,1,0,1,0
14831,63918,445,0,0,drop,66,66,0,1,0,1,0
14832,65389,26467,0,0,deny,62,62,0,1,0,1,0
14833,62799,25174,0,0,deny,62,62,0,1,0,1,0
14834,3064,44847,0,0,deny,62,62,0,1,0,1,0
14835,54746,22114,0,0,deny,146,146,0,1,0,1,0
14836,13285,29892,0,0,deny,145,145,0,1,0,1,0
14837,0,0,0,0,allow,400,204,196,4,0,2,2
14838,0,0,0,0,allow,200,102,98,2,0,1,1
14839,0,0,0,0,allow,600,306,294,6,0,3,3
14840,41462,2323,0,0,deny,60,60,0,1,0,1,0
14841,63852,25174,0,0,deny,146,146,0,1,0,1,0
14842,63753,445,0,0,drop,70,70,0,1,0,1,0
14843,63752,445,0,0,drop,70,70,0,1,0,1,0
14844,63749,445,0,0,drop,70,70,0,1,0,1,0
14845,63743,445,0,0,drop,70,70,0,1,0,1,0
14846,63742,445,0,0,drop,70,70,0,1,0,1,0
14847,23939,41615,0,0,deny,146,146,0,1,0,1,0
14848,59937,18375,0,0,deny,66,66,0,1,0,1,0
14849,22783,64147,0,0,deny,66,66,0,1,0,1,0
14850,52142,445,0,0,drop,70,70,0,1,0,1,0
14851,52139,445,0,0,drop,70,70,0,1,0,1,0
14852,52138,445,0,0,drop,70,70,0,1,0,1,0
14853,1377,44847,0,0,deny,62,62,0,1,0,1,0
14854,63901,445,0,0,drop,66,66,0,1,0,1,0
14855,63905,445,0,0,drop,66,66,0,1,0,1,0
14856,63908,445,0,0,drop,66,66,0,1,0,1,0
14857,63907,445,0,0,drop,66,66,0,1,0,1,0
14858,63902,445,0,0,drop,66,66,0,1,0,1,0
14859,63904,445,0,0,drop,66,66,0,1,0,1,0
14860,63903,445,0,0,drop,66,66,0,1,0,1,0
14861,63900,445,0,0,drop,66,66,0,1,0,1,0
14862,30729,22114,0,0,deny,66,66,0,1,0,1,0
14863,59523,37965,0,0,deny,62,62,0,1,0,1,0
14864,59060,50584,0,0,deny,66,66,0,1,0,1,0
14865,52744,25174,0,0,deny,62,62,0,1,0,1,0
14866,51615,25174,0,0,deny,66,66,0,1,0,1,0
14867,14777,25174,0,0,deny,62,62,0,1,0,1,0
14868,63731,445,0,0,drop,70,70,0,1,0,1,0
14869,25532,35440,0,0,deny,146,146,0,1,0,1,0
14870,15176,62413,0,0,deny,62,62,0,1,0,1,0
14871,50236,25174,0,0,deny,66,66,0,1,0,1,0
14872,52134,445,0,0,drop,70,70,0,1,0,1,0
14873,52133,445,0,0,drop,70,70,0,1,0,1,0
14874,52131,445,0,0,drop,70,70,0,1,0,1,0
14875,52122,445,0,0,drop,70,70,0,1,0,1,0
14876,48230,22114,0,0,deny,146,146,0,1,0,1,0
14877,54914,51505,0,0,deny,66,66,0,1,0,1,0
14878,10091,22114,0,0,deny,62,62,0,1,0,1,0
14879,45964,2228,0,0,deny,60,60,0,1,0,1,0
14880,59668,50584,0,0,deny,62,62,0,1,0,1,0
14881,63886,445,0,0,drop,66,66,0,1,0,1,0
14882,63885,445,0,0,drop,66,66,0,1,0,1,0
14883,63884,445,0,0,drop,66,66,0,1,0,1,0
14884,54976,15503,0,0,deny,66,66,0,1,0,1,0
14885,13588,15503,0,0,deny,62,62,0,1,0,1,0
14886,63727,445,0,0,drop,70,70,0,1,0,1,0
14887,2346,25174,0,0,deny,66,66,0,1,0,1,0
14888,443,63128,0,0,deny,1514,1514,0,1,0,1,0
14889,52118,445,0,0,drop,70,70,0,1,0,1,0
14890,50265,49893,64996,49893,allow,480,149,331,2,1200,1,1
14891,50774,443,17270,443,allow,4521,2256,2265,15,135,7,8
14892,36644,443,15948,443,allow,9329,3935,5394,30,405,17,13
14893,49531,80,57829,80,allow,78,78,0,1,5,1,0
14894,65421,443,16177,443,allow,2494,1643,851,17,25,9,8
14895,52072,25595,16816,25595,allow,66,66,0,1,5,1,0
14896,54941,80,51171,80,allow,2513,567,1946,10,75,6,4
14897,59893,80,45322,80,allow,130,70,60,2,15,1,1
14898,57410,53,64082,53,allow,711,87,624,2,30,1,1
14899,58871,443,24562,443,allow,405189,13572,391617,446,89,155,291
14900,9434,443,11212,443,allow,5693,499,5194,14,15,7,7
14901,56082,53,58517,53,allow,271,88,183,4,38,2,2
14902,53896,48027,7654,48027,allow,70,70,0,2,8,2,0
14903,49158,443,4149,443,allow,3655,1807,1848,17,15,9,8
14904,56467,53,49050,53,allow,578,286,292,9,15,5,4
14905,56937,53,51825,53,allow,178,91,87,2,30,1,1
14906,52104,51756,27820,51756,allow,70,70,0,2,8,2,0
14907,54542,443,54542,443,allow,150554,18764,131790,192,117,95,97
14908,46618,443,48794,443,allow,9505,3214,6291,33,19,19,14
14909,39568,443,60001,443,allow,4477,2605,1872,22,248,12,10
14910,55542,53,5716,53,allow,170,87,83,2,30,1,1
14911,53862,36120,51667,36120,allow,2254,1281,973,17,17,10,7
14912,45273,80,45273,80,allow,18685,7141,11544,33,28,17,16
14913,62394,80,62394,80,allow,29401,10036,19365,49,28,24,25
14914,9435,443,2463,443,allow,5693,499,5194,14,15,7,7
14915,64117,53,64117,53,allow,209,77,132,2,32,1,1
14916,57231,53,16422,53,allow,168,86,82,2,31,1,1
14917,40806,443,37490,443,allow,3287,2049,1238,12,31,7,5
14918,54942,80,32519,80,allow,5696,703,4993,14,75,8,6
14919,63995,443,63995,443,allow,4673,1766,2907,19,29,11,8
14920,46720,53,0,0,allow,82,82,0,1,30,1,0
14921,47992,5228,27773,5228,allow,2988,2036,952,16,3601,8,8
14922,54800,443,4050,443,allow,9612,4324,5288,31,400,11,20
14923,49146,443,34396,443,allow,3655,1807,1848,17,15,9,8
14924,56440,53,9792,53,allow,711,87,624,2,31,1,1
14925,53894,2944,4121,2944,allow,70,70,0,2,8,2,0
14926,17750,7579,37146,7579,allow,490,149,341,2,1200,1,1
14927,52102,19604,10302,19604,allow,70,70,0,2,8,2,0
14928,59952,80,58096,80,allow,440081,8465,431616,424,24,137,287
14929,59000,443,15029,443,allow,6362,1745,4617,25,18,13,12
14930,49341,443,6648,443,allow,6882,1788,5094,15,16,9,6
14931,64034,17935,14010,17935,allow,66,66,0,2,8,2,0
14932,9436,443,44079,443,allow,5693,499,5194,14,15,7,7
14933,51076,443,8592,443,allow,19880,4739,15141,58,187,26,32
14934,8282,25916,26002,25916,allow,133,64,69,3,33,2,1
14935,57164,443,51715,443,allow,522,78,444,8,22,2,6
14936,53870,24535,51626,24535,allow,70,70,0,1,5,1,0
14937,59964,443,4370,443,allow,48525,4928,43597,111,660,55,56
14938,53012,443,30523,443,allow,4073,2039,2034,14,135,7,7
14939,45230,443,23452,443,allow,33924,26047,7877,73,403,33,40
14940,48817,11602,48817,11602,allow,152,152,0,1,1200,1,0
14941,48817,57451,48817,57451,allow,152,152,0,1,1200,1,0
14942,56230,5228,8322,5228,allow,2564,1546,1018,18,3600,9,9
14943,64691,25320,0,0,deny,62,62,0,1,0,1,0
14944,63716,445,0,0,drop,70,70,0,1,0,1,0
14945,63718,445,0,0,drop,70,70,0,1,0,1,0
14946,63717,445,0,0,drop,70,70,0,1,0,1,0
14947,55554,22114,0,0,deny,146,146,0,1,0,1,0
14948,52117,445,0,0,drop,70,70,0,1,0,1,0
14949,52110,445,0,0,drop,70,70,0,1,0,1,0
14950,52109,445,0,0,drop,70,70,0,1,0,1,0
14951,5228,3434,0,0,deny,345,345,0,1,0,1,0
14952,63714,445,0,0,drop,70,70,0,1,0,1,0
14953,63711,445,0,0,drop,70,70,0,1,0,1,0
14954,51979,25174,0,0,deny,66,66,0,1,0,1,0
14955,1847,64147,0,0,deny,66,66,0,1,0,1,0
14956,59773,5900,0,0,deny,60,60,0,1,0,1,0
14957,58022,8112,0,0,deny,60,60,0,1,0,1,0
14958,41970,23,0,0,deny,60,60,0,1,0,1,0
14959,6980,25604,0,0,deny,100,100,0,1,0,1,0
14960,53207,50584,0,0,deny,66,66,0,1,0,1,0
14961,57834,80,57834,80,allow,2106,1657,449,10,20,6,4
14962,63704,445,0,0,drop,70,70,0,1,0,1,0
14963,1537,22114,0,0,deny,62,62,0,1,0,1,0
14964,52112,22114,0,0,deny,66,66,0,1,0,1,0
14965,6881,6881,0,0,deny,146,146,0,1,0,1,0
14966,52101,445,0,0,drop,70,70,0,1,0,1,0
14967,52098,445,0,0,drop,70,70,0,1,0,1,0
14968,52096,445,0,0,drop,70,70,0,1,0,1,0
14969,5790,43890,0,0,deny,62,62,0,1,0,1,0
14970,43260,41615,0,0,deny,145,145,0,1,0,1,0
14971,63873,445,0,0,drop,66,66,0,1,0,1,0
14972,56711,25174,0,0,deny,62,62,0,1,0,1,0
14973,18116,37807,0,0,deny,66,66,0,1,0,1,0
14974,38099,11392,0,0,deny,62,62,0,1,0,1,0
14975,63697,445,0,0,drop,70,70,0,1,0,1,0
14976,55425,37965,0,0,deny,66,66,0,1,0,1,0
14977,49370,11392,0,0,deny,66,66,0,1,0,1,0
14978,29884,25174,0,0,deny,146,146,0,1,0,1,0
14979,63696,445,0,0,drop,70,70,0,1,0,1,0
14980,34028,443,47575,443,allow,7804,1583,6221,26,981,13,13
14981,58952,443,55046,443,allow,5166,700,4466,16,15,7,9
14982,50041,443,48278,443,allow,7924,1798,6126,26,15,14,12
14983,25833,53,31276,53,allow,404,261,143,3,30,2,1
14984,32805,443,65246,443,allow,438124,21529,416595,481,398,138,343
14985,30188,51419,27819,51419,allow,502,150,352,2,1200,1,1
14986,64029,38651,56654,38651,allow,66,66,0,2,7,2,0
14987,53898,12172,10905,12172,allow,70,70,0,2,7,2,0
14988,53868,52706,53464,52706,allow,70,70,0,1,4,1,0
14989,49781,53,35337,53,allow,254,102,152,2,29,1,1
14990,50405,443,58184,443,allow,612,280,332,10,26,5,5
14991,53873,52055,19487,52055,allow,70,70,0,1,4,1,0
14992,54819,443,17467,443,allow,70,70,0,1,4,1,0
14993,52078,15518,32282,15518,allow,70,70,0,1,4,1,0
14994,60514,80,54084,80,allow,1641,944,697,9,15,5,4
14995,50474,443,49167,443,allow,17449456,390704,17058752,16816,383,4917,11899
14996,50584,51413,41920,51413,allow,475,150,325,2,1200,1,1
14997,44680,80,65456,80,allow,1658,922,736,10,17,6,4
14998,38704,443,15370,443,allow,90097,3289,86808,93,15,28,65
14999,53899,45682,27773,45682,allow,70,70,0,2,7,2,0
15000,52105,1024,36023,1024,allow,70,70,0,2,7,2,0
15001,52077,51638,8361,51638,allow,70,70,0,1,4,1,0
15002,54813,443,48795,443,allow,1633,819,814,16,40,8,8
15003,56737,80,46127,80,allow,194,128,66,4,25,3,1
15004,53869,17089,38908,17089,allow,70,70,0,1,4,1,0
15005,55542,53,10496,53,allow,177,94,83,2,29,1,1
15006,55130,27046,9695,27046,allow,1798,1386,412,8,29,4,4
15007,34692,53,2143,53,allow,271,102,169,2,30,1,1
15008,51913,443,46255,443,allow,13337,10008,3329,47,185,23,24
15009,50671,80,18183,80,allow,1658,1247,411,8,15,5,3
15010,56937,53,49569,53,allow,181,94,87,2,33,1,1
15011,49773,80,31365,80,allow,70,70,0,1,5,1,0
15012,28015,443,63063,443,allow,6435,1089,5346,18,75,9,9
15013,28014,443,49655,443,allow,6435,1089,5346,18,75,9,9
15014,28012,443,23129,443,allow,6388,1112,5276,18,75,9,9
15015,50177,443,50177,443,allow,5206,1389,3817,22,15,10,12
15016,53373,64147,0,0,deny,66,66,0,1,0,1,0
15017,52093,445,0,0,drop,70,70,0,1,0,1,0
15018,52090,445,0,0,drop,70,70,0,1,0,1,0
15019,55951,30188,0,0,deny,66,66,0,1,0,1,0
15020,30654,51221,0,0,deny,72,72,0,1,0,1,0
15021,63690,445,0,0,drop,70,70,0,1,0,1,0
15022,51077,443,6425,443,allow,2997,1906,1091,29,186,17,12
15023,49558,53,42255,53,allow,350,93,257,4,42,2,2
15024,46295,443,56188,443,allow,7493,3793,3700,40,109,26,14
15025,56322,80,56322,80,allow,27189,4515,22674,34,23,14,20
15026,56763,443,10844,443,allow,8058,2038,6020,20,15,11,9
15027,33304,443,15471,443,allow,1067,650,417,10,73,6,4
15028,41501,80,33952,80,allow,306627,58973,247654,556,297,246,310
15029,36983,80,52569,80,allow,130,70,60,2,15,1,1
15030,62353,80,60521,80,allow,2895,771,2124,12,24,6,6
15031,34436,443,8261,443,allow,9083,2087,6996,28,18,16,12
15032,65386,53,35268,53,allow,197,102,95,2,33,1,1
15033,65507,53,1633,53,allow,177,94,83,2,30,1,1
15034,55542,53,62446,53,allow,177,94,83,2,30,1,1
15035,41640,8080,50397,8080,allow,78,78,0,2,8,2,0
15036,53450,443,34036,443,allow,10139,3656,6483,29,128,14,15
15037,49428,53,23705,53,allow,200,94,106,2,30,1,1
15038,50484,443,37149,443,allow,30475,26737,3738,62,26,35,27
15039,58966,443,39805,443,allow,8209,2174,6035,25,210,12,13
15040,49994,80,9515,80,allow,2618,591,2027,11,16,6,5
15041,57832,443,1165,443,allow,91134,7506,83628,132,130,52,80
15042,48817,36292,48817,36292,allow,519,158,361,2,1200,1,1
15043,65507,443,3045,443,allow,453047,13340,439707,469,16,165,304
15044,50469,443,45578,443,allow,19063941,342071,18721870,17124,384,4119,13005
15045,49996,80,14871,80,allow,3007,604,2403,11,15,6,5
15046,56762,443,61918,443,allow,8005,1985,6020,20,15,11,9
15047,49730,53,34301,53,allow,539,100,439,4,54,2,2
15048,40587,53,36507,53,allow,271,102,169,2,30,1,1
15049,57308,53,39831,53,allow,302,110,192,2,30,1,1
15050,62246,443,21397,443,allow,117314,4775,112539,144,120,51,93
15051,50656,80,17387,80,allow,318,192,126,6,25,4,2
15052,56082,53,15374,53,allow,271,88,183,4,37,2,2
15053,49634,53,57122,53,allow,718,94,624,2,30,1,1
15054,55040,443,2837,443,allow,8558,1869,6689,31,236,14,17
15055,37965,63728,43778,63728,allow,1294,594,700,20,1781,10,10
15056,56483,443,20342,443,allow,6463,3844,2619,39,135,21,18
15057,44847,9912,37796,9912,allow,502,150,352,2,1200,1,1
15058,50462,443,22628,443,allow,14264,4441,9823,74,386,38,36
15059,35991,443,8225,443,allow,2509208,64544,2444664,2429,304,700,1729
15060,41336,443,51571,443,allow,350,210,140,6,30,4,2
15061,48854,443,38265,443,allow,2497156,63601,2433555,2465,17,852,1613
15062,52107,11191,13712,11191,allow,70,70,0,2,7,2,0
15063,52075,37919,16771,37919,allow,70,70,0,1,4,1,0
15064,52074,57947,9698,57947,allow,70,70,0,1,5,1,0
15065,9433,443,31139,443,allow,3299,441,2858,11,15,6,5
15066,56484,443,2923,443,allow,1857,1218,639,18,135,11,7
15067,28013,443,29765,443,allow,6130,1264,4866,18,75,9,9
15068,53895,36849,56387,36849,allow,70,70,0,2,7,2,0
15069,56671,80,31736,80,allow,234,234,0,4,12,4,0
15070,52252,443,52252,443,allow,221672,9306,212366,249,21,97,152
15071,52073,16316,63189,16316,allow,70,70,0,1,5,1,0
15072,49995,80,2817,80,allow,2669,604,2065,11,16,6,5
15073,49993,443,14877,443,allow,14857,1138,13719,26,17,10,16
15074,65508,443,2648,443,allow,92884,4939,87945,111,16,45,66
15075,34215,443,33625,443,allow,5341,1386,3955,19,649,11,8
15076,56736,80,11534,80,allow,194,128,66,4,25,3,1
15077,41670,80,41670,80,allow,3571,2892,679,13,23,8,5
15078,58715,80,58715,80,allow,5140,4161,979,17,28,10,7
15079,38130,443,8733,443,allow,717020,36766,680254,939,60,449,490
15080,65331,53,14108,53,allow,308,102,206,2,30,1,1
15081,64687,53,30992,53,allow,495,109,386,4,53,2,2
15082,56734,80,64954,80,allow,194,128,66,4,25,3,1
15083,52020,80,52020,80,allow,6764,5555,1209,20,28,12,8
15084,46456,443,58612,443,allow,4921,2134,2787,21,95,10,11
15085,64458,53,4904,53,allow,292,102,190,2,30,1,1
15086,55542,53,50778,53,allow,177,94,83,2,30,1,1
15087,65293,53,50670,53,allow,94,94,0,1,30,1,0
15088,10075,53,26138,53,allow,229,86,143,2,30,1,1
15089,64981,27068,50495,27068,allow,1680,1386,294,7,30,4,3
15090,52474,123,6683,123,allow,184,94,90,2,30,1,1
15091,65507,53,62722,53,allow,177,94,83,2,30,1,1
15092,33694,443,52274,443,allow,18876,16514,2362,43,95,24,19
15093,50482,443,33515,443,allow,6904692,144860,6759832,6483,140,1783,4700
15094,56735,80,63370,80,allow,194,128,66,4,25,3,1
15095,50650,443,2408,443,allow,9741,7503,2238,24,32,14,10
15096,52112,53559,37444,53559,allow,316,136,180,6,6,3,3
15097,9421,443,1496,443,allow,5699,505,5194,14,15,7,7
15098,48970,80,48970,80,allow,24303,4898,19405,40,28,21,19
15099,42420,443,29433,443,allow,8616,2683,5933,30,459,15,15
15100,55019,443,26461,443,allow,6866,1983,4883,23,330,11,12
15101,54432,53,45895,53,allow,168,78,90,2,30,1,1
15102,38649,443,32676,443,allow,13463,5427,8036,24,121,11,13
15103,50634,80,58631,80,allow,25670,13514,12156,46,36,21,25
15104,56082,53,31858,53,allow,271,88,183,4,37,2,2
15105,49997,80,20317,80,allow,2863,604,2259,11,15,6,5
15106,44992,80,44992,80,allow,2091,1642,449,10,20,6,4
15107,38385,443,54542,443,allow,5304,1112,4192,19,31,10,9
15108,60439,53,58321,53,allow,70,70,0,1,30,1,0
15109,39236,80,55447,80,allow,190,70,120,4,16,2,2
15110,49349,443,17096,443,allow,5282,1090,4192,17,25,10,7
15111,54503,443,54503,443,allow,157452,26878,130574,213,214,111,102
15112,33305,443,50193,443,allow,1067,650,417,10,73,6,4
15113,52103,7172,64684,7172,allow,70,70,0,2,7,2,0
15114,53160,39001,43902,39001,allow,70,70,0,1,5,1,0
15115,52071,57491,38679,57491,allow,70,70,0,1,5,1,0
15116,58950,443,1545,443,allow,5108,700,4408,15,15,7,8
15117,50262,443,64245,443,allow,11220,726,10494,18,75,8,10
15118,49498,53,33432,53,allow,211,102,109,2,30,1,1
15119,56213,53,25430,53,allow,168,78,90,2,30,1,1
15120,56274,53,38501,53,allow,177,94,83,2,30,1,1
15121,57903,443,20952,443,allow,4823,708,4115,19,240,6,13
15122,47636,443,43225,443,allow,5921,1018,4903,21,150,11,10
15123,58685,443,52844,443,allow,165763,5072,160691,181,120,61,120
15124,57470,1073,4669,1073,allow,402,132,270,6,1209,3,3
15125,56082,53,50090,53,allow,271,88,183,4,38,2,2
15126,52069,53446,32796,53446,allow,70,70,0,1,5,1,0
15127,51558,443,41569,443,allow,254,70,184,5,22,2,3
15128,58822,443,40826,443,allow,3594,1787,1807,31,163,17,14
15129,52250,443,52250,443,allow,162355,8745,153610,178,22,66,112
15130,56588,443,17428,443,allow,15450,6149,9301,106,177,47,59
15131,65359,53,37489,53,allow,210,102,108,2,30,1,1
15132,55232,53,52840,53,allow,177,94,83,2,30,1,1
15133,49835,53,10267,53,allow,199,94,105,2,31,1,1
15134,53890,23310,52916,23310,allow,70,70,0,2,8,2,0
15135,52931,443,65247,443,allow,8519,1687,6832,29,17,16,13
15136,22274,53,9607,53,allow,278,78,200,2,30,1,1
15137,61417,443,25149,443,allow,652760,608740,44020,734,432,496,238
15138,44068,443,30325,443,allow,3947,1744,2203,16,361,8,8
15139,52329,443,64562,443,allow,294025,14919,279106,401,42,192,209
15140,42386,443,56294,443,allow,12516,2906,9610,41,427,17,24
15141,52424,443,16403,443,allow,10070,5084,4986,41,16,24,17
15142,60796,40010,42755,40010,allow,316,136,180,6,7,3,3
15143,60464,11385,6156,11385,allow,1090,712,378,16,26,10,6
15144,52099,28401,4027,28401,allow,70,70,0,2,8,2,0
15145,52100,54130,10499,54130,allow,70,70,0,2,8,2,0
15146,45844,80,40841,80,allow,152,78,74,2,5,1,1
15147,33829,443,29338,443,allow,568,222,346,9,26,4,5
15148,16057,56205,0,0,deny,62,62,0,1,0,1,0
15149,37647,36237,0,0,deny,62,62,0,1,0,1,0
15150,64077,25174,0,0,deny,66,66,0,1,0,1,0
15151,63689,445,0,0,drop,70,70,0,1,0,1,0
15152,55079,25174,0,0,deny,66,66,0,1,0,1,0
15153,52557,44847,0,0,deny,62,62,0,1,0,1,0
15154,63860,445,0,0,drop,66,66,0,1,0,1,0
15155,63855,445,0,0,drop,66,66,0,1,0,1,0
15156,63245,26296,0,0,deny,159,159,0,1,0,1,0
15157,59587,25174,0,0,deny,62,62,0,1,0,1,0
15158,51966,25174,0,0,deny,62,62,0,1,0,1,0
15159,27505,25174,0,0,deny,62,62,0,1,0,1,0
15160,61635,37965,0,0,deny,66,66,0,1,0,1,0
15161,63685,445,0,0,drop,70,70,0,1,0,1,0
15162,7048,25174,0,0,deny,66,66,0,1,0,1,0
15163,52083,445,0,0,drop,70,70,0,1,0,1,0
15164,52080,445,0,0,drop,70,70,0,1,0,1,0
15165,52076,445,0,0,drop,70,70,0,1,0,1,0
15166,52072,445,0,0,drop,70,70,0,1,0,1,0
15167,63684,445,0,0,drop,70,70,0,1,0,1,0
15168,23331,25174,0,0,deny,62,62,0,1,0,1,0
15169,13062,52274,0,0,deny,66,66,0,1,0,1,0
15170,63852,445,0,0,drop,66,66,0,1,0,1,0
15171,50651,25174,0,0,deny,146,146,0,1,0,1,0
15172,22916,25174,0,0,deny,146,146,0,1,0,1,0
15173,63838,445,0,0,drop,66,66,0,1,0,1,0
15174,63847,445,0,0,drop,66,66,0,1,0,1,0
15175,63844,445,0,0,drop,66,66,0,1,0,1,0
15176,63841,445,0,0,drop,66,66,0,1,0,1,0
15177,63843,445,0,0,drop,66,66,0,1,0,1,0
15178,63839,445,0,0,drop,66,66,0,1,0,1,0
15179,63846,445,0,0,drop,66,66,0,1,0,1,0
15180,30574,64147,0,0,deny,62,62,0,1,0,1,0
15181,32970,64147,0,0,deny,145,145,0,1,0,1,0
15182,63679,445,0,0,drop,70,70,0,1,0,1,0
15183,56581,25174,0,0,deny,146,146,0,1,0,1,0
15184,52067,445,0,0,drop,70,70,0,1,0,1,0
15185,49415,22114,0,0,deny,62,62,0,1,0,1,0
15186,60311,30627,0,0,deny,66,66,0,1,0,1,0
15187,52060,445,0,0,drop,70,70,0,1,0,1,0
15188,52063,445,0,0,drop,70,70,0,1,0,1,0
15189,52059,445,0,0,drop,70,70,0,1,0,1,0
15190,54666,36237,0,0,deny,66,66,0,1,0,1,0
15191,65233,23117,0,0,deny,66,66,0,1,0,1,0
15192,24301,6881,0,0,deny,62,62,0,1,0,1,0
15193,57164,50584,0,0,deny,62,62,0,1,0,1,0
15194,63213,35440,0,0,deny,62,62,0,1,0,1,0
15195,2083,25174,0,0,deny,146,146,0,1,0,1,0
15196,5830,22114,0,0,deny,66,66,0,1,0,1,0
15197,31683,35440,0,0,deny,62,62,0,1,0,1,0
15198,52056,445,0,0,drop,70,70,0,1,0,1,0
15199,52053,445,0,0,drop,70,70,0,1,0,1,0
15200,52052,445,0,0,drop,70,70,0,1,0,1,0
15201,64509,9571,0,0,deny,62,62,0,1,0,1,0
15202,63666,445,0,0,drop,70,70,0,1,0,1,0
15203,58627,64097,0,0,deny,66,66,0,1,0,1,0
15204,63830,445,0,0,drop,66,66,0,1,0,1,0
15205,52050,445,0,0,drop,70,70,0,1,0,1,0
15206,50084,26672,0,0,deny,62,62,0,1,0,1,0
15207,63827,445,0,0,drop,66,66,0,1,0,1,0
15208,35657,48637,0,0,deny,62,62,0,1,0,1,0
15209,63663,445,0,0,drop,70,70,0,1,0,1,0
15210,63826,445,0,0,drop,66,66,0,1,0,1,0
15211,63824,445,0,0,drop,66,66,0,1,0,1,0
15212,36679,41864,0,0,deny,148,148,0,1,0,1,0
15213,12527,50584,0,0,deny,62,62,0,1,0,1,0
15214,63823,445,0,0,drop,66,66,0,1,0,1,0
15215,47943,50584,0,0,deny,74,74,0,1,0,1,0
15216,62550,51505,0,0,deny,66,66,0,1,0,1,0
15217,55199,21247,0,0,deny,62,62,0,1,0,1,0
15218,52045,445,0,0,drop,70,70,0,1,0,1,0
15219,63658,445,0,0,drop,70,70,0,1,0,1,0
15220,21606,80,0,0,deny,60,60,0,1,0,1,0
15221,63657,445,0,0,drop,70,70,0,1,0,1,0
15222,52039,445,0,0,drop,70,70,0,1,0,1,0
15223,52036,445,0,0,drop,70,70,0,1,0,1,0
15224,38755,22114,0,0,deny,66,66,0,1,0,1,0
15225,63655,445,0,0,drop,70,70,0,1,0,1,0
15226,55144,30188,0,0,deny,66,66,0,1,0,1,0
15227,63811,445,0,0,drop,66,66,0,1,0,1,0
15228,27995,22114,0,0,deny,62,62,0,1,0,1,0
15229,2427,25174,0,0,deny,62,62,0,1,0,1,0
15230,61382,25174,0,0,deny,66,66,0,1,0,1,0
15231,17097,62413,0,0,deny,62,62,0,1,0,1,0
15232,1074,25174,0,0,deny,146,146,0,1,0,1,0
15233,47910,7454,0,0,deny,60,60,0,1,0,1,0
15234,4706,36237,0,0,deny,146,146,0,1,0,1,0
15235,443,38956,0,0,deny,82,82,0,1,0,1,0
15236,17280,22114,0,0,deny,146,146,0,1,0,1,0
15237,63804,445,0,0,drop,66,66,0,1,0,1,0
15238,52024,445,0,0,drop,70,70,0,1,0,1,0
15239,57860,23,0,0,deny,60,60,0,1,0,1,0
15240,63648,445,0,0,drop,70,70,0,1,0,1,0
15241,45682,37965,0,0,deny,145,145,0,1,0,1,0
15242,52492,37965,0,0,deny,66,66,0,1,0,1,0
15243,63832,25174,0,0,deny,62,62,0,1,0,1,0
15244,0,0,0,0,allow,244,244,0,2,0,2,0
15245,63646,445,0,0,drop,70,70,0,1,0,1,0
15246,55116,7574,0,0,deny,66,66,0,1,0,1,0
15247,5222,27389,0,0,deny,66,66,0,1,0,1,0
15248,63802,445,0,0,drop,66,66,0,1,0,1,0
15249,63645,445,0,0,drop,70,70,0,1,0,1,0
15250,27110,22114,0,0,deny,62,62,0,1,0,1,0
15251,33359,30188,0,0,deny,62,62,0,1,0,1,0
15252,63644,445,0,0,drop,70,70,0,1,0,1,0
15253,63643,445,0,0,drop,70,70,0,1,0,1,0
15254,63640,445,0,0,drop,70,70,0,1,0,1,0
15255,63639,445,0,0,drop,70,70,0,1,0,1,0
15256,7000,23117,0,0,deny,62,62,0,1,0,1,0
15257,63795,445,0,0,drop,66,66,0,1,0,1,0
15258,54618,5900,0,0,deny,60,60,0,1,0,1,0
15259,21542,57470,0,0,deny,74,74,0,1,0,1,0
15260,63787,445,0,0,drop,66,66,0,1,0,1,0
15261,14438,51505,0,0,deny,146,146,0,1,0,1,0
15262,41210,23,0,0,deny,60,60,0,1,0,1,0
15263,11876,22,0,0,deny,60,60,0,1,0,1,0
15264,32132,25174,0,0,deny,66,66,0,1,0,1,0
15265,63625,445,0,0,drop,70,70,0,1,0,1,0
15266,63624,445,0,0,drop,70,70,0,1,0,1,0
15267,63621,445,0,0,drop,70,70,0,1,0,1,0
15268,33886,52255,0,0,deny,162,162,0,1,0,1,0
15269,63614,445,0,0,drop,70,70,0,1,0,1,0
15270,63615,445,0,0,drop,70,70,0,1,0,1,0
15271,42344,48637,0,0,deny,60,60,0,1,0,1,0
15272,27038,51505,0,0,deny,62,62,0,1,0,1,0
15273,26531,25174,0,0,deny,62,62,0,1,0,1,0
15274,26531,37965,0,0,deny,62,62,0,1,0,1,0
15275,51755,5900,0,0,deny,60,60,0,1,0,1,0
15276,52014,445,0,0,drop,70,70,0,1,0,1,0
15277,52012,445,0,0,drop,70,70,0,1,0,1,0
15278,52010,445,0,0,drop,70,70,0,1,0,1,0
15279,57337,64147,0,0,deny,66,66,0,1,0,1,0
15280,2074,32480,0,0,deny,146,146,0,1,0,1,0
15281,63775,445,0,0,drop,66,66,0,1,0,1,0
15282,63771,445,0,0,drop,66,66,0,1,0,1,0
15283,63778,445,0,0,drop,66,66,0,1,0,1,0
15284,63776,445,0,0,drop,66,66,0,1,0,1,0
15285,63779,445,0,0,drop,66,66,0,1,0,1,0
15286,63772,445,0,0,drop,66,66,0,1,0,1,0
15287,63773,445,0,0,drop,66,66,0,1,0,1,0
15288,63777,445,0,0,drop,66,66,0,1,0,1,0
15289,51413,1,0,0,deny,72,72,0,1,0,1,0
15290,54140,17372,0,0,deny,66,66,0,1,0,1,0
15291,47040,25174,0,0,deny,62,62,0,1,0,1,0
15292,63603,445,0,0,drop,70,70,0,1,0,1,0
15293,34932,38608,0,0,deny,62,62,0,1,0,1,0
15294,18086,25174,0,0,deny,62,62,0,1,0,1,0
15295,54280,3396,0,0,deny,60,60,0,1,0,1,0
15296,25871,53,25871,53,allow,266,72,194,2,30,1,1
15297,39186,53,39186,53,allow,371,237,134,3,33,2,1
15298,35201,443,64123,443,allow,291,171,120,4,15,2,2
15299,50729,443,32293,443,allow,10440,3521,6919,42,119,20,22
15300,56354,53,56354,53,allow,214,97,117,2,30,1,1
15301,37906,443,56891,443,allow,11293,3979,7314,29,125,17,12
15302,50727,443,38985,443,allow,26161,3618,22543,80,119,31,49
15303,49665,53,35069,53,allow,168,86,82,2,32,1,1
15304,60480,60519,7495,60519,allow,320,140,180,6,8,3,3
15305,49206,443,56721,443,allow,7875,1817,6058,41,255,19,22
15306,50598,80,50598,80,allow,10463,6606,3857,36,27,20,16
15307,61509,443,47638,443,allow,1506,984,522,14,27,8,6
15308,50574,80,15293,80,allow,61763,2941,58822,75,135,33,42
15309,26852,443,37860,443,allow,6701,2064,4637,19,19,9,10
15310,59652,443,50919,443,allow,562,562,0,4,175,4,0
15311,38019,443,55149,443,allow,884,464,420,13,28,7,6
15312,55014,443,4277,443,allow,4962,1352,3610,19,135,9,10
15313,65003,27046,30438,27046,allow,1749,924,825,6,31,3,3
15314,56303,53,13622,53,allow,170,87,83,2,30,1,1
15315,61964,443,61964,443,allow,4378,1471,2907,19,30,11,8
15316,58997,443,39971,443,allow,3576,2319,1257,21,23,11,10
15317,64455,53,64455,53,allow,257,101,156,2,33,1,1
15318,50602,80,50602,80,allow,7596,5063,2533,28,27,16,12
15319,28557,53,28557,53,allow,213,79,134,2,32,1,1
15320,49104,443,34299,443,allow,7424,2381,5043,24,18,13,11
15321,60479,53928,50197,53928,allow,70,70,0,2,8,2,0
15322,50305,443,11776,443,allow,3325,1851,1474,19,16,9,10
15323,60481,40075,5787,40075,allow,70,70,0,2,8,2,0
15324,64343,53,64343,53,allow,216,98,118,2,30,1,1
15325,53858,6889,25438,6889,allow,372,186,186,6,16,3,3
15326,44319,443,43736,443,allow,13919,3349,10570,46,120,25,21
15327,53893,11344,37839,11344,allow,70,70,0,2,8,2,0
15328,53860,33791,1451,33791,allow,492,306,186,8,16,5,3
15329,40650,443,51106,443,allow,7298,2661,4637,21,17,11,10
15330,65047,53,45819,53,allow,206,91,115,2,30,1,1
15331,58999,443,30350,443,allow,2687,1593,1094,20,20,11,9
15332,57870,7635,57870,7635,allow,138,78,60,2,6,1,1
15333,49357,80,5006,80,allow,3014,1052,1962,14,97,9,5
15334,52866,443,59183,443,allow,3101,801,2300,13,136,6,7
15335,56737,53,36153,53,allow,817,98,719,2,31,1,1
15336,63917,443,22910,443,allow,9043,5948,3095,31,121,15,16
15337,35719,443,27839,443,allow,9736,4347,5389,23,361,11,12
15338,65165,53,27998,53,allow,783,96,687,2,31,1,1
15339,55193,53,60056,53,allow,170,87,83,2,31,1,1
15340,63294,443,54054,443,allow,9929,4574,5355,29,134,14,15
15341,59786,25174,0,0,deny,62,62,0,1,0,1,0
15342,45202,23,0,0,deny,60,60,0,1,0,1,0
15343,18086,25174,0,0,deny,146,146,0,1,0,1,0
15344,52007,445,0,0,drop,70,70,0,1,0,1,0
15345,52006,445,0,0,drop,70,70,0,1,0,1,0
15346,52001,445,0,0,drop,70,70,0,1,0,1,0
15347,51998,445,0,0,drop,70,70,0,1,0,1,0
15348,54473,37807,0,0,deny,66,66,0,1,0,1,0
15349,63599,445,0,0,drop,70,70,0,1,0,1,0
15350,63756,445,0,0,drop,66,66,0,1,0,1,0
15351,63758,445,0,0,drop,66,66,0,1,0,1,0
15352,63755,445,0,0,drop,66,66,0,1,0,1,0
15353,60954,443,45270,443,allow,62583,3743,58840,88,32,40,48
15354,9230,443,20303,443,allow,6020,792,5228,18,25,9,9
15355,64814,53,31747,53,allow,565,215,350,6,37,3,3
15356,21424,53,21424,53,allow,225,90,135,2,29,1,1
15357,59985,443,35984,443,allow,55132,17147,37985,126,150,55,71
15358,57131,35776,0,0,deny,145,145,0,1,0,1,0
15359,48676,53389,0,0,deny,60,60,0,1,0,1,0
15360,38581,22114,0,0,deny,62,62,0,1,0,1,0
15361,38581,22114,0,0,deny,146,146,0,1,0,1,0
15362,35937,25174,0,0,deny,66,66,0,1,0,1,0
15363,63588,445,0,0,drop,70,70,0,1,0,1,0
15364,63589,445,0,0,drop,70,70,0,1,0,1,0
15365,63590,445,0,0,drop,70,70,0,1,0,1,0
15366,57220,26467,0,0,deny,62,62,0,1,0,1,0
15367,62512,25174,0,0,deny,62,62,0,1,0,1,0
15368,63584,445,0,0,drop,70,70,0,1,0,1,0
15369,63582,445,0,0,drop,70,70,0,1,0,1,0
15370,2062,35440,0,0,deny,66,66,0,1,0,1,0
15371,51985,445,0,0,drop,70,70,0,1,0,1,0
15372,51984,445,0,0,drop,70,70,0,1,0,1,0
15373,51981,445,0,0,drop,70,70,0,1,0,1,0
15374,11228,25174,0,0,deny,66,66,0,1,0,1,0
15375,10547,57470,0,0,deny,62,62,0,1,0,1,0
15376,65212,22114,0,0,deny,146,146,0,1,0,1,0
15377,55678,32468,0,0,deny,66,66,0,1,0,1,0
15378,29471,57470,0,0,deny,145,145,0,1,0,1,0
15379,63576,445,0,0,drop,70,70,0,1,0,1,0
15380,28385,50584,0,0,deny,62,62,0,1,0,1,0
15381,25565,51337,0,0,deny,60,60,0,1,0,1,0
15382,34112,44847,0,0,deny,66,66,0,1,0,1,0
15383,9552,57470,0,0,deny,66,66,0,1,0,1,0
15384,51973,445,0,0,drop,70,70,0,1,0,1,0
15385,51972,445,0,0,drop,70,70,0,1,0,1,0
15386,51968,445,0,0,drop,70,70,0,1,0,1,0
15387,51578,44847,0,0,deny,66,66,0,1,0,1,0
15388,63745,445,0,0,drop,66,66,0,1,0,1,0
15389,63569,445,0,0,drop,70,70,0,1,0,1,0
15390,44612,25174,0,0,deny,66,66,0,1,0,1,0
15391,5213,44847,0,0,deny,66,66,0,1,0,1,0
15392,63567,445,0,0,drop,70,70,0,1,0,1,0
15393,45944,44847,0,0,deny,146,146,0,1,0,1,0
15394,12531,22114,0,0,deny,62,62,0,1,0,1,0
15395,23658,18375,0,0,deny,62,62,0,1,0,1,0
15396,44919,26467,0,0,deny,62,62,0,1,0,1,0
15397,55451,56205,0,0,deny,66,66,0,1,0,1,0
15398,44334,26467,0,0,deny,62,62,0,1,0,1,0
15399,11136,15503,0,0,deny,62,62,0,1,0,1,0
15400,11136,15503,0,0,deny,62,62,0,1,0,1,0
15401,65231,50584,0,0,deny,66,66,0,1,0,1,0
15402,12841,37965,0,0,deny,62,62,0,1,0,1,0
15403,54684,37965,0,0,deny,62,62,0,1,0,1,0
15404,36034,35440,0,0,deny,146,146,0,1,0,1,0
15405,63562,445,0,0,drop,70,70,0,1,0,1,0
15406,60957,443,56619,443,allow,68539,4175,64364,98,32,46,52
15407,48852,443,7799,443,allow,38886,2134,36752,55,16,24,31
15408,50724,443,48529,443,allow,12515,5891,6624,42,166,22,20
15409,57231,53,2071,53,allow,168,86,82,2,31,1,1
15410,38140,443,44966,443,allow,82608,3591,79017,101,15,39,62
15411,56761,443,28881,443,allow,8057,2037,6020,20,15,11,9
15412,50605,80,50605,80,allow,2909,1798,1111,14,23,8,6
15413,56274,53,29071,53,allow,177,94,83,2,29,1,1
15414,58094,53,1806,53,allow,249,102,147,2,29,1,1
15415,49278,80,1561,80,allow,254,128,126,5,16,3,2
15416,60477,30889,55230,30889,allow,70,70,0,2,8,2,0
15417,52067,46837,56641,46837,allow,70,70,0,1,5,1,0
15418,2844,3389,2844,3389,allow,4635,2460,2175,21,18,12,9
15419,51523,443,27460,443,allow,4045,765,3280,11,45,5,6
15420,53135,80,21609,80,allow,2959,610,2349,12,15,6,6
15421,51979,443,5164,443,allow,11555,2620,8935,45,822,18,27
15422,38474,443,30004,443,allow,53562,2314,51248,64,31,24,40
15423,53857,22796,40353,22796,allow,492,306,186,8,15,5,3
15424,52096,55854,2133,55854,allow,70,70,0,2,7,2,0
15425,38664,443,9528,443,allow,6887,1076,5811,22,50,12,10
15426,54061,443,17849,443,allow,126027,103934,22093,380,239,237,143
15427,49944,53,58340,53,allow,334,90,244,4,38,2,2
15428,56387,443,8980,443,allow,9569,2225,7344,28,15,15,13
15429,45565,443,30523,443,allow,1784491,72960,1711531,1872,113,687,1185
15430,56760,443,12477,443,allow,8006,1986,6020,20,15,11,9
15431,52094,443,49643,443,allow,3296065,47110,3248955,2746,51,533,2213
15432,61660,443,61660,443,allow,18829,1995,16834,33,17,17,16
15433,18333,53,18333,53,allow,215,98,117,2,30,1,1
15434,53853,39723,8770,39723,allow,1890,1010,880,13,16,8,5
15435,64708,53,37304,53,allow,437,89,348,4,48,2,2
15436,49228,53,52033,53,allow,209,110,99,2,30,1,1
15437,37625,443,14545,443,allow,7766,1810,5956,24,46,14,10
15438,37628,443,37587,443,allow,5783,1761,4022,24,46,14,10
15439,46310,443,24043,443,allow,172,172,0,2,5,2,0
15440,53124,443,13902,443,allow,7459,2962,4497,24,47,14,10
15441,58443,443,26143,443,allow,12060,3749,8311,42,17,23,19
15442,64341,53,61484,53,allow,355,118,237,2,30,1,1
15443,61155,443,61155,443,allow,4575,1668,2907,19,27,11,8
15444,45020,443,16879,443,allow,2293,1592,701,16,21,8,8
15445,55669,53,24694,53,allow,195,94,101,2,30,1,1
15446,42305,443,8617,443,allow,1262512,53286,1209226,1457,280,548,909
15447,51283,443,17367,443,allow,638,292,346,10,28,5,5
15448,50597,80,50597,80,allow,16296,9143,7153,48,27,26,22
15449,55697,14795,5674,14795,allow,564,318,246,9,15,5,4
15450,49566,443,56246,443,allow,2888,1389,1499,18,15,9,9
15451,51559,443,32426,443,allow,254,70,184,5,21,2,3
15452,52097,23279,3582,23279,allow,70,70,0,2,7,2,0
15453,52249,443,52249,443,allow,152755,7304,145451,171,21,65,106
15454,50728,443,61192,443,allow,34661,17810,16851,89,119,40,49
15455,65344,53,8855,53,allow,180,94,86,2,35,1,1
15456,37622,443,52437,443,allow,12542,2527,10015,31,48,18,13
15457,18749,53,18749,53,allow,370,238,132,3,32,2,1
15458,52098,29067,36738,29067,allow,70,70,0,2,7,2,0
15459,56303,53,31666,53,allow,177,94,83,2,30,1,1
15460,18331,53,15455,53,allow,376,94,282,2,30,1,1
15461,64996,27034,9075,27034,allow,1761,924,837,6,30,3,3
15462,49631,53,6299,53,allow,198,102,96,2,33,1,1
15463,49362,443,33824,443,allow,9551,6129,3422,35,47,19,16
15464,55232,53,34536,53,allow,177,94,83,2,29,1,1
15465,44720,53,0,0,allow,86,86,0,1,29,1,0
15466,65224,53,29187,53,allow,232,110,122,2,30,1,1
15467,49665,53,15025,53,allow,168,86,82,2,29,1,1
15468,56303,53,55286,53,allow,177,94,83,2,30,1,1
15469,56557,443,11082,443,allow,36053,3513,32540,54,96,25,29
15470,40662,53,39686,53,allow,223,78,145,2,30,1,1
15471,55223,1053,57960,1053,allow,1210,950,260,2,30,1,1
15472,52422,443,1583,443,allow,1043,556,487,10,15,6,4
15473,60476,55100,21039,55100,allow,70,70,0,2,8,2,0
15474,52066,60118,49058,60118,allow,70,70,0,1,5,1,0
15475,36499,443,51972,443,allow,1159756,1123031,36725,1206,26,753,453
15476,49527,53,63553,53,allow,415,98,317,4,51,2,2
15477,11816,53,11816,53,allow,240,98,142,2,30,1,1
15478,51971,53,51971,53,allow,240,98,142,2,30,1,1
15479,49824,53,50073,53,allow,198,94,104,2,30,1,1
15480,51912,443,41941,443,allow,186,70,116,2,120,1,1
15481,58867,443,37875,443,allow,16230,11127,5103,69,330,34,35
15482,60575,80,18847,80,allow,9034,1860,7174,17,16,8,9
15483,55454,53,64127,53,allow,168,86,82,2,32,1,1
15484,64249,53,6288,53,allow,181,94,87,2,33,1,1
15485,52068,39864,30686,39864,allow,70,70,0,1,5,1,0
15486,59282,443,30587,443,allow,5413,968,4445,20,15,11,9
15487,37621,443,45461,443,allow,27993,2483,25510,51,48,25,26
15488,37600,443,40571,443,allow,19917,8751,11166,51,56,32,19
15489,65071,53,53845,53,allow,411,99,312,4,52,2,2
15490,49819,53,24234,53,allow,94,94,0,1,30,1,0
15491,59189,53,53487,53,allow,222,94,128,2,30,1,1
15492,51944,53,51944,53,allow,832,106,726,2,30,1,1
15493,60986,443,43448,443,allow,7231,2305,4926,32,40,18,14
15494,56759,443,10401,443,allow,8058,2038,6020,20,15,11,9
15495,37626,443,10434,443,allow,7766,1810,5956,24,46,14,10
15496,55133,53,55133,53,allow,228,90,138,2,30,1,1
15497,52854,53,0,0,allow,86,86,0,1,30,1,0
15498,52018,53,53682,53,allow,164,78,86,2,30,1,1
15499,36661,53,19439,53,allow,164,78,86,2,31,1,1
15500,42306,443,42899,443,allow,449862,38989,410873,644,280,286,358
15501,42308,443,54120,443,allow,433261,34730,398531,604,279,258,346
15502,6881,61404,13734,61404,allow,228,118,110,2,1200,1,1
15503,55868,53,18445,53,allow,177,94,83,2,30,1,1
15504,48020,443,61756,443,allow,33481,5635,27846,73,287,32,41
15505,64651,443,22018,443,allow,317618,11688,305930,350,164,118,232
15506,55319,443,12527,443,allow,6210,2720,3490,15,121,7,8
15507,57470,61467,29646,61467,allow,479,150,329,2,1199,1,1
15508,37965,6881,46281,6881,allow,479,150,329,2,1199,1,1
15509,65128,443,26680,443,allow,3055,1759,1296,22,126,12,10
15510,53126,443,58223,443,allow,11811,4242,7569,27,46,15,12
15511,49705,80,19257,80,allow,2733,591,2142,11,45,6,5
15512,25295,53,30242,53,allow,200,94,106,2,30,1,1
15513,53581,53,57842,53,allow,231,94,137,2,30,1,1
15514,33053,53,52435,53,allow,164,78,86,2,31,1,1
15515,56758,443,1030,443,allow,8005,1985,6020,20,16,11,9
15516,53888,39204,30742,39204,allow,70,70,0,2,8,2,0
15517,49767,53,4502,53,allow,177,94,83,2,30,1,1
15518,49562,53,28687,53,allow,198,94,104,2,30,1,1
15519,64030,53,24656,53,allow,338,110,228,2,30,1,1
15520,51965,445,0,0,drop,70,70,0,1,0,1,0
15521,53640,25174,0,0,deny,62,62,0,1,0,1,0
15522,63561,445,0,0,drop,70,70,0,1,0,1,0
15523,31235,22114,0,0,deny,62,62,0,1,0,1,0
15524,51963,445,0,0,drop,70,70,0,1,0,1,0
15525,39110,50584,0,0,deny,62,62,0,1,0,1,0
15526,40481,22114,0,0,deny,66,66,0,1,0,1,0
15527,22439,25174,0,0,deny,66,66,0,1,0,1,0
15528,26235,37965,0,0,deny,66,66,0,1,0,1,0
15529,1865,25174,0,0,deny,62,62,0,1,0,1,0
15530,63557,445,0,0,drop,70,70,0,1,0,1,0
15531,63731,445,0,0,drop,66,66,0,1,0,1,0
15532,63726,445,0,0,drop,66,66,0,1,0,1,0
15533,48706,23393,0,0,deny,60,60,0,1,0,1,0
15534,44674,25174,0,0,deny,62,62,0,1,0,1,0
15535,43207,26467,0,0,deny,62,62,0,1,0,1,0
15536,63556,445,0,0,drop,70,70,0,1,0,1,0
15537,51042,22114,0,0,deny,66,66,0,1,0,1,0
15538,51948,445,0,0,drop,70,70,0,1,0,1,0
15539,51946,445,0,0,drop,70,70,0,1,0,1,0
15540,51944,445,0,0,drop,70,70,0,1,0,1,0
15541,51945,445,0,0,drop,70,70,0,1,0,1,0
15542,1111,25174,0,0,deny,62,62,0,1,0,1,0
15543,6843,42873,0,0,deny,62,62,0,1,0,1,0
15544,63724,445,0,0,drop,66,66,0,1,0,1,0
15545,2083,25174,0,0,deny,62,62,0,1,0,1,0
15546,42030,25,0,0,deny,74,74,0,1,0,1,0
15547,51479,25174,0,0,deny,62,62,0,1,0,1,0
15548,63551,445,0,0,drop,70,70,0,1,0,1,0
15549,42632,44847,0,0,deny,146,146,0,1,0,1,0
15550,54142,20541,0,0,deny,66,66,0,1,0,1,0
15551,63715,445,0,0,drop,66,66,0,1,0,1,0
15552,63713,445,0,0,drop,66,66,0,1,0,1,0
15553,63712,445,0,0,drop,66,66,0,1,0,1,0
15554,63717,445,0,0,drop,66,66,0,1,0,1,0
15555,63719,445,0,0,drop,66,66,0,1,0,1,0
15556,63711,445,0,0,drop,66,66,0,1,0,1,0
15557,63708,445,0,0,drop,66,66,0,1,0,1,0
15558,51706,25174,0,0,deny,66,66,0,1,0,1,0
15559,51938,445,0,0,drop,70,70,0,1,0,1,0
15560,443,38956,0,0,deny,82,82,0,1,0,1,0
15561,51935,445,0,0,drop,70,70,0,1,0,1,0
15562,51932,445,0,0,drop,70,70,0,1,0,1,0
15563,51931,445,0,0,drop,70,70,0,1,0,1,0
15564,50328,22114,0,0,deny,66,66,0,1,0,1,0
15565,62489,23117,0,0,deny,62,62,0,1,0,1,0
15566,55508,64147,0,0,deny,62,62,0,1,0,1,0
15567,64587,43890,0,0,deny,66,66,0,1,0,1,0
15568,25207,48817,0,0,deny,62,62,0,1,0,1,0
15569,54236,36829,0,0,deny,66,66,0,1,0,1,0
15570,55570,44847,0,0,deny,62,62,0,1,0,1,0
15571,1620,53567,0,0,deny,66,66,0,1,0,1,0
15572,55012,25174,0,0,deny,66,66,0,1,0,1,0
15573,56676,37965,0,0,deny,62,62,0,1,0,1,0
15574,63538,445,0,0,drop,70,70,0,1,0,1,0
15575,51930,445,0,0,drop,70,70,0,1,0,1,0
15576,51928,445,0,0,drop,70,70,0,1,0,1,0
15577,51927,445,0,0,drop,70,70,0,1,0,1,0
15578,65025,57866,0,0,deny,66,66,0,1,0,1,0
15579,50052,65008,0,0,deny,60,60,0,1,0,1,0
15580,61643,22114,0,0,deny,62,62,0,1,0,1,0
15581,63702,445,0,0,drop,66,66,0,1,0,1,0
15582,51922,445,0,0,drop,70,70,0,1,0,1,0
15583,63535,445,0,0,drop,70,70,0,1,0,1,0
15584,54121,25174,0,0,deny,62,62,0,1,0,1,0
15585,1114,37965,0,0,deny,62,62,0,1,0,1,0
15586,11878,37807,0,0,deny,62,62,0,1,0,1,0
15587,63699,445,0,0,drop,66,66,0,1,0,1,0
15588,55341,39004,0,0,deny,74,74,0,1,0,1,0
15589,63696,445,0,0,drop,66,66,0,1,0,1,0
15590,63695,445,0,0,drop,66,66,0,1,0,1,0
15591,54373,26467,0,0,deny,62,62,0,1,0,1,0
15592,63694,445,0,0,drop,66,66,0,1,0,1,0
15593,22574,44847,0,0,deny,62,62,0,1,0,1,0
15594,30304,26467,0,0,deny,62,62,0,1,0,1,0
15595,63531,445,0,0,drop,70,70,0,1,0,1,0
15596,63529,445,0,0,drop,70,70,0,1,0,1,0
15597,51918,445,0,0,drop,70,70,0,1,0,1,0
15598,0,0,0,0,allow,200,102,98,2,0,1,1
15599,63527,445,0,0,drop,70,70,0,1,0,1,0
15600,51904,445,0,0,drop,70,70,0,1,0,1,0
15601,47913,25174,0,0,deny,62,62,0,1,0,1,0
15602,28192,50584,0,0,deny,66,66,0,1,0,1,0
15603,60058,25174,0,0,deny,66,66,0,1,0,1,0
15604,63683,445,0,0,drop,66,66,0,1,0,1,0
15605,62097,57470,0,0,deny,146,146,0,1,0,1,0
15606,34914,26467,0,0,deny,62,62,0,1,0,1,0
15607,22948,26467,0,0,deny,62,62,0,1,0,1,0
15608,56872,21247,0,0,deny,74,74,0,1,0,1,0
15609,63520,445,0,0,drop,70,70,0,1,0,1,0
15610,63675,445,0,0,drop,66,66,0,1,0,1,0
15611,63518,445,0,0,drop,70,70,0,1,0,1,0
15612,51894,445,0,0,drop,70,70,0,1,0,1,0
15613,53097,25174,0,0,deny,66,66,0,1,0,1,0
15614,42344,48637,0,0,deny,60,60,0,1,0,1,0
15615,56387,25174,0,0,deny,66,66,0,1,0,1,0
15616,63517,445,0,0,drop,70,70,0,1,0,1,0
15617,63516,445,0,0,drop,70,70,0,1,0,1,0
15618,49514,52255,0,0,deny,162,162,0,1,0,1,0
15619,63515,445,0,0,drop,70,70,0,1,0,1,0
15620,63672,445,0,0,drop,66,66,0,1,0,1,0
15621,54883,60043,0,0,deny,62,62,0,1,0,1,0
15622,63509,445,0,0,drop,70,70,0,1,0,1,0
15623,63510,445,0,0,drop,70,70,0,1,0,1,0
15624,62189,64147,0,0,deny,62,62,0,1,0,1,0
15625,57991,22114,0,0,deny,66,66,0,1,0,1,0
15626,19875,30170,0,0,deny,145,145,0,1,0,1,0
15627,54578,26467,0,0,deny,66,66,0,1,0,1,0
15628,443,38956,0,0,deny,82,82,0,1,0,1,0
15629,49752,50584,0,0,deny,62,62,0,1,0,1,0
15630,51490,30228,0,0,deny,100,100,0,1,0,1,0
15631,6842,42873,0,0,deny,66,66,0,1,0,1,0
15632,17947,36237,0,0,deny,62,62,0,1,0,1,0
15633,64036,23718,0,0,deny,62,62,0,1,0,1,0
15634,63666,445,0,0,drop,66,66,0,1,0,1,0
15635,63595,51050,0,0,deny,62,62,0,1,0,1,0
15636,18683,26467,0,0,deny,62,62,0,1,0,1,0
15637,63497,445,0,0,drop,70,70,0,1,0,1,0
15638,63495,445,0,0,drop,70,70,0,1,0,1,0
15639,63658,445,0,0,drop,66,66,0,1,0,1,0
15640,63494,445,0,0,drop,70,70,0,1,0,1,0
15641,22408,22114,0,0,deny,62,62,0,1,0,1,0
15642,63487,445,0,0,drop,70,70,0,1,0,1,0
15643,63486,445,0,0,drop,70,70,0,1,0,1,0
15644,38018,443,11782,443,allow,1851,1222,629,16,27,10,6
15645,57578,80,57578,80,allow,55886,2728,53158,68,148,25,43
15646,27179,53,27179,53,allow,398,255,143,3,34,2,1
15647,61572,53,61572,53,allow,213,79,134,2,33,1,1
15648,1485,53,1485,53,allow,194,87,107,2,30,1,1
15649,49767,53,37135,53,allow,170,87,83,2,30,1,1
15650,52094,55986,52536,55986,allow,70,70,0,2,8,2,0
15651,38857,443,38857,443,allow,115031,5628,109403,143,104,55,88
15652,51410,443,1294,443,allow,619870,220857,399013,1045,123,531,514
15653,58946,443,24412,443,allow,3990,2586,1404,17,16,9,8
15654,50400,443,40237,443,allow,316,136,180,6,6,3,3
15655,2527,53,2527,53,allow,371,237,134,3,34,2,1
15656,21772,443,21772,443,allow,17221,1314,15907,31,44,16,15
15657,38860,443,38860,443,allow,15584,2721,12863,44,103,21,23
15658,57749,15000,61462,15000,allow,130,70,60,2,6,1,1
15659,35717,443,25554,443,allow,8290,2954,5336,24,361,13,11
15660,38862,443,38862,443,allow,23553,2583,20970,46,103,19,27
15661,52095,48896,12899,48896,allow,70,70,0,2,8,2,0
15662,56324,53,56324,53,allow,257,101,156,2,34,1,1
15663,38140,443,56534,443,allow,11484,3842,7642,30,31,16,14
15664,38858,443,38858,443,allow,226465,10306,216159,292,104,135,157
15665,60415,53,60415,53,allow,257,101,156,2,33,1,1
15666,59812,443,39961,443,allow,6412,1530,4882,24,255,11,13
15667,58943,443,29236,443,allow,6611,4273,2338,22,17,11,11
15668,62044,443,20776,443,allow,10530,2001,8529,29,47,14,15
15669,57577,80,57577,80,allow,172548,4355,168193,172,148,53,119
15670,48150,443,17947,443,allow,502,222,280,8,28,4,4
15671,29226,80,29226,80,allow,490,264,226,8,35,5,3
15672,50868,443,26459,443,allow,7646,1697,5949,31,271,15,16
15673,54776,443,51403,443,allow,9501,1502,7999,24,29,13,11
15674,55698,45710,57579,45710,allow,70,70,0,1,5,1,0
15675,54774,443,8128,443,allow,9501,1502,7999,24,29,13,11
15676,40196,443,61662,443,allow,24750,1845,22905,39,171,17,22
15677,55216,443,23383,443,allow,8058,5498,2560,20,120,11,9
15678,54775,443,48406,443,allow,9501,1502,7999,24,29,13,11
15679,51762,443,40334,443,allow,5048,2345,2703,13,121,7,6
15680,55038,443,38606,443,allow,30239,8906,21333,61,32,34,27
15681,58994,443,55812,443,allow,3284,1878,1406,20,27,11,9
15682,49749,80,64733,80,allow,230959,4381,226578,217,91,60,157
15683,56705,53,36648,53,allow,711,87,624,2,30,1,1
15684,55854,443,29147,443,allow,3387,1672,1715,24,270,11,13
15685,42378,443,63662,443,allow,1970,1231,739,14,30,8,6
15686,58987,443,9430,443,allow,3730,2378,1352,23,28,12,11
15687,41882,443,10450,443,allow,7218,4166,3052,38,133,19,19
15688,64913,53,45280,53,allow,188,96,92,2,30,1,1
15689,56285,53,40728,53,allow,711,87,624,2,30,1,1
15690,49420,53,3179,53,allow,170,87,83,2,31,1,1
15691,30960,45762,15257,45762,allow,330,330,0,6,3609,6,0
15692,57051,53,63796,53,allow,783,96,687,2,30,1,1
15693,55423,53,61643,53,allow,711,87,624,2,31,1,1
15694,38049,53,38049,53,allow,213,87,126,2,31,1,1
15695,65388,53,55189,53,allow,764,99,665,2,31,1,1
15696,40549,443,33434,443,allow,5591,3194,2397,16,122,8,8
15697,4483,53,4483,53,allow,213,87,126,2,31,1,1
15698,44274,53,0,0,allow,82,82,0,1,31,1,0
15699,60432,443,46333,443,allow,4355,2135,2220,15,136,7,8
15700,57978,5228,59102,5228,allow,2725,1610,1115,20,3600,10,10
15701,59360,53,6794,53,allow,429,116,313,2,31,1,1
15702,49676,53,60800,53,allow,322,110,212,4,31,2,2
15703,55897,53,62688,53,allow,711,87,624,2,31,1,1
15704,50280,53,20623,53,allow,916,86,830,2,31,1,1
15705,54691,443,33638,443,allow,4851,1269,3582,21,148,9,12
15706,48817,1024,48817,1024,allow,152,152,0,1,1200,1,0
15707,40204,40001,61401,40001,allow,244,181,63,2,31,1,1
15708,48817,32794,48817,32794,allow,152,152,0,1,1200,1,0
15709,61660,64097,0,0,deny,62,62,0,1,0,1,0
15710,15806,11392,0,0,deny,66,66,0,1,0,1,0
15711,55600,22,0,0,deny,60,60,0,1,0,1,0
15712,55167,48817,0,0,deny,66,66,0,1,0,1,0
15713,31609,26296,0,0,deny,148,148,0,1,0,1,0
15714,4019,50584,0,0,deny,66,66,0,1,0,1,0
15715,9836,22114,0,0,deny,62,62,0,1,0,1,0
15716,51887,445,0,0,drop,70,70,0,1,0,1,0
15717,51885,445,0,0,drop,70,70,0,1,0,1,0
15718,51882,445,0,0,drop,70,70,0,1,0,1,0
15719,59282,51050,0,0,deny,66,66,0,1,0,1,0
15720,63646,445,0,0,drop,66,66,0,1,0,1,0
15721,56755,443,40162,443,allow,8059,2039,6020,20,15,11,9
15722,63644,445,0,0,drop,66,66,0,1,0,1,0
15723,63645,445,0,0,drop,66,66,0,1,0,1,0
15724,63647,445,0,0,drop,66,66,0,1,0,1,0
15725,63643,445,0,0,drop,66,66,0,1,0,1,0
15726,63642,445,0,0,drop,66,66,0,1,0,1,0
15727,63649,445,0,0,drop,66,66,0,1,0,1,0
15728,63641,445,0,0,drop,66,66,0,1,0,1,0
15729,26884,37965,0,0,deny,66,66,0,1,0,1,0
15730,6828,64322,0,0,deny,60,60,0,1,0,1,0
15731,26879,37965,0,0,deny,62,62,0,1,0,1,0
15732,51490,17500,0,0,deny,100,100,0,1,0,1,0
15733,42231,57470,0,0,deny,78,78,0,1,0,1,0
15734,63475,445,0,0,drop,70,70,0,1,0,1,0
15735,55408,64147,0,0,deny,66,66,0,1,0,1,0
15736,60113,22114,0,0,deny,66,66,0,1,0,1,0
15737,63741,50584,0,0,deny,66,66,0,1,0,1,0
15738,59303,21247,0,0,deny,66,66,0,1,0,1,0
15739,61550,5529,0,0,deny,145,145,0,1,0,1,0
15740,54021,25174,0,0,deny,62,62,0,1,0,1,0
15741,16620,25174,0,0,deny,62,62,0,1,0,1,0
15742,45169,14037,0,0,deny,74,74,0,1,0,1,0
15743,443,38956,0,0,deny,82,82,0,1,0,1,0
15744,13294,64147,0,0,deny,145,145,0,1,0,1,0
15745,45535,25174,0,0,deny,66,66,0,1,0,1,0
15746,13525,51505,0,0,deny,62,62,0,1,0,1,0
15747,10949,22114,0,0,deny,62,62,0,1,0,1,0
15748,57369,1433,0,0,deny,60,60,0,1,0,1,0
15749,59209,25174,0,0,deny,62,62,0,1,0,1,0
15750,51490,57587,0,0,deny,100,100,0,1,0,1,0
15751,51880,445,0,0,drop,70,70,0,1,0,1,0
15752,51879,445,0,0,drop,70,70,0,1,0,1,0
15753,51877,445,0,0,drop,70,70,0,1,0,1,0
15754,51866,445,0,0,drop,70,70,0,1,0,1,0
15755,63471,445,0,0,drop,70,70,0,1,0,1,0
15756,51490,50432,0,0,deny,100,100,0,1,0,1,0
15757,49694,5900,0,0,deny,60,60,0,1,0,1,0
15758,51728,44847,0,0,deny,66,66,0,1,0,1,0
15759,50052,65010,0,0,deny,60,60,0,1,0,1,0
15760,63628,445,0,0,drop,66,66,0,1,0,1,0
15761,63627,445,0,0,drop,66,66,0,1,0,1,0
15762,63626,445,0,0,drop,66,66,0,1,0,1,0
15763,35626,22114,0,0,deny,66,66,0,1,0,1,0
15764,60885,443,31610,443,allow,887,542,345,11,15,6,5
15765,50895,80,56986,80,allow,9046,1139,7907,20,255,11,9
15766,60849,80,64699,80,allow,9729,876,8853,21,45,11,10
15767,53859,34334,7486,34334,allow,492,306,186,8,14,5,3
15768,55868,53,41641,53,allow,177,94,83,2,29,1,1
15769,56741,443,24400,443,allow,9868,2027,7841,24,20,12,12
15770,38861,443,38861,443,allow,90303,5838,84465,140,103,68,72
15771,9418,443,37541,443,allow,5691,503,5188,14,15,7,7
15772,34495,80,62171,80,allow,1026,417,609,7,19,5,2
15773,60480,80,35551,80,allow,7406,1038,6368,18,16,10,8
15774,49193,443,7514,443,allow,3283,665,2618,16,160,7,9
15775,55700,26957,33294,26957,allow,70,70,0,2,8,2,0
15776,56670,80,44971,80,allow,234,234,0,4,12,4,0
15777,58894,443,4103,443,allow,152,86,66,2,4,1,1
15778,55695,28182,59050,28182,allow,504,318,186,8,16,5,3
15779,65129,443,48258,443,allow,1765,1126,639,17,125,10,7
15780,57587,80,57587,80,allow,218150,5323,212827,218,145,69,149
15781,56303,53,63690,53,allow,177,94,83,2,29,1,1
15782,49704,80,54649,80,allow,2058,589,1469,10,44,6,4
15783,64913,53,33116,53,allow,194,102,92,2,30,1,1
15784,64022,60918,37297,60918,allow,66,66,0,2,7,2,0
15785,9824,53,59579,53,allow,179,86,93,2,29,1,1
15786,55193,53,27254,53,allow,177,94,83,2,30,1,1
15787,42101,443,25094,443,allow,4904,1934,2970,17,135,8,9
15788,48861,53,40652,53,allow,164,78,86,2,30,1,1
15789,34105,443,37693,443,allow,43883,3446,40437,57,122,22,35
15790,38866,443,54319,443,allow,16577,10269,6308,33,17,20,13
15791,49214,443,63008,443,allow,7177,2666,4511,20,15,11,9
15792,50662,443,50298,443,allow,4190,1882,2308,17,19,10,7
15793,56604,443,32761,443,allow,7314,2061,5253,29,92,15,14
15794,52246,443,52246,443,allow,1615,941,674,15,21,7,8
15795,64787,53,13133,53,allow,299,101,198,4,34,2,2
15796,56756,443,23896,443,allow,8007,1987,6020,20,15,11,9
15797,49222,443,64126,443,allow,476852,12774,464078,491,17,177,314
15798,60882,443,27723,443,allow,4485,794,3691,17,25,9,8
15799,65209,53,43414,53,allow,585,206,379,6,79,3,3
15800,49386,53,12060,53,allow,332,102,230,2,30,1,1
15801,49420,53,37701,53,allow,185,102,83,2,30,1,1
15802,54199,443,3753,443,allow,26903,3579,23324,72,278,33,39
15803,58640,443,44043,443,allow,4440,114,4326,7,122,2,5
15804,55228,443,61820,443,allow,12645,4916,7729,39,94,22,17
15805,58140,53,58140,53,allow,262,106,156,2,34,1,1
15806,55699,21063,52402,21063,allow,70,70,0,1,5,1,0
15807,63201,53,63201,53,allow,262,106,156,2,32,1,1
15808,57204,443,62645,443,allow,340,140,200,6,25,3,3
15809,49925,53,18861,53,allow,953,215,738,6,46,3,3
15810,56360,443,55866,443,allow,188316,24744,163572,302,172,119,183
15811,55193,53,2306,53,allow,177,94,83,2,30,1,1
15812,64636,53,4639,53,allow,325,102,223,2,30,1,1
15813,65336,53,64946,53,allow,275,94,181,2,30,1,1
15814,49367,53,52320,53,allow,718,94,624,2,30,1,1
15815,64528,53,42814,53,allow,353,118,235,2,30,1,1
15816,55347,443,36174,443,allow,3811,2320,1491,33,735,18,15
15817,56510,443,37047,443,allow,8742,2483,6259,41,114,22,19
15818,50670,80,2254,80,allow,1658,1247,411,8,15,5,3
15819,41916,443,13885,443,allow,8634,3251,5383,24,17,14,10
15820,32837,443,39597,443,allow,3167,1498,1669,19,315,10,9
15821,53125,443,2099,443,allow,7738,2230,5508,24,45,14,10
15822,44641,80,65447,80,allow,1354,850,504,13,256,8,5
15823,24988,53,24988,53,allow,214,82,132,2,33,1,1
15824,54197,443,61116,443,allow,190,70,120,4,15,2,2
15825,52093,40828,32567,40828,allow,258,70,188,4,8,2,2
15826,64025,26826,22306,26826,allow,66,66,0,2,7,2,0
15827,53883,24830,47697,24830,allow,258,70,188,4,7,2,2
15828,50360,80,38167,80,allow,5307,2694,2613,17,25,9,8
15829,57604,443,23765,443,allow,2614,1689,925,18,21,10,8
15830,57544,7000,57544,7000,allow,3502,1935,1567,15,15,8,7
15831,38822,80,14880,80,allow,810,413,397,7,19,5,2
15832,57592,80,57592,80,allow,3118,689,2429,13,144,6,7
15833,53884,48754,60851,48754,allow,70,70,0,2,7,2,0
15834,52065,52021,23578,52021,allow,70,70,0,1,4,1,0
15835,43892,443,53731,443,allow,9754,4277,5477,27,330,14,13
15836,45077,443,30343,443,allow,9599,1234,8365,27,29,15,12
15837,57444,53,13400,53,allow,198,94,104,2,29,1,1
15838,49767,53,3628,53,allow,177,94,83,2,29,1,1
15839,32578,443,32578,443,allow,25033,2433,22600,42,25,21,21
15840,50616,53,45129,53,allow,177,94,83,2,30,1,1
15841,64913,53,23262,53,allow,194,102,92,2,29,1,1
15842,55222,53,59150,53,allow,1210,950,260,2,29,1,1
15843,64773,53,48477,53,allow,328,150,178,2,30,1,1
15844,33080,53,44512,53,allow,86,86,0,1,29,1,0
15845,42318,53,4117,53,allow,164,78,86,2,30,1,1
15846,65117,53,25899,53,allow,230,94,136,2,30,1,1
15847,59753,27016,15718,27016,allow,1718,1386,332,8,30,4,4
15848,44757,53,59516,53,allow,179,86,93,2,30,1,1
15849,49491,443,61216,443,allow,33157,17446,15711,66,135,38,28
15850,49666,53,7037,53,allow,325,126,199,2,30,1,1
15851,64750,53,14070,53,allow,276,102,174,2,30,1,1
15852,55542,443,7716,443,allow,11550,3336,8214,52,130,25,27
15853,57307,443,55707,443,allow,35035,5135,29900,81,216,33,48
15854,36411,443,59094,443,allow,10691,3704,6987,25,181,13,12
15855,56757,443,9849,443,allow,8057,2037,6020,20,15,11,9
15856,53163,32834,24170,32834,allow,70,70,0,2,8,2,0
15857,41269,443,9096,443,allow,78,78,0,1,5,1,0
15858,57591,80,57591,80,allow,144228,2522,141706,135,144,36,99
15859,49490,53,51051,53,allow,246,94,152,2,30,1,1
15860,33546,53,33546,53,allow,400,257,143,3,32,2,1
15861,50659,80,44031,80,allow,24433,3378,21055,31,21,12,19
15862,50358,80,6074,80,allow,306,180,126,6,25,4,2
15863,46193,53,56530,53,allow,311,86,225,2,30,1,1
15864,43539,53,26606,53,allow,168,78,90,2,30,1,1
15865,38700,53,38476,53,allow,164,78,86,2,30,1,1
15866,64173,53,16220,53,allow,210,94,116,2,30,1,1
15867,64986,27049,14066,27049,allow,1764,924,840,6,31,3,3
15868,47400,80,8007,80,allow,9083,1822,7261,20,257,5,15
15869,48817,13259,48817,13259,allow,460,150,310,2,1200,1,1
15870,50654,123,28946,123,allow,184,94,90,2,30,1,1
15871,50616,53,27498,53,allow,177,94,83,2,30,1,1
15872,55026,53,14938,53,allow,177,94,83,2,30,1,1
15873,57044,53,54820,53,allow,177,94,83,2,31,1,1
15874,57169,53,45860,53,allow,177,94,83,2,31,1,1
15875,50265,15402,25420,15402,allow,1450,747,703,16,1200,9,7
15876,49160,16767,65061,16767,allow,854,150,704,4,1200,2,2
15877,50265,57799,36521,57799,allow,1450,747,703,16,1200,9,7
15878,55063,5223,9362,5223,allow,4336,1518,2818,23,3002,14,9
15879,37965,63666,47723,63666,allow,10717,6715,4002,121,4588,71,50
15880,49453,53,64414,53,allow,227,110,117,2,31,1,1
15881,34179,80,3058,80,allow,2137,1258,879,11,150,6,5
15882,55877,56299,54578,56299,allow,481,150,331,2,1200,1,1
15883,52089,16543,21777,16543,allow,70,70,0,2,9,2,0
15884,53863,8999,63067,8999,allow,70,70,0,1,5,1,0
15885,64012,40642,7765,40642,allow,70,70,0,1,5,1,0
15886,55185,443,43469,443,allow,6389,1163,5226,19,25,11,8
15887,51414,443,57873,443,allow,8292,2164,6128,31,120,17,14
15888,56754,443,15698,443,allow,8006,1986,6020,20,16,11,9
15889,58949,443,63115,443,allow,5166,700,4466,16,15,7,9
15890,53722,443,28671,443,allow,70,70,0,1,5,1,0
15891,52064,43273,64418,43273,allow,70,70,0,1,5,1,0
15892,51412,443,35247,443,allow,200230,8733,191497,250,122,106,144
15893,50379,80,42640,80,allow,1083,653,430,8,16,5,3
15894,65323,27047,12346,27047,allow,1233,924,309,6,31,3,3
15895,37336,443,19104,443,allow,995086,50081,945005,1281,216,515,766
15896,64123,443,56759,443,allow,1411,852,559,13,25,7,6
15897,65451,53,3084,53,allow,728,234,494,6,67,3,3
15898,55026,53,50435,53,allow,177,94,83,2,30,1,1
15899,8949,53,8949,53,allow,832,106,726,2,30,1,1
15900,57306,53,57306,53,allow,220,90,130,2,30,1,1
15901,57452,53,57452,53,allow,203,82,121,2,30,1,1
15902,63462,445,0,0,drop,70,70,0,1,0,1,0
15903,63459,445,0,0,drop,70,70,0,1,0,1,0
15904,63460,445,0,0,drop,70,70,0,1,0,1,0
15905,29145,8168,0,0,deny,62,62,0,1,0,1,0
15906,63030,25174,0,0,deny,62,62,0,1,0,1,0
15907,63458,445,0,0,drop,70,70,0,1,0,1,0
15908,58120,25174,0,0,deny,62,62,0,1,0,1,0
15909,50609,2323,0,0,deny,60,60,0,1,0,1,0
15910,1500,10387,0,0,deny,157,157,0,1,0,1,0
15911,63455,445,0,0,drop,70,70,0,1,0,1,0
15912,51863,445,0,0,drop,70,70,0,1,0,1,0
15913,50106,30317,0,0,deny,66,66,0,1,0,1,0
15914,27679,37965,0,0,deny,62,62,0,1,0,1,0
15915,51861,445,0,0,drop,70,70,0,1,0,1,0
15916,51858,445,0,0,drop,70,70,0,1,0,1,0
15917,51852,445,0,0,drop,70,70,0,1,0,1,0
15918,49993,37965,0,0,deny,66,66,0,1,0,1,0
15919,57251,37965,0,0,deny,62,62,0,1,0,1,0
15920,1024,63737,0,0,deny,518,518,0,1,0,1,0
15921,29045,41864,0,0,deny,159,159,0,1,0,1,0
15922,443,38956,0,0,deny,82,82,0,1,0,1,0
15923,19747,37965,0,0,deny,62,62,0,1,0,1,0
15924,54917,60043,0,0,deny,66,66,0,1,0,1,0
15925,63385,25174,0,0,deny,66,66,0,1,0,1,0
15926,45682,37965,0,0,deny,62,62,0,1,0,1,0
15927,2837,25174,0,0,deny,62,62,0,1,0,1,0
15928,63449,445,0,0,drop,70,70,0,1,0,1,0
15929,50549,43890,0,0,deny,62,62,0,1,0,1,0
15930,1827,64147,0,0,deny,66,66,0,1,0,1,0
15931,2991,23,0,0,deny,60,60,0,1,0,1,0
15932,50321,48817,0,0,deny,143,143,0,1,0,1,0
15933,38586,3855,0,0,deny,145,145,0,1,0,1,0
15934,10910,57866,0,0,deny,62,62,0,1,0,1,0
15935,10910,57866,0,0,deny,146,146,0,1,0,1,0
15936,51845,445,0,0,drop,70,70,0,1,0,1,0
15937,33328,25174,0,0,deny,62,62,0,1,0,1,0
15938,51843,445,0,0,drop,70,70,0,1,0,1,0
15939,51841,445,0,0,drop,70,70,0,1,0,1,0
15940,63441,445,0,0,drop,70,70,0,1,0,1,0
15941,2332,35440,0,0,deny,66,66,0,1,0,1,0
15942,63438,445,0,0,drop,70,70,0,1,0,1,0
15943,50857,26467,0,0,deny,66,66,0,1,0,1,0
15944,37034,25174,0,0,deny,62,62,0,1,0,1,0
15945,63615,445,0,0,drop,66,66,0,1,0,1,0
15946,52166,26467,0,0,deny,66,66,0,1,0,1,0
15947,65159,37965,0,0,deny,74,74,0,1,0,1,0
15948,22856,22114,0,0,deny,66,66,0,1,0,1,0
15949,22677,25174,0,0,deny,66,66,0,1,0,1,0
15950,50563,37965,0,0,deny,66,66,0,1,0,1,0
15951,63435,445,0,0,drop,70,70,0,1,0,1,0
15952,59535,25174,0,0,deny,62,62,0,1,0,1,0
15953,7423,22114,0,0,deny,146,146,0,1,0,1,0
15954,63433,445,0,0,drop,70,70,0,1,0,1,0
15955,52537,57866,0,0,deny,66,66,0,1,0,1,0
15956,10128,23718,0,0,deny,146,146,0,1,0,1,0
15957,51837,445,0,0,drop,70,70,0,1,0,1,0
15958,443,38956,0,0,deny,82,82,0,1,0,1,0
15959,26263,8168,0,0,deny,66,66,0,1,0,1,0
15960,60869,48817,0,0,deny,66,66,0,1,0,1,0
15961,52494,36237,0,0,deny,62,62,0,1,0,1,0
15962,51836,445,0,0,drop,70,70,0,1,0,1,0
15963,47089,22114,0,0,deny,146,146,0,1,0,1,0
15964,63888,25174,0,0,deny,62,62,0,1,0,1,0
15965,63429,445,0,0,drop,70,70,0,1,0,1,0
15966,51602,22114,0,0,deny,66,66,0,1,0,1,0
15967,59599,62413,0,0,deny,146,146,0,1,0,1,0
15968,4788,53,4788,53,allow,825,99,726,2,0,1,1
15969,51425,37450,0,0,deny,66,66,0,1,0,1,0
15970,63599,445,0,0,drop,66,66,0,1,0,1,0
15971,63598,445,0,0,drop,66,66,0,1,0,1,0
15972,63428,445,0,0,drop,70,70,0,1,0,1,0
15973,56590,25174,0,0,deny,66,66,0,1,0,1,0
15974,49333,25174,0,0,deny,62,62,0,1,0,1,0
15975,60159,22114,0,0,deny,66,66,0,1,0,1,0
15976,1238,51505,0,0,deny,62,62,0,1,0,1,0
15977,64922,26296,0,0,deny,148,148,0,1,0,1,0
15978,51815,445,0,0,drop,70,70,0,1,0,1,0
15979,62579,57866,0,0,deny,66,66,0,1,0,1,0
15980,6929,35440,0,0,deny,66,66,0,1,0,1,0
15981,51825,445,0,0,drop,70,70,0,1,0,1,0
15982,51823,445,0,0,drop,70,70,0,1,0,1,0
15983,51822,445,0,0,drop,70,70,0,1,0,1,0
15984,6247,51221,0,0,deny,78,78,0,1,0,1,0
15985,48605,50584,0,0,deny,146,146,0,1,0,1,0
15986,63423,445,0,0,drop,70,70,0,1,0,1,0
15987,63596,445,0,0,drop,66,66,0,1,0,1,0
15988,42034,28189,0,0,deny,62,62,0,1,0,1,0
15989,25296,51505,0,0,deny,66,66,0,1,0,1,0
15990,64024,22114,0,0,deny,66,66,0,1,0,1,0
15991,61185,54532,0,0,deny,62,62,0,1,0,1,0
15992,27300,6881,0,0,deny,62,62,0,1,0,1,0
15993,63586,445,0,0,drop,66,66,0,1,0,1,0
15994,63590,445,0,0,drop,66,66,0,1,0,1,0
15995,63585,445,0,0,drop,66,66,0,1,0,1,0
15996,63579,445,0,0,drop,66,66,0,1,0,1,0
15997,63588,445,0,0,drop,66,66,0,1,0,1,0
15998,63582,445,0,0,drop,66,66,0,1,0,1,0
15999,63581,445,0,0,drop,66,66,0,1,0,1,0
16000,5222,32859,0,0,deny,66,66,0,1,0,1,0
16001,51811,445,0,0,drop,70,70,0,1,0,1,0
16002,51806,445,0,0,drop,70,70,0,1,0,1,0
16003,51805,445,0,0,drop,70,70,0,1,0,1,0
16004,51803,445,0,0,drop,70,70,0,1,0,1,0
16005,1190,25174,0,0,deny,62,62,0,1,0,1,0
16006,11136,19910,0,0,deny,62,62,0,1,0,1,0
16007,18750,57866,0,0,deny,62,62,0,1,0,1,0
16008,443,2629,0,0,deny,135,135,0,1,0,1,0
16009,63410,445,0,0,drop,70,70,0,1,0,1,0
16010,65289,25174,0,0,deny,66,66,0,1,0,1,0
16011,17982,11392,0,0,deny,62,62,0,1,0,1,0
16012,26301,22114,0,0,deny,146,146,0,1,0,1,0
16013,7288,25174,0,0,deny,66,66,0,1,0,1,0
16014,21064,25174,0,0,deny,146,146,0,1,0,1,0
16015,56800,23,0,0,deny,60,60,0,1,0,1,0
16016,1264,26296,0,0,deny,143,143,0,1,0,1,0
16017,1638,22114,0,0,deny,62,62,0,1,0,1,0
16018,1356,57470,0,0,deny,72,72,0,1,0,1,0
16019,63407,445,0,0,drop,70,70,0,1,0,1,0
16020,35011,37965,0,0,deny,62,62,0,1,0,1,0
16021,51800,445,0,0,drop,70,70,0,1,0,1,0
16022,51799,445,0,0,drop,70,70,0,1,0,1,0
16023,51798,445,0,0,drop,70,70,0,1,0,1,0
16024,63573,445,0,0,drop,66,66,0,1,0,1,0
16025,51794,445,0,0,drop,70,70,0,1,0,1,0
16026,63569,445,0,0,drop,66,66,0,1,0,1,0
16027,53495,37807,0,0,deny,66,66,0,1,0,1,0
16028,46537,25174,0,0,deny,62,62,0,1,0,1,0
16029,63568,445,0,0,drop,66,66,0,1,0,1,0
16030,63566,445,0,0,drop,66,66,0,1,0,1,0
16031,22783,64147,0,0,deny,66,66,0,1,0,1,0
16032,10003,64147,0,0,deny,62,62,0,1,0,1,0
16033,56621,50584,0,0,deny,62,62,0,1,0,1,0
16034,65389,26467,0,0,deny,62,62,0,1,0,1,0
16035,63564,445,0,0,drop,66,66,0,1,0,1,0
16036,56629,25174,0,0,deny,66,66,0,1,0,1,0
16037,64162,22114,0,0,deny,146,146,0,1,0,1,0
16038,63403,445,0,0,drop,70,70,0,1,0,1,0
16039,63401,445,0,0,drop,70,70,0,1,0,1,0
16040,48125,7548,0,0,deny,60,60,0,1,0,1,0
16041,63399,445,0,0,drop,70,70,0,1,0,1,0
16042,12545,43890,0,0,deny,146,146,0,1,0,1,0
16043,51789,445,0,0,drop,70,70,0,1,0,1,0
16044,1114,37965,0,0,deny,62,62,0,1,0,1,0
16045,5228,3434,0,0,deny,345,345,0,1,0,1,0
16046,51783,445,0,0,drop,70,70,0,1,0,1,0
16047,51777,445,0,0,drop,70,70,0,1,0,1,0
16048,42344,48637,0,0,deny,60,60,0,1,0,1,0
16049,9087,37965,0,0,deny,62,62,0,1,0,1,0
16050,63553,445,0,0,drop,66,66,0,1,0,1,0
16051,10091,22114,0,0,deny,62,62,0,1,0,1,0
16052,63587,22114,0,0,deny,62,62,0,1,0,1,0
16053,63392,445,0,0,drop,70,70,0,1,0,1,0
16054,60261,25174,0,0,deny,66,66,0,1,0,1,0
16055,63390,445,0,0,drop,70,70,0,1,0,1,0
16056,48019,22114,0,0,deny,66,66,0,1,0,1,0
16057,10273,21247,0,0,deny,62,62,0,1,0,1,0
16058,27144,25174,0,0,deny,66,66,0,1,0,1,0
16059,53822,25174,0,0,deny,66,66,0,1,0,1,0
16060,63546,445,0,0,drop,66,66,0,1,0,1,0
16061,58228,53733,0,0,deny,62,62,0,1,0,1,0
16062,51767,445,0,0,drop,70,70,0,1,0,1,0
16063,63389,445,0,0,drop,70,70,0,1,0,1,0
16064,34396,443,45872,443,allow,6214,1750,4464,24,316,12,12
16065,64803,80,9867,80,allow,5518,527,4991,13,75,6,7
16066,9413,443,2971,443,allow,3510,430,3080,10,15,6,4
16067,44205,443,40929,443,allow,13019,4593,8426,71,350,34,37
16068,60470,51413,5081,51413,allow,741,435,306,10,16,5,5
16069,51960,443,28367,443,allow,2648,1797,851,19,23,11,8
16070,51618,15000,8356,15000,allow,130,70,60,2,5,1,1
16071,34704,443,48562,443,allow,10207,3126,7081,26,24,14,12
16072,10036,80,8198,80,allow,2058,589,1469,10,46,6,4
16073,49676,53,19443,53,allow,216,110,106,2,30,1,1
16074,58910,443,57868,443,allow,27575,18478,9097,64,22,36,28
16075,48275,15000,58699,15000,allow,130,70,60,2,5,1,1
16076,55563,443,55563,443,allow,4628,1721,2907,19,30,11,8
16077,49655,80,10831,80,allow,6485767,147003,6338764,6221,320,2024,4197
16078,57001,53,10240,53,allow,170,87,83,2,31,1,1
16079,40204,40039,52941,40039,allow,152,90,62,2,31,1,1
16080,54950,443,18760,443,allow,5281,1393,3888,22,16,13,9
16081,53891,1056,54785,1056,allow,260,140,120,5,6,3,2
16082,45122,15000,56634,15000,allow,130,70,60,2,5,1,1
16083,49994,443,47759,443,allow,352,292,60,2,5,1,1
16084,53838,15000,39426,15000,allow,130,70,60,2,5,1,1
16085,9414,443,33463,443,allow,5689,501,5188,14,15,7,7
16086,62693,443,62693,443,allow,4788,1881,2907,19,31,11,8
16087,52245,443,52245,443,allow,1615,941,674,15,21,7,8
16088,57965,443,27190,443,allow,8366,2018,6348,32,104,17,15
16089,59084,443,59084,443,allow,4598,1691,2907,19,30,11,8
16090,50387,443,3636,443,allow,2227,1018,1209,17,16,8,9
16091,64802,80,15134,80,allow,2424,529,1895,11,75,6,5
16092,41278,443,28567,443,allow,7238,2601,4637,20,17,10,10
16093,50354,80,47927,80,allow,306,180,126,6,25,4,2
16094,54516,53,54516,53,allow,235,90,145,2,33,1,1
16095,55454,53,60300,53,allow,168,86,82,2,33,1,1
16096,51408,443,61197,443,allow,1576,789,787,17,122,9,8
16097,49450,443,10791,443,allow,5792,1511,4281,19,77,11,8
16098,42023,443,45040,443,allow,42402,3988,38414,82,89,39,43
16099,47091,15000,23609,15000,allow,138,78,60,2,6,1,1
16100,47168,15000,16770,15000,allow,130,70,60,2,5,1,1
16101,57912,443,57912,443,allow,4559,1652,2907,19,27,11,8
16102,50604,80,50604,80,allow,1707,1007,700,11,21,6,5
16103,51959,443,27606,443,allow,2648,1797,851,19,23,11,8
16104,58939,443,28561,443,allow,6403,4065,2338,22,16,11,11
16105,32866,443,34870,443,allow,23467,16522,6945,51,161,29,22
16106,49721,80,41494,80,allow,340,140,200,6,15,3,3
16107,6960,53,6960,53,allow,186,83,103,2,30,1,1
16108,56225,53,16256,53,allow,188,96,92,2,30,1,1
16109,49696,443,61815,443,allow,42348,4871,37477,71,150,40,31
16110,49330,443,4383,443,allow,7913,2091,5822,23,42,11,12
16111,52138,443,52138,443,allow,80933,20860,60073,121,324,66,55
16112,56800,443,5999,443,allow,8337,2820,5517,19,30,10,9
16113,53861,53065,56189,53065,allow,70,70,0,1,5,1,0
16114,52058,8329,7251,8329,allow,66,66,0,1,5,1,0
16115,58936,443,15489,443,allow,10014,6664,3350,28,17,14,14
16116,58874,443,39745,443,allow,21478,2212,19266,47,86,19,28
16117,56528,443,48835,443,allow,158084,6138,151946,173,95,64,109
16118,56553,53,20095,53,allow,701,88,613,2,30,1,1
16119,57169,53,44732,53,allow,170,87,83,2,30,1,1
16120,56879,53,15909,53,allow,780,93,687,2,31,1,1
16121,6881,51413,48817,51413,allow,200,111,89,2,1200,1,1
16122,65528,53,47715,53,allow,217,75,142,4,30,2,2
16123,55065,53,19490,53,allow,711,87,624,2,30,1,1
16124,56181,53,54189,53,allow,764,99,665,2,31,1,1
16125,49485,53,58732,53,allow,752,93,659,2,31,1,1
16126,56728,53,40582,53,allow,744,95,649,2,31,1,1
16127,54692,443,45906,443,allow,5907,2630,3277,21,147,10,11
16128,55036,53,30063,53,allow,733,93,640,2,31,1,1
16129,50038,53,5932,53,allow,170,87,83,2,31,1,1
16130,52707,443,49592,443,allow,39551,4663,34888,60,357,27,33
16131,64877,53,24917,53,allow,182,93,89,2,31,1,1
16132,55214,53,41945,53,allow,711,87,624,2,31,1,1
16133,57246,53,12706,53,allow,752,93,659,2,31,1,1
16134,39717,5228,64597,5228,allow,7587,2099,5488,26,3602,14,12
16135,64931,53,32751,53,allow,174,89,85,2,31,1,1
16136,57109,53,44560,53,allow,711,87,624,2,31,1,1
16137,50645,53,43858,53,allow,256,93,163,2,31,1,1
16138,55318,53,46114,53,allow,711,87,624,2,31,1,1
16139,50550,5228,24310,5228,allow,2661,1518,1143,18,3600,9,9
16140,63388,445,0,0,drop,70,70,0,1,0,1,0
16141,63387,445,0,0,drop,70,70,0,1,0,1,0
16142,25457,25604,0,0,deny,145,145,0,1,0,1,0
16143,63384,445,0,0,drop,70,70,0,1,0,1,0
16144,63385,445,0,0,drop,70,70,0,1,0,1,0
16145,63545,25174,0,0,deny,66,66,0,1,0,1,0
16146,63543,445,0,0,drop,66,66,0,1,0,1,0
16147,1847,64147,0,0,deny,66,66,0,1,0,1,0
16148,56127,37965,0,0,deny,66,66,0,1,0,1,0
16149,47357,50584,0,0,deny,62,62,0,1,0,1,0
16150,63369,445,0,0,drop,70,70,0,1,0,1,0
16151,63368,445,0,0,drop,70,70,0,1,0,1,0
16152,44993,53,47761,53,allow,168,78,90,2,30,1,1
16153,57136,53,53104,53,allow,177,94,83,2,30,1,1
16154,65513,53,25094,53,allow,178,94,84,2,30,1,1
16155,36191,443,31290,443,allow,9386,1934,7452,32,135,17,15
16156,60475,443,46189,443,allow,5888,1175,4713,19,43,11,8
16157,60721,22114,0,0,deny,62,62,0,1,0,1,0
16158,63362,445,0,0,drop,70,70,0,1,0,1,0
16159,63536,445,0,0,drop,66,66,0,1,0,1,0
16160,58900,37807,0,0,deny,66,66,0,1,0,1,0
16161,63359,445,0,0,drop,70,70,0,1,0,1,0
16162,63358,445,0,0,drop,70,70,0,1,0,1,0
16163,63527,445,0,0,drop,66,66,0,1,0,1,0
16164,59523,37965,0,0,deny,62,62,0,1,0,1,0
16165,55425,37965,0,0,deny,66,66,0,1,0,1,0
16166,53207,50584,0,0,deny,66,66,0,1,0,1,0
16167,50126,23117,0,0,deny,62,62,0,1,0,1,0
16168,62796,37807,0,0,deny,62,62,0,1,0,1,0
16169,12830,25174,0,0,deny,146,146,0,1,0,1,0
16170,56711,25174,0,0,deny,62,62,0,1,0,1,0
16171,48230,57866,0,0,deny,62,62,0,1,0,1,0
16172,51759,445,0,0,drop,70,70,0,1,0,1,0
16173,51754,445,0,0,drop,70,70,0,1,0,1,0
16174,51755,445,0,0,drop,70,70,0,1,0,1,0
16175,63347,445,0,0,drop,70,70,0,1,0,1,0
16176,50446,26467,0,0,deny,66,66,0,1,0,1,0
16177,63517,445,0,0,drop,66,66,0,1,0,1,0
16178,63518,445,0,0,drop,66,66,0,1,0,1,0
16179,63515,445,0,0,drop,66,66,0,1,0,1,0
16180,63520,445,0,0,drop,66,66,0,1,0,1,0
16181,63513,445,0,0,drop,66,66,0,1,0,1,0
16182,63514,445,0,0,drop,66,66,0,1,0,1,0
16183,63519,445,0,0,drop,66,66,0,1,0,1,0
16184,63512,445,0,0,drop,66,66,0,1,0,1,0
16185,59018,22114,0,0,deny,62,62,0,1,0,1,0
16186,68,67,0,0,deny,346,346,0,1,0,1,0
16187,58509,21247,0,0,deny,66,66,0,1,0,1,0
16188,53373,64147,0,0,deny,66,66,0,1,0,1,0
16189,64077,25174,0,0,deny,66,66,0,1,0,1,0
16190,56713,25174,0,0,deny,146,146,0,1,0,1,0
16191,10914,35974,0,0,deny,60,60,0,1,0,1,0
16192,63342,445,0,0,drop,70,70,0,1,0,1,0
16193,7041,37965,0,0,deny,66,66,0,1,0,1,0
16194,51752,445,0,0,drop,70,70,0,1,0,1,0
16195,51753,445,0,0,drop,70,70,0,1,0,1,0
16196,51751,445,0,0,drop,70,70,0,1,0,1,0
16197,51738,445,0,0,drop,70,70,0,1,0,1,0
16198,46734,50265,0,0,deny,74,74,0,1,0,1,0
16199,5223,14446,0,0,deny,220,220,0,1,0,1,0
16200,1377,44847,0,0,deny,62,62,0,1,0,1,0
16201,63333,445,0,0,drop,70,70,0,1,0,1,0
16202,63334,445,0,0,drop,70,70,0,1,0,1,0
16203,63332,445,0,0,drop,70,70,0,1,0,1,0
16204,44293,23,0,0,deny,60,60,0,1,0,1,0
16205,44797,53,29838,53,allow,179,86,93,2,29,1,1
16206,50102,53,50102,53,allow,216,90,126,2,29,1,1
16207,57100,53,13292,53,allow,402,118,284,2,30,1,1
16208,36277,443,45497,443,allow,14212,8194,6018,38,104,21,17
16209,44649,443,58778,443,allow,7013,1092,5921,21,31,12,9
16210,42294,443,1257,443,allow,10384,4353,6031,29,251,16,13
16211,51155,443,7506,443,allow,8351,2366,5985,41,185,20,21
16212,64104,53,1753,53,allow,855,311,544,8,79,4,4
16213,41902,443,1832,443,allow,6511,1866,4645,21,17,12,9
16214,56282,3389,56282,3389,allow,3425,1470,1955,16,16,8,8
16215,50898,443,4601,443,allow,8480,2236,6244,27,81,15,12
16216,52062,60388,22555,60388,allow,70,70,0,1,5,1,0
16217,56733,80,32206,80,allow,214,140,74,4,25,3,1
16218,51411,443,3217,443,allow,1444,723,721,15,121,8,7
16219,64013,48970,31452,48970,allow,70,70,0,1,4,1,0
16220,51990,443,58670,443,allow,2094,1402,692,14,15,8,6
16221,35649,53,35649,53,allow,220,90,130,2,29,1,1
16222,56225,53,65429,53,allow,194,102,92,2,29,1,1
16223,57044,53,13631,53,allow,177,94,83,2,29,1,1
16224,33415,53,42301,53,allow,164,78,86,2,29,1,1
16225,39186,443,31509,443,allow,8126,2183,5943,29,270,14,15
16226,55193,53,10853,53,allow,177,94,83,2,29,1,1
16227,47681,443,29966,443,allow,6790,1336,5454,20,187,11,9
16228,51606,443,52418,443,allow,3013,1661,1352,14,20,8,6
16229,58784,443,58898,443,allow,41305,2456,38849,63,30,29,34
16230,52470,443,33189,443,allow,7915,1213,6702,23,50,12,11
16231,57169,53,49234,53,allow,177,94,83,2,30,1,1
16232,39735,53,51086,53,allow,223,78,145,2,30,1,1
16233,44313,53,51644,53,allow,199,94,105,2,30,1,1
16234,64967,53,44002,53,allow,751,102,649,2,30,1,1
16235,57017,53,22107,53,allow,177,94,83,2,30,1,1
16236,52059,47363,55015,47363,allow,70,70,0,1,5,1,0
16237,64024,57825,29804,57825,allow,312,132,180,6,6,3,3
16238,60356,443,15398,443,allow,8079,2282,5797,26,17,15,11
16239,49665,53,61260,53,allow,361,118,243,4,33,2,2
16240,60501,443,35631,443,allow,12006,3698,8308,23,15,13,10
16241,55694,62954,52341,62954,allow,504,318,186,8,15,5,3
16242,49042,443,19321,443,allow,5792,1764,4028,24,31,14,10
16243,59252,443,29438,443,allow,8442,1134,7308,23,15,13,10
16244,65513,53,49907,53,allow,186,102,84,2,30,1,1
16245,62487,443,47119,443,allow,14840,3978,10862,32,33,15,17
16246,50820,80,16954,80,allow,550,476,74,6,15,5,1
16247,56970,443,55404,443,allow,16378,3002,13376,35,17,17,18
16248,52471,443,64710,443,allow,8398,1552,6846,27,50,14,13
16249,36097,443,29806,443,allow,6131,1384,4747,27,50,15,12
16250,46750,443,52499,443,allow,350,210,140,6,25,4,2
16251,56752,443,37907,443,allow,8007,1987,6020,20,15,11,9
16252,53849,17580,55160,17580,allow,492,306,186,8,15,5,3
16253,49717,53,61877,53,allow,781,94,687,2,30,1,1
16254,51878,443,1905,443,allow,7241,1972,5269,28,68,16,12
16255,50822,80,16918,80,allow,550,476,74,6,15,5,1
16256,43677,443,7474,443,allow,7698,2373,5325,21,159,12,9
16257,52214,443,59996,443,allow,10898,3170,7728,33,331,14,19
16258,55696,64301,60133,64301,allow,316,190,126,5,15,3,2
16259,49715,53,2852,53,allow,734,94,640,2,30,1,1
16260,57169,53,55485,53,allow,177,94,83,2,30,1,1
16261,58207,443,31795,443,allow,10209,2530,7679,33,223,17,16
16262,64583,443,48873,443,allow,9150,2109,7041,27,32,15,12
16263,42951,443,65078,443,allow,6513,1609,4904,26,303,14,12
16264,53016,80,9240,80,allow,4419,271,4148,13,28,3,10
16265,54598,53,30660,53,allow,168,78,90,2,30,1,1
16266,5380,53,15988,53,allow,377,94,283,2,30,1,1
16267,50680,443,36184,443,allow,2993,866,2127,10,120,5,5
16268,53844,16925,27697,16925,allow,940,502,438,14,18,7,7
16269,52092,48658,51084,48658,allow,316,136,180,6,7,3,3
16270,53076,443,8791,443,allow,96850,6037,90813,150,177,55,95
16271,54953,53,34688,53,allow,263,94,169,2,30,1,1
16272,49676,53,26255,53,allow,216,110,106,2,30,1,1
16273,57136,53,3723,53,allow,177,94,83,2,30,1,1
16274,54749,443,23422,443,allow,273283,194709,78574,1567,3312,746,821
16275,42993,443,4203,443,allow,7821,3237,4584,39,149,19,20
16276,43231,443,33460,443,allow,56226,4852,51374,71,106,30,41
16277,57380,443,31912,443,allow,5553,927,4626,16,15,10,6
16278,51409,443,17023,443,allow,1442,721,721,15,122,8,7
16279,39651,443,15343,443,allow,18514,4506,14008,72,105,41,31
16280,38528,443,36554,443,allow,13608,3518,10090,48,217,24,24
16281,58744,443,58147,443,allow,14878,4225,10653,83,330,41,42
16282,51175,443,19417,443,allow,2132473,55149,2077324,2144,63,731,1413
16283,52091,4789,12478,4789,allow,70,70,0,2,7,2,0
16284,58945,443,49273,443,allow,5168,700,4468,16,15,7,9
16285,52088,35605,28933,35605,allow,70,70,0,2,8,2,0
16286,49782,443,53470,443,allow,70,70,0,2,7,2,0
16287,52096,443,13873,443,allow,4747,3601,1146,18,15,10,8
16288,49826,443,11659,443,allow,6105,852,5253,17,77,9,8
16289,52060,29868,29510,29868,allow,70,70,0,1,5,1,0
16290,52061,35717,37968,35717,allow,70,70,0,1,5,1,0
16291,65378,53,29573,53,allow,476,121,355,4,40,2,2
16292,50603,80,50603,80,allow,1706,1006,700,11,21,6,5
16293,62486,443,21615,443,allow,10390,7057,3333,27,33,15,12
16294,48265,443,59042,443,allow,4138,2416,1722,31,80,16,15
16295,36098,443,41283,443,allow,5901,1324,4577,25,50,14,11
16296,56225,53,8973,53,allow,194,102,92,2,29,1,1
16297,43861,123,6210,123,allow,184,94,90,2,29,1,1
16298,58942,443,33385,443,allow,5168,700,4468,16,15,7,9
16299,49800,53,35452,53,allow,485,93,392,4,48,2,2
16300,64040,53,17235,53,allow,226,102,124,2,29,1,1
16301,5588,5588,0,0,allow,3562,1936,1626,48,194,24,24
16302,40495,53,8395,53,allow,168,78,90,2,29,1,1
16303,54998,53,24555,53,allow,168,78,90,2,30,1,1
16304,65110,53,31746,53,allow,406,142,264,2,30,1,1
16305,41153,53,8565,53,allow,168,78,90,2,30,1,1
16306,64950,53,51754,53,allow,728,102,626,2,30,1,1
16307,65314,53,39947,53,allow,195,102,93,2,30,1,1
16308,50130,53,10528,53,allow,183,94,89,2,30,1,1
16309,56703,53,62070,53,allow,183,94,89,2,31,1,1
16310,49858,53,41757,53,allow,177,94,83,2,30,1,1
16311,47135,53,52086,53,allow,199,94,105,2,30,1,1
16312,56367,53,30541,53,allow,194,102,92,2,30,1,1
16313,64974,27054,45428,27054,allow,3142,1386,1756,8,31,4,4
16314,56970,443,7987,443,allow,6815,3817,2998,23,143,11,12
16315,51910,443,52422,443,allow,29367,10171,19196,66,184,32,34
16316,65139,53,58108,53,allow,754,94,660,2,31,1,1
16317,58785,443,2616,443,allow,37165,2164,35001,58,29,28,30
16318,65386,53,49656,53,allow,197,102,95,2,33,1,1
16319,62488,443,33482,443,allow,1326,876,450,11,32,6,5
16320,46862,443,48242,443,allow,6162,925,5237,18,179,10,8
16321,36099,443,35934,443,allow,5901,1324,4577,25,50,14,11
16322,36815,443,48632,443,allow,416,210,206,7,29,4,3
16323,65314,53,31001,53,allow,195,102,93,2,30,1,1
16324,51081,53,49643,53,allow,168,78,90,2,30,1,1
16325,57017,53,16260,53,allow,177,94,83,2,30,1,1
16326,44864,443,47449,443,allow,8779,1861,6918,34,120,17,17
16327,55404,443,57333,443,allow,2352,1394,958,17,275,9,8
16328,57027,53,59688,53,allow,177,94,83,2,31,1,1
16329,49675,7000,49675,7000,allow,3132,815,2317,14,15,7,7
16330,58743,443,24933,443,allow,14819,3993,10826,80,330,36,44
16331,52063,7886,16483,7886,allow,70,70,0,1,5,1,0
16332,51989,80,9142,80,allow,1344,899,445,8,15,6,2
16333,53077,443,54152,443,allow,6173,924,5249,18,177,10,8
16334,52358,443,40970,443,allow,4145,2738,1407,29,27,16,13
16335,64585,443,46353,443,allow,24686,1935,22751,36,18,17,19
16336,50352,80,51125,80,allow,2537,783,1754,13,25,7,6
16337,50477,443,60268,443,allow,130,70,60,2,15,1,1
16338,40806,8000,37524,8000,allow,195,71,124,4,58,2,2
16339,51756,53,33754,53,allow,168,78,90,2,30,1,1
16340,42066,443,21363,443,allow,377544,10569,366975,414,221,152,262
16341,49858,53,34344,53,allow,177,94,83,2,30,1,1
16342,49657,53,23289,53,allow,198,94,104,2,30,1,1
16343,57001,53,43521,53,allow,177,94,83,2,30,1,1
16344,40880,443,42551,443,allow,8142,2090,6052,22,360,10,12
16345,57027,53,37270,53,allow,177,94,83,2,30,1,1
16346,49700,443,6522,443,allow,39240,3804,35436,72,133,38,34
16347,56753,443,16519,443,allow,8058,2038,6020,20,15,11,9
16348,53848,43725,33158,43725,allow,552,306,246,9,15,5,4
16349,58944,443,12374,443,allow,5166,700,4466,16,15,7,9
16350,46500,443,37783,443,allow,494,280,214,8,29,5,3
16351,53437,6057,54615,6057,allow,245,245,0,2,30,2,0
16352,57115,53,44854,53,allow,728,102,626,2,30,1,1
16353,57001,53,25113,53,allow,177,94,83,2,30,1,1
16354,50499,53,23624,53,allow,718,94,624,2,30,1,1
16355,52434,53,49925,53,allow,183,86,97,2,30,1,1
16356,65528,53,44314,53,allow,168,86,82,2,30,1,1
16357,57833,443,7309,443,allow,215996,13055,202941,265,127,96,169
16358,50091,53,1529,53,allow,172,94,78,2,31,1,1
16359,50038,53,46782,53,allow,177,94,83,2,31,1,1
16360,6881,6992,61749,6992,allow,150,150,0,1,1200,1,0
16361,33227,53,32032,53,allow,177,86,91,2,30,1,1
16362,49676,53,4887,53,allow,216,110,106,2,30,1,1
16363,43366,53,27594,53,allow,168,78,90,2,30,1,1
16364,50038,53,24889,53,allow,177,94,83,2,30,1,1
16365,57387,53,49331,53,allow,178,94,84,2,30,1,1
16366,42903,53,55150,53,allow,168,78,90,2,30,1,1
16367,57001,53,51576,53,allow,177,94,83,2,31,1,1
16368,40192,443,40192,443,allow,11928,3226,8702,23,160,11,12
16369,52136,443,52136,443,allow,298081,63335,234746,337,323,145,192
16370,65367,53,17484,53,allow,271,94,177,2,30,1,1
16371,40204,40025,3762,40025,allow,148,86,62,2,30,1,1
16372,64741,53,19831,53,allow,420,110,310,2,30,1,1
16373,59218,53,41217,53,allow,511,126,385,2,31,1,1
16374,65528,53,30567,53,allow,168,86,82,2,31,1,1
16375,34244,443,6672,443,allow,3528,1045,2483,13,120,6,7
16376,50461,443,13300,443,allow,78333,12774,65559,140,128,59,81
16377,57470,50321,60490,50321,allow,5231,5231,0,79,5173,79,0
16378,37658,16385,25619,16385,allow,130,70,60,2,30,1,1
16379,64955,443,38956,443,allow,2279,1129,1150,25,120,12,13
16380,64525,443,3519,443,allow,5981,1902,4079,14,120,7,7
16381,15503,55878,37795,55878,allow,481,150,331,2,1200,1,1
16382,37135,443,52476,443,allow,16921,7469,9452,40,138,19,21
16383,37653,5223,43344,5223,allow,142,142,0,1,5,1,0
16384,45755,443,42960,443,allow,1625,1038,587,14,26,8,6
16385,37565,443,55641,443,allow,4898,1119,3779,17,30,9,8
16386,37564,443,37233,443,allow,1386,924,462,12,30,7,5
16387,51215,443,16837,443,allow,11490,3671,7819,33,93,18,15
16388,37566,443,61835,443,allow,1386,924,462,12,30,7,5
16389,40204,40038,53758,40038,allow,585,86,499,2,30,1,1
16390,37658,16384,24782,16384,allow,130,70,60,2,30,1,1
16391,63500,445,0,0,drop,66,66,0,1,0,1,0
16392,63498,445,0,0,drop,66,66,0,1,0,1,0
16393,63497,445,0,0,drop,66,66,0,1,0,1,0
16394,63328,445,0,0,drop,70,70,0,1,0,1,0
16395,51923,22114,0,0,deny,146,146,0,1,0,1,0
16396,63326,445,0,0,drop,70,70,0,1,0,1,0
16397,13062,52274,0,0,deny,66,66,0,1,0,1,0
16398,31738,51505,0,0,deny,62,62,0,1,0,1,0
16399,1080,8391,0,0,deny,66,66,0,1,0,1,0
16400,53389,23,0,0,deny,60,60,0,1,0,1,0
16401,51734,445,0,0,drop,70,70,0,1,0,1,0
16402,51732,445,0,0,drop,70,70,0,1,0,1,0
16403,51727,445,0,0,drop,70,70,0,1,0,1,0
16404,51724,445,0,0,drop,70,70,0,1,0,1,0
16405,51291,25174,0,0,deny,62,62,0,1,0,1,0
16406,7048,25174,0,0,deny,66,66,0,1,0,1,0
16407,13120,25174,0,0,deny,62,62,0,1,0,1,0
16408,60311,30627,0,0,deny,66,66,0,1,0,1,0
16409,56328,36237,0,0,deny,62,62,0,1,0,1,0
16410,45964,55559,0,0,deny,60,60,0,1,0,1,0
16411,1042,33175,0,0,deny,145,145,0,1,0,1,0
16412,52781,57470,0,0,deny,62,62,0,1,0,1,0
16413,45941,23386,0,0,deny,60,60,0,1,0,1,0
16414,65233,23117,0,0,deny,66,66,0,1,0,1,0
16415,37034,25174,0,0,deny,146,146,0,1,0,1,0
16416,63320,445,0,0,drop,70,70,0,1,0,1,0
16417,51271,37965,0,0,deny,66,66,0,1,0,1,0
16418,63213,35440,0,0,deny,62,62,0,1,0,1,0
16419,60980,5900,0,0,deny,60,60,0,1,0,1,0
16420,63313,445,0,0,drop,70,70,0,1,0,1,0
16421,63310,445,0,0,drop,70,70,0,1,0,1,0
16422,42030,25,0,0,deny,74,74,0,1,0,1,0
16423,51717,445,0,0,drop,70,70,0,1,0,1,0
16424,51716,445,0,0,drop,70,70,0,1,0,1,0
16425,51711,445,0,0,drop,70,70,0,1,0,1,0
16426,65015,22114,0,0,deny,62,62,0,1,0,1,0
16427,58627,64097,0,0,deny,66,66,0,1,0,1,0
16428,31683,35440,0,0,deny,62,62,0,1,0,1,0
16429,63488,445,0,0,drop,66,66,0,1,0,1,0
16430,39061,22114,0,0,deny,146,146,0,1,0,1,0
16431,50063,35776,0,0,deny,148,148,0,1,0,1,0
16432,63307,445,0,0,drop,70,70,0,1,0,1,0
16433,1114,37965,0,0,deny,62,62,0,1,0,1,0
16434,36477,40740,0,0,deny,145,145,0,1,0,1,0
16435,63305,445,0,0,drop,70,70,0,1,0,1,0
16436,49797,25174,0,0,deny,66,66,0,1,0,1,0
16437,27348,22114,0,0,deny,62,62,0,1,0,1,0
16438,27969,25174,0,0,deny,66,66,0,1,0,1,0
16439,62911,36237,0,0,deny,62,62,0,1,0,1,0
16440,30304,64147,0,0,deny,62,62,0,1,0,1,0
16441,12527,50584,0,0,deny,62,62,0,1,0,1,0
16442,51709,445,0,0,drop,70,70,0,1,0,1,0
16443,4793,50584,0,0,deny,66,66,0,1,0,1,0
16444,21482,22114,0,0,deny,62,62,0,1,0,1,0
16445,63301,445,0,0,drop,70,70,0,1,0,1,0
16446,51708,445,0,0,drop,70,70,0,1,0,1,0
16447,34811,56205,0,0,deny,66,66,0,1,0,1,0
16448,25523,35974,0,0,deny,62,62,0,1,0,1,0
16449,16570,25174,0,0,deny,62,62,0,1,0,1,0
16450,24931,25174,0,0,deny,146,146,0,1,0,1,0
16451,55161,37807,0,0,deny,62,62,0,1,0,1,0
16452,63300,445,0,0,drop,70,70,0,1,0,1,0
16453,53389,23,0,0,deny,60,60,0,1,0,1,0
16454,63472,445,0,0,drop,66,66,0,1,0,1,0
16455,63468,445,0,0,drop,66,66,0,1,0,1,0
16456,55130,25174,0,0,deny,62,62,0,1,0,1,0
16457,63032,22114,0,0,deny,66,66,0,1,0,1,0
16458,61961,11392,0,0,deny,66,66,0,1,0,1,0
16459,27995,22114,0,0,deny,62,62,0,1,0,1,0
16460,51695,445,0,0,drop,70,70,0,1,0,1,0
16461,51692,445,0,0,drop,70,70,0,1,0,1,0
16462,51691,445,0,0,drop,70,70,0,1,0,1,0
16463,51686,445,0,0,drop,70,70,0,1,0,1,0
16464,63295,445,0,0,drop,70,70,0,1,0,1,0
16465,54166,25174,0,0,deny,62,62,0,1,0,1,0
16466,25063,64147,0,0,deny,62,62,0,1,0,1,0
16467,63467,445,0,0,drop,66,66,0,1,0,1,0
16468,59755,44512,0,0,deny,66,66,0,1,0,1,0
16469,63457,445,0,0,drop,66,66,0,1,0,1,0
16470,63459,445,0,0,drop,66,66,0,1,0,1,0
16471,63455,445,0,0,drop,66,66,0,1,0,1,0
16472,63453,445,0,0,drop,66,66,0,1,0,1,0
16473,63452,445,0,0,drop,66,66,0,1,0,1,0
16474,63450,445,0,0,drop,66,66,0,1,0,1,0
16475,0,0,0,0,allow,124,64,60,2,0,1,1
16476,13285,29892,0,0,deny,145,145,0,1,0,1,0
16477,55116,7574,0,0,deny,66,66,0,1,0,1,0
16478,51684,445,0,0,drop,70,70,0,1,0,1,0
16479,51678,445,0,0,drop,70,70,0,1,0,1,0
16480,51676,445,0,0,drop,70,70,0,1,0,1,0
16481,51675,445,0,0,drop,70,70,0,1,0,1,0
16482,27505,25174,0,0,deny,62,62,0,1,0,1,0
16483,63282,445,0,0,drop,70,70,0,1,0,1,0
16484,51834,35440,0,0,deny,66,66,0,1,0,1,0
16485,27110,22114,0,0,deny,62,62,0,1,0,1,0
16486,63279,445,0,0,drop,70,70,0,1,0,1,0
16487,51609,37807,0,0,deny,62,62,0,1,0,1,0
16488,55056,44512,0,0,deny,62,62,0,1,0,1,0
16489,51674,445,0,0,drop,70,70,0,1,0,1,0
16490,51672,445,0,0,drop,70,70,0,1,0,1,0
16491,51669,445,0,0,drop,70,70,0,1,0,1,0
16492,42344,48637,0,0,deny,60,60,0,1,0,1,0
16493,63442,445,0,0,drop,66,66,0,1,0,1,0
16494,49824,25174,0,0,deny,146,146,0,1,0,1,0
16495,51666,445,0,0,drop,70,70,0,1,0,1,0
16496,15113,25174,0,0,deny,146,146,0,1,0,1,0
16497,25565,43088,0,0,deny,60,60,0,1,0,1,0
16498,63440,445,0,0,drop,66,66,0,1,0,1,0
16499,9552,57470,0,0,deny,66,66,0,1,0,1,0
16500,59696,57470,0,0,deny,62,62,0,1,0,1,0
16501,6036,51505,0,0,deny,66,66,0,1,0,1,0
16502,63474,48817,0,0,deny,62,62,0,1,0,1,0
16503,63438,445,0,0,drop,66,66,0,1,0,1,0
16504,63437,445,0,0,drop,66,66,0,1,0,1,0
16505,10547,57470,0,0,deny,62,62,0,1,0,1,0
16506,50084,26672,0,0,deny,62,62,0,1,0,1,0
16507,63274,445,0,0,drop,70,70,0,1,0,1,0
16508,35657,48637,0,0,deny,62,62,0,1,0,1,0
16509,63273,445,0,0,drop,70,70,0,1,0,1,0
16510,49651,37965,0,0,deny,74,74,0,1,0,1,0
16511,63436,445,0,0,drop,66,66,0,1,0,1,0
16512,61738,2767,0,0,deny,62,62,0,1,0,1,0
16513,42075,36237,0,0,deny,146,146,0,1,0,1,0
16514,8229,22114,0,0,deny,62,62,0,1,0,1,0
16515,7210,22114,0,0,deny,62,62,0,1,0,1,0
16516,63271,445,0,0,drop,70,70,0,1,0,1,0
16517,47040,25174,0,0,deny,62,62,0,1,0,1,0
16518,23021,25174,0,0,deny,62,62,0,1,0,1,0
16519,51663,445,0,0,drop,70,70,0,1,0,1,0
16520,57761,30317,0,0,deny,66,66,0,1,0,1,0
16521,48817,21939,48817,21939,allow,513,152,361,2,1200,1,1
16522,56367,53,52598,53,allow,188,96,92,2,31,1,1
16523,49601,53,48706,53,allow,762,97,665,2,30,1,1
16524,55892,53,8349,53,allow,182,93,89,2,30,1,1
16525,56370,443,46541,443,allow,3715,1791,1924,23,203,12,11
16526,56361,443,32525,443,allow,3775,1791,1984,24,203,12,12
16527,57809,53,57809,53,allow,213,79,134,2,33,1,1
16528,41850,53,41850,53,allow,257,101,156,2,33,1,1
16529,35485,443,29586,443,allow,1633,1038,595,14,34,8,6
16530,5588,5588,0,0,allow,3562,1936,1626,48,195,24,24
16531,55388,53,60267,53,allow,170,87,83,2,31,1,1
16532,53918,53,0,0,allow,222,82,140,2,30,1,1
16533,50078,443,50829,443,allow,7418,2721,4697,23,17,12,11
16534,62042,80,65130,80,allow,10924,548,10376,17,48,6,11
16535,56353,443,16805,443,allow,3775,1791,1984,24,203,12,12
16536,56365,443,26003,443,allow,3734,1750,1984,24,203,12,12
16537,56356,443,29331,443,allow,3734,1750,1984,24,203,12,12
16538,33734,53,33734,53,allow,257,101,156,2,33,1,1
16539,9405,443,45039,443,allow,5691,503,5188,14,15,7,7
16540,52261,5222,10119,5222,allow,5380,2214,3166,55,503,26,29
16541,57196,53,50893,53,allow,182,93,89,2,30,1,1
16542,51439,443,28008,443,allow,10119,1855,8264,26,28,15,11
16543,47034,443,4001,443,allow,4531,3268,1263,23,27,13,10
16544,53512,443,1529,443,allow,1625,1038,587,14,34,8,6
16545,58463,53,64645,53,allow,380,88,292,2,30,1,1
16546,38677,443,26000,443,allow,5306,1619,3687,20,29,12,8
16547,55693,45341,22935,45341,allow,70,70,0,1,5,1,0
16548,58930,443,60456,443,allow,10413,7123,3290,30,18,17,13
16549,49236,443,49236,443,allow,554853,293345,261508,600,69,317,283
16550,56369,443,26395,443,allow,3674,1750,1924,23,203,12,11
16551,56359,443,2986,443,allow,3734,1750,1984,24,203,12,12
16552,56360,443,15487,443,allow,3734,1750,1984,24,203,12,12
16553,58928,443,59647,443,allow,6548,4210,2338,23,18,12,11
16554,64988,27052,9710,27052,allow,735,462,273,2,31,1,1
16555,48817,46429,48817,46429,allow,763,296,467,4,1200,2,2
16556,56355,443,33571,443,allow,3734,1750,1984,24,203,12,12
16557,38676,443,10906,443,allow,5306,1619,3687,20,29,12,8
16558,50443,80,50443,80,allow,73400,3702,69698,77,19,26,51
16559,56362,443,16235,443,allow,3734,1750,1984,24,203,12,12
16560,53513,443,7067,443,allow,1625,1038,587,14,34,8,6
16561,52632,443,52632,443,allow,4351,1444,2907,19,28,11,8
16562,56363,443,61094,443,allow,3734,1750,1984,24,203,12,12
16563,53516,443,26441,443,allow,560,280,280,9,34,5,4
16564,14605,53,14605,53,allow,209,77,132,2,32,1,1
16565,56354,443,18179,443,allow,3775,1791,1984,24,203,12,12
16566,41252,53,41252,53,allow,398,255,143,3,32,2,1
16567,56368,443,23641,443,allow,3734,1750,1984,24,203,12,12
16568,64877,53,58345,53,allow,182,93,89,2,30,1,1
16569,56358,443,57449,443,allow,3734,1750,1984,24,203,12,12
16570,49611,19000,49520,19000,allow,594,174,420,2,31,1,1
16571,55046,443,52512,443,allow,3804,1099,2705,19,137,8,11
16572,46441,443,33380,443,allow,416,210,206,7,28,4,3
16573,48817,6881,48817,6881,allow,863,363,500,4,1200,2,2
16574,53146,443,41053,443,allow,29874004,955051,28918953,31844,303,10580,21264
16575,38675,443,48538,443,allow,5236,1549,3687,19,29,11,8
16576,35484,443,11377,443,allow,1633,1038,595,14,34,8,6
16577,49237,443,49237,443,allow,33985,8645,25340,53,35,28,25
16578,57442,2258,57442,2258,allow,156,156,0,3,8,3,0
16579,56367,443,45911,443,allow,3674,1750,1924,23,203,12,11
16580,56366,443,31914,443,allow,3715,1791,1924,23,203,12,11
16581,56357,443,45710,443,allow,3674,1750,1924,23,203,12,11
16582,56364,443,6103,443,allow,3775,1791,1984,24,203,12,12
16583,56312,53,62143,53,allow,711,87,624,2,30,1,1
16584,56615,53,58132,53,allow,170,87,83,2,30,1,1
16585,39017,443,58610,443,allow,5176,861,4315,16,26,9,7
16586,57027,53,52973,53,allow,170,87,83,2,30,1,1
16587,50619,53,43137,53,allow,815,95,720,2,30,1,1
16588,63440,53,0,0,allow,206,95,111,2,30,1,1
16589,48817,33028,48817,33028,allow,152,152,0,1,1200,1,0
16590,48817,13073,48817,13073,allow,787,296,491,4,1200,2,2
16591,56088,53,23327,53,allow,256,93,163,2,31,1,1
16592,55179,53,34684,53,allow,182,93,89,2,31,1,1
16593,35708,443,18676,443,allow,8264,1910,6354,21,361,10,11
16594,50176,53,47477,53,allow,768,99,669,2,31,1,1
16595,38287,443,17803,443,allow,424,210,214,7,131,4,3
16596,48817,27003,48817,27003,allow,839,296,543,4,1200,2,2
16597,6881,6881,29502,6881,allow,231,111,120,2,1200,1,1
16598,48817,16156,48817,16156,allow,513,152,361,2,1200,1,1
16599,55349,53,40115,53,allow,701,88,613,2,31,1,1
16600,48817,6884,48817,6884,allow,479,277,202,4,1200,2,2
16601,48817,6881,48817,6881,allow,479,277,202,4,1200,2,2
16602,45184,5228,38008,5228,allow,9107,2358,6749,24,3600,13,11
16603,62988,60038,0,0,allow,66,66,0,1,90,1,0
16604,51656,445,0,0,drop,70,70,0,1,0,1,0
16605,51652,445,0,0,drop,70,70,0,1,0,1,0
16606,54140,17372,0,0,deny,66,66,0,1,0,1,0
16607,2543,25174,0,0,deny,66,66,0,1,0,1,0
16608,55464,22114,0,0,deny,62,62,0,1,0,1,0
16609,63264,445,0,0,drop,70,70,0,1,0,1,0
16610,63423,445,0,0,drop,66,66,0,1,0,1,0
16611,63364,57470,0,0,deny,66,66,0,1,0,1,0
16612,52925,64147,0,0,deny,62,62,0,1,0,1,0
16613,63262,445,0,0,drop,70,70,0,1,0,1,0
16614,43639,26467,0,0,deny,66,66,0,1,0,1,0
16615,26881,25174,0,0,deny,66,66,0,1,0,1,0
16616,40128,80,6000,80,allow,2437,1277,1160,12,16,7,5
16617,19944,22114,0,0,deny,62,62,0,1,0,1,0
16618,63261,445,0,0,drop,70,70,0,1,0,1,0
16619,22636,30188,0,0,deny,66,66,0,1,0,1,0
16620,63260,445,0,0,drop,70,70,0,1,0,1,0
16621,35937,25174,0,0,deny,66,66,0,1,0,1,0
16622,63416,445,0,0,drop,66,66,0,1,0,1,0
16623,63259,445,0,0,drop,70,70,0,1,0,1,0
16624,19662,22114,0,0,deny,62,62,0,1,0,1,0
16625,51638,445,0,0,drop,70,70,0,1,0,1,0
16626,63253,445,0,0,drop,70,70,0,1,0,1,0
16627,63254,445,0,0,drop,70,70,0,1,0,1,0
16628,45169,14037,0,0,deny,74,74,0,1,0,1,0
16629,60793,53733,0,0,deny,66,66,0,1,0,1,0
16630,63414,445,0,0,drop,66,66,0,1,0,1,0
16631,63239,445,0,0,drop,70,70,0,1,0,1,0
16632,63237,445,0,0,drop,70,70,0,1,0,1,0
16633,63234,445,0,0,drop,70,70,0,1,0,1,0
16634,63229,445,0,0,drop,70,70,0,1,0,1,0
16635,37555,16385,34137,16385,allow,130,70,60,2,30,1,1
16636,56367,53,38735,53,allow,194,102,92,2,30,1,1
16637,50980,443,12783,443,allow,3964,1908,2056,23,94,13,10
16638,56751,443,1821,443,allow,8059,2039,6020,20,15,11,9
16639,50038,53,65055,53,allow,286,87,199,4,59,2,2
16640,34200,443,26443,443,allow,7341,2121,5220,18,135,8,10
16641,56477,443,27592,443,allow,5638,2934,2704,15,120,7,8
16642,54762,53,0,0,allow,86,86,0,1,30,1,0
16643,46767,443,3623,443,allow,8376,2231,6145,25,330,12,13
16644,45754,443,17919,443,allow,1625,1038,587,14,25,8,6
16645,49558,443,48351,443,allow,12704,3459,9245,50,1336,18,32
16646,34456,80,16801,80,allow,2913,633,2280,15,16,8,7
16647,44293,443,16772,443,allow,5880,2280,3600,31,76,14,17
16648,49928,443,19902,443,allow,4904,864,4040,17,28,10,7
16649,49929,443,10803,443,allow,7069,2667,4402,22,28,13,9
16650,40634,443,26237,443,allow,4917,1273,3644,17,34,10,7
16651,41821,80,46291,80,allow,1056,362,694,10,49,6,4
16652,64877,53,56552,53,allow,183,94,89,2,29,1,1
16653,41613,80,21847,80,allow,6003,691,5312,13,16,7,6
16654,41612,80,44236,80,allow,2016,552,1464,8,16,5,3
16655,56615,53,39007,53,allow,177,94,83,2,29,1,1
16656,57111,53,59340,53,allow,199,94,105,2,30,1,1
16657,39924,443,50465,443,allow,5229,1002,4227,21,16,11,10
16658,60794,20010,30261,20010,allow,70,70,0,2,8,2,0
16659,56669,80,21282,80,allow,234,234,0,4,12,4,0
16660,55794,443,55794,443,allow,4578,1671,2907,19,28,11,8
16661,64723,53,45766,53,allow,329,118,211,2,30,1,1
16662,38360,53,56266,53,allow,168,78,90,2,30,1,1
16663,57027,53,33808,53,allow,177,94,83,2,30,1,1
16664,56985,443,5059,443,allow,2281,1126,1155,25,120,12,13
16665,55388,53,1153,53,allow,177,94,83,2,30,1,1
16666,56747,53,48027,53,allow,226,110,116,2,30,1,1
16667,56492,53,39207,53,allow,177,94,83,2,30,1,1
16668,56747,53,24796,53,allow,172,94,78,2,30,1,1
16669,55171,53,4183,53,allow,79,79,0,2,34,2,0
16670,51911,80,54033,80,allow,5474,1920,3554,20,65,12,8
16671,54743,80,43064,80,allow,6453,1316,5137,16,315,9,7
16672,60337,443,11026,443,allow,1862,1223,639,18,89,11,7
16673,56437,80,52294,80,allow,17128,1499,15629,24,21,9,15
16674,55535,80,6697,80,allow,18450,1862,16588,29,17,15,14
16675,34952,53,65291,53,allow,177,94,83,2,30,1,1
16676,60553,443,11360,443,allow,7981,1867,6114,32,313,17,15
16677,56221,443,24462,443,allow,129824,16359,113465,185,459,79,106
16678,64009,80,25096,80,allow,314,192,122,6,15,4,2
16679,56703,53,54677,53,allow,183,94,89,2,30,1,1
16680,58938,443,4576,443,allow,6035,770,5265,18,15,8,10
16681,34452,80,18909,80,allow,6260,696,5564,17,16,9,8
16682,55258,53,4040,53,allow,177,94,83,2,30,1,1
16683,56615,53,33953,53,allow,177,94,83,2,30,1,1
16684,64443,53,23166,53,allow,878,184,694,6,71,3,3
16685,57235,53,31902,53,allow,210,102,108,2,30,1,1
16686,64971,27026,15730,27026,allow,1012,462,550,4,30,2,2
16687,55179,53,18189,53,allow,183,94,89,2,30,1,1
16688,56492,53,3429,53,allow,177,94,83,2,30,1,1
16689,63989,53,19416,53,allow,259,110,149,2,30,1,1
16690,65528,53,21468,53,allow,168,86,82,2,30,1,1
16691,56490,443,32124,443,allow,163763,5320,158443,178,120,60,118
16692,40146,443,31443,443,allow,280,140,140,5,130,3,2
16693,40877,443,50860,443,allow,6451,1003,5448,21,360,11,10
16694,48817,47005,48817,47005,allow,158,158,0,1,1200,1,0
16695,55937,53,13424,53,allow,177,94,83,2,30,1,1
16696,34454,80,29541,80,allow,2913,633,2280,15,16,8,7
16697,9394,443,24044,443,allow,3613,433,3180,11,15,6,5
16698,43166,80,43166,80,allow,26540,1137,25403,36,136,15,21
16699,65480,53,23239,53,allow,211,102,109,2,30,1,1
16700,37555,16384,61049,16384,allow,130,70,60,2,30,1,1
16701,65263,53,53101,53,allow,232,110,122,2,30,1,1
16702,56747,53,24392,53,allow,172,94,78,2,30,1,1
16703,44080,443,25950,443,allow,7476,2315,5161,18,135,8,10
16704,50986,443,50781,443,allow,67798,17043,50755,202,146,110,92
16705,10125,443,63386,443,allow,6151,2939,3212,28,332,13,15
16706,8890,443,57332,443,allow,4367,1108,3259,37,426,11,26
16707,51979,443,24826,443,allow,10613,3156,7457,42,15,24,18
16708,56396,443,27935,443,allow,4239,1850,2389,25,179,12,13
16709,35265,80,15083,80,allow,3524,2698,826,14,16,8,6
16710,5588,5588,0,0,allow,3562,1936,1626,48,194,24,24
16711,51221,65427,56298,65427,allow,460,150,310,2,1200,1,1
16712,60338,443,20283,443,allow,3648,2251,1397,28,89,16,12
16713,9404,443,30760,443,allow,5693,499,5194,14,15,7,7
16714,9407,443,42706,443,allow,5697,503,5194,14,15,7,7
16715,49158,80,49158,80,allow,10922,816,10106,19,18,8,11
16716,49935,443,48016,443,allow,366,180,186,7,28,4,3
16717,49631,53,64330,53,allow,198,102,96,2,33,1,1
16718,65422,53,8384,53,allow,448,84,364,4,54,2,2
16719,54955,443,20454,443,allow,10265,1831,8434,34,319,17,17
16720,52070,80,56531,80,allow,3572,2746,826,14,15,8,6
16721,61406,443,61406,443,allow,4529,1622,2907,19,27,11,8
16722,45727,443,38522,443,allow,1625,1038,587,14,29,8,6
16723,41820,80,9493,80,allow,1056,362,694,10,49,6,4
16724,32961,80,43846,80,allow,480,258,222,8,12,5,3
16725,57913,443,45296,443,allow,9578079,276384,9301695,9817,153,2984,6833
16726,38142,53,38142,53,allow,404,259,145,3,32,2,1
16727,55763,8060,49115,8060,allow,70,70,0,2,7,2,0
16728,56749,443,28025,443,allow,8058,2038,6020,20,15,11,9
16729,50657,80,54275,80,allow,23292,2267,21025,28,21,10,18
16730,59779,443,11374,443,allow,142,142,0,1,5,1,0
16731,50441,80,50441,80,allow,79227,5480,73747,89,19,32,57
16732,56279,443,27594,443,allow,15248,5524,9724,54,364,27,27
16733,49566,443,36540,443,allow,10225,5069,5156,30,106,17,13
16734,58420,53,57046,53,allow,351,78,273,2,29,1,1
16735,56615,53,15642,53,allow,177,94,83,2,29,1,1
16736,5588,5588,0,0,allow,3562,1936,1626,48,193,24,24
16737,50130,53,58704,53,allow,183,94,89,2,29,1,1
16738,50130,53,12691,53,allow,183,94,89,2,29,1,1
16739,49008,53,13913,53,allow,168,78,90,2,29,1,1
16740,58940,443,24448,443,allow,5108,700,4408,15,15,7,8
16741,37658,16386,64660,16386,allow,130,70,60,2,29,1,1
16742,34458,80,25271,80,allow,6260,696,5564,17,16,9,8
16743,57387,53,39674,53,allow,178,94,84,2,30,1,1
16744,48933,443,5665,443,allow,4372,2402,1970,27,53,14,13
16745,50091,53,50600,53,allow,164,86,78,2,30,1,1
16746,64927,53,2368,53,allow,315,110,205,2,30,1,1
16747,55545,3389,55545,3389,allow,3527,1638,1889,18,18,11,7
16748,55388,53,28391,53,allow,177,94,83,2,30,1,1
16749,55258,53,48782,53,allow,177,94,83,2,30,1,1
16750,50439,80,50439,80,allow,96018,5956,90062,107,20,41,66
16751,64938,53,18539,53,allow,210,102,108,2,30,1,1
16752,49545,53,14108,53,allow,195,102,93,2,30,1,1
16753,40878,443,41466,443,allow,6517,1003,5514,22,360,11,11
16754,50265,16082,44635,16082,allow,858,858,0,14,1200,14,0
16755,60449,80,21730,80,allow,50477,10880,39597,69,16,33,36
16756,45289,80,45289,80,allow,144717,5580,139137,180,20,81,99
16757,56750,443,39492,443,allow,8006,1986,6020,20,15,11,9
16758,58021,443,29855,443,allow,8075,4109,3966,42,91,19,23
16759,38702,443,49260,443,allow,1117339,17881,1099458,1006,16,256,750
16760,47508,443,1346,443,allow,5778,1095,4683,17,26,10,7
16761,56748,443,11472,443,allow,8007,1987,6020,20,15,11,9
16762,49653,80,47758,80,allow,2815,1605,1210,17,166,9,8
16763,37555,16386,23177,16386,allow,130,70,60,2,30,1,1
16764,57196,53,25390,53,allow,183,94,89,2,30,1,1
16765,59732,27036,24754,27036,allow,1218,924,294,6,30,3,3
16766,54951,443,21945,443,allow,69882,3520,66362,96,320,38,58
16767,64249,53,23999,53,allow,181,94,87,2,33,1,1
16768,48728,80,37214,80,allow,3524,2698,826,14,16,8,6
16769,47643,80,39174,80,allow,3524,2698,826,14,16,8,6
16770,55544,3389,55544,3389,allow,3657,1638,2019,20,18,11,9
16771,56513,53,54850,53,allow,215,102,113,2,30,1,1
16772,64975,27033,50776,27033,allow,734,462,272,2,30,1,1
16773,56703,53,38555,53,allow,183,94,89,2,30,1,1
16774,55840,53,36401,53,allow,199,94,105,2,30,1,1
16775,56559,53,54013,53,allow,177,94,83,2,30,1,1
16776,41554,53,50330,53,allow,199,94,105,2,30,1,1
16777,59773,53,11146,53,allow,218,78,140,2,31,1,1
16778,56134,53,62024,53,allow,183,94,89,2,31,1,1
16779,55283,443,55908,443,allow,2964,1657,1307,18,47,9,9
16780,60474,8999,37889,8999,allow,70,70,0,2,8,2,0
16781,65455,53,29477,53,allow,564,108,456,4,50,2,2
16782,50635,53,9293,53,allow,199,94,105,2,30,1,1
16783,43818,53,4303,53,allow,168,78,90,2,30,1,1
16784,51958,443,6859,443,allow,9994,8270,1724,34,68,19,15
16785,64931,53,5623,53,allow,179,94,85,2,30,1,1
16786,56588,53,8372,53,allow,197,102,95,2,30,1,1
16787,56559,53,63676,53,allow,177,94,83,2,30,1,1
16788,65390,53,64921,53,allow,387,134,253,2,30,1,1
16789,64023,53,29476,53,allow,179,94,85,2,30,1,1
16790,40876,443,14567,443,allow,6450,1003,5447,21,360,11,10
16791,65427,53,2149,53,allow,238,94,144,2,30,1,1
16792,55759,53,49971,53,allow,177,94,83,2,30,1,1
16793,64707,53,25293,53,allow,216,102,114,2,30,1,1
16794,10151,6889,16341,6889,allow,481,150,331,2,1200,1,1
16795,48817,6889,48817,6889,allow,158,158,0,1,1200,1,0
16796,48817,6881,48817,6881,allow,334,158,176,2,1200,1,1
16797,48817,63615,48817,63615,allow,765,296,469,4,1200,2,2
16798,61140,443,36707,443,allow,10803,2906,7897,20,135,10,10
16799,57441,443,53245,443,allow,9774,3034,6740,29,19,14,15
16800,60795,40010,57308,40010,allow,316,136,180,6,6,3,3
16801,50077,80,42513,80,allow,804,380,424,9,15,5,4
16802,55937,53,36384,53,allow,177,94,83,2,30,1,1
16803,55643,53,52917,53,allow,183,94,89,2,31,1,1
16804,38703,443,53775,443,allow,90561,3481,87080,96,16,31,65
16805,52082,14804,9932,14804,allow,70,70,0,2,8,2,0
16806,55179,53,17808,53,allow,183,94,89,2,30,1,1
16807,43681,443,22567,443,allow,40598,5313,35285,83,97,43,40
16808,56747,443,61148,443,allow,8059,2039,6020,20,16,11,9
16809,63228,445,0,0,drop,70,70,0,1,0,1,0
16810,63407,445,0,0,drop,66,66,0,1,0,1,0
16811,63404,445,0,0,drop,66,66,0,1,0,1,0
16812,21064,25174,0,0,deny,62,62,0,1,0,1,0
16813,51578,44847,0,0,deny,66,66,0,1,0,1,0
16814,14397,37965,0,0,deny,62,62,0,1,0,1,0
16815,10914,35974,0,0,deny,60,60,0,1,0,1,0
16816,61767,25174,0,0,deny,62,62,0,1,0,1,0
16817,515,10214,0,0,deny,66,66,0,1,0,1,0
16818,36696,25174,0,0,deny,62,62,0,1,0,1,0
16819,63217,445,0,0,drop,70,70,0,1,0,1,0
16820,59524,25174,0,0,deny,66,66,0,1,0,1,0
16821,1262,23,0,0,deny,60,60,0,1,0,1,0
16822,63062,11392,0,0,deny,66,66,0,1,0,1,0
16823,5228,3434,0,0,deny,1093,1093,0,1,0,1,0
16824,51630,445,0,0,drop,70,70,0,1,0,1,0
16825,51626,445,0,0,drop,70,70,0,1,0,1,0
16826,51627,445,0,0,drop,70,70,0,1,0,1,0
16827,63387,445,0,0,drop,66,66,0,1,0,1,0
16828,63389,445,0,0,drop,66,66,0,1,0,1,0
16829,63391,445,0,0,drop,66,66,0,1,0,1,0
16830,63390,445,0,0,drop,66,66,0,1,0,1,0
16831,63388,445,0,0,drop,66,66,0,1,0,1,0
16832,63385,445,0,0,drop,66,66,0,1,0,1,0
16833,63386,445,0,0,drop,66,66,0,1,0,1,0
16834,63384,445,0,0,drop,66,66,0,1,0,1,0
16835,52483,1433,0,0,deny,60,60,0,1,0,1,0
16836,60403,22114,0,0,deny,66,66,0,1,0,1,0
16837,26531,37965,0,0,deny,62,62,0,1,0,1,0
16838,443,61686,0,0,deny,1484,1484,0,1,0,1,0
16839,31235,22114,0,0,deny,62,62,0,1,0,1,0
16840,63213,445,0,0,drop,70,70,0,1,0,1,0
16841,22439,25174,0,0,deny,66,66,0,1,0,1,0
16842,52340,64147,0,0,deny,66,66,0,1,0,1,0
16843,1865,25174,0,0,deny,62,62,0,1,0,1,0
16844,26235,37965,0,0,deny,66,66,0,1,0,1,0
16845,63203,445,0,0,drop,70,70,0,1,0,1,0
16846,63204,445,0,0,drop,70,70,0,1,0,1,0
16847,51621,445,0,0,drop,70,70,0,1,0,1,0
16848,51622,445,0,0,drop,70,70,0,1,0,1,0
16849,51609,445,0,0,drop,70,70,0,1,0,1,0
16850,51610,445,0,0,drop,70,70,0,1,0,1,0
16851,63200,445,0,0,drop,70,70,0,1,0,1,0
16852,63196,445,0,0,drop,70,70,0,1,0,1,0
16853,16454,25174,0,0,deny,62,62,0,1,0,1,0
16854,63369,445,0,0,drop,66,66,0,1,0,1,0
16855,63370,445,0,0,drop,66,66,0,1,0,1,0
16856,63368,445,0,0,drop,66,66,0,1,0,1,0
16857,9089,55108,0,0,deny,148,148,0,1,0,1,0
16858,32736,22114,0,0,deny,66,66,0,1,0,1,0
16859,34152,11119,0,0,deny,148,148,0,1,0,1,0
16860,28795,37965,0,0,deny,62,62,0,1,0,1,0
16861,22220,25174,0,0,deny,146,146,0,1,0,1,0
16862,59476,23,0,0,deny,60,60,0,1,0,1,0
16863,50046,22114,0,0,deny,62,62,0,1,0,1,0
16864,48706,23393,0,0,deny,60,60,0,1,0,1,0
16865,42030,25,0,0,deny,74,74,0,1,0,1,0
16866,51607,445,0,0,drop,70,70,0,1,0,1,0
16867,57131,35776,0,0,deny,145,145,0,1,0,1,0
16868,51604,445,0,0,drop,70,70,0,1,0,1,0
16869,51600,445,0,0,drop,70,70,0,1,0,1,0
16870,51597,445,0,0,drop,70,70,0,1,0,1,0
16871,63191,445,0,0,drop,70,70,0,1,0,1,0
16872,1860,25174,0,0,deny,66,66,0,1,0,1,0
16873,2849,30188,0,0,deny,62,62,0,1,0,1,0
16874,2083,25174,0,0,deny,62,62,0,1,0,1,0
16875,64587,43890,0,0,deny,66,66,0,1,0,1,0
16876,50328,22114,0,0,deny,66,66,0,1,0,1,0
16877,54236,36829,0,0,deny,66,66,0,1,0,1,0
16878,1620,53567,0,0,deny,66,66,0,1,0,1,0
16879,6247,51221,0,0,deny,78,78,0,1,0,1,0
16880,63183,445,0,0,drop,70,70,0,1,0,1,0
16881,53073,32468,0,0,deny,66,66,0,1,0,1,0
16882,25878,25174,0,0,deny,66,66,0,1,0,1,0
16883,57496,25174,0,0,deny,66,66,0,1,0,1,0
16884,63182,445,0,0,drop,70,70,0,1,0,1,0
16885,51414,22,0,0,deny,60,60,0,1,0,1,0
16886,62512,25174,0,0,deny,62,62,0,1,0,1,0
16887,2383,37965,0,0,deny,66,66,0,1,0,1,0
16888,51588,445,0,0,drop,70,70,0,1,0,1,0
16889,51587,445,0,0,drop,70,70,0,1,0,1,0
16890,51584,445,0,0,drop,70,70,0,1,0,1,0
16891,29972,50584,0,0,deny,62,62,0,1,0,1,0
16892,63176,445,0,0,drop,70,70,0,1,0,1,0
16893,25570,35440,0,0,deny,146,146,0,1,0,1,0
16894,6729,51505,0,0,deny,62,62,0,1,0,1,0
16895,63357,445,0,0,drop,66,66,0,1,0,1,0
16896,11878,37807,0,0,deny,62,62,0,1,0,1,0
16897,63175,445,0,0,drop,70,70,0,1,0,1,0
16898,55341,39004,0,0,deny,74,74,0,1,0,1,0
16899,58627,25174,0,0,deny,62,62,0,1,0,1,0
16900,63171,445,0,0,drop,70,70,0,1,0,1,0
16901,11136,15503,0,0,deny,62,62,0,1,0,1,0
16902,24144,57470,0,0,deny,62,62,0,1,0,1,0
16903,51581,445,0,0,drop,70,70,0,1,0,1,0
16904,52238,26467,0,0,deny,62,62,0,1,0,1,0
16905,51579,445,0,0,drop,70,70,0,1,0,1,0
16906,63170,445,0,0,drop,70,70,0,1,0,1,0
16907,5228,3434,0,0,deny,1093,1093,0,1,0,1,0
16908,5228,3434,0,0,deny,601,601,0,1,0,1,0
16909,5228,3434,0,0,deny,345,345,0,1,0,1,0
16910,40312,55442,0,0,deny,62,62,0,1,0,1,0
16911,47788,30170,0,0,deny,146,146,0,1,0,1,0
16912,30373,23,0,0,deny,60,60,0,1,0,1,0
16913,42285,57470,0,0,deny,62,62,0,1,0,1,0
16914,50734,37965,0,0,deny,62,62,0,1,0,1,0
16915,28192,50584,0,0,deny,66,66,0,1,0,1,0
16916,45726,64147,0,0,deny,62,62,0,1,0,1,0
16917,0,0,0,0,allow,198,128,70,3,0,2,1
16918,47913,25174,0,0,deny,62,62,0,1,0,1,0
16919,52038,50584,0,0,deny,62,62,0,1,0,1,0
16920,63339,445,0,0,drop,66,66,0,1,0,1,0
16921,63341,445,0,0,drop,66,66,0,1,0,1,0
16922,56127,37965,0,0,deny,66,66,0,1,0,1,0
16923,23658,18375,0,0,deny,62,62,0,1,0,1,0
16924,30500,26296,0,0,deny,159,159,0,1,0,1,0
16925,34073,37965,0,0,deny,62,62,0,1,0,1,0
16926,63165,445,0,0,drop,70,70,0,1,0,1,0
16927,54280,3385,0,0,deny,60,60,0,1,0,1,0
16928,51569,445,0,0,drop,70,70,0,1,0,1,0
16929,51567,445,0,0,drop,70,70,0,1,0,1,0
16930,51566,445,0,0,drop,70,70,0,1,0,1,0
16931,51560,445,0,0,drop,70,70,0,1,0,1,0
16932,1943,48817,0,0,deny,62,62,0,1,0,1,0
16933,48301,25174,0,0,deny,66,66,0,1,0,1,0
16934,63336,445,0,0,drop,66,66,0,1,0,1,0
16935,39110,50584,0,0,deny,62,62,0,1,0,1,0
16936,56872,21247,0,0,deny,74,74,0,1,0,1,0
16937,3399,25174,0,0,deny,66,66,0,1,0,1,0
16938,54726,30041,0,0,deny,66,66,0,1,0,1,0
16939,63325,445,0,0,drop,66,66,0,1,0,1,0
16940,63331,445,0,0,drop,66,66,0,1,0,1,0
16941,63330,445,0,0,drop,66,66,0,1,0,1,0
16942,63328,445,0,0,drop,66,66,0,1,0,1,0
16943,63320,445,0,0,drop,66,66,0,1,0,1,0
16944,63329,445,0,0,drop,66,66,0,1,0,1,0
16945,63326,445,0,0,drop,66,66,0,1,0,1,0
16946,52682,22114,0,0,deny,66,66,0,1,0,1,0
16947,60097,22114,0,0,deny,62,62,0,1,0,1,0
16948,32746,50584,0,0,deny,146,146,0,1,0,1,0
16949,42986,25174,0,0,deny,66,66,0,1,0,1,0
16950,13235,44847,0,0,deny,66,66,0,1,0,1,0
16951,51554,445,0,0,drop,70,70,0,1,0,1,0
16952,27038,51505,0,0,deny,146,146,0,1,0,1,0
16953,45118,39004,0,0,deny,74,74,0,1,0,1,0
16954,49824,25174,0,0,deny,62,62,0,1,0,1,0
16955,36663,22114,0,0,deny,146,146,0,1,0,1,0
16956,51551,445,0,0,drop,70,70,0,1,0,1,0
16957,51548,445,0,0,drop,70,70,0,1,0,1,0
16958,51547,445,0,0,drop,70,70,0,1,0,1,0
16959,39313,37965,0,0,deny,62,62,0,1,0,1,0
16960,63152,445,0,0,drop,70,70,0,1,0,1,0
16961,6843,42873,0,0,deny,62,62,0,1,0,1,0
16962,57991,22114,0,0,deny,66,66,0,1,0,1,0
16963,6842,42873,0,0,deny,66,66,0,1,0,1,0
16964,43207,26467,0,0,deny,62,62,0,1,0,1,0
16965,54021,25174,0,0,deny,62,62,0,1,0,1,0
16966,35111,22114,0,0,deny,66,66,0,1,0,1,0
16967,36804,25174,0,0,deny,66,66,0,1,0,1,0
16968,39959,23117,0,0,deny,62,62,0,1,0,1,0
16969,39839,22114,0,0,deny,146,146,0,1,0,1,0
16970,43814,34476,0,0,deny,146,146,0,1,0,1,0
16971,63149,445,0,0,drop,70,70,0,1,0,1,0
16972,56289,25174,0,0,deny,66,66,0,1,0,1,0
16973,51866,22114,0,0,deny,66,66,0,1,0,1,0
16974,30304,26467,0,0,deny,62,62,0,1,0,1,0
16975,52166,26467,0,0,deny,66,66,0,1,0,1,0
16976,51543,445,0,0,drop,70,70,0,1,0,1,0
16977,51544,445,0,0,drop,70,70,0,1,0,1,0
16978,51540,445,0,0,drop,70,70,0,1,0,1,0
16979,63316,445,0,0,drop,66,66,0,1,0,1,0
16980,45964,2225,0,0,deny,60,60,0,1,0,1,0
16981,26940,443,35054,443,allow,7599,2842,4757,27,22,15,12
16982,57702,53,57702,53,allow,398,255,143,3,32,2,1
16983,58929,443,63640,443,allow,6160,4121,2039,22,17,11,11
16984,56149,53,12166,53,allow,174,89,85,2,30,1,1
16985,56902,53,41488,53,allow,768,99,669,2,30,1,1
16986,55609,53,45313,53,allow,172,88,84,2,30,1,1
16987,58986,443,33028,443,allow,2894,1653,1241,24,26,12,12
16988,44661,443,11205,443,allow,9468,2242,7226,23,15,12,11
16989,59923,53,59923,53,allow,365,233,132,3,33,2,1
16990,6159,53,6159,53,allow,404,259,145,3,32,2,1
16991,53875,43611,35716,43611,allow,70,70,0,2,8,2,0
16992,43784,443,17789,443,allow,10458,1688,8770,30,15,17,13
16993,50134,53,55373,53,allow,748,106,642,2,30,1,1
16994,56803,53,43368,53,allow,182,93,89,2,30,1,1
16995,49718,53,39555,53,allow,793,101,692,2,30,1,1
16996,38662,15000,56543,15000,allow,138,78,60,2,6,1,1
16997,137,137,55406,137,allow,114,114,0,2,32,2,0
16998,53878,55950,58060,55950,allow,70,70,0,2,8,2,0
16999,56503,53,37647,53,allow,578,286,292,9,15,5,4
17000,34996,5222,11344,5222,allow,8140,2222,5918,42,201,22,20
17001,53876,53380,35736,53380,allow,70,70,0,2,8,2,0
17002,56556,53,39317,53,allow,762,97,665,2,30,1,1
17003,64023,53,59287,53,allow,174,89,85,2,30,1,1
17004,64628,53,26706,53,allow,753,93,660,2,30,1,1
17005,44967,443,36379,443,allow,7474,1946,5528,33,270,18,15
17006,57163,443,13914,443,allow,1779,1375,404,11,40,5,6
17007,56354,53,25392,53,allow,753,93,660,2,30,1,1
17008,53162,60352,25976,60352,allow,70,70,0,2,8,2,0
17009,55156,53,48355,53,allow,256,87,169,4,37,2,2
17010,25309,53,25309,53,allow,371,237,134,3,33,2,1
17011,29599,443,15239,443,allow,2227,1018,1209,17,16,8,9
17012,56588,53,28936,53,allow,194,99,95,2,30,1,1
17013,52385,53,0,0,allow,138,69,69,2,30,1,1
17014,51606,443,32165,443,allow,9979,4380,5599,26,256,12,14
17015,50108,53,31749,53,allow,174,89,85,2,30,1,1
17016,56668,53,61467,53,allow,701,88,613,2,30,1,1
17017,58922,443,2924,443,allow,14553,9653,4900,38,19,22,16
17018,64950,53,8334,53,allow,186,95,91,2,31,1,1
17019,50176,443,54312,443,allow,6081,844,5237,17,15,9,8
17020,52079,1024,34017,1024,allow,70,70,0,2,8,2,0
17021,37569,443,55677,443,allow,120566,15345,105221,173,125,72,101
17022,55759,53,57416,53,allow,170,87,83,2,30,1,1
17023,50552,53,56537,53,allow,710,89,621,2,30,1,1
17024,56926,53,27418,53,allow,711,87,624,2,30,1,1
17025,55376,53,48930,53,allow,789,110,679,2,31,1,1
17026,56375,53,7555,53,allow,216,110,106,2,31,1,1
17027,55489,53,34902,53,allow,748,106,642,2,31,1,1
17028,56373,53,1027,53,allow,181,98,83,2,31,1,1
17029,49313,53,6801,53,allow,295,101,194,4,31,2,2
17030,64787,53,4166,53,allow,174,89,85,2,31,1,1
17031,59005,443,25143,443,allow,4921,2525,2396,14,135,7,7
17032,48817,32897,48817,32897,allow,152,152,0,1,1200,1,0
17033,56185,53,24061,53,allow,168,86,82,2,31,1,1
17034,55058,53,41146,53,allow,216,110,106,2,31,1,1
17035,56712,443,43897,443,allow,1540037,36876,1503161,1511,62,511,1000
17036,56960,53,22344,53,allow,192,98,94,2,31,1,1
17037,56272,53,26836,53,allow,186,95,91,2,31,1,1
17038,64668,53,32390,53,allow,772,103,669,2,31,1,1
17039,57119,53,0,0,allow,318,95,223,2,31,1,1
17040,50504,53,13475,53,allow,168,86,82,2,31,1,1
17041,56260,53,39887,53,allow,170,87,83,2,31,1,1
17042,64787,53,24820,53,allow,740,93,647,2,31,1,1
17043,55251,53,62666,53,allow,208,106,102,2,31,1,1
17044,54959,53,17105,53,allow,206,105,101,2,31,1,1
17045,24929,53,24929,53,allow,217,87,130,2,31,1,1
17046,55383,443,17690,443,allow,40612,4090,36522,71,150,31,40
17047,57063,53,16093,53,allow,186,95,91,2,31,1,1
17048,55829,53,4732,53,allow,208,106,102,2,31,1,1
17049,64551,53,55757,53,allow,755,94,661,2,31,1,1
17050,56375,53,32161,53,allow,216,110,106,2,31,1,1
17051,55190,53,7214,53,allow,733,86,647,2,31,1,1
17052,57083,53,56856,53,allow,755,94,661,2,31,1,1
17053,63090,53,11762,53,allow,510,164,346,2,31,1,1
17054,65354,53,6099,53,allow,168,86,82,2,31,1,1
17055,56762,53,35908,53,allow,168,86,82,2,31,1,1
17056,56810,53,54787,53,allow,170,87,83,2,31,1,1
17057,51538,445,0,0,drop,70,70,0,1,0,1,0
17058,63145,445,0,0,drop,70,70,0,1,0,1,0
17059,54796,22114,0,0,deny,66,66,0,1,0,1,0
17060,63311,445,0,0,drop,66,66,0,1,0,1,0
17061,3169,22114,0,0,deny,66,66,0,1,0,1,0
17062,63143,445,0,0,drop,70,70,0,1,0,1,0
17063,49577,57470,0,0,deny,62,62,0,1,0,1,0
17064,56403,51505,0,0,deny,66,66,0,1,0,1,0
17065,4019,50584,0,0,deny,66,66,0,1,0,1,0
17066,63308,445,0,0,drop,66,66,0,1,0,1,0
17067,63310,445,0,0,drop,66,66,0,1,0,1,0
17068,63141,445,0,0,drop,70,70,0,1,0,1,0
17069,51567,443,62736,443,allow,400,70,330,7,17,2,5
17070,55156,53,47566,53,allow,256,87,169,4,37,2,2
17071,65506,443,5450,443,allow,92243,4519,87724,105,16,39,66
17072,61643,22114,0,0,deny,62,62,0,1,0,1,0
17073,47812,30627,0,0,deny,62,62,0,1,0,1,0
17074,63307,445,0,0,drop,66,66,0,1,0,1,0
17075,7912,35440,0,0,deny,146,146,0,1,0,1,0
17076,62217,37807,0,0,deny,66,66,0,1,0,1,0
17077,55408,64147,0,0,deny,66,66,0,1,0,1,0
17078,62189,64147,0,0,deny,62,62,0,1,0,1,0
17079,58247,57866,0,0,deny,66,66,0,1,0,1,0
17080,16057,51050,0,0,deny,66,66,0,1,0,1,0
17081,63741,50584,0,0,deny,66,66,0,1,0,1,0
17082,17173,23,0,0,deny,60,60,0,1,0,1,0
17083,60117,50934,0,0,deny,66,66,0,1,0,1,0
17084,51532,445,0,0,drop,70,70,0,1,0,1,0
17085,45169,14037,0,0,deny,74,74,0,1,0,1,0
17086,58193,23,0,0,deny,60,60,0,1,0,1,0
17087,51522,445,0,0,drop,70,70,0,1,0,1,0
17088,51525,445,0,0,drop,70,70,0,1,0,1,0
17089,45682,8055,0,0,deny,159,159,0,1,0,1,0
17090,22948,26467,0,0,deny,62,62,0,1,0,1,0
17091,27081,10197,0,0,deny,62,62,0,1,0,1,0
17092,63134,445,0,0,drop,70,70,0,1,0,1,0
17093,10949,22114,0,0,deny,62,62,0,1,0,1,0
17094,45535,25174,0,0,deny,66,66,0,1,0,1,0
17095,63132,445,0,0,drop,70,70,0,1,0,1,0
17096,51728,44847,0,0,deny,66,66,0,1,0,1,0
17097,63294,445,0,0,drop,66,66,0,1,0,1,0
17098,62348,65348,0,0,deny,145,145,0,1,0,1,0
17099,6872,23,0,0,deny,60,60,0,1,0,1,0
17100,63131,445,0,0,drop,70,70,0,1,0,1,0
17101,64595,64147,0,0,deny,66,66,0,1,0,1,0
17102,29742,50584,0,0,deny,146,146,0,1,0,1,0
17103,6712,5060,0,0,deny,410,410,0,1,0,1,0
17104,63130,445,0,0,drop,70,70,0,1,0,1,0
17105,63717,37965,0,0,deny,62,62,0,1,0,1,0
17106,1030,35776,0,0,deny,139,139,0,1,0,1,0
17107,63129,445,0,0,drop,70,70,0,1,0,1,0
17108,64963,53,58073,53,allow,453,186,267,6,30,3,3
17109,52083,26607,11051,26607,allow,70,70,0,2,7,2,0
17110,49791,53,37520,53,allow,412,90,322,4,34,2,2
17111,60471,19776,4815,19776,allow,70,70,0,1,5,1,0
17112,55388,53,11740,53,allow,292,87,205,4,42,2,2
17113,60334,443,17024,443,allow,7506,4789,2717,28,130,16,12
17114,36816,1812,36816,1812,allow,204,138,66,2,29,1,1
17115,56803,53,52529,53,allow,183,94,89,2,30,1,1
17116,57264,53,53973,53,allow,197,102,95,2,30,1,1
17117,50204,80,48586,80,allow,1221,781,440,11,14,6,5
17118,54519,443,53980,443,allow,8413,2503,5910,23,16,13,10
17119,64735,53,3296,53,allow,730,102,628,2,30,1,1
17120,53042,443,14232,443,allow,5452,1545,3907,22,16,13,9
17121,56446,443,26551,443,allow,8620,2018,6602,34,80,18,16
17122,56703,80,22325,80,allow,41915,4128,37787,59,64,29,30
17123,52084,30863,64593,30863,allow,70,70,0,2,7,2,0
17124,52056,50328,41814,50328,allow,70,70,0,1,4,1,0
17125,55156,53,28197,53,allow,256,87,169,4,36,2,2
17126,46892,443,33257,443,allow,12488,5447,7041,28,16,16,12
17127,55828,443,33777,443,allow,8420,4472,3948,63,450,32,31
17128,123,123,13425,123,allow,184,94,90,2,29,1,1
17129,61066,53,0,0,allow,283,78,205,2,29,1,1
17130,55156,53,47092,53,allow,256,87,169,4,36,2,2
17131,23613,53,55694,53,allow,177,94,83,2,29,1,1
17132,61230,53,16263,53,allow,177,94,83,2,29,1,1
17133,64069,53,35417,53,allow,183,86,97,2,29,1,1
17134,52413,53,24477,53,allow,168,78,90,2,30,1,1
17135,64967,27051,5112,27051,allow,1020,462,558,4,29,2,2
17136,53801,53,14956,53,allow,167,78,89,2,30,1,1
17137,58935,443,64941,443,allow,5167,700,4467,16,15,7,9
17138,63034,443,51705,443,allow,37694,8319,29375,85,153,36,49
17139,58173,993,62958,993,allow,430,60,370,7,24,2,5
17140,49786,443,10389,443,allow,8941,1816,7125,27,15,15,12
17141,36604,443,8659,443,allow,6506,1532,4974,28,16,14,14
17142,34432,80,52921,80,allow,6260,696,5564,17,16,9,8
17143,49376,53,15412,53,allow,391,134,257,2,30,1,1
17144,55641,53,43709,53,allow,70,70,0,1,30,1,0
17145,49686,53,47017,53,allow,183,94,89,2,30,1,1
17146,46674,53,59897,53,allow,168,78,90,2,30,1,1
17147,52080,9554,2824,9554,allow,70,70,0,2,7,2,0
17148,60333,443,9820,443,allow,8945,5766,3179,30,130,18,12
17149,48778,443,13282,443,allow,6770,2047,4723,26,16,14,12
17150,34298,53,58428,53,allow,199,94,105,2,30,1,1
17151,55643,53,36774,53,allow,183,94,89,2,30,1,1
17152,56746,443,25716,443,allow,8006,1986,6020,20,15,11,9
17153,49830,443,24513,443,allow,8471,2343,6128,30,240,15,15
17154,56067,53,5556,53,allow,195,102,93,2,30,1,1
17155,58934,443,63790,443,allow,5167,700,4467,16,15,7,9
17156,64900,53,45787,53,allow,197,102,95,2,30,1,1
17157,49447,53,53080,53,allow,168,78,90,2,30,1,1
17158,50056,27018,46603,27018,allow,468,390,78,5,30,4,1
17159,55669,53,38123,53,allow,177,94,83,2,30,1,1
17160,55759,53,16569,53,allow,177,94,83,2,30,1,1
17161,46707,443,23817,443,allow,9723,1780,7943,35,120,17,18
17162,49777,53,52771,53,allow,216,110,106,2,30,1,1
17163,49747,53,22028,53,allow,278,94,184,2,30,1,1
17164,63884,53,63884,53,allow,400,257,143,3,33,2,1
17165,55609,53,21760,53,allow,178,94,84,2,30,1,1
17166,38564,443,56432,443,allow,1312,651,661,13,185,7,6
17167,33947,443,18903,443,allow,25302,10587,14715,88,123,37,51
17168,45679,53,45679,53,allow,262,106,156,2,33,1,1
17169,60469,60092,63327,60092,allow,70,70,0,1,5,1,0
17170,63848,80,63848,80,allow,555419,4827,550592,451,21,64,387
17171,57206,53,29989,53,allow,292,85,207,4,50,2,2
17172,59782,53,21953,53,allow,168,78,90,2,30,1,1
17173,55179,53,32980,53,allow,183,94,89,2,30,1,1
17174,55609,53,6401,53,allow,178,94,84,2,30,1,1
17175,49251,53,13051,53,allow,94,94,0,1,30,1,0
17176,49908,53,39258,53,allow,789,110,679,2,30,1,1
17177,56149,53,1500,53,allow,179,94,85,2,30,1,1
17178,64787,53,33533,53,allow,179,94,85,2,30,1,1
17179,36621,443,53395,443,allow,2239099,75601,2163498,2512,71,983,1529
17180,56770,443,61506,443,allow,5829,2962,2867,35,89,17,18
17181,56588,53,38290,53,allow,305,99,206,4,49,2,2
17182,51218,5223,10817,5223,allow,11005,5789,5216,34,23,18,16
17183,38405,80,54534,80,allow,1114,534,580,12,16,7,5
17184,53882,13613,12263,13613,allow,320,140,180,6,5,3,3
17185,17428,3389,17428,3389,allow,4695,2520,2175,22,19,13,9
17186,54816,443,23557,443,allow,130,70,60,3,4,2,1
17187,60472,20273,4062,20273,allow,70,70,0,1,5,1,0
17188,55701,31543,58312,31543,allow,320,140,180,6,5,3,3
17189,37116,80,37116,80,allow,2971,1509,1462,10,15,6,4
17190,53964,443,1978,443,allow,152,78,74,2,5,1,1
17191,56700,80,19955,80,allow,51889,4253,47636,68,64,31,37
17192,56745,443,12454,443,allow,8058,2038,6020,20,15,11,9
17193,49545,53,14394,53,allow,195,102,93,2,29,1,1
17194,52164,443,1593,443,allow,161883,8848,153035,177,54,64,113
17195,51709,53,0,0,allow,201,94,107,2,29,1,1
17196,55643,53,52326,53,allow,183,94,89,2,29,1,1
17197,37611,443,31494,443,allow,3936,1618,2318,26,146,14,12
17198,54550,53,0,0,allow,188,86,102,2,29,1,1
17199,9742,80,9742,80,allow,1384,648,736,9,15,5,4
17200,56803,53,37278,53,allow,183,94,89,2,29,1,1
17201,43910,443,49945,443,allow,10506,2984,7522,30,15,17,13
17202,56134,53,59241,53,allow,183,94,89,2,29,1,1
17203,40026,443,36114,443,allow,6058,1749,4309,22,200,13,9
17204,58841,443,21745,443,allow,18238,3980,14258,61,152,27,34
17205,50654,80,39837,80,allow,3728,1504,2224,13,21,7,6
17206,55759,53,35937,53,allow,177,94,83,2,30,1,1
17207,50655,80,2422,80,allow,2108,1167,941,10,20,6,4
17208,61956,80,61956,80,allow,2102,1583,519,11,23,6,5
17209,5588,5588,0,0,allow,3562,1936,1626,48,194,24,24
17210,56588,53,41777,53,allow,197,102,95,2,29,1,1
17211,64023,53,2522,53,allow,179,94,85,2,29,1,1
17212,64987,27042,62086,27042,allow,1012,462,550,4,30,2,2
17213,64900,53,46043,53,allow,197,102,95,2,30,1,1
17214,58764,53,65299,53,allow,268,94,174,2,30,1,1
17215,50108,53,40711,53,allow,179,94,85,2,30,1,1
17216,64023,53,57287,53,allow,179,94,85,2,30,1,1
17217,50376,53,47622,53,allow,167,78,89,2,30,1,1
17218,55609,53,4360,53,allow,178,94,84,2,30,1,1
17219,50077,53,35101,53,allow,787,110,677,2,30,1,1
17220,49777,53,28087,53,allow,216,110,106,2,30,1,1
17221,49620,53,15285,53,allow,211,110,101,2,30,1,1
17222,56267,53,59732,53,allow,453,186,267,6,30,3,3
17223,49686,53,55592,53,allow,183,94,89,2,30,1,1
17224,54974,53,5978,53,allow,212,102,110,2,30,1,1
17225,56260,53,6502,53,allow,177,94,83,2,30,1,1
17226,64892,53,23593,53,allow,772,102,670,2,30,1,1
17227,47512,443,61793,443,allow,8785,2057,6728,31,396,10,21
17228,55058,53,43398,53,allow,216,110,106,2,31,1,1
17229,56960,53,21026,53,allow,196,102,94,2,31,1,1
17230,50584,6881,29773,6881,allow,502,150,352,2,1200,1,1
17231,44847,22467,39791,22467,allow,150,150,0,1,1200,1,0
17232,19473,40959,26703,40959,allow,491,150,341,2,1200,1,1
17233,65381,53,27857,53,allow,317,102,215,2,31,1,1
17234,62345,443,13195,443,allow,6343025,74037,6268988,5018,58,765,4253
17235,53270,443,54512,443,allow,12757,4360,8397,41,17,23,18
17236,43880,80,10125,80,allow,2693,841,1852,13,16,8,5
17237,56809,53,56809,53,allow,404,259,145,3,33,2,1
17238,9227,443,31374,443,allow,5146,960,4186,17,25,9,8
17239,49385,443,34796,443,allow,44437,2600,41837,62,16,28,34
17240,52092,443,18467,443,allow,13078,7055,6023,114,162,59,55
17241,56109,53,22951,53,allow,177,94,83,2,30,1,1
17242,54528,53,37583,53,allow,197,94,103,2,30,1,1
17243,46331,53,26643,53,allow,199,94,105,2,30,1,1
17244,65506,53,15371,53,allow,197,102,95,2,30,1,1
17245,38562,443,22999,443,allow,1310,649,661,13,185,7,6
17246,65505,443,12963,443,allow,458741,13270,445471,469,16,164,305
17247,58614,53,27966,53,allow,168,78,90,2,30,1,1
17248,49866,53,19774,53,allow,225,110,115,2,30,1,1
17249,64546,53,63352,53,allow,889,404,485,10,30,5,5
17250,49359,53,28261,53,allow,718,94,624,2,30,1,1
17251,55669,53,15952,53,allow,177,94,83,2,30,1,1
17252,51622,53,52520,53,allow,260,86,174,2,30,1,1
17253,64549,53,44048,53,allow,273,86,187,2,30,1,1
17254,57338,443,27463,443,allow,8126,1887,6239,32,732,17,15
17255,56067,53,40948,53,allow,195,102,93,2,30,1,1
17256,55961,53,7584,53,allow,214,102,112,2,30,1,1
17257,49224,53,60967,53,allow,177,94,83,2,30,1,1
17258,49598,53,15528,53,allow,214,102,112,2,30,1,1
17259,49255,53,62654,53,allow,212,102,110,2,30,1,1
17260,56160,53,58234,53,allow,195,102,93,2,31,1,1
17261,48817,57013,48817,57013,allow,158,158,0,1,1200,1,0
17262,51221,3054,33559,3054,allow,870,330,540,12,1320,6,6
17263,49977,53,38356,53,allow,209,110,99,2,30,1,1
17264,64950,53,65250,53,allow,193,102,91,2,30,1,1
17265,65335,53,50606,53,allow,216,102,114,2,30,1,1
17266,55417,53,42244,53,allow,179,94,85,2,30,1,1
17267,56367,53,31807,53,allow,194,102,92,2,30,1,1
17268,56160,53,61640,53,allow,195,102,93,2,30,1,1
17269,64357,53,56985,53,allow,183,94,89,2,30,1,1
17270,57210,53,57210,53,allow,628,82,546,2,30,1,1
17271,55660,53,31252,53,allow,177,94,83,2,30,1,1
17272,63095,443,9067,443,allow,571,166,405,2,30,1,1
17273,63094,53,39482,53,allow,384,166,218,2,30,1,1
17274,63092,53,40692,53,allow,304,86,218,2,30,1,1
17275,55945,53,49702,53,allow,177,94,83,2,31,1,1
17276,54959,53,55132,53,allow,211,110,101,2,31,1,1
17277,55417,53,15668,53,allow,179,94,85,2,31,1,1
17278,56272,53,13597,53,allow,193,102,91,2,31,1,1
17279,54540,443,17427,443,allow,6680,3784,2896,18,135,9,9
17280,56560,53,25642,53,allow,900,110,790,2,31,1,1
17281,64357,53,37789,53,allow,183,94,89,2,31,1,1
17282,56373,53,9374,53,allow,177,94,83,2,30,1,1
17283,56260,53,30984,53,allow,177,94,83,2,31,1,1
17284,50999,53,58447,53,allow,214,78,136,2,30,1,1
17285,65506,53,20953,53,allow,197,102,95,2,30,1,1
17286,49828,53,30864,53,allow,340,110,230,2,31,1,1
17287,63631,443,40886,443,allow,8640,5157,3483,17,120,10,7
17288,49656,443,4978,443,allow,182624,7130,175494,212,132,77,135
17289,62287,443,17565,443,allow,3644,610,3034,13,119,6,7
17290,45908,443,37140,443,allow,507235,15454,491781,534,136,188,346
17291,55320,53,54468,53,allow,304,94,210,2,30,1,1
17292,55417,53,40418,53,allow,179,94,85,2,30,1,1
17293,55750,53,13328,53,allow,211,110,101,2,30,1,1
17294,63093,443,45246,443,allow,304,86,218,2,30,1,1
17295,50098,53,35550,53,allow,199,102,97,2,31,1,1
17296,55795,443,23533,443,allow,5283,2688,2595,14,135,7,7
17297,58029,443,3427,443,allow,1312,651,661,13,185,7,6
17298,58031,443,14165,443,allow,1314,653,661,13,185,7,6
17299,30188,49786,29335,49786,allow,502,150,352,2,1200,1,1
17300,60596,53,45720,53,allow,300,86,214,2,31,1,1
17301,55942,53,19231,53,allow,197,102,95,2,31,1,1
17302,52077,51638,13368,51638,allow,70,70,0,2,8,2,0
17303,59875,443,49654,443,allow,6922,2214,4708,32,136,20,12
17304,54960,443,1507,443,allow,17670,2044,15626,53,316,21,32
17305,42158,443,61169,443,allow,6865,3366,3499,39,206,15,24
17306,63319,53,8378,53,allow,315,102,213,2,31,1,1
17307,55454,53,12163,53,allow,168,86,82,2,32,1,1
17308,52075,37919,58563,37919,allow,70,70,0,2,8,2,0
17309,53873,52055,21698,52055,allow,70,70,0,2,8,2,0
17310,56699,80,7390,80,allow,64386,3122,61264,79,64,35,44
17311,49221,36069,51500,36069,allow,1941,1009,932,10,16,6,4
17312,55989,53,49458,53,allow,205,86,119,2,30,1,1
17313,53800,53,27732,53,allow,260,86,174,2,30,1,1
17314,64472,53,59070,53,allow,183,94,89,2,31,1,1
17315,63087,443,39607,443,allow,448,166,282,2,31,1,1
17316,64576,53,14840,53,allow,194,102,92,2,31,1,1
17317,63076,443,26735,443,allow,304,86,218,2,31,1,1
17318,56661,443,39690,443,allow,7900,3324,4576,28,139,13,15
17319,50458,53,29574,53,allow,177,94,83,2,31,1,1
17320,57359,53,20340,53,allow,458,188,270,6,31,3,3
17321,53867,60272,19562,60272,allow,70,70,0,2,8,2,0
17322,49763,53,30741,53,allow,258,110,148,2,30,1,1
17323,49224,53,31598,53,allow,177,94,83,2,30,1,1
17324,63126,445,0,0,drop,70,70,0,1,0,1,0
17325,63124,445,0,0,drop,70,70,0,1,0,1,0
17326,1036,64147,0,0,deny,62,62,0,1,0,1,0
17327,63287,445,0,0,drop,66,66,0,1,0,1,0
17328,50321,18593,0,0,deny,143,143,0,1,0,1,0
17329,35626,22114,0,0,deny,66,66,0,1,0,1,0
17330,51511,445,0,0,drop,70,70,0,1,0,1,0
17331,50106,30317,0,0,deny,66,66,0,1,0,1,0
17332,10914,35974,0,0,deny,60,60,0,1,0,1,0
17333,11382,43890,0,0,deny,66,66,0,1,0,1,0
17334,63111,445,0,0,drop,70,70,0,1,0,1,0
17335,63110,445,0,0,drop,70,70,0,1,0,1,0
17336,54917,60043,0,0,deny,66,66,0,1,0,1,0
17337,54883,60043,0,0,deny,62,62,0,1,0,1,0
17338,63106,445,0,0,drop,70,70,0,1,0,1,0
17339,3717,25174,0,0,deny,62,62,0,1,0,1,0
17340,63285,445,0,0,drop,66,66,0,1,0,1,0
17341,63101,445,0,0,drop,70,70,0,1,0,1,0
17342,63100,445,0,0,drop,70,70,0,1,0,1,0
17343,47783,50432,0,0,deny,62,62,0,1,0,1,0
17344,11136,19910,0,0,deny,62,62,0,1,0,1,0
17345,63278,445,0,0,drop,66,66,0,1,0,1,0
17346,59355,51505,0,0,deny,66,66,0,1,0,1,0
17347,63272,445,0,0,drop,66,66,0,1,0,1,0
17348,51310,64147,0,0,deny,62,62,0,1,0,1,0
17349,27679,37965,0,0,deny,62,62,0,1,0,1,0
17350,65006,26467,0,0,deny,62,62,0,1,0,1,0
17351,51413,57470,0,0,deny,72,72,0,1,0,1,0
17352,18113,22114,0,0,deny,62,62,0,1,0,1,0
17353,33328,25174,0,0,deny,62,62,0,1,0,1,0
17354,33328,25174,0,0,deny,146,146,0,1,0,1,0
17355,46734,50265,0,0,deny,74,74,0,1,0,1,0
17356,63089,445,0,0,drop,70,70,0,1,0,1,0
17357,12318,36866,0,0,deny,139,139,0,1,0,1,0
17358,6666,16010,0,0,deny,60,60,0,1,0,1,0
17359,15701,37965,0,0,deny,146,146,0,1,0,1,0
17360,52503,50584,0,0,deny,66,66,0,1,0,1,0
17361,54769,50584,0,0,deny,146,146,0,1,0,1,0
17362,51726,64147,0,0,deny,66,66,0,1,0,1,0
17363,51045,25174,0,0,deny,62,62,0,1,0,1,0
17364,65159,37965,0,0,deny,74,74,0,1,0,1,0
17365,58103,10197,0,0,deny,66,66,0,1,0,1,0
17366,51503,445,0,0,drop,70,70,0,1,0,1,0
17367,51501,445,0,0,drop,70,70,0,1,0,1,0
17368,51499,445,0,0,drop,70,70,0,1,0,1,0
17369,61840,25174,0,0,deny,62,62,0,1,0,1,0
17370,22856,22114,0,0,deny,66,66,0,1,0,1,0
17371,17947,36237,0,0,deny,62,62,0,1,0,1,0
17372,63262,445,0,0,drop,66,66,0,1,0,1,0
17373,63260,445,0,0,drop,66,66,0,1,0,1,0
17374,63259,445,0,0,drop,66,66,0,1,0,1,0
17375,63255,445,0,0,drop,66,66,0,1,0,1,0
17376,63257,445,0,0,drop,66,66,0,1,0,1,0
17377,63258,445,0,0,drop,66,66,0,1,0,1,0
17378,63261,445,0,0,drop,66,66,0,1,0,1,0
17379,63254,445,0,0,drop,66,66,0,1,0,1,0
17380,7356,25174,0,0,deny,62,62,0,1,0,1,0
17381,14614,25174,0,0,deny,62,62,0,1,0,1,0
17382,52537,57866,0,0,deny,66,66,0,1,0,1,0
17383,56249,55442,0,0,deny,66,66,0,1,0,1,0
17384,26263,8168,0,0,deny,66,66,0,1,0,1,0
17385,29145,8168,0,0,deny,62,62,0,1,0,1,0
17386,63085,445,0,0,drop,70,70,0,1,0,1,0
17387,54418,22114,0,0,deny,62,62,0,1,0,1,0
17388,21604,50201,0,0,deny,62,62,0,1,0,1,0
17389,63076,445,0,0,drop,70,70,0,1,0,1,0
17390,63075,445,0,0,drop,70,70,0,1,0,1,0
17391,63074,445,0,0,drop,70,70,0,1,0,1,0
17392,56621,50584,0,0,deny,62,62,0,1,0,1,0
17393,50620,50584,0,0,deny,66,66,0,1,0,1,0
17394,63071,445,0,0,drop,70,70,0,1,0,1,0
17395,51425,37450,0,0,deny,66,66,0,1,0,1,0
17396,63068,445,0,0,drop,70,70,0,1,0,1,0
17397,63982,25174,0,0,deny,62,62,0,1,0,1,0
17398,54754,50432,0,0,deny,66,66,0,1,0,1,0
17399,51492,445,0,0,drop,70,70,0,1,0,1,0
17400,51487,445,0,0,drop,70,70,0,1,0,1,0
17401,51485,445,0,0,drop,70,70,0,1,0,1,0
17402,51480,445,0,0,drop,70,70,0,1,0,1,0
17403,45964,3111,0,0,deny,60,60,0,1,0,1,0
17404,6712,123,0,0,deny,90,90,0,1,0,1,0
17405,63241,445,0,0,drop,66,66,0,1,0,1,0
17406,63240,445,0,0,drop,66,66,0,1,0,1,0
17407,63239,445,0,0,drop,66,66,0,1,0,1,0
17408,6929,35440,0,0,deny,66,66,0,1,0,1,0
17409,31172,22114,0,0,deny,146,146,0,1,0,1,0
17410,6247,51221,0,0,deny,78,78,0,1,0,1,0
17411,15442,22114,0,0,deny,62,62,0,1,0,1,0
17412,26527,25174,0,0,deny,66,66,0,1,0,1,0
17413,37429,25174,0,0,deny,62,62,0,1,0,1,0
17414,7810,25174,0,0,deny,62,62,0,1,0,1,0
17415,51478,445,0,0,drop,70,70,0,1,0,1,0
17416,63062,445,0,0,drop,70,70,0,1,0,1,0
17417,52430,35440,0,0,deny,146,146,0,1,0,1,0
17418,51471,445,0,0,drop,70,70,0,1,0,1,0
17419,51470,445,0,0,drop,70,70,0,1,0,1,0
17420,51468,445,0,0,drop,70,70,0,1,0,1,0
17421,23021,2222,0,0,deny,60,60,0,1,0,1,0
17422,47424,25174,0,0,deny,66,66,0,1,0,1,0
17423,56897,11446,0,0,deny,66,66,0,1,0,1,0
17424,1190,25174,0,0,deny,62,62,0,1,0,1,0
17425,63055,445,0,0,drop,70,70,0,1,0,1,0
17426,56397,26467,0,0,deny,62,62,0,1,0,1,0
17427,63053,445,0,0,drop,70,70,0,1,0,1,0
17428,36011,25174,0,0,deny,66,66,0,1,0,1,0
17429,6356,26467,0,0,deny,62,62,0,1,0,1,0
17430,54526,44847,0,0,deny,66,66,0,1,0,1,0
17431,52359,23,0,0,deny,60,60,0,1,0,1,0
17432,63049,445,0,0,drop,70,70,0,1,0,1,0
17433,51461,445,0,0,drop,70,70,0,1,0,1,0
17434,51457,445,0,0,drop,70,70,0,1,0,1,0
17435,51458,445,0,0,drop,70,70,0,1,0,1,0
17436,48025,44847,0,0,deny,146,146,0,1,0,1,0
17437,63047,445,0,0,drop,70,70,0,1,0,1,0
17438,0,0,0,0,deny,70,70,0,1,0,1,0
17439,0,0,0,0,allow,480,244,236,4,0,2,2
17440,51414,22,0,0,deny,60,60,0,1,0,1,0
17441,63230,445,0,0,drop,66,66,0,1,0,1,0
17442,53577,35894,0,0,deny,62,62,0,1,0,1,0
17443,3064,44847,0,0,deny,62,62,0,1,0,1,0
17444,63043,445,0,0,drop,70,70,0,1,0,1,0
17445,53199,30188,0,0,deny,66,66,0,1,0,1,0
17446,1356,57470,0,0,deny,72,72,0,1,0,1,0
17447,49893,25174,0,0,deny,66,66,0,1,0,1,0
17448,63041,445,0,0,drop,70,70,0,1,0,1,0
17449,55826,42771,0,0,deny,62,62,0,1,0,1,0
17450,55825,52700,0,0,deny,62,62,0,1,0,1,0
17451,51453,445,0,0,drop,70,70,0,1,0,1,0
17452,48826,25174,0,0,deny,62,62,0,1,0,1,0
17453,53022,25174,0,0,deny,62,62,0,1,0,1,0
17454,51451,445,0,0,drop,70,70,0,1,0,1,0
17455,30598,37965,0,0,deny,62,62,0,1,0,1,0
17456,11488,22114,0,0,deny,62,62,0,1,0,1,0
17457,52744,25174,0,0,deny,66,66,0,1,0,1,0
17458,17415,25174,0,0,deny,62,62,0,1,0,1,0
17459,62056,30317,0,0,deny,146,146,0,1,0,1,0
17460,63211,445,0,0,drop,66,66,0,1,0,1,0
17461,63212,445,0,0,drop,66,66,0,1,0,1,0
17462,63037,445,0,0,drop,70,70,0,1,0,1,0
17463,52808,57470,0,0,deny,146,146,0,1,0,1,0
17464,15176,62413,0,0,deny,66,66,0,1,0,1,0
17465,61017,64147,0,0,deny,62,62,0,1,0,1,0
17466,1733,65448,0,0,deny,62,62,0,1,0,1,0
17467,42238,25174,0,0,deny,62,62,0,1,0,1,0
17468,61185,54532,0,0,deny,62,62,0,1,0,1,0
17469,19875,30170,0,0,deny,145,145,0,1,0,1,0
17470,59668,50584,0,0,deny,66,66,0,1,0,1,0
17471,51441,445,0,0,drop,70,70,0,1,0,1,0
17472,51434,445,0,0,drop,70,70,0,1,0,1,0
17473,51433,445,0,0,drop,70,70,0,1,0,1,0
17474,51431,445,0,0,drop,70,70,0,1,0,1,0
17475,22036,44847,0,0,deny,146,146,0,1,0,1,0
17476,18203,23,0,0,deny,60,60,0,1,0,1,0
17477,60261,25174,0,0,deny,66,66,0,1,0,1,0
17478,63587,22114,0,0,deny,62,62,0,1,0,1,0
17479,63208,445,0,0,drop,66,66,0,1,0,1,0
17480,54216,64147,0,0,deny,66,66,0,1,0,1,0
17481,59373,22,59373,22,deny,295,126,169,4,1,2,2
17482,63202,445,0,0,drop,66,66,0,1,0,1,0
17483,64691,25320,0,0,deny,66,66,0,1,0,1,0
17484,63200,445,0,0,drop,66,66,0,1,0,1,0
17485,63203,445,0,0,drop,66,66,0,1,0,1,0
17486,63083,53,63784,53,allow,303,85,218,2,30,1,1
17487,64357,53,46898,53,allow,182,93,89,2,30,1,1
17488,63091,443,18908,443,allow,382,164,218,2,30,1,1
17489,49197,53,13288,53,allow,777,87,690,2,30,1,1
17490,65506,53,39413,53,allow,194,99,95,2,30,1,1
17491,50641,53,60493,53,allow,760,97,663,2,30,1,1
17492,56714,443,11426,443,allow,579769,15036,564733,578,61,199,379
17493,57148,443,64280,443,allow,12000,9252,2748,34,273,17,17
17494,51437,80,35977,80,allow,1703,538,1165,8,177,5,3
17495,64472,53,7630,53,allow,182,93,89,2,30,1,1
17496,50052,53,19645,53,allow,738,86,652,2,30,1,1
17497,55945,53,26703,53,allow,170,87,83,2,30,1,1
17498,51432,80,62424,80,allow,1675,539,1136,8,178,5,3
17499,60343,80,4297,80,allow,2005,1094,911,11,87,6,5
17500,9296,443,44194,443,allow,3792,488,3304,14,16,7,7
17501,9314,443,56500,443,allow,3792,488,3304,14,16,7,7
17502,42379,443,33462,443,allow,1622,1137,485,11,26,7,4
17503,47647,443,47647,443,allow,4565,1658,2907,19,28,11,8
17504,25436,53,25436,53,allow,235,90,145,2,32,1,1
17505,45416,80,25189,80,allow,2713,753,1960,12,15,7,5
17506,36339,443,4245,443,allow,7295,1830,5465,23,316,13,10
17507,53463,29500,1810,29500,allow,877,577,300,10,143,5,5
17508,65147,53,28135,53,allow,763,101,662,2,30,1,1
17509,55039,443,27278,443,allow,8209,2789,5420,24,42,14,10
17510,45308,443,7277,443,allow,3657,1867,1790,22,391,7,15
17511,9305,443,52742,443,allow,3616,429,3187,11,16,6,5
17512,60341,80,24741,80,allow,2005,1094,911,11,87,6,5
17513,60336,443,57486,443,allow,6613,4394,2219,50,122,29,21
17514,53877,32737,64789,32737,allow,320,140,180,6,7,3,3
17515,52072,25595,25464,25595,allow,70,70,0,2,8,2,0
17516,53870,24535,42849,24535,allow,70,70,0,2,8,2,0
17517,9373,80,65080,80,allow,1643,485,1158,10,15,5,5
17518,9377,80,44297,80,allow,1643,485,1158,10,15,5,5
17519,38280,443,38280,443,allow,3333,2072,1261,21,148,12,9
17520,9319,443,38033,443,allow,5687,499,5188,14,16,7,7
17521,56582,53,23626,53,allow,711,87,624,2,31,1,1
17522,64995,27023,24538,27023,allow,1773,924,849,6,30,3,3
17523,9303,443,49206,443,allow,3616,429,3187,11,16,6,5
17524,55965,53,22177,53,allow,184,94,90,2,30,1,1
17525,60346,80,8391,80,allow,2124,1158,966,13,87,7,6
17526,56020,53,29198,53,allow,711,87,624,2,30,1,1
17527,60344,80,63030,80,allow,2005,1094,911,11,87,6,5
17528,49756,53,23691,53,allow,264,89,175,4,48,2,2
17529,45394,80,27437,80,allow,4886,1260,3626,17,17,10,7
17530,9317,443,63611,443,allow,5687,499,5188,14,16,7,7
17531,45414,80,30413,80,allow,2873,753,2120,12,15,7,5
17532,39233,53,39233,53,allow,235,90,145,2,33,1,1
17533,63150,443,63150,443,allow,6792,1521,5271,18,28,11,7
17534,41036,443,13628,443,allow,153,93,60,2,5,1,1
17535,53880,61393,8542,61393,allow,320,140,180,6,6,3,3
17536,60345,80,36242,80,allow,2124,1158,966,13,87,7,6
17537,45021,53,45021,53,allow,213,79,134,2,32,1,1
17538,52076,28895,42169,28895,allow,70,70,0,2,8,2,0
17539,54977,53,19132,53,allow,275,93,182,4,32,2,2
17540,50663,80,56397,80,allow,1366,865,501,8,15,5,3
17541,49531,80,27250,80,allow,78,78,0,2,8,2,0
17542,42377,443,33699,443,allow,1622,1137,485,11,26,7,4
17543,49304,443,52179,443,allow,932965,16289,916676,768,65,148,620
17544,52054,50513,53866,50513,allow,66,66,0,1,5,1,0
17545,55907,53,13623,53,allow,711,87,624,2,30,1,1
17546,49363,53,12270,53,allow,208,106,102,2,30,1,1
17547,55417,53,13088,53,allow,174,89,85,2,30,1,1
17548,57082,53,0,0,allow,82,82,0,1,30,1,0
17549,13237,53,13237,53,allow,823,98,725,2,30,1,1
17550,36352,443,46352,443,allow,3256,1753,1503,17,315,10,7
17551,41576,443,2351,443,allow,2227,1018,1209,17,15,8,9
17552,31090,53,31090,53,allow,365,233,132,3,34,2,1
17553,64135,53,50232,53,allow,192,98,94,2,31,1,1
17554,60342,80,14869,80,allow,2005,1094,911,11,87,6,5
17555,42380,443,32272,443,allow,1622,1137,485,11,26,7,4
17556,53041,443,37580,443,allow,7263,1834,5429,27,16,15,12
17557,38368,15000,38283,15000,allow,130,70,60,2,5,1,1
17558,28234,36653,45143,36653,allow,64,64,0,1,10,1,0
17559,42631,443,38369,443,allow,153,93,60,2,5,1,1
17560,51855,7700,11959,7700,allow,12087,9521,2566,76,32,38,38
17561,65315,53,25931,53,allow,770,101,669,2,30,1,1
17562,9304,443,28860,443,allow,3922,552,3370,16,16,8,8
17563,55566,53,37015,53,allow,740,93,647,2,30,1,1
17564,49686,53,35211,53,allow,182,93,89,2,30,1,1
17565,63082,443,41312,443,allow,303,85,218,2,30,1,1
17566,55772,53,9529,53,allow,782,105,677,2,30,1,1
17567,60089,53,50988,53,allow,297,83,214,2,30,1,1
17568,55134,53,55134,53,allow,825,99,726,2,31,1,1
17569,56294,53,56294,53,allow,229,89,140,2,31,1,1
17570,64746,53,11815,53,allow,186,95,91,2,31,1,1
17571,48817,6881,48817,6881,allow,773,279,494,4,1200,2,2
17572,48817,6884,48817,6884,allow,328,152,176,2,1200,1,1
17573,48817,7294,48817,7294,allow,479,152,327,2,1200,1,1
17574,55275,53,41187,53,allow,770,101,669,2,30,1,1
17575,65386,53,25163,53,allow,194,99,95,2,30,1,1
17576,56912,53,9519,53,allow,198,101,97,2,31,1,1
17577,59720,443,13294,443,allow,3346,1219,2127,15,136,7,8
17578,48817,45682,48817,45682,allow,513,152,361,2,1200,1,1
17579,48817,42099,48817,42099,allow,479,152,327,2,1200,1,1
17580,56160,53,63340,53,allow,190,97,93,2,30,1,1
17581,56845,53,56845,53,allow,825,99,726,2,30,1,1
17582,60384,53,44713,53,allow,234,96,138,2,31,1,1
17583,56246,53,10681,53,allow,816,97,719,2,31,1,1
17584,64414,53,56894,53,allow,182,93,89,2,31,1,1
17585,63952,53,34336,53,allow,206,105,101,2,31,1,1
17586,57681,53,57681,53,allow,220,100,120,2,31,1,1
17587,55942,53,46906,53,allow,194,99,95,2,31,1,1
17588,57371,53,9888,53,allow,755,93,662,2,31,1,1
17589,56805,53,62222,53,allow,815,95,720,2,31,1,1
17590,64318,53,59823,53,allow,182,93,89,2,31,1,1
17591,48817,49490,48817,49490,allow,513,152,361,2,1200,1,1
17592,55230,53,36374,53,allow,182,93,89,2,30,1,1
17593,54980,53,25043,53,allow,763,101,662,2,30,1,1
17594,57294,53,3249,53,allow,760,97,663,2,31,1,1
17595,35191,53,35191,53,allow,825,99,726,2,31,1,1
17596,58390,53,44510,53,allow,240,76,164,2,31,1,1
17597,56913,53,30099,53,allow,772,103,669,2,31,1,1
17598,56561,53,2642,53,allow,216,110,106,2,31,1,1
17599,49802,53,5262,53,allow,755,93,662,2,31,1,1
17600,49978,53,54478,53,allow,760,97,663,2,31,1,1
17601,57384,53,45393,53,allow,752,93,659,2,31,1,1
17602,64970,27055,4626,27055,allow,735,462,273,2,31,1,1
17603,49286,53,16984,53,allow,184,94,90,2,31,1,1
17604,55024,53,56157,53,allow,168,86,82,2,31,1,1
17605,55194,53,53010,53,allow,190,97,93,2,31,1,1
17606,49631,53,31277,53,allow,196,100,96,2,31,1,1
17607,48817,18529,48817,18529,allow,152,152,0,1,1200,1,0
17608,56497,53,2084,53,allow,170,87,83,2,31,1,1
17609,65336,53,14965,53,allow,732,89,643,2,31,1,1
17610,48817,51413,48817,51413,allow,479,152,327,2,1200,1,1
17611,48817,51413,48817,51413,allow,479,152,327,2,1200,1,1
17612,48817,6882,48817,6882,allow,152,152,0,1,1200,1,0
17613,48817,49157,48817,49157,allow,328,152,176,2,1200,1,1
17614,55786,53,65115,53,allow,186,95,91,2,31,1,1
17615,48817,8621,48817,8621,allow,152,152,0,1,1200,1,0
17616,48817,63838,48817,63838,allow,513,152,361,2,1200,1,1
17617,48817,37028,48817,37028,allow,513,152,361,2,1200,1,1
17618,48817,26484,48817,26484,allow,513,152,361,2,1200,1,1
17619,48817,51413,48817,51413,allow,479,152,327,2,1200,1,1
17620,48817,6881,48817,6881,allow,494,152,342,2,1200,1,1
17621,48817,6881,48817,6881,allow,506,152,354,2,1200,1,1
17622,48817,41706,48817,41706,allow,513,152,361,2,1200,1,1
17623,48817,6881,48817,6881,allow,506,152,354,2,1200,1,1
17624,63195,445,0,0,drop,66,66,0,1,0,1,0
17625,63197,445,0,0,drop,66,66,0,1,0,1,0
17626,63201,445,0,0,drop,66,66,0,1,0,1,0
17627,63192,445,0,0,drop,66,66,0,1,0,1,0
17628,63024,445,0,0,drop,70,70,0,1,0,1,0
17629,51427,445,0,0,drop,70,70,0,1,0,1,0
17630,63545,25174,0,0,deny,66,66,0,1,0,1,0
17631,51423,445,0,0,drop,70,70,0,1,0,1,0
17632,51419,445,0,0,drop,70,70,0,1,0,1,0
17633,51420,445,0,0,drop,70,70,0,1,0,1,0
17634,7222,57470,0,0,deny,62,62,0,1,0,1,0
17635,51979,25174,0,0,deny,66,66,0,1,0,1,0
17636,20576,37965,0,0,deny,62,62,0,1,0,1,0
17637,56127,37965,0,0,deny,66,66,0,1,0,1,0
17638,63021,445,0,0,drop,70,70,0,1,0,1,0
17639,45783,22114,0,0,deny,62,62,0,1,0,1,0
17640,58900,37807,0,0,deny,66,66,0,1,0,1,0
17641,61550,5529,0,0,deny,145,145,0,1,0,1,0
17642,56762,53,10998,53,allow,168,86,82,2,30,1,1
17643,9338,443,8556,443,allow,4462,500,3962,13,15,7,6
17644,50098,53,37375,53,allow,199,102,97,2,30,1,1
17645,63089,53,1694,53,allow,512,166,346,2,30,1,1
17646,64135,53,40678,53,allow,196,102,94,2,30,1,1
17647,50491,443,32943,443,allow,28729,1634,27095,40,120,16,24
17648,56863,80,39475,80,allow,13608,783,12825,21,45,9,12
17649,37613,443,61713,443,allow,10042,3117,6925,28,47,16,12
17650,60129,80,34372,80,allow,2910,1439,1471,12,31,7,5
17651,49270,80,7008,80,allow,254,128,126,5,15,3,2
17652,53881,11513,24027,11513,allow,320,140,180,6,5,3,3
17653,34430,80,5069,80,allow,2913,633,2280,15,15,8,7
17654,34436,80,7684,80,allow,6260,696,5564,17,15,9,8
17655,41611,80,9523,80,allow,1860,712,1148,8,15,5,3
17656,56744,443,27482,443,allow,8008,1988,6020,20,15,11,9
17657,55829,53,51099,53,allow,177,94,83,2,30,1,1
17658,53161,30013,6313,30013,allow,70,70,0,2,7,2,0
17659,41790,443,32230,443,allow,232,172,60,3,4,2,1
17660,9318,443,40235,443,allow,3649,424,3225,12,15,6,6
17661,49765,443,5454,443,allow,11588,4383,7205,39,46,22,17
17662,49773,80,19021,80,allow,70,70,0,2,8,2,0
17663,56698,80,23963,80,allow,176644,9435,167209,266,65,104,162
17664,56940,53,20579,53,allow,316,97,219,4,33,2,2
17665,53869,17089,2091,17089,allow,70,70,0,2,7,2,0
17666,49363,53,19246,53,allow,212,110,102,2,29,1,1
17667,57063,53,6247,53,allow,193,102,91,2,29,1,1
17668,55492,53,7520,53,allow,216,110,106,2,29,1,1
17669,56082,53,1185,53,allow,730,102,628,2,29,1,1
17670,49620,53,9957,53,allow,211,110,101,2,29,1,1
17671,55492,53,34032,53,allow,216,110,106,2,29,1,1
17672,55945,53,7616,53,allow,177,94,83,2,29,1,1
17673,55660,53,60167,53,allow,177,94,83,2,30,1,1
17674,37561,443,20164,443,allow,9766,3093,6673,37,270,21,16
17675,9308,443,57827,443,allow,3837,488,3349,15,15,7,8
17676,9339,443,39172,443,allow,3614,434,3180,11,15,6,5
17677,49702,443,53414,443,allow,42430,4111,38319,79,130,42,37
17678,49756,53,23582,53,allow,264,89,175,4,47,2,2
17679,49875,53,51820,53,allow,399,86,313,4,49,2,2
17680,56375,53,4140,53,allow,322,110,212,4,30,2,2
17681,56810,53,11762,53,allow,177,94,83,2,30,1,1
17682,56960,53,26282,53,allow,196,102,94,2,30,1,1
17683,64746,53,35675,53,allow,193,102,91,2,30,1,1
17684,65248,53,49147,53,allow,212,110,102,2,30,1,1
17685,65225,53,20120,53,allow,822,102,720,2,30,1,1
17686,56561,53,19091,53,allow,216,110,106,2,30,1,1
17687,56741,443,30975,443,allow,8059,2039,6020,20,15,11,9
17688,52071,57491,41650,57491,allow,70,70,0,2,8,2,0
17689,63079,443,63360,443,allow,304,86,218,2,30,1,1
17690,9341,443,61165,443,allow,3835,501,3334,14,15,7,7
17691,59394,443,52019,443,allow,5993,1987,4006,17,26,9,8
17692,55528,80,12209,80,allow,3868,2218,1650,19,39,11,8
17693,53161,443,60488,443,allow,9458,4646,4812,26,25,14,12
17694,53271,443,21027,443,allow,1544,1073,471,13,15,8,5
17695,64699,53,61689,53,allow,338,110,228,2,30,1,1
17696,55058,53,31545,53,allow,216,110,106,2,30,1,1
17697,50504,53,41149,53,allow,168,86,82,2,30,1,1
17698,57431,53,12535,53,allow,994,86,908,2,30,1,1
17699,49620,53,32011,53,allow,198,110,88,2,30,1,1
17700,49172,53,13814,53,allow,305,94,211,2,30,1,1
17701,54959,53,28413,53,allow,211,110,101,2,30,1,1
17702,50458,53,25707,53,allow,177,94,83,2,30,1,1
17703,56375,53,25593,53,allow,216,110,106,2,30,1,1
17704,55251,53,16099,53,allow,212,110,102,2,30,1,1
17705,42025,443,50486,443,allow,70,70,0,1,5,1,0
17706,39055,53,10136,53,allow,289,86,203,2,30,1,1
17707,8896,123,46598,123,allow,94,94,0,1,30,1,0
17708,39114,443,44592,443,allow,1238821,42695,1196126,1389,72,535,854
17709,64384,53,46498,53,allow,350,94,256,2,30,1,1
17710,64486,53,21384,53,allow,290,102,188,2,30,1,1
17711,56272,53,41462,53,allow,193,102,91,2,30,1,1
17712,49313,53,49710,53,allow,199,102,97,2,30,1,1
17713,55251,53,49536,53,allow,212,110,102,2,30,1,1
17714,57778,443,43252,443,allow,6182,3879,2303,53,3828,31,22
17715,56668,80,5597,80,allow,234,234,0,4,12,4,0
17716,9331,443,37171,443,allow,3616,429,3187,11,15,6,5
17717,9340,443,64311,443,allow,3835,501,3334,14,15,7,7
17718,53851,443,36931,443,allow,11779,3603,8176,42,142,21,21
17719,9325,443,25037,443,allow,3616,429,3187,11,15,6,5
17720,9326,443,61009,443,allow,3616,429,3187,11,15,6,5
17721,42457,5222,64493,5222,allow,35380,2898,32482,63,227,22,41
17722,45077,443,32205,443,allow,6533,1777,4756,24,271,13,11
17723,56771,53,50189,53,allow,166,86,80,2,30,1,1
17724,64318,53,51027,53,allow,183,94,89,2,30,1,1
17725,63081,53,24594,53,allow,304,86,218,2,30,1,1
17726,63080,443,52084,443,allow,304,86,218,2,30,1,1
17727,53160,39001,22070,39001,allow,70,70,0,2,8,2,0
17728,55531,80,42208,80,allow,3277,2255,1022,18,39,10,8
17729,9315,443,40509,443,allow,3649,424,3225,12,15,6,6
17730,53163,443,28652,443,allow,12979,4609,8370,27,25,15,12
17731,49293,53,34843,53,allow,382,95,287,4,48,2,2
17732,49686,53,23134,53,allow,183,94,89,2,30,1,1
17733,63088,443,45061,443,allow,512,166,346,2,30,1,1
17734,60203,53,37285,53,allow,328,86,242,2,30,1,1
17735,55230,53,3013,53,allow,183,94,89,2,30,1,1
17736,64472,53,45709,53,allow,183,94,89,2,30,1,1
17737,63078,53,5697,53,allow,304,86,218,2,30,1,1
17738,56769,53,50586,53,allow,195,102,93,2,30,1,1
17739,55942,53,36132,53,allow,197,102,95,2,30,1,1
17740,56629,443,36618,443,allow,22938,14436,8502,43,35,23,20
17741,52073,16316,19866,16316,allow,70,70,0,2,8,2,0
17742,53872,24710,60030,24710,allow,70,70,0,2,7,2,0
17743,49840,443,58601,443,allow,6998,1906,5092,22,24,12,10
17744,60883,443,43627,443,allow,5710,1228,4482,21,16,12,9
17745,49756,53,1585,53,allow,264,89,175,4,48,2,2
17746,55560,443,48574,443,allow,7047,1994,5053,20,24,12,8
17747,53157,34841,3594,34841,allow,698,320,378,10,16,6,4
17748,38358,80,53485,80,allow,409,289,120,5,15,3,2
17749,54447,443,59840,443,allow,9818,2008,7810,23,317,12,11
17750,54977,53,63603,53,allow,275,93,182,4,32,2,2
17751,54977,53,36032,53,allow,275,93,182,4,31,2,2
17752,9332,443,23835,443,allow,3616,429,3187,11,15,6,5
17753,53868,52706,33006,52706,allow,70,70,0,2,7,2,0
17754,9321,443,54415,443,allow,3345,432,2913,11,15,6,5
17755,51968,443,63060,443,allow,5315,3154,2161,56,47,32,24
17756,52053,34411,40436,34411,allow,70,70,0,1,4,1,0
17757,51443,443,42123,443,allow,322,262,60,2,15,1,1
17758,34434,80,45920,80,allow,2913,633,2280,15,15,8,7
17759,50041,443,6754,443,allow,17237,1717,15520,36,152,16,20
17760,59405,443,1405,443,allow,276,70,206,5,26,2,3
17761,52078,15518,47758,15518,allow,70,70,0,2,7,2,0
17762,53871,43266,33475,43266,allow,70,70,0,2,7,2,0
17763,56276,443,23651,443,allow,154,94,60,2,4,1,1
17764,56803,53,3207,53,allow,429,93,336,4,44,2,2
17765,55750,53,45785,53,allow,211,110,101,2,29,1,1
17766,9333,443,63777,443,allow,5200,499,4701,13,15,7,6
17767,64787,53,58679,53,allow,179,94,85,2,29,1,1
17768,9329,443,17986,443,allow,3255,430,2825,11,15,6,5
17769,55829,53,11417,53,allow,212,110,102,2,29,1,1
17770,25608,53,25608,53,allow,823,98,725,2,30,1,1
17771,57023,443,30630,443,allow,10514,2031,8483,28,149,12,16
17772,55530,80,60637,80,allow,3334,2314,1020,19,39,11,8
17773,47149,443,19883,443,allow,5995,1092,4903,22,72,12,10
17774,9327,443,1143,443,allow,3616,429,3187,11,15,6,5
17775,64318,53,45436,53,allow,183,94,89,2,30,1,1
17776,38322,443,57596,443,allow,10632,3838,6794,37,256,18,19
17777,50541,53,14016,53,allow,458,188,270,6,30,3,3
17778,56771,53,26482,53,allow,166,86,80,2,30,1,1
17779,31214,53,31214,53,allow,216,90,126,2,30,1,1
17780,9295,443,22317,443,allow,3837,488,3349,15,15,7,8
17781,63086,53,16338,53,allow,512,166,346,2,30,1,1
17782,64804,53,12585,53,allow,383,97,286,4,58,2,2
17783,57264,53,5808,53,allow,197,102,95,2,29,1,1
17784,56109,53,49882,53,allow,177,94,83,2,29,1,1
17785,55251,53,30492,53,allow,212,110,102,2,30,1,1
17786,63085,53,50123,53,allow,448,166,282,2,30,1,1
17787,64135,53,23762,53,allow,196,102,94,2,30,1,1
17788,55669,53,4616,53,allow,784,94,690,2,30,1,1
17789,65354,53,12903,53,allow,168,86,82,2,30,1,1
17790,56333,53,17825,53,allow,199,102,97,2,30,1,1
17791,55520,443,13062,443,allow,272841,13586,259255,353,176,164,189
17792,64414,53,2206,53,allow,183,94,89,2,30,1,1
17793,56078,53,23353,53,allow,168,86,82,2,30,1,1
17794,55024,53,28341,53,allow,168,86,82,2,30,1,1
17795,43882,443,18318,443,allow,10494,2409,8085,21,137,9,12
17796,37965,6224,9493,6224,allow,38098,12284,25814,207,2433,100,107
17797,56550,53,42634,53,allow,166,86,80,2,30,1,1
17798,55871,53,4127,53,allow,177,94,83,2,30,1,1
17799,9336,443,60185,443,allow,4702,674,4028,15,15,8,7
17800,56743,443,64118,443,allow,8060,2040,6020,20,15,11,9
17801,52074,57947,10118,57947,allow,70,70,0,2,8,2,0
17802,65386,53,26119,53,allow,1160,392,768,10,66,5,5
17803,49313,53,45650,53,allow,199,102,97,2,30,1,1
17804,56185,53,61715,53,allow,168,86,82,2,30,1,1
17805,54959,53,14757,53,allow,211,110,101,2,30,1,1
17806,56260,53,19443,53,allow,177,94,83,2,30,1,1
17807,56769,53,26341,53,allow,195,102,93,2,30,1,1
17808,50074,53,31884,53,allow,168,86,82,2,30,1,1
17809,65506,53,16583,53,allow,197,102,95,2,30,1,1
17810,55020,443,50900,443,allow,670633,656612,14021,657,146,465,192
17811,64576,53,5234,53,allow,194,102,92,2,31,1,1
17812,57219,5223,28908,5223,allow,9687,5105,4582,30,298,16,14
17813,9330,443,63077,443,allow,3255,430,2825,11,15,6,5
17814,48919,443,27329,443,allow,10338,3346,6992,27,19,15,12
17815,56742,443,47140,443,allow,8007,1987,6020,20,15,11,9
17816,55532,80,8734,80,allow,3367,2346,1021,19,39,11,8
17817,9316,443,33323,443,allow,3649,424,3225,12,15,6,6
17818,28033,443,38606,443,allow,6305,2124,4181,20,16,10,10
17819,56762,53,42811,53,allow,168,86,82,2,30,1,1
17820,55058,53,37390,53,allow,216,110,106,2,30,1,1
17821,55965,53,4442,53,allow,184,94,90,2,30,1,1
17822,50074,53,48010,53,allow,168,86,82,2,30,1,1
17823,63084,443,51859,443,allow,571,166,405,2,30,1,1
17824,56272,53,7235,53,allow,193,102,91,2,30,1,1
17825,63077,53,21461,53,allow,304,86,218,2,30,1,1
17826,58463,443,33811,443,allow,19057,9308,9749,111,307,53,58
17827,64746,53,28024,53,allow,193,102,91,2,31,1,1
17828,8283,52443,34417,52443,allow,130,70,60,2,30,1,1
17829,9328,443,4611,443,allow,5198,504,4694,13,15,7,6
17830,58933,443,10888,443,allow,5167,700,4467,16,15,7,9
17831,51513,443,63128,443,allow,10839,705,10134,14,46,4,10
17832,34244,80,38249,80,allow,656,398,258,11,39,7,4
17833,55533,80,6176,80,allow,3386,2365,1021,19,39,11,8
17834,55534,80,1439,80,allow,3335,2314,1021,19,38,11,8
17835,9324,443,33759,443,allow,3255,430,2825,11,15,6,5
17836,54352,443,22800,443,allow,6854,2318,4536,20,16,11,9
17837,9320,443,10901,443,allow,3599,566,3033,15,15,8,7
17838,52498,80,52498,80,allow,15453,911,14542,25,16,11,14
17839,56862,80,27370,80,allow,2058,589,1469,10,45,6,4
17840,49756,53,28013,53,allow,264,89,175,4,47,2,2
17841,65237,53,38520,53,allow,733,86,647,2,30,1,1
17842,56960,53,36561,53,allow,196,102,94,2,30,1,1
17843,57375,53,58111,53,allow,247,102,145,2,30,1,1
17844,56810,53,28804,53,allow,177,94,83,2,30,1,1
17845,49313,53,30091,53,allow,199,102,97,2,30,1,1
17846,64472,53,42723,53,allow,183,94,89,2,30,1,1
17847,64273,53,36287,53,allow,239,94,145,2,30,1,1
17848,50462,53,31547,53,allow,299,94,205,2,30,1,1
17849,55230,53,6138,53,allow,183,94,89,2,30,1,1
17850,65225,53,58694,53,allow,199,102,97,2,30,1,1
17851,56561,53,15305,53,allow,216,110,106,2,30,1,1
17852,55711,53,17367,53,allow,177,94,83,2,30,1,1
17853,49855,53,34570,53,allow,177,94,83,2,30,1,1
17854,56522,53,55041,53,allow,177,94,83,2,30,1,1
17855,49286,53,40231,53,allow,184,94,90,2,31,1,1
17856,56522,53,65076,53,allow,177,94,83,2,31,1,1
17857,48817,1025,48817,1025,allow,334,158,176,2,1199,1,1
17858,48817,60483,48817,60483,allow,519,158,361,2,1199,1,1
17859,48817,39388,48817,39388,allow,1267,631,636,6,1199,3,3
17860,48817,51413,48817,51413,allow,485,158,327,2,1199,1,1
17861,48817,51234,48817,51234,allow,158,158,0,1,1200,1,0
17862,48817,8999,48817,8999,allow,512,158,354,2,1200,1,1
17863,37263,53,37263,53,allow,220,90,130,2,30,1,1
17864,52533,53,8262,53,allow,242,78,164,2,30,1,1
17865,64135,53,37160,53,allow,196,102,94,2,30,1,1
17866,56160,53,39836,53,allow,195,102,93,2,30,1,1
17867,49246,53,41120,53,allow,172,94,78,2,30,1,1
17868,55194,53,9824,53,allow,195,102,93,2,31,1,1
17869,64926,53,21011,53,allow,166,86,80,2,31,1,1
17870,65428,53,31541,53,allow,195,102,93,2,31,1,1
17871,47656,443,30620,443,allow,684,140,544,11,165,3,8
17872,52888,5223,32740,5223,allow,12302,5509,6793,43,1061,16,27
17873,21133,21689,35631,21689,allow,481,150,331,2,1199,1,1
17874,48817,1049,48817,1049,allow,334,158,176,2,1199,1,1
17875,48817,38081,48817,38081,allow,863,363,500,4,1200,2,2
17876,48817,7131,48817,7131,allow,158,158,0,1,1200,1,0
17877,48817,51417,48817,51417,allow,485,158,327,2,1200,1,1
17878,63952,53,14655,53,allow,211,110,101,2,30,1,1
17879,55965,53,49770,53,allow,184,94,90,2,30,1,1
17880,55945,53,48545,53,allow,177,94,83,2,30,1,1
17881,56910,53,3209,53,allow,199,102,97,2,30,1,1
17882,56810,53,31641,53,allow,177,94,83,2,30,1,1
17883,49954,53,59869,53,allow,753,94,659,2,30,1,1
17884,51880,8001,36976,8001,allow,86,86,0,1,30,1,0
17885,56561,53,31365,53,allow,216,110,106,2,31,1,1
17886,49246,53,51289,53,allow,164,86,78,2,31,1,1
17887,65006,53,63104,53,allow,994,86,908,2,30,1,1
17888,55453,443,3812,443,allow,3015948,160028,2855920,3852,218,1499,2353
17889,56963,53,8410,53,allow,199,102,97,2,31,1,1
17890,54644,443,51226,443,allow,6440,3492,2948,19,135,9,10
17891,54539,443,15655,443,allow,4552,2230,2322,14,134,7,7
17892,33525,443,32155,443,allow,8088,2191,5897,28,508,13,15
17893,48817,58518,48817,58518,allow,580,121,459,4,1199,2,2
17894,48817,1722,48817,1722,allow,158,158,0,1,1200,1,0
17895,48817,23456,48817,23456,allow,485,158,327,2,1200,1,1
17896,57648,443,58910,443,allow,35696,3196,32500,48,121,19,29
17897,51088,443,60075,443,allow,14025,7301,6724,38,171,22,16
17898,54977,53,39208,53,allow,275,93,182,4,31,2,2
17899,61141,443,38623,443,allow,383052,17263,365789,396,132,119,277
17900,6881,6889,7381,6889,allow,228,118,110,2,1200,1,1
17901,48817,6889,48817,6889,allow,502,158,344,2,1200,1,1
17902,48817,51413,48817,51413,allow,485,158,327,2,1200,1,1
17903,49717,53,48239,53,allow,444,96,348,4,44,2,2
17904,55881,443,18861,443,allow,25586,4360,21226,57,81,29,28
17905,53879,43702,31911,43702,allow,320,140,180,6,6,3,3
17906,52081,51835,33500,51835,allow,316,136,180,6,6,3,3
17907,52050,31648,38816,31648,allow,70,70,0,1,5,1,0
17908,35961,80,62048,80,allow,11575,902,10673,20,46,11,9
17909,63963,53,7667,53,allow,262,86,176,4,46,2,2
17910,63963,53,46328,53,allow,262,86,176,4,46,2,2
17911,50606,80,30995,80,allow,83795,22317,61478,117,43,52,65
17912,27739,7000,27739,7000,allow,2163,676,1487,14,15,7,7
17913,60167,80,41576,80,allow,6017,5209,808,12,30,7,5
17914,50940,443,27136,443,allow,29500,27698,1802,51,17,29,22
17915,61876,443,60944,443,allow,3776,1446,2330,20,153,9,11
17916,52049,52557,23041,52557,allow,70,70,0,1,5,1,0
17917,52048,44059,7624,44059,allow,160,70,90,2,5,1,1
17918,63952,53,42119,53,allow,358,105,253,4,44,2,2
17919,57655,56205,0,0,deny,62,62,0,1,0,1,0
17920,44815,36829,0,0,deny,62,62,0,1,0,1,0
17921,42231,57470,0,0,deny,78,78,0,1,0,1,0
17922,63016,445,0,0,drop,70,70,0,1,0,1,0
17923,49417,38558,0,0,deny,66,66,0,1,0,1,0
17924,51417,445,0,0,drop,70,70,0,1,0,1,0
17925,51416,445,0,0,drop,70,70,0,1,0,1,0
17926,51414,445,0,0,drop,70,70,0,1,0,1,0
17927,63015,445,0,0,drop,70,70,0,1,0,1,0
17928,14023,37965,0,0,deny,62,62,0,1,0,1,0
17929,63186,445,0,0,drop,66,66,0,1,0,1,0
17930,59192,25174,0,0,deny,66,66,0,1,0,1,0
17931,51410,445,0,0,drop,70,70,0,1,0,1,0
17932,48706,23394,0,0,deny,60,60,0,1,0,1,0
17933,49931,25174,0,0,deny,62,62,0,1,0,1,0
17934,63181,445,0,0,drop,66,66,0,1,0,1,0
17935,63013,445,0,0,drop,70,70,0,1,0,1,0
17936,63180,445,0,0,drop,66,66,0,1,0,1,0
17937,63178,445,0,0,drop,66,66,0,1,0,1,0
17938,45424,23,0,0,deny,60,60,0,1,0,1,0
17939,63176,445,0,0,drop,66,66,0,1,0,1,0
17940,48230,57866,0,0,deny,62,62,0,1,0,1,0
17941,60075,41705,0,0,deny,62,62,0,1,0,1,0
17942,38475,11392,0,0,deny,66,66,0,1,0,1,0
17943,9102,29635,0,0,deny,148,148,0,1,0,1,0
17944,55951,30188,0,0,deny,66,66,0,1,0,1,0
17945,30280,37965,0,0,deny,66,66,0,1,0,1,0
17946,50052,65008,0,0,deny,60,60,0,1,0,1,0
17947,16057,56205,0,0,deny,66,66,0,1,0,1,0
17948,51404,445,0,0,drop,70,70,0,1,0,1,0
17949,47910,7454,0,0,deny,60,60,0,1,0,1,0
17950,63006,445,0,0,drop,70,70,0,1,0,1,0
17951,51401,445,0,0,drop,70,70,0,1,0,1,0
17952,51394,445,0,0,drop,70,70,0,1,0,1,0
17953,10914,35974,0,0,deny,60,60,0,1,0,1,0
17954,63004,445,0,0,drop,70,70,0,1,0,1,0
17955,52557,44847,0,0,deny,66,66,0,1,0,1,0
17956,28156,50584,0,0,deny,62,62,0,1,0,1,0
17957,63166,445,0,0,drop,66,66,0,1,0,1,0
17958,63003,445,0,0,drop,70,70,0,1,0,1,0
17959,63002,445,0,0,drop,70,70,0,1,0,1,0
17960,9087,37965,0,0,deny,62,62,0,1,0,1,0
17961,7041,37965,0,0,deny,66,66,0,1,0,1,0
17962,64755,31573,0,0,deny,62,62,0,1,0,1,0
17963,63001,445,0,0,drop,70,70,0,1,0,1,0
17964,62995,445,0,0,drop,70,70,0,1,0,1,0
17965,62996,445,0,0,drop,70,70,0,1,0,1,0
17966,23331,25174,0,0,deny,66,66,0,1,0,1,0
17967,2422,62507,0,0,deny,62,62,0,1,0,1,0
17968,443,32698,0,0,deny,89,89,0,1,0,1,0
17969,54048,25174,0,0,deny,62,62,0,1,0,1,0
17970,63158,445,0,0,drop,66,66,0,1,0,1,0
17971,51383,445,0,0,drop,70,70,0,1,0,1,0
17972,62983,445,0,0,drop,70,70,0,1,0,1,0
17973,62981,445,0,0,drop,70,70,0,1,0,1,0
17974,37647,36237,0,0,deny,66,66,0,1,0,1,0
17975,62980,445,0,0,drop,70,70,0,1,0,1,0
17976,51291,25174,0,0,deny,62,62,0,1,0,1,0
17977,62973,445,0,0,drop,70,70,0,1,0,1,0
17978,62972,445,0,0,drop,70,70,0,1,0,1,0
17979,61002,37965,0,0,deny,145,145,0,1,0,1,0
17980,63156,445,0,0,drop,66,66,0,1,0,1,0
17981,46734,50265,0,0,deny,74,74,0,1,0,1,0
17982,49415,22114,0,0,deny,66,66,0,1,0,1,0
17983,61591,22114,0,0,deny,62,62,0,1,0,1,0
17984,13120,25174,0,0,deny,62,62,0,1,0,1,0
17985,26435,39004,0,0,deny,62,62,0,1,0,1,0
17986,59234,21247,0,0,deny,62,62,0,1,0,1,0
17987,52973,57470,0,0,deny,74,74,0,1,0,1,0
17988,51271,37965,0,0,deny,66,66,0,1,0,1,0
17989,63149,445,0,0,drop,66,66,0,1,0,1,0
17990,53567,64147,0,0,deny,62,62,0,1,0,1,0
17991,58022,9200,0,0,deny,60,60,0,1,0,1,0
17992,63146,445,0,0,drop,66,66,0,1,0,1,0
17993,42144,30170,0,0,deny,146,146,0,1,0,1,0
17994,50442,25174,0,0,deny,62,62,0,1,0,1,0
17995,7482,57470,0,0,deny,66,66,0,1,0,1,0
17996,62961,445,0,0,drop,70,70,0,1,0,1,0
17997,60269,443,14941,443,allow,499,425,74,4,0,3,1
17998,30574,64147,0,0,deny,62,62,0,1,0,1,0
17999,26752,64147,0,0,deny,62,62,0,1,0,1,0
18000,64509,9571,0,0,deny,62,62,0,1,0,1,0
18001,1024,44847,0,0,deny,146,146,0,1,0,1,0
18002,30654,51221,0,0,deny,72,72,0,1,0,1,0
18003,51374,445,0,0,drop,70,70,0,1,0,1,0
18004,51372,445,0,0,drop,70,70,0,1,0,1,0
18005,51370,445,0,0,drop,70,70,0,1,0,1,0
18006,1238,51505,0,0,deny,146,146,0,1,0,1,0
18007,54817,47993,0,0,deny,66,66,0,1,0,1,0
18008,63133,445,0,0,drop,66,66,0,1,0,1,0
18009,63131,445,0,0,drop,66,66,0,1,0,1,0
18010,63127,445,0,0,drop,66,66,0,1,0,1,0
18011,63128,445,0,0,drop,66,66,0,1,0,1,0
18012,63126,445,0,0,drop,66,66,0,1,0,1,0
18013,63130,445,0,0,drop,66,66,0,1,0,1,0
18014,63125,445,0,0,drop,66,66,0,1,0,1,0
18015,63129,445,0,0,drop,66,66,0,1,0,1,0
18016,27969,25174,0,0,deny,66,66,0,1,0,1,0
18017,30861,46783,0,0,deny,62,62,0,1,0,1,0
18018,62957,445,0,0,drop,70,70,0,1,0,1,0
18019,47943,50584,0,0,deny,74,74,0,1,0,1,0
18020,4793,50584,0,0,deny,66,66,0,1,0,1,0
18021,21482,22114,0,0,deny,62,62,0,1,0,1,0
18022,6247,51221,0,0,deny,78,78,0,1,0,1,0
18023,63708,25174,0,0,deny,62,62,0,1,0,1,0
18024,21496,50265,0,0,deny,62,62,0,1,0,1,0
18025,45837,25174,0,0,deny,146,146,0,1,0,1,0
18026,62948,445,0,0,drop,70,70,0,1,0,1,0
18027,62945,445,0,0,drop,70,70,0,1,0,1,0
18028,62946,445,0,0,drop,70,70,0,1,0,1,0
18029,16570,25174,0,0,deny,62,62,0,1,0,1,0
18030,34811,56205,0,0,deny,66,66,0,1,0,1,0
18031,62944,445,0,0,drop,70,70,0,1,0,1,0
18032,62940,445,0,0,drop,70,70,0,1,0,1,0
18033,51367,445,0,0,drop,70,70,0,1,0,1,0
18034,51365,445,0,0,drop,70,70,0,1,0,1,0
18035,51354,445,0,0,drop,70,70,0,1,0,1,0
18036,51353,445,0,0,drop,70,70,0,1,0,1,0
18037,63032,22114,0,0,deny,66,66,0,1,0,1,0
18038,55144,30188,0,0,deny,66,66,0,1,0,1,0
18039,25031,25174,0,0,deny,62,62,0,1,0,1,0
18040,63113,445,0,0,drop,66,66,0,1,0,1,0
18041,63111,445,0,0,drop,66,66,0,1,0,1,0
18042,63112,445,0,0,drop,66,66,0,1,0,1,0
18043,6141,23,0,0,deny,60,60,0,1,0,1,0
18044,55199,21247,0,0,deny,66,66,0,1,0,1,0
18045,35666,22114,0,0,deny,62,62,0,1,0,1,0
18046,60869,48817,0,0,deny,66,66,0,1,0,1,0
18047,62934,445,0,0,drop,70,70,0,1,0,1,0
18048,20167,1550,0,0,deny,104,104,0,1,0,1,0
18049,44889,23,0,0,deny,60,60,0,1,0,1,0
18050,17097,62413,0,0,deny,62,62,0,1,0,1,0
18051,51351,445,0,0,drop,70,70,0,1,0,1,0
18052,25063,64147,0,0,deny,62,62,0,1,0,1,0
18053,30707,30317,0,0,deny,62,62,0,1,0,1,0
18054,53257,37450,0,0,deny,62,62,0,1,0,1,0
18055,51344,445,0,0,drop,70,70,0,1,0,1,0
18056,51341,445,0,0,drop,70,70,0,1,0,1,0
18057,51339,445,0,0,drop,70,70,0,1,0,1,0
18058,63832,25174,0,0,deny,66,66,0,1,0,1,0
18059,59949,44847,0,0,deny,62,62,0,1,0,1,0
18060,62927,445,0,0,drop,70,70,0,1,0,1,0
18061,62926,445,0,0,drop,70,70,0,1,0,1,0
18062,50936,22114,0,0,deny,62,62,0,1,0,1,0
18063,33359,30188,0,0,deny,66,66,0,1,0,1,0
18064,63347,25174,0,0,deny,62,62,0,1,0,1,0
18065,52024,25174,0,0,deny,62,62,0,1,0,1,0
18066,7877,22114,0,0,deny,62,62,0,1,0,1,0
18067,7000,23117,0,0,deny,66,66,0,1,0,1,0
18068,62920,445,0,0,drop,70,70,0,1,0,1,0
18069,62919,445,0,0,drop,70,70,0,1,0,1,0
18070,59755,44512,0,0,deny,66,66,0,1,0,1,0
18071,55056,44512,0,0,deny,62,62,0,1,0,1,0
18072,51332,445,0,0,drop,70,70,0,1,0,1,0
18073,51329,445,0,0,drop,70,70,0,1,0,1,0
18074,51327,445,0,0,drop,70,70,0,1,0,1,0
18075,63101,445,0,0,drop,66,66,0,1,0,1,0
18076,56306,17500,0,0,deny,146,146,0,1,0,1,0
18077,62915,445,0,0,drop,70,70,0,1,0,1,0
18078,61400,64147,0,0,deny,62,62,0,1,0,1,0
18079,25523,35974,0,0,deny,62,62,0,1,0,1,0
18080,62885,62413,0,0,deny,62,62,0,1,0,1,0
18081,62913,445,0,0,drop,70,70,0,1,0,1,0
18082,59988,64147,0,0,deny,66,66,0,1,0,1,0
18083,50566,22114,0,0,deny,62,62,0,1,0,1,0
18084,57337,64147,0,0,deny,66,66,0,1,0,1,0
18085,51396,56205,0,0,deny,62,62,0,1,0,1,0
18086,49651,37965,0,0,deny,74,74,0,1,0,1,0
18087,33886,65504,0,0,deny,162,162,0,1,0,1,0
18088,51325,445,0,0,drop,70,70,0,1,0,1,0
18089,51320,445,0,0,drop,70,70,0,1,0,1,0
18090,2543,25174,0,0,deny,66,66,0,1,0,1,0
18091,62909,445,0,0,drop,70,70,0,1,0,1,0
18092,50951,53,0,0,allow,82,82,0,1,30,1,0
18093,50972,3544,50946,3544,allow,258,107,151,2,30,1,1
18094,56522,53,28369,53,allow,170,87,83,2,30,1,1
18095,64249,53,29634,53,allow,178,91,87,2,30,1,1
18096,28132,53,28132,53,allow,176,78,98,2,30,1,1
18097,54858,443,53726,443,allow,5252,3392,1860,22,316,12,10
18098,45406,80,51652,80,allow,573,499,74,6,15,5,1
18099,32864,53,32864,53,allow,404,259,145,3,32,2,1
18100,58926,443,61395,443,allow,5329,3428,1901,20,16,10,10
18101,56916,443,36796,443,allow,13829,2472,11357,30,243,13,17
18102,55945,53,36008,53,allow,760,97,663,2,30,1,1
18103,63963,53,56258,53,allow,262,86,176,4,46,2,2
18104,55102,80,41246,80,allow,46215,1615,44600,57,18,24,33
18105,59366,443,63784,443,allow,59122,7352,51770,85,322,41,44
18106,56680,443,28221,443,allow,8942,1817,7125,23,77,13,10
18107,55024,53,61199,53,allow,174,89,85,2,30,1,1
18108,49449,53,12310,53,allow,216,110,106,2,30,1,1
18109,55487,53,4696,53,allow,732,89,643,2,30,1,1
18110,52929,443,62112,443,allow,5582,1388,4194,19,15,9,10
18111,60191,80,55591,80,allow,2589,1231,1358,9,28,5,4
18112,64576,53,33878,53,allow,188,96,92,2,31,1,1
18113,33122,80,28324,80,allow,9055,863,8192,18,45,10,8
18114,56192,53,15421,53,allow,170,87,83,2,30,1,1
18115,36560,3142,36560,3142,allow,138,78,60,2,5,1,1
18116,38406,80,52487,80,allow,52105,1615,50490,61,18,24,37
18117,60500,443,54155,443,allow,103479,7755,95724,165,19,70,95
18118,56832,80,37022,80,allow,54049,2036,52013,69,18,31,38
18119,49298,443,58144,443,allow,3949,2535,1414,24,75,12,12
18120,28035,443,12518,443,allow,5458,1390,4068,17,15,9,8
18121,39776,443,45893,443,allow,6283,1439,4844,25,316,13,12
18122,52529,80,44880,80,allow,1056,682,374,10,15,6,4
18123,51037,443,13769,443,allow,7298,2661,4637,21,17,11,10
18124,45404,80,36835,80,allow,574,500,74,6,15,5,1
18125,56786,443,44559,443,allow,9096,4394,4702,26,256,15,11
18126,60065,80,60065,80,allow,246733,5745,240988,246,144,80,166
18127,58881,443,10013,443,allow,1413,876,537,12,26,6,6
18128,64340,53,64340,53,allow,847,110,737,2,30,1,1
18129,5588,5588,0,0,allow,3562,1936,1626,48,193,24,24
18130,45533,80,45533,80,allow,52365,3013,49352,53,51,13,40
18131,57417,53,14881,53,allow,295,101,194,4,31,2,2
18132,55602,443,15216,443,allow,7360,2298,5062,22,255,12,10
18133,52930,443,20378,443,allow,5584,1390,4194,19,15,9,10
18134,28034,443,40574,443,allow,5456,1388,4068,17,15,9,8
18135,34353,53,34353,53,allow,213,79,134,2,33,1,1
18136,45400,80,25751,80,allow,574,500,74,6,15,5,1
18137,49733,443,61095,443,allow,204,70,134,4,26,2,2
18138,34493,443,37498,443,allow,11771,2624,9147,50,20,25,25
18139,46617,53,46617,53,allow,213,87,126,2,30,1,1
18140,45402,80,27119,80,allow,573,499,74,6,15,5,1
18141,37542,53,41860,53,allow,240,76,164,2,30,1,1
18142,65248,53,20664,53,allow,208,106,102,2,30,1,1
18143,41672,53,20887,53,allow,240,76,164,2,30,1,1
18144,52711,443,58119,443,allow,15118,3979,11139,34,353,17,17
18145,49855,53,31460,53,allow,170,87,83,2,30,1,1
18146,50443,53,37606,53,allow,788,108,680,2,31,1,1
18147,64681,443,43290,443,allow,2924,653,2271,13,135,6,7
18148,64965,27049,54387,27049,allow,747,462,285,2,31,1,1
18149,2267,53,42274,53,allow,204,118,86,2,31,1,1
18150,2267,53,57413,53,allow,204,118,86,2,31,1,1
18151,2267,53,31811,53,allow,204,118,86,2,31,1,1
18152,56963,53,56853,53,allow,198,101,97,2,31,1,1
18153,49111,443,50826,443,allow,43887,3283,40604,60,398,21,39
18154,50265,56845,47720,56845,allow,480,149,331,2,1200,1,1
18155,56091,53,8508,53,allow,771,101,670,2,31,1,1
18156,57322,53,27268,53,allow,192,98,94,2,31,1,1
18157,2267,53,17239,53,allow,204,118,86,2,31,1,1
18158,56340,53,14544,53,allow,196,100,96,2,31,1,1
18159,46770,443,32021,443,allow,90614,3825,86789,108,214,42,66
18160,49484,53,47845,53,allow,742,88,654,2,31,1,1
18161,56603,53,59539,53,allow,168,86,82,2,31,1,1
18162,64106,53,59908,53,allow,190,97,93,2,31,1,1
18163,65279,53,56734,53,allow,182,93,89,2,31,1,1
18164,65428,53,32499,53,allow,190,97,93,2,31,1,1
18165,64960,27021,59267,27021,allow,742,462,280,2,31,1,1
18166,2267,53,29941,53,allow,204,118,86,2,31,1,1
18167,54924,3478,57299,3478,allow,432,200,232,6,31,3,3
18168,54924,3478,25286,3478,allow,312,140,172,4,31,2,2
18169,65099,53,63994,53,allow,198,101,97,2,31,1,1
18170,64146,53,41885,53,allow,194,99,95,2,31,1,1
18171,59061,443,25060,443,allow,5464,3984,1480,35,221,20,15
18172,44063,443,1759,443,allow,7762,2601,5161,18,137,8,10
18173,49891,53,42483,53,allow,164,84,80,2,31,1,1
18174,64963,27037,16564,27037,allow,741,462,279,2,31,1,1
18175,57761,30317,0,0,deny,66,66,0,1,0,1,0
18176,50251,35440,0,0,deny,66,66,0,1,0,1,0
18177,63085,445,0,0,drop,66,66,0,1,0,1,0
18178,63083,445,0,0,drop,66,66,0,1,0,1,0
18179,59786,25174,0,0,deny,66,66,0,1,0,1,0
18180,1024,37450,0,0,deny,62,62,0,1,0,1,0
18181,60786,25174,0,0,deny,66,66,0,1,0,1,0
18182,55464,22114,0,0,deny,62,62,0,1,0,1,0
18183,63364,57470,0,0,deny,66,66,0,1,0,1,0
18184,34932,38608,0,0,deny,62,62,0,1,0,1,0
18185,54438,62413,0,0,deny,66,66,0,1,0,1,0
18186,51315,445,0,0,drop,70,70,0,1,0,1,0
18187,52078,443,12860,443,allow,9757,2051,7706,34,256,15,19
18188,57442,66,38674,66,allow,70,70,0,1,5,1,0
18189,53152,443,33270,443,allow,116790,7062,109728,166,144,85,81
18190,49449,53,15422,53,allow,216,110,106,2,30,1,1
18191,59032,53,50252,53,allow,295,86,209,2,30,1,1
18192,56912,53,3525,53,allow,199,102,97,2,30,1,1
18193,53158,17234,38811,17234,allow,70,70,0,1,4,1,0
18194,63952,53,32922,53,allow,211,110,101,2,29,1,1
18195,56912,53,5094,53,allow,199,102,97,2,29,1,1
18196,55965,53,59955,53,allow,184,94,90,2,29,1,1
18197,37918,443,47034,443,allow,6521,2079,4442,32,3827,19,13
18198,64318,53,41262,53,allow,499,183,316,6,57,3,3
18199,49302,53,61464,53,allow,234,94,140,2,30,1,1
18200,38460,443,14446,443,allow,272822,10124,262698,330,81,126,204
18201,55194,53,43998,53,allow,195,102,93,2,30,1,1
18202,54912,80,63649,80,allow,1992,1350,642,10,15,5,5
18203,62293,443,17682,443,allow,598,598,0,8,40,8,0
18204,42108,80,8576,80,allow,8370,1025,7345,18,80,10,8
18205,55238,443,7974,443,allow,6186,1650,4536,20,16,11,9
18206,64414,53,13029,53,allow,183,94,89,2,29,1,1
18207,55194,53,21353,53,allow,195,102,93,2,29,1,1
18208,52541,53,60922,53,allow,242,78,164,2,29,1,1
18209,49363,53,56997,53,allow,309,94,215,2,29,1,1
18210,55871,53,54584,53,allow,177,94,83,2,29,1,1
18211,49286,53,40508,53,allow,184,94,90,2,29,1,1
18212,64414,53,36942,53,allow,183,94,89,2,29,1,1
18213,65248,53,6844,53,allow,446,106,340,4,47,2,2
18214,55699,53,3858,53,allow,271,103,168,4,59,2,2
18215,51531,443,29173,443,allow,898,460,438,12,39,5,7
18216,54022,443,20800,443,allow,121935,7839,114096,175,255,82,93
18217,49218,443,54857,443,allow,590577,16239,574338,610,23,222,388
18218,45374,80,46773,80,allow,806,463,343,9,15,6,3
18219,53619,443,9096,443,allow,24190,18242,5948,43,330,25,18
18220,49497,443,34229,443,allow,185560,47806,137754,421,295,217,204
18221,64146,53,31528,53,allow,197,102,95,2,30,1,1
18222,65002,27064,63916,27064,allow,735,462,273,2,30,1,1
18223,55024,53,59987,53,allow,179,94,85,2,30,1,1
18224,3580,53,3580,53,allow,832,106,726,2,30,1,1
18225,45886,80,22615,80,allow,6959,2024,4935,14,148,8,6
18226,56336,53,29646,53,allow,178,94,84,2,30,1,1
18227,61856,443,61856,443,allow,4918,1626,3292,17,17,10,7
18228,55024,53,16229,53,allow,179,94,85,2,30,1,1
18229,36998,80,39862,80,allow,130,70,60,2,15,1,1
18230,9247,80,43064,80,allow,860,794,66,6,17,5,1
18231,64140,53,22655,53,allow,306,94,212,4,33,2,2
18232,49286,53,14433,53,allow,184,94,90,2,30,1,1
18233,65116,53,63214,53,allow,200,94,106,2,30,1,1
18234,63137,47117,19060,47117,allow,574,448,126,10,25,8,2
18235,49631,53,56350,53,allow,198,102,96,2,30,1,1
18236,44235,443,40190,443,allow,2863,1501,1362,20,317,10,10
18237,57669,443,51063,443,allow,12569,8228,4341,28,256,16,12
18238,60793,40010,33213,40010,allow,316,136,180,6,6,3,3
18239,64985,27037,29129,27037,allow,734,462,272,2,30,1,1
18240,12364,80,12364,80,allow,7282,653,6629,16,16,8,8
18241,65011,53,59179,53,allow,168,86,82,2,30,1,1
18242,50609,53,13488,53,allow,766,102,664,2,30,1,1
18243,65245,53,31425,53,allow,184,102,82,2,30,1,1
18244,56603,53,39210,53,allow,168,86,82,2,30,1,1
18245,56522,53,51170,53,allow,177,94,83,2,30,1,1
18246,64746,53,23146,53,allow,193,102,91,2,30,1,1
18247,49855,53,65525,53,allow,177,94,83,2,30,1,1
18248,61675,443,61675,443,allow,8512,2483,6029,21,18,12,9
18249,52066,60118,24886,60118,allow,70,70,0,2,8,2,0
18250,52068,39864,59001,39864,allow,70,70,0,2,8,2,0
18251,56739,443,41966,443,allow,7914,1925,5989,20,15,11,9
18252,55699,53,30470,53,allow,271,103,168,4,59,2,2
18253,39785,53,39785,53,allow,229,98,131,2,30,1,1
18254,55942,53,15569,53,allow,197,102,95,2,30,1,1
18255,65000,27019,62331,27019,allow,728,462,266,2,30,1,1
18256,55786,53,31916,53,allow,102,102,0,1,30,1,0
18257,50837,443,12077,443,allow,3292,2022,1270,16,16,9,7
18258,51505,443,22811,443,allow,7211,823,6388,16,15,10,6
18259,58169,443,39268,443,allow,30845,9943,20902,172,133,73,99
18260,49538,80,51947,80,allow,2050,1691,359,9,75,6,3
18261,50644,80,26132,80,allow,314,192,122,6,25,4,2
18262,63963,53,20929,53,allow,262,86,176,4,46,2,2
18263,64935,53,16580,53,allow,765,102,663,2,30,1,1
18264,50520,53,48841,53,allow,183,94,89,2,30,1,1
18265,65011,53,42934,53,allow,168,86,82,2,30,1,1
18266,58681,123,50487,123,allow,184,94,90,2,30,1,1
18267,64249,53,32881,53,allow,181,94,87,2,30,1,1
18268,53831,54676,36346,54676,allow,492,306,186,8,16,5,3
18269,60449,443,18490,443,allow,26571,2432,24139,42,30,21,21
18270,39802,443,46895,443,allow,2863801,103667,2760134,3193,182,1240,1953
18271,53807,443,5620,443,allow,4622,860,3762,16,17,9,7
18272,57221,53,53360,53,allow,184,102,82,2,30,1,1
18273,38145,443,38145,443,allow,4599,1692,2907,19,29,11,8
18274,60422,443,51829,443,allow,7274,1925,5349,24,138,12,12
18275,55526,80,64372,80,allow,6138,1242,4896,15,40,7,8
18276,46318,443,20839,443,allow,6373,1744,4629,22,15,13,9
18277,43827,443,64958,443,allow,130,70,60,2,14,1,1
18278,53874,43922,52145,43922,allow,320,140,180,6,6,3,3
18279,53842,57861,18155,57861,allow,492,306,186,8,14,5,3
18280,33143,80,14116,80,allow,7406,1038,6368,18,15,10,8
18281,52067,46837,12452,46837,allow,70,70,0,2,8,2,0
18282,56740,443,16895,443,allow,7862,1873,5989,20,15,11,9
18283,50938,443,19392,443,allow,37198,29093,8105,64,17,34,30
18284,52069,53446,38596,53446,allow,70,70,0,2,7,2,0
18285,50646,80,29942,80,allow,1328,917,411,10,25,6,4
18286,52051,29868,57987,29868,allow,70,70,0,1,4,1,0
18287,58927,443,34485,443,allow,5168,700,4468,16,15,7,9
18288,56125,80,62901,80,allow,2091,799,1292,10,15,6,4
18289,56333,53,9058,53,allow,822,102,720,2,29,1,1
18290,65248,53,43627,53,allow,212,110,102,2,29,1,1
18291,55829,53,27683,53,allow,177,94,83,2,29,1,1
18292,56762,53,10015,53,allow,168,86,82,2,29,1,1
18293,64357,53,31050,53,allow,183,94,89,2,29,1,1
18294,50661,80,15216,80,allow,1658,1247,411,8,15,5,3
18295,52261,53,10393,53,allow,195,94,101,2,29,1,1
18296,64477,53,60345,53,allow,211,102,109,2,29,1,1
18297,44157,53,44157,53,allow,216,90,126,2,29,1,1
18298,56550,53,19597,53,allow,166,86,80,2,29,1,1
18299,10947,53,10947,53,allow,197,90,107,2,29,1,1
18300,49620,53,16282,53,allow,198,110,88,2,29,1,1
18301,49855,53,48096,53,allow,177,94,83,2,30,1,1
18302,56192,53,47862,53,allow,177,94,83,2,30,1,1
18303,55711,53,26039,53,allow,177,94,83,2,29,1,1
18304,56912,53,8353,53,allow,199,102,97,2,30,1,1
18305,62306,53,46053,53,allow,387,94,293,2,30,1,1
18306,56910,53,22546,53,allow,199,102,97,2,29,1,1
18307,56497,53,16693,53,allow,177,94,83,2,30,1,1
18308,49332,53,35822,53,allow,276,118,158,2,30,1,1
18309,56078,53,11255,53,allow,168,86,82,2,30,1,1
18310,50520,53,8153,53,allow,183,94,89,2,30,1,1
18311,55751,53,8390,53,allow,216,94,122,2,30,1,1
18312,51001,53,26424,53,allow,183,86,97,2,30,1,1
18313,64245,53,16068,53,allow,344,94,250,2,30,1,1
18314,53833,53,46684,53,allow,211,78,133,2,30,1,1
18315,56500,53,38812,53,allow,164,86,78,2,30,1,1
18316,17750,8953,36082,8953,allow,491,150,341,2,1200,1,1
18317,49160,51413,36529,51413,allow,800,150,650,4,1200,2,2
18318,65064,53,46432,53,allow,198,102,96,2,30,1,1
18319,63972,53,46168,53,allow,193,102,91,2,30,1,1
18320,64966,27051,35392,27051,allow,736,462,274,2,30,1,1
18321,65279,53,28048,53,allow,183,94,89,2,31,1,1
18322,2267,53,18224,53,allow,204,118,86,2,31,1,1
18323,47244,443,21922,443,allow,5953,1848,4105,18,17,10,8
18324,53806,443,60221,443,allow,12788,2594,10194,40,17,20,20
18325,9225,443,21069,443,allow,5510,901,4609,15,25,8,7
18326,64287,53,27313,53,allow,497,90,407,4,33,2,2
18327,60970,80,26224,80,allow,912,472,440,8,15,3,5
18328,56281,53,56281,53,allow,851,114,737,2,30,1,1
18329,64894,53,8238,53,allow,195,102,93,2,30,1,1
18330,64926,53,24382,53,allow,166,86,80,2,30,1,1
18331,64894,53,19330,53,allow,195,102,93,2,30,1,1
18332,56192,53,30886,53,allow,177,94,83,2,30,1,1
18333,65245,53,21925,53,allow,184,102,82,2,30,1,1
18334,49304,53,30791,53,allow,214,102,112,2,30,1,1
18335,55786,53,13962,53,allow,193,102,91,2,30,1,1
18336,54673,443,44962,443,allow,10244,2295,7949,38,121,20,18
18337,49776,443,33796,443,allow,214,140,74,4,15,3,1
18338,58883,443,51515,443,allow,1115,591,524,12,25,6,6
18339,51505,443,27614,443,allow,1210,450,760,17,54,5,12
18340,49449,53,11737,53,allow,216,110,106,2,30,1,1
18341,60711,53,53816,53,allow,211,78,133,2,30,1,1
18342,55211,53,36249,53,allow,183,94,89,2,30,1,1
18343,49637,53,0,0,allow,86,86,0,1,30,1,0
18344,56752,53,41172,53,allow,183,94,89,2,30,1,1
18345,46128,443,47204,443,allow,9814,2331,7483,38,255,19,19
18346,52856,443,43323,443,allow,5495,1303,4192,17,15,9,8
18347,37185,443,49991,443,allow,14035,8420,5615,31,256,18,13
18348,56738,443,13897,443,allow,7863,1874,5989,20,15,11,9
18349,42810,443,64537,443,allow,9265,2134,7131,24,123,12,12
18350,56740,80,35362,80,allow,1462,703,759,8,17,5,3
18351,55211,53,32834,53,allow,183,94,89,2,30,1,1
18352,56497,53,37841,53,allow,177,94,83,2,30,1,1
18353,35459,443,23832,443,allow,119911,5690,114221,153,173,63,90
18354,60580,53,20280,53,allow,181,86,95,2,30,1,1
18355,64573,53,37433,53,allow,757,102,655,2,30,1,1
18356,56121,53,26656,53,allow,338,110,228,2,30,1,1
18357,65036,53,4183,53,allow,199,102,97,2,30,1,1
18358,56500,53,54568,53,allow,164,86,78,2,30,1,1
18359,49226,53,3367,53,allow,194,102,92,2,30,1,1
18360,55024,53,31814,53,allow,179,94,85,2,30,1,1
18361,64829,53,40836,53,allow,213,102,111,2,30,1,1
18362,51689,53,34111,53,allow,198,86,112,2,30,1,1
18363,61830,443,61830,443,allow,88574,15708,72866,114,176,52,62
18364,49804,53,30225,53,allow,209,102,107,2,30,1,1
18365,56497,53,27099,53,allow,177,94,83,2,30,1,1
18366,55865,53,64490,53,allow,168,86,82,2,30,1,1
18367,49180,53,27807,53,allow,359,118,241,2,30,1,1
18368,2267,53,1779,53,allow,204,118,86,2,31,1,1
18369,2267,53,42129,53,allow,204,118,86,2,31,1,1
18370,50559,53,4402,53,allow,216,110,106,2,31,1,1
18371,2267,53,1251,53,allow,204,118,86,2,31,1,1
18372,55591,53,39527,53,allow,195,102,93,2,31,1,1
18373,2267,53,46205,53,allow,204,118,86,2,31,1,1
18374,2267,53,54928,53,allow,204,118,86,2,31,1,1
18375,64106,53,27158,53,allow,195,102,93,2,31,1,1
18376,59478,443,44670,443,allow,9310,2994,6316,25,122,11,14
18377,64576,53,63457,53,allow,194,102,92,2,31,1,1
18378,57470,37395,27238,37395,allow,1566,332,1234,11,1199,5,6
18379,56100,53,57045,53,allow,216,110,106,2,31,1,1
18380,2267,53,13385,53,allow,204,118,86,2,31,1,1
18381,2267,53,11454,53,allow,204,118,86,2,31,1,1
18382,56752,53,15313,53,allow,183,94,89,2,31,1,1
18383,56019,53,28168,53,allow,194,102,92,2,31,1,1
18384,65099,53,22746,53,allow,199,102,97,2,31,1,1
18385,57331,53,47400,53,allow,178,94,84,2,31,1,1
18386,55069,53,13593,53,allow,195,102,93,2,31,1,1
18387,49563,443,54610,443,allow,6462,2102,4360,18,180,8,10
18388,57470,1031,51778,1031,allow,402,132,270,6,1209,3,3
18389,64051,53,51013,53,allow,430,172,258,6,61,3,3
18390,40302,443,5180,443,allow,7586,3785,3801,20,30,11,9
18391,55015,443,24425,443,allow,22687,6933,15754,50,50,26,24
18392,54592,80,24898,80,allow,1113,534,579,12,16,7,5
18393,53198,53,24028,53,allow,365,86,279,2,30,1,1
18394,63972,53,35839,53,allow,193,102,91,2,30,1,1
18395,56192,53,42935,53,allow,177,94,83,2,30,1,1
18396,64146,53,63495,53,allow,197,102,95,2,30,1,1
18397,64188,53,45023,53,allow,194,94,100,2,30,1,1
18398,57322,53,63683,53,allow,196,102,94,2,31,1,1
18399,47836,443,38604,443,allow,36324,2308,34016,55,81,22,33
18400,55865,53,56298,53,allow,168,86,82,2,30,1,1
18401,63103,53,6941,53,allow,222,86,136,2,30,1,1
18402,64535,53,33577,53,allow,734,86,648,2,31,1,1
18403,48724,443,22721,443,allow,4371,2036,2335,18,24,10,8
18404,56737,443,49751,443,allow,7915,1926,5989,20,16,11,9
18405,52070,55946,25301,55946,allow,316,136,180,6,7,3,3
18406,51314,445,0,0,drop,70,70,0,1,0,1,0
18407,51308,445,0,0,drop,70,70,0,1,0,1,0
18408,51307,445,0,0,drop,70,70,0,1,0,1,0
18409,45964,2225,0,0,deny,60,60,0,1,0,1,0
18410,45964,2225,0,0,deny,60,60,0,1,0,1,0
18411,63079,445,0,0,drop,66,66,0,1,0,1,0
18412,49754,35440,0,0,deny,146,146,0,1,0,1,0
18413,22636,30188,0,0,deny,66,66,0,1,0,1,0
18414,57220,26467,0,0,deny,66,66,0,1,0,1,0
18415,62896,445,0,0,drop,70,70,0,1,0,1,0
18416,56306,57587,0,0,deny,146,146,0,1,0,1,0
18417,19662,22114,0,0,deny,62,62,0,1,0,1,0
18418,63067,445,0,0,drop,66,66,0,1,0,1,0
18419,63069,445,0,0,drop,66,66,0,1,0,1,0
18420,63068,445,0,0,drop,66,66,0,1,0,1,0
18421,63072,445,0,0,drop,66,66,0,1,0,1,0
18422,63066,445,0,0,drop,66,66,0,1,0,1,0
18423,63065,445,0,0,drop,66,66,0,1,0,1,0
18424,63063,445,0,0,drop,66,66,0,1,0,1,0
18425,2062,35440,0,0,deny,66,66,0,1,0,1,0
18426,51298,445,0,0,drop,70,70,0,1,0,1,0
18427,26881,25174,0,0,deny,66,66,0,1,0,1,0
18428,60793,53733,0,0,deny,66,66,0,1,0,1,0
18429,62893,445,0,0,drop,70,70,0,1,0,1,0
18430,51292,445,0,0,drop,70,70,0,1,0,1,0
18431,51295,445,0,0,drop,70,70,0,1,0,1,0
18432,51291,445,0,0,drop,70,70,0,1,0,1,0
18433,55678,32468,0,0,deny,66,66,0,1,0,1,0
18434,41541,25174,0,0,deny,66,66,0,1,0,1,0
18435,68,67,0,0,deny,346,346,0,1,0,1,0
18436,59213,25174,0,0,deny,66,66,0,1,0,1,0
18437,8889,21251,0,0,deny,60,60,0,1,0,1,0
18438,60104,30188,0,0,deny,62,62,0,1,0,1,0
18439,62888,445,0,0,drop,70,70,0,1,0,1,0
18440,51560,46783,0,0,deny,62,62,0,1,0,1,0
18441,62887,445,0,0,drop,70,70,0,1,0,1,0
18442,515,10214,0,0,deny,66,66,0,1,0,1,0
18443,51289,445,0,0,drop,70,70,0,1,0,1,0
18444,51287,445,0,0,drop,70,70,0,1,0,1,0
18445,51286,445,0,0,drop,70,70,0,1,0,1,0
18446,62885,445,0,0,drop,70,70,0,1,0,1,0
18447,63057,445,0,0,drop,66,66,0,1,0,1,0
18448,51282,445,0,0,drop,70,70,0,1,0,1,0
18449,56306,1,0,0,deny,146,146,0,1,0,1,0
18450,44612,25174,0,0,deny,66,66,0,1,0,1,0
18451,63053,445,0,0,drop,66,66,0,1,0,1,0
18452,59524,25174,0,0,deny,66,66,0,1,0,1,0
18453,63051,445,0,0,drop,66,66,0,1,0,1,0
18454,63050,445,0,0,drop,66,66,0,1,0,1,0
18455,11136,15503,0,0,deny,62,62,0,1,0,1,0
18456,63048,445,0,0,drop,66,66,0,1,0,1,0
18457,62878,445,0,0,drop,70,70,0,1,0,1,0
18458,53640,25174,0,0,deny,66,66,0,1,0,1,0
18459,64214,25174,0,0,deny,62,62,0,1,0,1,0
18460,51281,445,0,0,drop,70,70,0,1,0,1,0
18461,63062,11392,0,0,deny,66,66,0,1,0,1,0
18462,62876,445,0,0,drop,70,70,0,1,0,1,0
18463,40481,22114,0,0,deny,66,66,0,1,0,1,0
18464,6881,46776,0,0,deny,146,146,0,1,0,1,0
18465,53197,25174,0,0,deny,62,62,0,1,0,1,0
18466,51267,445,0,0,drop,70,70,0,1,0,1,0
18467,51265,445,0,0,drop,70,70,0,1,0,1,0
18468,62875,445,0,0,drop,70,70,0,1,0,1,0
18469,62874,445,0,0,drop,70,70,0,1,0,1,0
18470,53470,22114,0,0,deny,66,66,0,1,0,1,0
18471,62873,445,0,0,drop,70,70,0,1,0,1,0
18472,62867,445,0,0,drop,70,70,0,1,0,1,0
18473,62870,445,0,0,drop,70,70,0,1,0,1,0
18474,63037,445,0,0,drop,66,66,0,1,0,1,0
18475,8889,53670,0,0,deny,60,60,0,1,0,1,0
18476,6880,31359,0,0,deny,107,107,0,1,0,1,0
18477,50822,50584,0,0,deny,62,62,0,1,0,1,0
18478,2383,37965,0,0,deny,66,66,0,1,0,1,0
18479,62855,445,0,0,drop,70,70,0,1,0,1,0
18480,62854,445,0,0,drop,70,70,0,1,0,1,0
18481,62852,445,0,0,drop,70,70,0,1,0,1,0
18482,63030,445,0,0,drop,66,66,0,1,0,1,0
18483,25150,25174,0,0,deny,62,62,0,1,0,1,0
18484,51255,445,0,0,drop,70,70,0,1,0,1,0
18485,62844,445,0,0,drop,70,70,0,1,0,1,0
18486,62845,445,0,0,drop,70,70,0,1,0,1,0
18487,46280,5900,0,0,deny,60,60,0,1,0,1,0
18488,55012,25174,0,0,deny,66,66,0,1,0,1,0
18489,54530,46776,0,0,deny,66,66,0,1,0,1,0
18490,55385,53,61909,53,allow,710,89,621,2,0,1,1
18491,55643,53,39402,53,allow,182,93,89,2,0,1,1
18492,18642,42707,0,0,deny,145,145,0,1,0,1,0
18493,28795,37965,0,0,deny,62,62,0,1,0,1,0
18494,51706,25174,0,0,deny,66,66,0,1,0,1,0
18495,45941,23387,0,0,deny,60,60,0,1,0,1,0
18496,63027,445,0,0,drop,66,66,0,1,0,1,0
18497,54684,37965,0,0,deny,62,62,0,1,0,1,0
18498,1860,25174,0,0,deny,66,66,0,1,0,1,0
18499,1027,25174,0,0,deny,62,62,0,1,0,1,0
18500,51479,25174,0,0,deny,66,66,0,1,0,1,0
18501,62489,23117,0,0,deny,66,66,0,1,0,1,0
18502,43185,50584,0,0,deny,146,146,0,1,0,1,0
18503,25207,48817,0,0,deny,62,62,0,1,0,1,0
18504,63019,445,0,0,drop,66,66,0,1,0,1,0
18505,55570,44847,0,0,deny,66,66,0,1,0,1,0
18506,33941,37807,0,0,deny,62,62,0,1,0,1,0
18507,62833,445,0,0,drop,70,70,0,1,0,1,0
18508,53073,32468,0,0,deny,66,66,0,1,0,1,0
18509,63017,445,0,0,drop,66,66,0,1,0,1,0
18510,6247,51221,0,0,deny,78,78,0,1,0,1,0
18511,60260,22114,0,0,deny,62,62,0,1,0,1,0
18512,56306,15503,0,0,deny,146,146,0,1,0,1,0
18513,55711,26467,0,0,deny,62,62,0,1,0,1,0
18514,29972,50584,0,0,deny,62,62,0,1,0,1,0
18515,80,8562,0,0,deny,74,74,0,1,0,1,0
18516,56424,53,24013,53,allow,711,87,624,2,0,1,1
18517,51746,25174,0,0,deny,62,62,0,1,0,1,0
18518,54121,25174,0,0,deny,66,66,0,1,0,1,0
18519,62828,445,0,0,drop,70,70,0,1,0,1,0
18520,51246,445,0,0,drop,70,70,0,1,0,1,0
18521,51242,445,0,0,drop,70,70,0,1,0,1,0
18522,51243,445,0,0,drop,70,70,0,1,0,1,0
18523,57496,25174,0,0,deny,66,66,0,1,0,1,0
18524,63004,445,0,0,drop,66,66,0,1,0,1,0
18525,63005,445,0,0,drop,66,66,0,1,0,1,0
18526,63003,445,0,0,drop,66,66,0,1,0,1,0
18527,63002,445,0,0,drop,66,66,0,1,0,1,0
18528,63001,445,0,0,drop,66,66,0,1,0,1,0
18529,63000,445,0,0,drop,66,66,0,1,0,1,0
18530,62999,445,0,0,drop,66,66,0,1,0,1,0
18531,62997,445,0,0,drop,66,66,0,1,0,1,0
18532,15281,25174,0,0,deny,146,146,0,1,0,1,0
18533,50459,62413,0,0,deny,62,62,0,1,0,1,0
18534,56676,37965,0,0,deny,66,66,0,1,0,1,0
18535,15605,50265,0,0,deny,62,62,0,1,0,1,0
18536,58022,5560,0,0,deny,60,60,0,1,0,1,0
18537,62820,445,0,0,drop,70,70,0,1,0,1,0
18538,62819,445,0,0,drop,70,70,0,1,0,1,0
18539,62818,445,0,0,drop,70,70,0,1,0,1,0
18540,62815,445,0,0,drop,70,70,0,1,0,1,0
18541,32997,22,0,0,deny,60,60,0,1,0,1,0
18542,62812,445,0,0,drop,70,70,0,1,0,1,0
18543,21064,25174,0,0,deny,62,62,0,1,0,1,0
18544,54373,26467,0,0,deny,62,62,0,1,0,1,0
18545,43828,44847,0,0,deny,62,62,0,1,0,1,0
18546,13285,29892,0,0,deny,145,145,0,1,0,1,0
18547,64392,25174,0,0,deny,62,62,0,1,0,1,0
18548,64190,2767,0,0,deny,62,62,0,1,0,1,0
18549,51238,445,0,0,drop,70,70,0,1,0,1,0
18550,51233,445,0,0,drop,70,70,0,1,0,1,0
18551,51236,445,0,0,drop,70,70,0,1,0,1,0
18552,51226,445,0,0,drop,70,70,0,1,0,1,0
18553,43584,24748,0,0,deny,156,156,0,1,0,1,0
18554,23594,48983,0,0,deny,159,159,0,1,0,1,0
18555,60058,25174,0,0,deny,66,66,0,1,0,1,0
18556,62982,445,0,0,drop,66,66,0,1,0,1,0
18557,62984,445,0,0,drop,66,66,0,1,0,1,0
18558,62983,445,0,0,drop,66,66,0,1,0,1,0
18559,57284,22114,0,0,deny,62,62,0,1,0,1,0
18560,62806,445,0,0,drop,70,70,0,1,0,1,0
18561,60823,25174,0,0,deny,62,62,0,1,0,1,0
18562,48301,25174,0,0,deny,66,66,0,1,0,1,0
18563,22714,30188,0,0,deny,146,146,0,1,0,1,0
18564,28306,25604,0,0,deny,62,62,0,1,0,1,0
18565,62064,22114,0,0,deny,66,66,0,1,0,1,0
18566,55508,64147,0,0,deny,62,62,0,1,0,1,0
18567,61523,37807,0,0,deny,66,66,0,1,0,1,0
18568,51222,445,0,0,drop,70,70,0,1,0,1,0
18569,35111,22114,0,0,deny,66,66,0,1,0,1,0
18570,54726,30041,0,0,deny,66,66,0,1,0,1,0
18571,51218,445,0,0,drop,70,70,0,1,0,1,0
18572,51216,445,0,0,drop,70,70,0,1,0,1,0
18573,51213,445,0,0,drop,70,70,0,1,0,1,0
18574,62799,445,0,0,drop,70,70,0,1,0,1,0
18575,62797,445,0,0,drop,70,70,0,1,0,1,0
18576,13235,44847,0,0,deny,66,66,0,1,0,1,0
18577,12841,37965,0,0,deny,62,62,0,1,0,1,0
18578,52682,22114,0,0,deny,66,66,0,1,0,1,0
18579,49752,50584,0,0,deny,62,62,0,1,0,1,0
18580,62793,445,0,0,drop,70,70,0,1,0,1,0
18581,63323,54369,0,0,deny,78,78,0,1,0,1,0
18582,55167,48817,0,0,deny,66,66,0,1,0,1,0
18583,62791,445,0,0,drop,70,70,0,1,0,1,0
18584,49514,65504,0,0,deny,162,162,0,1,0,1,0
18585,64036,23718,0,0,deny,66,66,0,1,0,1,0
18586,51866,22114,0,0,deny,66,66,0,1,0,1,0
18587,49824,25174,0,0,deny,62,62,0,1,0,1,0
18588,63595,51050,0,0,deny,66,66,0,1,0,1,0
18589,22408,22114,0,0,deny,66,66,0,1,0,1,0
18590,51205,445,0,0,drop,70,70,0,1,0,1,0
18591,51204,445,0,0,drop,70,70,0,1,0,1,0
18592,51203,445,0,0,drop,70,70,0,1,0,1,0
18593,62787,445,0,0,drop,70,70,0,1,0,1,0
18594,62972,445,0,0,drop,66,66,0,1,0,1,0
18595,7160,34317,0,0,deny,146,146,0,1,0,1,0
18596,63998,11372,44405,11372,allow,504,382,122,8,16,6,2
18597,49571,443,45165,443,allow,3972,887,3085,13,31,6,7
18598,2267,53,35610,53,allow,204,118,86,2,30,1,1
18599,64739,53,44159,53,allow,172,88,84,2,30,1,1
18600,52045,16853,9076,16853,allow,66,66,0,1,5,1,0
18601,38766,53,38766,53,allow,371,237,134,3,32,2,1
18602,49731,443,10101,443,allow,4484,1063,3421,15,25,7,8
18603,5588,5588,0,0,allow,3562,1936,1626,48,195,24,24
18604,56761,53,40671,53,allow,788,108,680,2,30,1,1
18605,57357,443,47242,443,allow,126,60,66,3,11,2,1
18606,49341,80,65147,80,allow,1969,463,1506,13,55,7,6
18607,55069,53,8912,53,allow,190,97,93,2,31,1,1
18608,56703,53,61350,53,allow,198,101,97,2,31,1,1
18609,56134,53,39668,53,allow,93,93,0,1,30,1,0
18610,55944,53,48983,53,allow,762,98,664,2,30,1,1
18611,51621,443,45721,443,allow,5964,1007,4957,18,16,11,7
18612,55591,53,58697,53,allow,190,97,93,2,31,1,1
18613,54924,3478,2909,3478,allow,312,140,172,4,30,2,2
18614,57318,443,57308,443,allow,10504,1787,8717,27,364,12,15
18615,61827,443,61827,443,allow,56634,10853,45781,76,175,34,42
18616,58077,443,14905,443,allow,9138,4704,4434,24,315,13,11
18617,27322,443,7841,443,allow,5235,1839,3396,22,48,10,12
18618,42382,443,39819,443,allow,4844,1099,3745,18,25,10,8
18619,56633,53,42067,53,allow,164,84,80,2,31,1,1
18620,45837,443,61728,443,allow,39986,3118,36868,72,82,30,42
18621,55879,53,24811,53,allow,749,94,655,2,30,1,1
18622,64051,53,14293,53,allow,430,172,258,6,60,3,3
18623,56752,53,57000,53,allow,182,93,89,2,30,1,1
18624,51071,443,30007,443,allow,13412,5710,7702,50,257,24,26
18625,2267,53,32396,53,allow,204,118,86,2,30,1,1
18626,50116,22,50116,22,allow,146,60,86,2,9,1,1
18627,56308,53,17371,53,allow,814,110,704,2,30,1,1
18628,57168,53,20859,53,allow,760,96,664,2,30,1,1
18629,55896,53,31620,53,allow,168,86,82,2,30,1,1
18630,57331,53,59568,53,allow,172,88,84,2,30,1,1
18631,63972,53,23173,53,allow,186,95,91,2,30,1,1
18632,55441,443,55441,443,allow,4423,1516,2907,19,30,11,8
18633,37151,80,11771,80,allow,130,70,60,2,15,1,1
18634,58921,443,47044,443,allow,10782,7193,3589,30,16,17,13
18635,36017,443,12463,443,allow,4883,3524,1359,20,200,11,9
18636,13553,53,13553,53,allow,235,90,145,2,32,1,1
18637,49732,443,33979,443,allow,4414,993,3421,14,25,6,8
18638,59933,80,6671,80,allow,582,138,444,9,25,3,6
18639,61831,443,61831,443,allow,530764,27638,503126,528,175,179,349
18640,27318,443,31101,443,allow,16040,2126,13914,40,50,21,19
18641,55698,45710,26352,45710,allow,70,70,0,2,8,2,0
18642,58912,443,7357,443,allow,7941,5160,2781,25,17,13,12
18643,58913,443,48481,443,allow,5264,3357,1907,21,17,11,10
18644,51614,443,28714,443,allow,3833,867,2966,14,16,9,5
18645,58909,443,25795,443,allow,7671,4890,2781,25,17,13,12
18646,51619,443,5811,443,allow,3894,863,3031,15,16,9,6
18647,56336,53,24893,53,allow,172,88,84,2,30,1,1
18648,60581,53,60581,53,allow,197,76,121,2,30,1,1
18649,2267,53,10348,53,allow,204,118,86,2,30,1,1
18650,56040,53,54233,53,allow,761,100,661,2,30,1,1
18651,56231,53,34438,53,allow,757,98,659,2,30,1,1
18652,2267,53,10522,53,allow,204,118,86,2,30,1,1
18653,49797,53,55138,53,allow,767,102,665,2,31,1,1
18654,56677,53,31185,53,allow,767,102,665,2,31,1,1
18655,49112,443,21171,443,allow,6319,877,5442,23,396,8,15
18656,57470,26944,61791,26944,allow,480,149,331,2,1200,1,1
18657,55940,53,33630,53,allow,742,88,654,2,30,1,1
18658,52716,443,35091,443,allow,69951,4941,65010,95,351,45,50
18659,57341,53,29078,53,allow,184,94,90,2,31,1,1
18660,35981,53,35981,53,allow,227,89,138,2,31,1,1
18661,57200,53,22685,53,allow,770,102,668,2,31,1,1
18662,52040,53,52040,53,allow,251,98,153,2,31,1,1
18663,65048,53,54954,53,allow,754,94,660,2,31,1,1
18664,49944,53,20178,53,allow,192,98,94,2,31,1,1
18665,55735,53,13880,53,allow,198,101,97,2,31,1,1
18666,49110,443,4488,443,allow,43476,3775,39701,67,397,28,39
18667,57470,17690,10017,17690,allow,1818,1188,630,26,2804,19,7
18668,49885,53,17170,53,allow,760,97,663,2,31,1,1
18669,55323,53,14352,53,allow,172,88,84,2,31,1,1
18670,64964,27035,57797,27035,allow,996,462,534,4,31,2,2
18671,64679,53,50625,53,allow,172,88,84,2,31,1,1
18672,56490,53,61381,53,allow,744,89,655,2,31,1,1
18673,56377,53,45673,53,allow,793,101,692,2,31,1,1
18674,56940,53,36969,53,allow,200,102,98,2,31,1,1
18675,56349,53,17487,53,allow,216,110,106,2,31,1,1
18676,49823,53,45548,53,allow,202,103,99,2,31,1,1
18677,49113,443,18821,443,allow,6318,877,5441,23,396,8,15
18678,39775,443,49168,443,allow,6883,1887,4996,23,361,12,11
18679,46776,443,41505,443,allow,7389,1786,5603,26,211,14,12
18680,55920,53,34293,53,allow,810,108,702,2,31,1,1
18681,55468,53,52823,53,allow,754,94,660,2,31,1,1
18682,64068,53,56393,53,allow,168,86,82,2,31,1,1
18683,55624,53,14345,53,allow,198,101,97,2,31,1,1
18684,55419,53,50922,53,allow,760,97,663,2,31,1,1
18685,55520,53,33643,53,allow,188,96,92,2,31,1,1
18686,56852,53,36624,53,allow,762,101,661,2,31,1,1
18687,60483,443,59259,443,allow,3089,866,2223,11,121,6,5
18688,15503,23852,58898,23852,allow,10840,6789,4051,143,4379,82,61
18689,6881,6883,20913,6883,allow,259,150,109,2,1200,1,1
18690,54578,26467,0,0,deny,66,66,0,1,0,1,0
18691,62786,445,0,0,drop,70,70,0,1,0,1,0
18692,3169,22114,0,0,deny,66,66,0,1,0,1,0
18693,54796,22114,0,0,deny,66,66,0,1,0,1,0
18694,34914,26467,0,0,deny,62,62,0,1,0,1,0
18695,9836,22114,0,0,deny,66,66,0,1,0,1,0
18696,52227,64147,0,0,deny,62,62,0,1,0,1,0
18697,56403,51505,0,0,deny,66,66,0,1,0,1,0
18698,47812,30627,0,0,deny,62,62,0,1,0,1,0
18699,62217,37807,0,0,deny,66,66,0,1,0,1,0
18700,55435,25174,0,0,deny,62,62,0,1,0,1,0
18701,51197,445,0,0,drop,70,70,0,1,0,1,0
18702,50145,53,7031,53,allow,184,94,90,2,30,1,1
18703,54924,3478,47718,3478,allow,312,140,172,4,30,2,2
18704,51612,443,60658,443,allow,5677,918,4759,18,15,10,8
18705,51194,445,0,0,drop,70,70,0,1,0,1,0
18706,62781,445,0,0,drop,70,70,0,1,0,1,0
18707,60117,50934,0,0,deny,66,66,0,1,0,1,0
18708,5227,50584,0,0,deny,62,62,0,1,0,1,0
18709,63577,30188,0,0,deny,66,66,0,1,0,1,0
18710,58247,57866,0,0,deny,66,66,0,1,0,1,0
18711,16057,51050,0,0,deny,66,66,0,1,0,1,0
18712,62956,445,0,0,drop,66,66,0,1,0,1,0
18713,62953,445,0,0,drop,66,66,0,1,0,1,0
18714,41486,1433,0,0,deny,60,60,0,1,0,1,0
18715,52230,50265,0,0,deny,62,62,0,1,0,1,0
18716,42231,57470,0,0,deny,78,78,0,1,0,1,0
18717,55210,53,63664,53,allow,969,86,883,2,30,1,1
18718,65275,53,12888,53,allow,370,126,244,2,30,1,1
18719,56019,53,13898,53,allow,194,102,92,2,30,1,1
18720,16403,16385,49252,16385,allow,548,248,300,10,30,5,5
18721,64739,53,17167,53,allow,178,94,84,2,30,1,1
18722,49514,53,53009,53,allow,749,94,655,2,30,1,1
18723,57379,443,26122,443,allow,7211,823,6388,16,15,10,6
18724,56336,53,15481,53,allow,489,88,401,4,46,2,2
18725,49762,53,30143,53,allow,819,102,717,2,29,1,1
18726,59833,53,30174,53,allow,377,86,291,2,29,1,1
18727,54981,53,59429,53,allow,757,102,655,2,29,1,1
18728,64999,27034,10678,27034,allow,735,462,273,2,29,1,1
18729,56202,53,55288,53,allow,819,102,717,2,29,1,1
18730,65283,53,11652,53,allow,333,102,231,2,29,1,1
18731,57322,53,53567,53,allow,196,102,94,2,29,1,1
18732,64806,53,37126,53,allow,211,102,109,2,29,1,1
18733,50035,53,20021,53,allow,308,102,206,2,29,1,1
18734,53609,53,21780,53,allow,385,94,291,2,30,1,1
18735,57417,53,39419,53,allow,199,102,97,2,30,1,1
18736,61826,443,61826,443,allow,95212,17857,77355,119,175,53,66
18737,53453,443,33620,443,allow,17494,6818,10676,46,46,25,21
18738,54948,443,58033,443,allow,493685,14728,478957,612,316,213,399
18739,49639,443,42419,443,allow,21062,2202,18860,34,80,15,19
18740,49341,53,21121,53,allow,392,86,306,2,29,1,1
18741,64106,53,52132,53,allow,195,102,93,2,29,1,1
18742,64790,53,60024,53,allow,178,94,84,2,29,1,1
18743,49746,53,29622,53,allow,185,102,83,2,30,1,1
18744,49203,53,4131,53,allow,403,99,304,4,32,2,2
18745,2267,53,35940,53,allow,204,118,86,2,30,1,1
18746,55786,53,64576,53,allow,193,102,91,2,29,1,1
18747,2267,53,48892,53,allow,204,118,86,2,30,1,1
18748,64994,27032,29881,27032,allow,737,462,275,2,29,1,1
18749,49762,53,6291,53,allow,196,102,94,2,29,1,1
18750,2267,53,13716,53,allow,204,118,86,2,30,1,1
18751,49449,53,37523,53,allow,216,110,106,2,29,1,1
18752,63972,53,24077,53,allow,193,102,91,2,29,1,1
18753,51328,443,46063,443,allow,6021,1981,4040,21,15,9,12
18754,57221,53,46489,53,allow,184,102,82,2,29,1,1
18755,49226,53,7327,53,allow,194,102,92,2,29,1,1
18756,64065,53,56733,53,allow,264,94,170,2,29,1,1
18757,52046,59791,21148,59791,allow,70,70,0,1,4,1,0
18758,52047,42805,53752,42805,allow,70,70,0,1,4,1,0
18759,2267,53,32602,53,allow,204,118,86,2,30,1,1
18760,49165,5938,24586,5938,allow,143727,72050,71677,1106,10824,655,451
18761,2267,53,54801,53,allow,204,118,86,2,30,1,1
18762,50972,3544,54977,3544,allow,409,107,302,4,29,2,2
18763,56336,53,34970,53,allow,178,94,84,2,29,1,1
18764,57331,53,50054,53,allow,178,94,84,2,30,1,1
18765,50286,53,44602,53,allow,766,102,664,2,30,1,1
18766,49364,80,23008,80,allow,1614,1300,314,10,15,5,5
18767,47453,443,47453,443,allow,4475,1568,2907,19,28,11,8
18768,49673,53,51744,53,allow,421,88,333,4,39,2,2
18769,65261,53,11148,53,allow,313,97,216,4,56,2,2
18770,2267,53,18938,53,allow,204,118,86,2,30,1,1
18771,56560,53,3085,53,allow,199,102,97,2,30,1,1
18772,65279,53,39619,53,allow,183,94,89,2,30,1,1
18773,57339,53,52334,53,allow,196,94,102,2,30,1,1
18774,55896,53,34756,53,allow,168,86,82,2,30,1,1
18775,64068,53,31141,53,allow,168,86,82,2,30,1,1
18776,49746,53,23888,53,allow,177,94,83,2,30,1,1
18777,56100,53,6720,53,allow,216,110,106,2,30,1,1
18778,64068,53,47417,53,allow,168,86,82,2,31,1,1
18779,55855,443,32782,443,allow,11485,3525,7960,32,33,18,14
18780,56667,80,26674,80,allow,234,234,0,4,12,4,0
18781,64962,27048,15901,27048,allow,747,462,285,2,30,1,1
18782,49604,53,29008,53,allow,969,86,883,2,30,1,1
18783,50145,53,3618,53,allow,807,94,713,2,30,1,1
18784,49567,5223,11151,5223,allow,9705,5123,4582,29,74,15,14
18785,54924,3478,45480,3478,allow,452,280,172,5,30,3,2
18786,49782,80,45830,80,allow,130,70,60,2,15,1,1
18787,2267,53,56692,53,allow,204,118,86,2,30,1,1
18788,51327,443,49417,443,allow,8433,3066,5367,21,17,10,11
18789,49900,443,19208,443,allow,52800,13228,39572,134,154,64,70
18790,64980,27047,61209,27047,allow,735,462,273,2,30,1,1
18791,56560,53,4551,53,allow,199,102,97,2,30,1,1
18792,46908,80,46908,80,allow,5464,713,4751,15,16,8,7
18793,65106,53,10929,53,allow,193,102,91,2,30,1,1
18794,50234,53,13512,53,allow,242,78,164,2,30,1,1
18795,64715,53,60767,53,allow,315,98,217,4,58,2,2
18796,49910,53,38613,53,allow,218,94,124,2,30,1,1
18797,65279,53,57423,53,allow,183,94,89,2,30,1,1
18798,57417,53,7685,53,allow,199,102,97,2,30,1,1
18799,49652,53,26066,53,allow,229,110,119,2,30,1,1
18800,15561,53,15561,53,allow,199,90,109,2,30,1,1
18801,35915,80,21762,80,allow,1283,644,639,9,146,5,4
18802,16403,16384,8455,16384,allow,426,186,240,8,30,4,4
18803,58925,443,39506,443,allow,5167,700,4467,16,15,7,9
18804,49220,2710,38165,2710,allow,70,70,0,1,5,1,0
18805,65111,53,19274,53,allow,355,96,259,4,38,2,2
18806,50660,80,51110,80,allow,1658,1247,411,8,15,5,3
18807,55989,53,12782,53,allow,821,102,719,2,30,1,1
18808,50559,53,61943,53,allow,216,110,106,2,30,1,1
18809,65099,53,58455,53,allow,199,102,97,2,30,1,1
18810,65174,53,57194,53,allow,214,110,104,2,30,1,1
18811,43348,443,43348,443,allow,46356,1595,44761,52,17,15,37
18812,34911,443,4016,443,allow,414843,13933,400910,459,136,160,299
18813,27448,5222,60213,5222,allow,8039,1649,6390,41,357,13,28
18814,34901,443,15952,443,allow,70,70,0,1,5,1,0
18815,50151,80,25475,80,allow,1915831,46544,1869287,1569,166,311,1258
18816,56734,443,60875,443,allow,7889,1900,5989,20,15,11,9
18817,58322,53,41674,53,allow,352,78,274,2,30,1,1
18818,50829,53,16960,53,allow,168,78,90,2,30,1,1
18819,49965,53,5956,53,allow,257,110,147,2,30,1,1
18820,55896,53,64776,53,allow,168,86,82,2,30,1,1
18821,55591,53,22310,53,allow,195,102,93,2,30,1,1
18822,56736,443,32910,443,allow,7890,1901,5989,20,15,11,9
18823,7701,80,7701,80,allow,900,519,381,7,141,4,3
18824,64051,53,27383,53,allow,430,172,258,6,59,3,3
18825,56108,53,60144,53,allow,298,92,206,4,41,2,2
18826,55268,53,38039,53,allow,318,91,227,4,33,2,2
18827,55699,21063,32423,21063,allow,70,70,0,2,8,2,0
18828,53841,8999,39565,8999,allow,70,70,0,1,4,1,0
18829,60166,80,1732,80,allow,186,64,122,4,28,2,2
18830,60466,64337,26945,64337,allow,70,70,0,1,5,1,0
18831,49628,53,16334,53,allow,168,86,82,2,31,1,1
18832,47828,443,14141,443,allow,143399,8522,134877,208,153,101,107
18833,33826,443,52979,443,allow,416,210,206,7,57,4,3
18834,40464,80,50769,80,allow,15535,2173,13362,30,21,17,13
18835,55830,443,44368,443,allow,62,62,0,1,5,1,0
18836,52065,52021,26408,52021,allow,70,70,0,2,7,2,0
18837,52147,443,32446,443,allow,27251,9966,17285,70,73,35,35
18838,34166,443,10129,443,allow,1984,1233,751,16,20,8,8
18839,54018,443,16505,443,allow,13330,3836,9494,53,255,29,24
18840,47075,80,40568,80,allow,1614,1300,314,10,15,5,5
18841,65036,53,9458,53,allow,199,102,97,2,29,1,1
18842,49426,53,14946,53,allow,492,91,401,4,56,2,2
18843,49412,53,45661,53,allow,761,102,659,2,29,1,1
18844,64853,53,57521,53,allow,814,110,704,2,29,1,1
18845,57174,53,49887,53,allow,293,86,207,2,29,1,1
18846,56963,53,37570,53,allow,199,102,97,2,29,1,1
18847,49456,53,27659,53,allow,360,110,250,2,29,1,1
18848,56603,53,47573,53,allow,168,86,82,2,29,1,1
18849,65428,53,15132,53,allow,195,102,93,2,29,1,1
18850,64791,53,19745,53,allow,763,102,661,2,29,1,1
18851,65064,53,48752,53,allow,821,102,719,2,29,1,1
18852,64790,53,14045,53,allow,178,94,84,2,29,1,1
18853,65036,53,55693,53,allow,199,102,97,2,29,1,1
18854,57331,53,57928,53,allow,178,94,84,2,29,1,1
18855,65008,53,11411,53,allow,276,118,158,2,29,1,1
18856,56560,53,17987,53,allow,199,102,97,2,30,1,1
18857,65099,53,38778,53,allow,199,102,97,2,29,1,1
18858,2267,53,43002,53,allow,204,118,86,2,30,1,1
18859,56340,53,44693,53,allow,198,102,96,2,30,1,1
18860,64742,53,7062,53,allow,338,110,228,2,30,1,1
18861,2267,53,21811,53,allow,204,118,86,2,30,1,1
18862,56202,53,15464,53,allow,196,102,94,2,29,1,1
18863,50559,53,13725,53,allow,216,110,106,2,29,1,1
18864,65518,53,57051,53,allow,198,94,104,2,30,1,1
18865,63780,28124,24113,28124,allow,4536,2883,1653,27,94,15,12
18866,36088,443,55123,443,allow,7229,2357,4872,26,270,14,12
18867,2267,53,16452,53,allow,204,118,86,2,30,1,1
18868,49697,53,7185,53,allow,195,94,101,2,30,1,1
18869,55069,53,50203,53,allow,195,102,93,2,30,1,1
18870,49504,53,3816,53,allow,198,94,104,2,30,1,1
18871,49823,53,39665,53,allow,209,110,99,2,31,1,1
18872,47582,443,49001,443,allow,6214,1733,4481,13,120,6,7
18873,56340,53,42393,53,allow,198,102,96,2,30,1,1
18874,49238,53,61405,53,allow,274,94,180,2,30,1,1
18875,65028,53,41163,53,allow,265,94,171,2,30,1,1
18876,50045,53,44466,53,allow,168,86,82,2,31,1,1
18877,56349,53,28965,53,allow,216,110,106,2,31,1,1
18878,64627,53,12613,53,allow,184,102,82,2,31,1,1
18879,50515,80,58648,80,allow,7871,1409,6462,17,75,7,10
18880,34902,443,35566,443,allow,70,70,0,1,5,1,0
18881,34900,443,21666,443,allow,70,70,0,1,5,1,0
18882,37672,5223,8222,5223,allow,110,110,0,1,5,1,0
18883,50652,443,65076,443,allow,2477,1505,972,15,20,9,6
18884,64641,53,15849,53,allow,193,94,99,2,30,1,1
18885,65106,53,42197,53,allow,193,102,91,2,30,1,1
18886,2267,53,1505,53,allow,204,118,86,2,30,1,1
18887,57417,53,46711,53,allow,199,102,97,2,30,1,1
18888,55896,53,48962,53,allow,168,86,82,2,30,1,1
18889,54225,53,12389,53,allow,274,78,196,2,30,1,1
18890,65406,53,43109,53,allow,273,102,171,2,30,1,1
18891,49891,53,34490,53,allow,166,86,80,2,30,1,1
18892,56703,53,53438,53,allow,199,102,97,2,30,1,1
18893,56603,53,32862,53,allow,168,86,82,2,30,1,1
18894,55684,53,8013,53,allow,214,110,104,2,30,1,1
18895,55134,53,13756,53,allow,214,110,104,2,30,1,1
18896,56703,53,19999,53,allow,199,102,97,2,30,1,1
18897,55134,53,17370,53,allow,214,110,104,2,30,1,1
18898,56772,53,46490,53,allow,185,102,83,2,31,1,1
18899,56633,53,58541,53,allow,166,86,80,2,30,1,1
18900,65499,53,27799,53,allow,167,86,81,2,30,1,1
18901,9222,443,6216,443,allow,6676,1097,5579,21,26,11,10
18902,51620,443,44132,443,allow,4320,932,3388,16,15,10,6
18903,49918,53,55343,53,allow,396,88,308,4,59,2,2
18904,64934,53,9879,53,allow,216,94,122,2,30,1,1
18905,44014,53,29782,53,allow,199,94,105,2,30,1,1
18906,65248,53,32569,53,allow,779,86,693,2,30,1,1
18907,65174,53,23443,53,allow,214,110,104,2,30,1,1
18908,64969,27044,17492,27044,allow,741,462,279,2,30,1,1
18909,50346,53,1416,53,allow,168,78,90,2,30,1,1
18910,54286,123,33034,123,allow,184,94,90,2,30,1,1
18911,56100,53,20590,53,allow,216,110,106,2,30,1,1
18912,16403,16386,35244,16386,allow,426,186,240,8,30,4,4
18913,56963,53,36385,53,allow,199,102,97,2,30,1,1
18914,64393,53,12221,53,allow,183,94,89,2,31,1,1
18915,50207,53,41164,53,allow,189,102,87,2,30,1,1
18916,10016,443,37717,443,allow,6575,1263,5312,22,315,12,10
18917,51326,443,48019,443,allow,6250,1422,4828,20,17,10,10
18918,58288,443,25819,443,allow,6438,2646,3792,18,37,11,7
18919,9968,53,9968,53,allow,370,238,132,3,32,2,1
18920,57316,53,57316,53,allow,216,82,134,2,32,1,1
18921,56735,443,32808,443,allow,7942,1953,5989,20,15,11,9
18922,55989,53,12123,53,allow,198,102,96,2,30,1,1
18923,54167,53,8254,53,allow,210,94,116,2,30,1,1
18924,64979,27050,52278,27050,allow,735,462,273,2,30,1,1
18925,55684,53,46714,53,allow,214,110,104,2,30,1,1
18926,55551,53,53923,53,allow,180,94,86,2,30,1,1
18927,62067,443,12137,443,allow,4833,2196,2637,13,120,7,6
18928,56231,53,22476,53,allow,779,86,693,2,30,1,1
18929,57322,53,59513,53,allow,196,102,94,2,30,1,1
18930,49348,53,21322,53,allow,749,94,655,2,30,1,1
18931,55624,53,50480,53,allow,199,102,97,2,30,1,1
18932,49156,53,59173,53,allow,195,102,93,2,30,1,1
18933,65428,53,61145,53,allow,195,102,93,2,30,1,1
18934,56340,53,40288,53,allow,198,102,96,2,30,1,1
18935,50218,53,36162,53,allow,165,86,79,2,31,1,1
18936,49156,53,49438,53,allow,195,102,93,2,30,1,1
18937,50267,53,48112,53,allow,734,94,640,2,31,1,1
18938,65038,53,49241,53,allow,173,94,79,2,31,1,1
18939,55591,53,62499,53,allow,195,102,93,2,31,1,1
18940,56117,53,32150,53,allow,178,94,84,2,31,1,1
18941,8907,443,50464,443,allow,7594,1457,6137,26,404,10,16
18942,57341,53,25205,53,allow,184,94,90,2,30,1,1
18943,64679,53,60915,53,allow,178,94,84,2,30,1,1
18944,55323,53,20826,53,allow,178,94,84,2,30,1,1
18945,49606,53,26399,53,allow,231,110,121,2,31,1,1
18946,49944,53,39307,53,allow,196,102,94,2,31,1,1
18947,55134,53,55976,53,allow,214,110,104,2,31,1,1
18948,56272,53,59359,53,allow,167,86,81,2,31,1,1
18949,65471,53,50193,53,allow,498,204,294,6,31,3,3
18950,50207,53,12070,53,allow,189,102,87,2,31,1,1
18951,55887,53,54286,53,allow,166,86,80,2,31,1,1
18952,38262,80,2079,80,allow,3843,1312,2531,19,227,6,13
18953,6881,6889,24381,6889,allow,228,118,110,2,1199,1,1
18954,51083,5223,18916,5223,allow,4070,1456,2614,26,2889,15,11
18955,64979,53,62369,53,allow,754,94,660,2,30,1,1
18956,64130,53,8273,53,allow,215,94,121,2,31,1,1
18957,57341,53,32411,53,allow,184,94,90,2,31,1,1
18958,49203,53,46082,53,allow,168,86,82,2,31,1,1
18959,65187,53,58684,53,allow,199,102,97,2,31,1,1
18960,47661,443,40195,443,allow,3718,420,3298,13,120,6,7
18961,37965,7765,33226,7765,allow,460,150,310,2,1199,1,1
18962,51969,80,21230,80,allow,622,70,552,10,1117,2,8
18963,41332,80,41332,80,allow,230861,5063,225798,227,18,74,153
18964,55069,53,19618,53,allow,195,102,93,2,31,1,1
18965,56703,53,34394,53,allow,199,102,97,2,31,1,1
18966,64012,40642,36772,40642,allow,66,66,0,2,8,2,0
18967,59179,80,14130,80,allow,1399,762,637,10,76,6,4
18968,54270,443,24840,443,allow,6620,672,5948,17,128,8,9
18969,33229,443,52661,443,allow,2161,1231,930,17,180,9,8
18970,49156,443,29780,443,allow,8569,2165,6404,23,34,12,11
18971,45926,443,11767,443,allow,9153,4216,4937,29,331,16,13
18972,58924,443,40571,443,allow,5168,700,4468,16,15,7,9
18973,64013,48970,1892,48970,allow,66,66,0,2,8,2,0
18974,64503,53,62802,53,allow,477,87,390,4,37,2,2
18975,59209,25174,0,0,deny,66,66,0,1,0,1,0
18976,53376,22114,0,0,deny,62,62,0,1,0,1,0
18977,16013,61903,0,0,deny,145,145,0,1,0,1,0
18978,51184,445,0,0,drop,70,70,0,1,0,1,0
18979,51177,445,0,0,drop,70,70,0,1,0,1,0
18980,51176,445,0,0,drop,70,70,0,1,0,1,0
18981,51175,445,0,0,drop,70,70,0,1,0,1,0
18982,64595,64147,0,0,deny,66,66,0,1,0,1,0
18983,45726,64147,0,0,deny,62,62,0,1,0,1,0
18984,62951,445,0,0,drop,66,66,0,1,0,1,0
18985,62768,445,0,0,drop,70,70,0,1,0,1,0
18986,19747,37965,0,0,deny,62,62,0,1,0,1,0
18987,58120,25174,0,0,deny,66,66,0,1,0,1,0
18988,8889,49138,0,0,deny,60,60,0,1,0,1,0
18989,6943,1,0,0,deny,100,100,0,1,0,1,0
18990,62941,445,0,0,drop,66,66,0,1,0,1,0
18991,62939,445,0,0,drop,66,66,0,1,0,1,0
18992,62944,445,0,0,drop,66,66,0,1,0,1,0
18993,62945,445,0,0,drop,66,66,0,1,0,1,0
18994,62940,445,0,0,drop,66,66,0,1,0,1,0
18995,62937,445,0,0,drop,66,66,0,1,0,1,0
18996,62935,445,0,0,drop,66,66,0,1,0,1,0
18997,62765,445,0,0,drop,70,70,0,1,0,1,0
18998,63895,44847,0,0,deny,62,62,0,1,0,1,0
18999,39313,37965,0,0,deny,62,62,0,1,0,1,0
19000,51171,445,0,0,drop,70,70,0,1,0,1,0
19001,42951,22114,0,0,deny,62,62,0,1,0,1,0
19002,22530,23718,0,0,deny,62,62,0,1,0,1,0
19003,51167,445,0,0,drop,70,70,0,1,0,1,0
19004,51164,445,0,0,drop,70,70,0,1,0,1,0
19005,51163,445,0,0,drop,70,70,0,1,0,1,0
19006,63385,25174,0,0,deny,66,66,0,1,0,1,0
19007,41388,1433,0,0,deny,60,60,0,1,0,1,0
19008,2837,25174,0,0,deny,66,66,0,1,0,1,0
19009,59355,51505,0,0,deny,66,66,0,1,0,1,0
19010,62760,445,0,0,drop,70,70,0,1,0,1,0
19011,50549,43890,0,0,deny,66,66,0,1,0,1,0
19012,11382,43890,0,0,deny,66,66,0,1,0,1,0
19013,62759,445,0,0,drop,70,70,0,1,0,1,0
19014,80,5101,0,0,deny,78,78,0,1,0,1,0
19015,1827,64147,0,0,deny,66,66,0,1,0,1,0
19016,63083,25174,0,0,deny,62,62,0,1,0,1,0
19017,18683,26467,0,0,deny,62,62,0,1,0,1,0
19018,62757,445,0,0,drop,70,70,0,1,0,1,0
19019,50316,25604,0,0,deny,62,62,0,1,0,1,0
19020,50563,37965,0,0,deny,66,66,0,1,0,1,0
19021,51160,445,0,0,drop,70,70,0,1,0,1,0
19022,51159,445,0,0,drop,70,70,0,1,0,1,0
19023,51158,445,0,0,drop,70,70,0,1,0,1,0
19024,58022,7474,0,0,deny,60,60,0,1,0,1,0
19025,62929,445,0,0,drop,66,66,0,1,0,1,0
19026,51413,57470,0,0,deny,72,72,0,1,0,1,0
19027,50857,26467,0,0,deny,66,66,0,1,0,1,0
19028,51154,445,0,0,drop,70,70,0,1,0,1,0
19029,52503,50584,0,0,deny,66,66,0,1,0,1,0
19030,51726,64147,0,0,deny,66,66,0,1,0,1,0
19031,1036,64147,0,0,deny,62,62,0,1,0,1,0
19032,62926,445,0,0,drop,66,66,0,1,0,1,0
19033,58103,10197,0,0,deny,66,66,0,1,0,1,0
19034,62923,445,0,0,drop,66,66,0,1,0,1,0
19035,62922,445,0,0,drop,66,66,0,1,0,1,0
19036,27081,10197,0,0,deny,62,62,0,1,0,1,0
19037,39959,23117,0,0,deny,62,62,0,1,0,1,0
19038,62921,445,0,0,drop,66,66,0,1,0,1,0
19039,22677,25174,0,0,deny,66,66,0,1,0,1,0
19040,16092,50265,0,0,deny,62,62,0,1,0,1,0
19041,62750,445,0,0,drop,70,70,0,1,0,1,0
19042,31627,64147,0,0,deny,62,62,0,1,0,1,0
19043,51109,11392,0,0,deny,62,62,0,1,0,1,0
19044,14740,26467,0,0,deny,62,62,0,1,0,1,0
19045,62748,445,0,0,drop,70,70,0,1,0,1,0
19046,63888,25174,0,0,deny,66,66,0,1,0,1,0
19047,51149,445,0,0,drop,70,70,0,1,0,1,0
19048,62747,445,0,0,drop,70,70,0,1,0,1,0
19049,51145,445,0,0,drop,70,70,0,1,0,1,0
19050,51143,445,0,0,drop,70,70,0,1,0,1,0
19051,62746,445,0,0,drop,70,70,0,1,0,1,0
19052,59424,50265,0,0,deny,70,70,0,1,0,1,0
19053,51602,22114,0,0,deny,66,66,0,1,0,1,0
19054,62745,445,0,0,drop,70,70,0,1,0,1,0
19055,62743,445,0,0,drop,70,70,0,1,0,1,0
19056,62739,445,0,0,drop,70,70,0,1,0,1,0
19057,50620,50584,0,0,deny,66,66,0,1,0,1,0
19058,40819,30975,0,0,deny,157,157,0,1,0,1,0
19059,56590,25174,0,0,deny,66,66,0,1,0,1,0
19060,54754,50432,0,0,deny,66,66,0,1,0,1,0
19061,47783,50432,0,0,deny,62,62,0,1,0,1,0
19062,62909,445,0,0,drop,66,66,0,1,0,1,0
19063,63920,64147,0,0,deny,66,66,0,1,0,1,0
19064,3766,25174,0,0,deny,62,62,0,1,0,1,0
19065,55600,22,0,0,deny,60,60,0,1,0,1,0
19066,62727,445,0,0,drop,70,70,0,1,0,1,0
19067,62725,445,0,0,drop,70,70,0,1,0,1,0
19068,62723,445,0,0,drop,70,70,0,1,0,1,0
19069,57131,35776,0,0,deny,145,145,0,1,0,1,0
19070,62717,445,0,0,drop,70,70,0,1,0,1,0
19071,62716,445,0,0,drop,70,70,0,1,0,1,0
19072,48176,50584,0,0,deny,62,62,0,1,0,1,0
19073,3064,44847,0,0,deny,62,62,0,1,0,1,0
19074,62902,445,0,0,drop,66,66,0,1,0,1,0
19075,25296,51505,0,0,deny,66,66,0,1,0,1,0
19076,6247,51221,0,0,deny,78,78,0,1,0,1,0
19077,38475,11392,0,0,deny,66,66,0,1,0,1,0
19078,51126,445,0,0,drop,70,70,0,1,0,1,0
19079,27300,6881,0,0,deny,66,66,0,1,0,1,0
19080,37429,25174,0,0,deny,62,62,0,1,0,1,0
19081,42034,28189,0,0,deny,62,62,0,1,0,1,0
19082,47424,25174,0,0,deny,66,66,0,1,0,1,0
19083,45964,3111,0,0,deny,60,60,0,1,0,1,0
19084,62900,445,0,0,drop,66,66,0,1,0,1,0
19085,56897,11446,0,0,deny,66,66,0,1,0,1,0
19086,26527,25174,0,0,deny,66,66,0,1,0,1,0
19087,63023,51505,0,0,deny,62,62,0,1,0,1,0
19088,53140,51221,0,0,deny,74,74,0,1,0,1,0
19089,6356,26467,0,0,deny,62,62,0,1,0,1,0
19090,52644,57209,0,0,deny,62,62,0,1,0,1,0
19091,62705,445,0,0,drop,70,70,0,1,0,1,0
19092,52143,37807,0,0,deny,62,62,0,1,0,1,0
19093,36011,25174,0,0,deny,66,66,0,1,0,1,0
19094,54526,44847,0,0,deny,66,66,0,1,0,1,0
19095,62893,445,0,0,drop,66,66,0,1,0,1,0
19096,62889,445,0,0,drop,66,66,0,1,0,1,0
19097,43584,24748,0,0,deny,156,156,0,1,0,1,0
19098,43584,24748,0,0,deny,156,156,0,1,0,1,0
19099,43584,24748,0,0,deny,156,156,0,1,0,1,0
19100,59803,22114,0,0,deny,146,146,0,1,0,1,0
19101,62701,445,0,0,drop,70,70,0,1,0,1,0
19102,27063,25174,0,0,deny,62,62,0,1,0,1,0
19103,1646,23,0,0,deny,60,60,0,1,0,1,0
19104,51118,445,0,0,drop,70,70,0,1,0,1,0
19105,51116,445,0,0,drop,70,70,0,1,0,1,0
19106,51114,445,0,0,drop,70,70,0,1,0,1,0
19107,53495,37807,0,0,deny,66,66,0,1,0,1,0
19108,16037,25174,0,0,deny,62,62,0,1,0,1,0
19109,62690,445,0,0,drop,70,70,0,1,0,1,0
19110,62872,445,0,0,drop,66,66,0,1,0,1,0
19111,62691,445,0,0,drop,70,70,0,1,0,1,0
19112,62876,445,0,0,drop,66,66,0,1,0,1,0
19113,62875,445,0,0,drop,66,66,0,1,0,1,0
19114,62692,445,0,0,drop,70,70,0,1,0,1,0
19115,62870,445,0,0,drop,66,66,0,1,0,1,0
19116,62877,445,0,0,drop,66,66,0,1,0,1,0
19117,62871,445,0,0,drop,66,66,0,1,0,1,0
19118,62869,445,0,0,drop,66,66,0,1,0,1,0
19119,62874,445,0,0,drop,66,66,0,1,0,1,0
19120,38518,1900,0,0,deny,139,139,0,1,0,1,0
19121,52210,51505,0,0,deny,62,62,0,1,0,1,0
19122,62687,445,0,0,drop,70,70,0,1,0,1,0
19123,44127,30188,0,0,deny,146,146,0,1,0,1,0
19124,56629,25174,0,0,deny,66,66,0,1,0,1,0
19125,62684,445,0,0,drop,70,70,0,1,0,1,0
19126,60342,36237,0,0,deny,62,62,0,1,0,1,0
19127,17781,50265,0,0,deny,62,62,0,1,0,1,0
19128,21542,57470,0,0,deny,74,74,0,1,0,1,0
19129,18113,22114,0,0,deny,62,62,0,1,0,1,0
19130,1027,64147,0,0,deny,62,62,0,1,0,1,0
19131,50977,56205,0,0,deny,66,66,0,1,0,1,0
19132,52744,25174,0,0,deny,66,66,0,1,0,1,0
19133,48676,53399,0,0,deny,60,60,0,1,0,1,0
19134,17415,25174,0,0,deny,62,62,0,1,0,1,0
19135,51111,445,0,0,drop,70,70,0,1,0,1,0
19136,51108,445,0,0,drop,70,70,0,1,0,1,0
19137,51097,445,0,0,drop,70,70,0,1,0,1,0
19138,51098,445,0,0,drop,70,70,0,1,0,1,0
19139,15176,62413,0,0,deny,66,66,0,1,0,1,0
19140,62679,445,0,0,drop,70,70,0,1,0,1,0
19141,53822,25174,0,0,deny,66,66,0,1,0,1,0
19142,62857,445,0,0,drop,66,66,0,1,0,1,0
19143,62856,445,0,0,drop,66,66,0,1,0,1,0
19144,62854,445,0,0,drop,66,66,0,1,0,1,0
19145,55629,42873,0,0,deny,74,74,0,1,0,1,0
19146,59668,50584,0,0,deny,66,66,0,1,0,1,0
19147,63323,54369,0,0,deny,78,78,0,1,0,1,0
19148,48019,22114,0,0,deny,66,66,0,1,0,1,0
19149,10273,21247,0,0,deny,66,66,0,1,0,1,0
19150,62671,445,0,0,drop,70,70,0,1,0,1,0
19151,27144,25174,0,0,deny,66,66,0,1,0,1,0
19152,51095,445,0,0,drop,70,70,0,1,0,1,0
19153,55443,53,49327,53,allow,188,96,92,2,30,1,1
19154,64721,53,36880,53,allow,212,108,104,2,30,1,1
19155,49156,53,9695,53,allow,190,97,93,2,30,1,1
19156,55551,53,29205,53,allow,176,90,86,2,30,1,1
19157,55070,80,64489,80,allow,246,120,126,5,16,3,2
19158,50983,443,64084,443,allow,11897,6250,5647,27,81,14,13
19159,55812,53,55812,53,allow,235,90,145,2,32,1,1
19160,52058,8329,19334,8329,allow,70,70,0,2,9,2,0
19161,52450,443,52450,443,allow,4750,1843,2907,19,26,11,8
19162,42478,80,42478,80,allow,1913,1464,449,10,19,6,4
19163,59383,80,59383,80,allow,1915,1466,449,10,19,6,4
19164,50985,443,12787,443,allow,8007,3336,4671,19,78,11,8
19165,50982,443,30343,443,allow,8227,3496,4731,20,82,11,9
19166,55782,53,37884,53,allow,728,96,632,2,30,1,1
19167,49605,53,30084,53,allow,756,95,661,2,30,1,1
19168,52240,443,52240,443,allow,1615,941,674,15,21,7,8
19169,42607,443,22766,443,allow,167,107,60,2,5,1,1
19170,56636,443,56636,443,allow,4620,1713,2907,19,28,11,8
19171,46673,80,11851,80,allow,1151,711,440,10,15,5,5
19172,55031,53,63225,53,allow,756,95,661,2,31,1,1
19173,58907,443,50091,443,allow,2976,1572,1404,17,17,9,8
19174,58077,36653,11744,36653,allow,204,64,140,4,11,2,2
19175,51526,4545,51526,4545,allow,156,156,0,3,8,3,0
19176,61099,443,1871,443,allow,82,82,0,1,5,1,0
19177,58915,443,1330,443,allow,6138,3860,2278,20,16,10,10
19178,8889,33873,8889,33873,allow,124,60,64,2,30,1,1
19179,42384,443,16298,443,allow,8561,2300,6261,37,316,18,19
19180,49203,53,20527,53,allow,168,86,82,2,31,1,1
19181,54769,80,54769,80,allow,23168,3380,19788,36,19,18,18
19182,41350,80,41350,80,allow,1914,1465,449,10,19,6,4
19183,55690,53,56846,53,allow,182,93,89,2,30,1,1
19184,47783,80,47783,80,allow,1904,1455,449,10,19,6,4
19185,55946,53,3113,53,allow,762,98,664,2,31,1,1
19186,58889,15000,32384,15000,allow,138,78,60,2,6,1,1
19187,23150,53,23150,53,allow,365,233,132,3,32,2,1
19188,45051,53,45051,53,allow,404,259,145,3,32,2,1
19189,65187,53,4197,53,allow,198,101,97,2,30,1,1
19190,61196,53,61196,53,allow,213,79,134,2,32,1,1
19191,58906,443,27261,443,allow,2896,1492,1404,17,17,9,8
19192,41629,15000,21496,15000,allow,130,70,60,2,5,1,1
19193,58985,443,13213,443,allow,9218,1776,7442,28,23,13,15
19194,36158,443,62102,443,allow,7848,2137,5711,23,25,13,10
19195,52898,80,52898,80,allow,1916,1467,449,10,19,6,4
19196,50678,80,40361,80,allow,300,174,126,5,15,3,2
19197,59951,80,3769,80,allow,1221,339,882,9,16,5,4
19198,50981,443,28253,443,allow,8407,3736,4671,19,101,11,8
19199,49522,443,49522,443,allow,7647,1693,5954,31,77,16,15
19200,49570,443,54043,443,allow,1013,492,521,10,30,4,6
19201,50984,443,27569,443,allow,8023,3352,4671,19,80,11,8
19202,60199,443,24633,443,allow,5858,1511,4347,20,21,11,9
19203,47551,443,47551,443,allow,4743,1836,2907,19,29,11,8
19204,33372,3389,33372,3389,allow,4695,2520,2175,22,19,13,9
19205,50599,80,50599,80,allow,4228,3295,933,17,19,9,8
19206,53861,53065,16335,53065,allow,70,70,0,2,8,2,0
19207,50986,443,39025,443,allow,18156,12850,5306,32,76,19,13
19208,3891,53,3891,53,allow,235,90,145,2,32,1,1
19209,22751,53,22751,53,allow,235,90,145,2,32,1,1
19210,64393,53,49935,53,allow,182,93,89,2,31,1,1
19211,55134,53,14594,53,allow,212,108,104,2,30,1,1
19212,48206,53,48206,53,allow,253,99,154,2,30,1,1
19213,28885,53,28885,53,allow,404,259,145,3,32,2,1
19214,50346,53,56767,53,allow,760,97,663,2,30,1,1
19215,56756,53,42523,53,allow,760,97,663,2,30,1,1
19216,58916,443,3751,443,allow,6376,4098,2278,20,16,10,10
19217,56871,53,58198,53,allow,745,93,652,2,30,1,1
19218,47391,443,14660,443,allow,9921,3169,6752,31,20,17,14
19219,57196,53,22247,53,allow,754,94,660,2,31,1,1
19220,56285,53,7225,53,allow,751,95,656,2,31,1,1
19221,56266,53,14847,53,allow,186,95,91,2,31,1,1
19222,35353,443,50088,443,allow,1864,250,1614,8,120,4,4
19223,53342,443,18889,443,allow,82909,70964,11945,139,283,71,68
19224,55481,53,35011,53,allow,758,96,662,2,30,1,1
19225,56045,53,39272,53,allow,731,91,640,2,30,1,1
19226,55335,53,8773,53,allow,754,94,660,2,30,1,1
19227,49415,53,54397,53,allow,188,96,92,2,31,1,1
19228,56062,53,2393,53,allow,192,98,94,2,31,1,1
19229,56847,53,17178,53,allow,761,100,661,2,31,1,1
19230,64554,53,25900,53,allow,198,101,97,2,31,1,1
19231,49650,53,49396,53,allow,776,102,674,2,31,1,1
19232,55887,53,42850,53,allow,164,84,80,2,31,1,1
19233,61425,443,50113,443,allow,9380,3315,6065,26,93,14,12
19234,61406,443,11878,443,allow,12588,4915,7673,28,94,15,13
19235,55972,53,38960,53,allow,756,95,661,2,31,1,1
19236,65291,53,61483,53,allow,190,97,93,2,31,1,1
19237,38733,443,51557,443,allow,7655,2018,5637,31,93,16,15
19238,56117,53,31292,53,allow,172,88,84,2,31,1,1
19239,55818,53,21143,53,allow,775,103,672,2,31,1,1
19240,64782,53,40065,53,allow,758,93,665,2,31,1,1
19241,64140,53,60265,53,allow,184,94,90,2,31,1,1
19242,48817,49301,48817,49301,allow,490,149,341,2,1200,1,1
19243,59117,53,0,0,allow,82,82,0,1,31,1,0
19244,55889,53,49760,53,allow,198,101,97,2,31,1,1
19245,34351,53,57036,53,allow,202,83,119,2,31,1,1
19246,62619,3389,62619,3389,allow,3504,1790,1714,17,34,9,8
19247,56756,53,46487,53,allow,166,85,81,2,31,1,1
19248,57023,53,64217,53,allow,174,89,85,2,31,1,1
19249,56502,53,50256,53,allow,726,85,641,2,31,1,1
19250,56127,53,8590,53,allow,166,85,81,2,31,1,1
19251,56973,53,12553,53,allow,186,95,91,2,31,1,1
19252,57382,53,8955,53,allow,184,94,90,2,31,1,1
19253,56550,53,58694,53,allow,84,84,0,1,31,1,0
19254,45374,443,48527,443,allow,88469,3492,84977,104,396,35,69
19255,55541,53,53785,53,allow,772,100,672,2,31,1,1
19256,63578,35440,0,0,deny,62,62,0,1,0,1,0
19257,62670,445,0,0,drop,70,70,0,1,0,1,0
19258,58228,53733,0,0,deny,66,66,0,1,0,1,0
19259,51087,445,0,0,drop,70,70,0,1,0,1,0
19260,51084,445,0,0,drop,70,70,0,1,0,1,0
19261,51088,445,0,0,drop,70,70,0,1,0,1,0
19262,64691,25320,0,0,deny,66,66,0,1,0,1,0
19263,1646,23,0,0,deny,60,60,0,1,0,1,0
19264,6712,123,0,0,deny,90,90,0,1,0,1,0
19265,62664,445,0,0,drop,70,70,0,1,0,1,0
19266,62663,445,0,0,drop,70,70,0,1,0,1,0
19267,13684,25174,0,0,deny,62,62,0,1,0,1,0
19268,10088,37807,0,0,deny,66,66,0,1,0,1,0
19269,45783,22114,0,0,deny,62,62,0,1,0,1,0
19270,8889,9794,0,0,deny,60,60,0,1,0,1,0
19271,47357,50584,0,0,deny,66,66,0,1,0,1,0
19272,56268,44847,0,0,deny,66,66,0,1,0,1,0
19273,60721,22114,0,0,deny,66,66,0,1,0,1,0
19274,49156,53,43723,53,allow,195,102,93,2,32,1,1
19275,52061,35717,8703,35717,allow,70,70,0,2,8,2,0
19276,57331,53,27996,53,allow,164,86,78,2,30,1,1
19277,9698,53,9698,53,allow,197,90,107,2,30,1,1
19278,443,62732,0,0,deny,60,60,0,1,0,1,0
19279,62659,445,0,0,drop,70,70,0,1,0,1,0
19280,44546,32468,0,0,deny,62,62,0,1,0,1,0
19281,51077,445,0,0,drop,70,70,0,1,0,1,0
19282,51075,445,0,0,drop,70,70,0,1,0,1,0
19283,51072,445,0,0,drop,70,70,0,1,0,1,0
19284,62658,445,0,0,drop,70,70,0,1,0,1,0
19285,62796,37807,0,0,deny,66,66,0,1,0,1,0
19286,51944,56205,0,0,deny,62,62,0,1,0,1,0
19287,62845,445,0,0,drop,66,66,0,1,0,1,0
19288,19361,23117,0,0,deny,66,66,0,1,0,1,0
19289,51979,25174,0,0,deny,66,66,0,1,0,1,0
19290,10050,31573,0,0,deny,146,146,0,1,0,1,0
19291,33761,25174,0,0,deny,62,62,0,1,0,1,0
19292,58844,51505,0,0,deny,66,66,0,1,0,1,0
19293,42231,57470,0,0,deny,78,78,0,1,0,1,0
19294,62651,445,0,0,drop,70,70,0,1,0,1,0
19295,35011,37965,0,0,deny,62,62,0,1,0,1,0
19296,51068,445,0,0,drop,70,70,0,1,0,1,0
19297,51067,445,0,0,drop,70,70,0,1,0,1,0
19298,55951,30188,0,0,deny,66,66,0,1,0,1,0
19299,16057,56205,0,0,deny,66,66,0,1,0,1,0
19300,58509,21247,0,0,deny,66,66,0,1,0,1,0
19301,3047,50584,0,0,deny,146,146,0,1,0,1,0
19302,15235,36237,0,0,deny,62,62,0,1,0,1,0
19303,62830,445,0,0,drop,66,66,0,1,0,1,0
19304,62829,445,0,0,drop,66,66,0,1,0,1,0
19305,52557,44847,0,0,deny,66,66,0,1,0,1,0
19306,57073,57470,0,0,deny,62,62,0,1,0,1,0
19307,54721,22114,0,0,deny,62,62,0,1,0,1,0
19308,28156,50584,0,0,deny,62,62,0,1,0,1,0
19309,55424,38303,0,0,deny,66,66,0,1,0,1,0
19310,52827,25174,0,0,deny,146,146,0,1,0,1,0
19311,51058,445,0,0,drop,70,70,0,1,0,1,0
19312,51055,445,0,0,drop,70,70,0,1,0,1,0
19313,51054,445,0,0,drop,70,70,0,1,0,1,0
19314,51048,445,0,0,drop,70,70,0,1,0,1,0
19315,62638,445,0,0,drop,70,70,0,1,0,1,0
19316,23331,25174,0,0,deny,66,66,0,1,0,1,0
19317,54817,47993,0,0,deny,66,66,0,1,0,1,0
19318,62821,445,0,0,drop,66,66,0,1,0,1,0
19319,45144,25174,0,0,deny,62,62,0,1,0,1,0
19320,56940,53,28824,53,allow,200,102,98,2,30,1,1
19321,55690,53,37274,53,allow,183,94,89,2,30,1,1
19322,56062,53,34305,53,allow,196,102,94,2,30,1,1
19323,49284,53,21270,53,allow,177,94,83,2,30,1,1
19324,64068,53,59683,53,allow,168,86,82,2,30,1,1
19325,37606,443,47206,443,allow,6277,1868,4409,22,45,13,9
19326,60864,443,60864,443,allow,8578,2549,6029,22,16,13,9
19327,55922,53,5571,53,allow,807,94,713,2,29,1,1
19328,50218,53,12883,53,allow,165,86,79,2,29,1,1
19329,57651,80,10587,80,allow,1151,711,440,10,15,5,5
19330,33410,80,44582,80,allow,1570,754,816,10,15,6,4
19331,55443,53,14959,53,allow,194,102,92,2,30,1,1
19332,58923,443,63838,443,allow,5167,700,4467,16,14,7,9
19333,9248,80,12948,80,allow,844,778,66,6,15,5,1
19334,56062,53,55511,53,allow,196,102,94,2,30,1,1
19335,53722,443,10654,443,allow,70,70,0,2,7,2,0
19336,65127,443,37615,443,allow,146,64,82,3,9,2,1
19337,52095,443,5865,443,allow,3023,2045,978,15,15,9,6
19338,64146,53,50563,53,allow,308,99,209,4,39,2,2
19339,53821,443,16981,443,allow,7980,1434,6546,24,19,13,11
19340,21189,53,21189,53,allow,374,240,134,3,32,2,1
19341,55922,53,13122,53,allow,184,94,90,2,29,1,1
19342,56349,53,42172,53,allow,216,110,106,2,29,1,1
19343,64444,53,35858,53,allow,183,94,89,2,29,1,1
19344,65187,53,35953,53,allow,199,102,97,2,29,1,1
19345,65499,53,26043,53,allow,167,86,81,2,29,1,1
19346,49823,53,8034,53,allow,209,110,99,2,29,1,1
19347,56772,53,30219,53,allow,185,102,83,2,29,1,1
19348,64051,53,30405,53,allow,1114,468,646,12,67,6,6
19349,64679,53,2951,53,allow,178,94,84,2,30,1,1
19350,55551,53,64054,53,allow,180,94,86,2,29,1,1
19351,64858,53,43430,53,allow,211,102,109,2,30,1,1
19352,49415,53,4512,53,allow,194,102,92,2,30,1,1
19353,57374,53,58495,53,allow,216,102,114,2,30,1,1
19354,56423,53,58524,53,allow,168,86,82,2,30,1,1
19355,58917,80,56785,80,allow,4107,3453,654,13,16,7,6
19356,59297,80,59297,80,allow,107500,4003,103497,173,16,57,116
19357,57439,443,32851,443,allow,5502,1543,3959,17,20,9,8
19358,28032,443,27743,443,allow,6756,2587,4169,19,16,10,9
19359,58911,443,55607,443,allow,5168,700,4468,16,16,7,9
19360,56732,443,23589,443,allow,7855,1866,5989,20,15,11,9
19361,50601,80,50601,80,allow,4206,3273,933,17,19,9,8
19362,61060,53,35678,53,allow,311,94,217,2,30,1,1
19363,64721,53,18309,53,allow,214,110,104,2,30,1,1
19364,49284,53,55787,53,allow,185,102,83,2,30,1,1
19365,60870,53,30144,53,allow,220,94,126,2,30,1,1
19366,61740,443,10410,443,allow,9854,2716,7138,36,49,20,16
19367,56272,53,1689,53,allow,167,86,81,2,30,1,1
19368,55735,53,9793,53,allow,199,102,97,2,30,1,1
19369,49300,443,63188,443,allow,6101,848,5253,17,21,9,8
19370,50045,53,13478,53,allow,168,86,82,2,30,1,1
19371,64329,53,38742,53,allow,479,111,368,4,50,2,2
19372,65089,53,28362,53,allow,199,102,97,2,30,1,1
19373,56622,53,10987,53,allow,214,110,104,2,30,1,1
19374,50377,53,41134,53,allow,214,110,104,2,30,1,1
19375,55887,53,55834,53,allow,166,86,80,2,30,1,1
19376,56323,53,21945,53,allow,168,94,74,2,30,1,1
19377,65089,53,20611,53,allow,199,102,97,2,30,1,1
19378,58914,443,39439,443,allow,5168,700,4468,16,16,7,9
19379,56215,53,9049,53,allow,165,86,79,2,30,1,1
19380,49609,53,44822,53,allow,754,94,660,2,30,1,1
19381,56731,443,49373,443,allow,7907,1918,5989,20,15,11,9
19382,55443,53,18885,53,allow,194,102,92,2,30,1,1
19383,64721,53,29674,53,allow,214,110,104,2,30,1,1
19384,56323,53,5698,53,allow,152,78,74,2,30,1,1
19385,56622,53,31873,53,allow,214,110,104,2,30,1,1
19386,49710,53,33849,53,allow,183,102,81,2,30,1,1
19387,65387,53,9016,53,allow,221,94,127,2,30,1,1
19388,49342,53,10156,53,allow,443,182,261,6,30,3,3
19389,64506,53,14791,53,allow,230,94,136,2,30,1,1
19390,49710,53,1886,53,allow,183,102,81,2,30,1,1
19391,51081,443,32211,443,allow,6653,3225,3428,18,135,9,9
19392,55690,53,57021,53,allow,183,94,89,2,30,1,1
19393,59476,443,42006,443,allow,4697,923,3774,13,120,6,7
19394,64792,53,60591,53,allow,166,86,80,2,30,1,1
19395,56127,53,6171,53,allow,167,86,81,2,30,1,1
19396,57319,53,4407,53,allow,189,102,87,2,30,1,1
19397,52064,43273,5722,43273,allow,70,70,0,2,7,2,0
19398,52514,80,52514,80,allow,1916,1467,449,10,19,6,4
19399,59298,80,59298,80,allow,85989,14398,71591,143,15,40,103
19400,63991,80,39490,80,allow,314,192,122,6,15,4,2
19401,65119,53,47223,53,allow,568,188,380,6,60,3,3
19402,64689,53,47457,53,allow,763,102,661,2,30,1,1
19403,36013,53,23635,53,allow,86,86,0,1,30,1,0
19404,49505,53,42199,53,allow,225,110,115,2,30,1,1
19405,47894,443,29583,443,allow,295475,14093,281382,413,469,162,251
19406,52063,7886,55344,7886,allow,70,70,0,2,8,2,0
19407,49518,443,49518,443,allow,103941,6635,97306,158,76,81,77
19408,65187,53,40747,53,allow,345,101,244,4,53,2,2
19409,57331,53,30032,53,allow,172,94,78,2,30,1,1
19410,64493,53,17644,53,allow,280,97,183,4,60,2,2
19411,55132,53,34901,53,allow,889,404,485,10,30,5,5
19412,49741,53,35577,53,allow,766,102,664,2,30,1,1
19413,49795,53,15978,53,allow,209,110,99,2,30,1,1
19414,60710,53,32625,53,allow,211,78,133,2,30,1,1
19415,50026,53,4265,53,allow,395,99,296,4,57,2,2
19416,64297,53,43105,53,allow,364,94,270,4,49,2,2
19417,35814,443,57995,443,allow,9126,3975,5151,21,15,11,10
19418,60602,5222,39358,5222,allow,5564,2206,3358,50,310,20,30
19419,54106,80,38158,80,allow,78,78,0,1,5,1,0
19420,56733,443,4067,443,allow,7941,1952,5989,20,15,11,9
19421,47996,80,47996,80,allow,1920,1471,449,10,19,6,4
19422,57664,80,57664,80,allow,1917,1468,449,10,19,6,4
19423,46248,443,47277,443,allow,979612,946319,33293,1091,25,690,401
19424,64512,53,2401,53,allow,524,91,433,4,34,2,2
19425,56739,80,48782,80,allow,1462,703,759,8,16,5,3
19426,49588,53,53938,53,allow,733,94,639,2,29,1,1
19427,65134,53,52533,53,allow,812,110,702,2,29,1,1
19428,64444,53,57791,53,allow,183,94,89,2,29,1,1
19429,56752,53,3213,53,allow,183,94,89,2,29,1,1
19430,64679,53,32723,53,allow,328,88,240,4,32,2,2
19431,56047,443,45831,443,allow,126,60,66,3,4,2,1
19432,52209,443,18180,443,allow,502469,15202,487267,580,97,193,387
19433,50377,53,58981,53,allow,214,110,104,2,30,1,1
19434,37569,443,45273,443,allow,11226,3029,8197,36,55,18,18
19435,64309,53,55479,53,allow,549,188,361,6,57,3,3
19436,58919,443,29317,443,allow,5166,700,4466,16,15,7,9
19437,60620,80,60620,80,allow,1916,1467,449,10,19,6,4
19438,49347,53,23678,53,allow,342,91,251,4,54,2,2
19439,55636,80,55636,80,allow,1916,1467,449,10,19,6,4
19440,55520,53,61502,53,allow,194,102,92,2,30,1,1
19441,55520,53,61056,53,allow,194,102,92,2,29,1,1
19442,61673,443,61673,443,allow,76863,6096,70767,103,17,49,54
19443,56254,53,3663,53,allow,498,204,294,6,30,3,3
19444,64721,53,12160,53,allow,466,108,358,4,45,2,2
19445,64748,53,3750,53,allow,168,94,74,2,29,1,1
19446,64128,53,22207,53,allow,194,94,100,2,31,1,1
19447,53863,8999,11307,8999,allow,70,70,0,2,7,2,0
19448,64961,27025,27939,27025,allow,1334,462,872,4,30,2,2
19449,52059,47363,50172,47363,allow,70,70,0,2,8,2,0
19450,54519,443,46768,443,allow,70,70,0,1,5,1,0
19451,64748,53,7421,53,allow,152,78,74,2,30,1,1
19452,57319,53,9103,53,allow,189,102,87,2,30,1,1
19453,55624,53,2352,53,allow,199,102,97,2,30,1,1
19454,38701,443,23957,443,allow,1065134,19929,1045205,1009,16,288,721
19455,49527,53,33639,53,allow,173,94,79,2,30,1,1
19456,50600,80,50600,80,allow,4262,3329,933,17,19,9,8
19457,56622,53,54285,53,allow,214,110,104,2,30,1,1
19458,49520,443,49520,443,allow,88797,5446,83351,137,76,70,67
19459,57438,443,63629,443,allow,7720,2815,4905,22,20,10,12
19460,58918,443,16774,443,allow,5166,700,4466,16,16,7,9
19461,56134,53,5515,53,allow,183,94,89,2,29,1,1
19462,64744,53,61506,53,allow,770,102,668,2,29,1,1
19463,49614,53,25029,53,allow,380,110,270,2,29,1,1
19464,56215,53,29779,53,allow,165,86,79,2,30,1,1
19465,64657,53,3237,53,allow,193,102,91,2,30,1,1
19466,55714,53,2036,53,allow,165,86,79,2,30,1,1
19467,64060,53,33741,53,allow,258,110,148,2,30,1,1
19468,56304,53,62384,53,allow,443,182,261,6,31,3,3
19469,55999,443,22014,443,allow,3640,606,3034,13,120,6,7
19470,61681,443,50543,443,allow,10714,3531,7183,26,120,12,14
19471,48305,443,59833,443,allow,572565,17274,555291,546,147,124,422
19472,6881,6881,26676,6881,allow,238,118,120,2,1200,1,1
19473,50228,53,44907,53,allow,173,94,79,2,30,1,1
19474,55463,53,8245,53,allow,193,102,91,2,30,1,1
19475,65142,53,52457,53,allow,167,86,81,2,30,1,1
19476,56266,53,65060,53,allow,193,102,91,2,30,1,1
19477,64140,53,44344,53,allow,184,94,90,2,31,1,1
19478,63885,443,2549,443,allow,254829,10396,244433,255,194,64,191
19479,49415,53,62672,53,allow,194,102,92,2,30,1,1
19480,59965,80,33685,80,allow,1638,1324,314,10,15,5,5
19481,63966,443,14721,443,allow,22930,2512,20418,37,75,17,20
19482,52062,60388,61139,60388,allow,70,70,0,2,8,2,0
19483,52044,5824,26075,5824,allow,70,70,0,1,5,1,0
19484,63139,53,20764,53,allow,234,234,0,4,47,4,0
19485,49476,53,34696,53,allow,764,102,662,2,30,1,1
19486,64052,53,55826,53,allow,232,102,130,2,30,1,1
19487,56136,53,4435,53,allow,733,94,639,2,30,1,1
19488,65056,53,56800,53,allow,270,94,176,2,30,1,1
19489,49944,53,37550,53,allow,196,102,94,2,30,1,1
19490,56388,53,30178,53,allow,165,86,79,2,30,1,1
19491,64178,53,3511,53,allow,276,94,182,2,30,1,1
19492,55735,53,16181,53,allow,199,102,97,2,30,1,1
19493,64959,27038,6979,27038,allow,996,462,534,4,30,2,2
19494,49527,53,30173,53,allow,165,86,79,2,30,1,1
19495,56349,53,21926,53,allow,216,110,106,2,30,1,1
19496,65006,53,44331,53,allow,763,102,661,2,30,1,1
19497,55043,443,31088,443,allow,11681,3607,8074,40,120,20,20
19498,51221,32329,23850,32329,allow,870,330,540,12,1316,6,6
19499,33228,443,46001,443,allow,2567,1173,1394,19,179,8,11
19500,61398,80,61398,80,allow,1917,1468,449,10,19,6,4
19501,52060,29868,16909,29868,allow,70,70,0,2,8,2,0
19502,56738,80,55725,80,allow,1462,703,759,8,16,5,3
19503,65038,53,25509,53,allow,165,86,79,2,30,1,1
19504,9021,53,9021,53,allow,216,90,126,2,30,1,1
19505,49844,53,19437,53,allow,734,102,632,2,30,1,1
19506,64627,53,26278,53,allow,168,86,82,2,30,1,1
19507,56940,53,50066,53,allow,200,102,98,2,30,1,1
19508,55979,53,24460,53,allow,168,86,82,2,30,1,1
19509,56388,53,39602,53,allow,173,94,79,2,30,1,1
19510,55551,53,65057,53,allow,180,94,86,2,30,1,1
19511,53831,53,28587,53,allow,260,86,174,2,30,1,1
19512,49636,53,12225,53,allow,180,94,86,2,30,1,1
19513,39771,80,39771,80,allow,17982,4308,13674,30,20,15,15
19514,54105,80,38446,80,allow,78,78,0,1,5,1,0
19515,50377,53,60945,53,allow,214,110,104,2,30,1,1
19516,55735,53,42351,53,allow,199,102,97,2,30,1,1
19517,36125,443,36185,443,allow,6620,1197,5423,22,129,12,10
19518,45571,443,60221,443,allow,3974,2015,1959,21,345,10,11
19519,65220,53,61957,53,allow,811,94,717,2,30,1,1
19520,65291,53,24701,53,allow,195,102,93,2,30,1,1
19521,49203,53,46894,53,allow,168,86,82,2,30,1,1
19522,64792,53,47254,53,allow,166,86,80,2,30,1,1
19523,64554,53,41182,53,allow,199,102,97,2,30,1,1
19524,56117,53,21155,53,allow,178,94,84,2,30,1,1
19525,46851,53,12035,53,allow,168,78,90,2,30,1,1
19526,39195,443,6951,443,allow,8991,2438,6553,18,120,8,10
19527,55443,53,14783,53,allow,194,102,92,2,30,1,1
19528,50228,53,36486,53,allow,173,94,79,2,30,1,1
19529,64393,53,36156,53,allow,183,94,89,2,30,1,1
19530,49388,53,27609,53,allow,215,102,113,2,30,1,1
19531,41107,53,24186,53,allow,168,78,90,2,30,1,1
19532,64376,53,46569,53,allow,247,94,153,2,30,1,1
19533,64657,53,42843,53,allow,816,102,714,2,30,1,1
19534,56423,53,27855,53,allow,184,102,82,2,30,1,1
19535,50071,53,62204,53,allow,458,188,270,6,30,3,3
19536,49415,53,16500,53,allow,194,102,92,2,30,1,1
19537,55856,53,56508,53,allow,265,94,171,2,30,1,1
19538,60709,53,36089,53,allow,260,86,174,2,30,1,1
19539,49765,53,13036,53,allow,194,102,92,2,31,1,1
19540,55877,42466,20270,42466,allow,481,150,331,2,1200,1,1
19541,56379,53,59317,53,allow,166,86,80,2,30,1,1
19542,49574,53,25202,53,allow,816,102,714,2,30,1,1
19543,57334,53,42427,53,allow,184,94,90,2,30,1,1
19544,55367,53,46146,53,allow,195,102,93,2,31,1,1
19545,57053,53,53183,53,allow,173,94,79,2,31,1,1
19546,57333,53,36710,53,allow,167,86,81,2,31,1,1
19547,65417,53,49087,53,allow,402,118,284,2,30,1,1
19548,55889,53,7647,53,allow,199,102,97,2,30,1,1
19549,56379,53,29859,53,allow,166,86,80,2,31,1,1
19550,57023,53,45929,53,allow,179,94,85,2,31,1,1
19551,49966,53,36472,53,allow,182,102,80,2,30,1,1
19552,56266,53,13342,53,allow,193,102,91,2,31,1,1
19553,64393,53,13343,53,allow,183,94,89,2,31,1,1
19554,57382,53,16095,53,allow,184,94,90,2,31,1,1
19555,57323,53,24768,53,allow,194,102,92,2,31,1,1
19556,56837,443,38721,443,allow,2349,258,2091,10,120,4,6
19557,55141,53,56040,53,allow,184,94,90,2,31,1,1
19558,51221,1950,25491,1950,allow,870,330,540,12,1316,6,6
19559,58934,53,32905,53,allow,205,86,119,2,30,1,1
19560,49966,53,59809,53,allow,166,86,80,2,30,1,1
19561,64140,53,48538,53,allow,184,94,90,2,30,1,1
19562,56195,53,54925,53,allow,811,94,717,2,30,1,1
19563,65139,53,1458,53,allow,216,110,106,2,30,1,1
19564,55714,53,64632,53,allow,173,94,79,2,30,1,1
19565,52165,443,19255,443,allow,289596,9131,280465,283,48,85,198
19566,64853,53,20952,53,allow,199,102,97,2,31,1,1
19567,55887,53,33560,53,allow,166,86,80,2,31,1,1
19568,57430,53,3513,53,allow,200,102,98,2,31,1,1
19569,65139,53,19988,53,allow,216,110,106,2,31,1,1
19570,55816,53,60578,53,allow,214,110,104,2,31,1,1
19571,59477,443,7119,443,allow,14489,12206,2283,25,120,15,10
19572,57334,53,60234,53,allow,184,94,90,2,31,1,1
19573,63996,45759,44503,45759,allow,70,70,0,1,5,1,0
19574,52041,48103,59658,48103,allow,70,70,0,1,5,1,0
19575,64344,53,48570,53,allow,286,102,184,4,46,2,2
19576,49823,53,25346,53,allow,502,103,399,4,51,2,2
19577,55624,53,59892,53,allow,308,101,207,4,53,2,2
19578,56975,53,16815,53,allow,413,170,243,6,31,3,3
19579,49636,53,15924,53,allow,180,94,86,2,31,1,1
19580,56819,53,17305,53,allow,209,110,99,2,31,1,1
19581,55841,53,16397,53,allow,458,188,270,6,31,3,3
19582,58908,443,8392,443,allow,5166,700,4466,16,16,7,9
19583,38700,443,57335,443,allow,90113,3417,86696,95,16,30,65
19584,29988,44847,0,0,deny,66,66,0,1,0,1,0
19585,51564,50584,0,0,deny,62,62,0,1,0,1,0
19586,50079,23,0,0,deny,60,60,0,1,0,1,0
19587,62816,445,0,0,drop,66,66,0,1,0,1,0
19588,62810,445,0,0,drop,66,66,0,1,0,1,0
19589,62812,445,0,0,drop,66,66,0,1,0,1,0
19590,62817,445,0,0,drop,66,66,0,1,0,1,0
19591,62813,445,0,0,drop,66,66,0,1,0,1,0
19592,62818,445,0,0,drop,66,66,0,1,0,1,0
19593,62811,445,0,0,drop,66,66,0,1,0,1,0
19594,37647,36237,0,0,deny,66,66,0,1,0,1,0
19595,44147,64147,0,0,deny,62,62,0,1,0,1,0
19596,51042,445,0,0,drop,70,70,0,1,0,1,0
19597,54377,56205,0,0,deny,62,62,0,1,0,1,0
19598,9528,44847,0,0,deny,62,62,0,1,0,1,0
19599,31738,51505,0,0,deny,62,62,0,1,0,1,0
19600,51039,445,0,0,drop,70,70,0,1,0,1,0
19601,51035,445,0,0,drop,70,70,0,1,0,1,0
19602,51038,445,0,0,drop,70,70,0,1,0,1,0
19603,56328,36237,0,0,deny,66,66,0,1,0,1,0
19604,19267,5555,0,0,deny,60,60,0,1,0,1,0
19605,52781,57470,0,0,deny,66,66,0,1,0,1,0
19606,49415,22114,0,0,deny,66,66,0,1,0,1,0
19607,61591,22114,0,0,deny,62,62,0,1,0,1,0
19608,62630,445,0,0,drop,70,70,0,1,0,1,0
19609,62629,445,0,0,drop,70,70,0,1,0,1,0
19610,7423,22114,0,0,deny,62,62,0,1,0,1,0
19611,62627,445,0,0,drop,70,70,0,1,0,1,0
19612,19455,25174,0,0,deny,146,146,0,1,0,1,0
19613,25565,18855,0,0,deny,60,60,0,1,0,1,0
19614,45682,37965,0,0,deny,62,62,0,1,0,1,0
19615,7001,6881,0,0,deny,62,62,0,1,0,1,0
19616,7067,22114,0,0,deny,62,62,0,1,0,1,0
19617,51034,445,0,0,drop,70,70,0,1,0,1,0
19618,51031,445,0,0,drop,70,70,0,1,0,1,0
19619,51028,445,0,0,drop,70,70,0,1,0,1,0
19620,57669,64147,0,0,deny,62,62,0,1,0,1,0
19621,62802,445,0,0,drop,66,66,0,1,0,1,0
19622,51026,445,0,0,drop,70,70,0,1,0,1,0
19623,65015,22114,0,0,deny,66,66,0,1,0,1,0
19624,62798,445,0,0,drop,66,66,0,1,0,1,0
19625,33215,37965,0,0,deny,62,62,0,1,0,1,0
19626,58880,443,32825,443,allow,1413,876,537,12,11,6,6
19627,34166,22114,0,0,deny,62,62,0,1,0,1,0
19628,58303,22114,0,0,deny,62,62,0,1,0,1,0
19629,62795,445,0,0,drop,66,66,0,1,0,1,0
19630,62794,445,0,0,drop,66,66,0,1,0,1,0
19631,62620,445,0,0,drop,70,70,0,1,0,1,0
19632,49797,25174,0,0,deny,66,66,0,1,0,1,0
19633,62792,445,0,0,drop,66,66,0,1,0,1,0
19634,27348,22114,0,0,deny,66,66,0,1,0,1,0
19635,62911,36237,0,0,deny,66,66,0,1,0,1,0
19636,62618,445,0,0,drop,70,70,0,1,0,1,0
19637,47943,50584,0,0,deny,74,74,0,1,0,1,0
19638,44815,36829,0,0,deny,62,62,0,1,0,1,0
19639,30304,64147,0,0,deny,66,66,0,1,0,1,0
19640,62617,445,0,0,drop,70,70,0,1,0,1,0
19641,62616,445,0,0,drop,70,70,0,1,0,1,0
19642,51021,445,0,0,drop,70,70,0,1,0,1,0
19643,62615,445,0,0,drop,70,70,0,1,0,1,0
19644,22733,26467,0,0,deny,62,62,0,1,0,1,0
19645,55161,37807,0,0,deny,66,66,0,1,0,1,0
19646,5476,23,0,0,deny,60,60,0,1,0,1,0
19647,62609,445,0,0,drop,70,70,0,1,0,1,0
19648,62610,445,0,0,drop,70,70,0,1,0,1,0
19649,6247,51221,0,0,deny,78,78,0,1,0,1,0
19650,51009,445,0,0,drop,70,70,0,1,0,1,0
19651,51012,445,0,0,drop,70,70,0,1,0,1,0
19652,30654,51221,0,0,deny,72,72,0,1,0,1,0
19653,35666,22114,0,0,deny,62,62,0,1,0,1,0
19654,62781,445,0,0,drop,66,66,0,1,0,1,0
19655,57797,64147,0,0,deny,62,62,0,1,0,1,0
19656,55144,30188,0,0,deny,66,66,0,1,0,1,0
19657,61961,11392,0,0,deny,66,66,0,1,0,1,0
19658,62597,445,0,0,drop,70,70,0,1,0,1,0
19659,62595,445,0,0,drop,70,70,0,1,0,1,0
19660,63400,57470,0,0,deny,66,66,0,1,0,1,0
19661,62591,445,0,0,drop,70,70,0,1,0,1,0
19662,59234,21247,0,0,deny,62,62,0,1,0,1,0
19663,62587,445,0,0,drop,70,70,0,1,0,1,0
19664,62586,445,0,0,drop,70,70,0,1,0,1,0
19665,55130,25174,0,0,deny,66,66,0,1,0,1,0
19666,55199,21247,0,0,deny,66,66,0,1,0,1,0
19667,25031,25174,0,0,deny,62,62,0,1,0,1,0
19668,54166,25174,0,0,deny,66,66,0,1,0,1,0
19669,17781,44847,0,0,deny,146,146,0,1,0,1,0
19670,62774,445,0,0,drop,66,66,0,1,0,1,0
19671,51003,445,0,0,drop,70,70,0,1,0,1,0
19672,45941,23386,0,0,deny,60,60,0,1,0,1,0
19673,34713,22114,0,0,deny,146,146,0,1,0,1,0
19674,17097,62413,0,0,deny,62,62,0,1,0,1,0
19675,63832,25174,0,0,deny,66,66,0,1,0,1,0
19676,52321,26467,0,0,deny,62,62,0,1,0,1,0
19677,30707,30317,0,0,deny,62,62,0,1,0,1,0
19678,18017,25773,0,0,reset-both,143,143,0,1,0,1,0
19679,15189,25174,0,0,deny,146,146,0,1,0,1,0
19680,62772,445,0,0,drop,66,66,0,1,0,1,0
19681,62575,445,0,0,drop,70,70,0,1,0,1,0
19682,27321,25174,0,0,deny,146,146,0,1,0,1,0
19683,23306,25174,0,0,deny,146,146,0,1,0,1,0
19684,62765,445,0,0,drop,66,66,0,1,0,1,0
19685,51834,35440,0,0,deny,66,66,0,1,0,1,0
19686,7000,23117,0,0,deny,66,66,0,1,0,1,0
19687,13525,51505,0,0,deny,146,146,0,1,0,1,0
19688,62760,445,0,0,drop,66,66,0,1,0,1,0
19689,34636,23,0,0,deny,60,60,0,1,0,1,0
19690,1536,50584,0,0,deny,146,146,0,1,0,1,0
19691,51609,37807,0,0,deny,66,66,0,1,0,1,0
19692,62571,445,0,0,drop,70,70,0,1,0,1,0
19693,56770,26467,0,0,deny,62,62,0,1,0,1,0
19694,62014,35440,0,0,deny,66,66,0,1,0,1,0
19695,57337,64147,0,0,deny,66,66,0,1,0,1,0
19696,33359,30188,0,0,deny,66,66,0,1,0,1,0
19697,30574,64147,0,0,deny,62,62,0,1,0,1,0
19698,54769,50584,0,0,deny,62,62,0,1,0,1,0
19699,62560,445,0,0,drop,70,70,0,1,0,1,0
19700,62562,445,0,0,drop,70,70,0,1,0,1,0
19701,62559,445,0,0,drop,70,70,0,1,0,1,0
19702,55562,50584,0,0,deny,62,62,0,1,0,1,0
19703,49994,26467,0,0,deny,62,62,0,1,0,1,0
19704,64509,9571,0,0,deny,62,62,0,1,0,1,0
19705,62557,445,0,0,drop,70,70,0,1,0,1,0
19706,50991,445,0,0,drop,70,70,0,1,0,1,0
19707,50987,445,0,0,drop,70,70,0,1,0,1,0
19708,50986,445,0,0,drop,70,70,0,1,0,1,0
19709,63474,48817,0,0,deny,66,66,0,1,0,1,0
19710,19875,30170,0,0,deny,145,145,0,1,0,1,0
19711,6036,51505,0,0,deny,66,66,0,1,0,1,0
19712,62554,445,0,0,drop,70,70,0,1,0,1,0
19713,62743,445,0,0,drop,66,66,0,1,0,1,0
19714,62748,445,0,0,drop,66,66,0,1,0,1,0
19715,62747,445,0,0,drop,66,66,0,1,0,1,0
19716,62746,445,0,0,drop,66,66,0,1,0,1,0
19717,62744,445,0,0,drop,66,66,0,1,0,1,0
19718,62745,445,0,0,drop,66,66,0,1,0,1,0
19719,62742,445,0,0,drop,66,66,0,1,0,1,0
19720,62741,445,0,0,drop,66,66,0,1,0,1,0
19721,46509,36237,0,0,deny,66,66,0,1,0,1,0
19722,61738,2767,0,0,deny,66,66,0,1,0,1,0
19723,58250,35440,0,0,deny,62,62,0,1,0,1,0
19724,8229,22114,0,0,deny,66,66,0,1,0,1,0
19725,63323,54369,0,0,deny,78,78,0,1,0,1,0
19726,7210,22114,0,0,deny,66,66,0,1,0,1,0
19727,23021,25174,0,0,deny,66,66,0,1,0,1,0
19728,56161,62413,0,0,deny,62,62,0,1,0,1,0
19729,55019,443,64416,443,allow,13326,1847,11479,27,31,14,13
19730,64493,53,24989,53,allow,280,97,183,4,59,2,2
19731,48590,443,14073,443,allow,3538,2083,1455,17,256,9,8
19732,5588,5588,0,0,allow,3354,1792,1562,46,193,23,23
19733,5588,5588,0,0,allow,3354,1792,1562,46,194,23,23
19734,55367,53,8311,53,allow,190,97,93,2,31,1,1
19735,56790,53,40538,53,allow,758,93,665,2,30,1,1
19736,31019,53,31019,53,allow,194,87,107,2,30,1,1
19737,52621,443,59205,443,allow,190,70,120,4,15,2,2
19738,57968,53,57968,53,allow,371,237,134,3,32,2,1
19739,49407,53,35774,53,allow,774,101,673,2,30,1,1
19740,56313,53,15835,53,allow,196,100,96,2,30,1,1
19741,55816,53,28988,53,allow,212,108,104,2,30,1,1
19742,24009,53,24009,53,allow,825,99,726,2,30,1,1
19743,65274,53,19286,53,allow,295,101,194,4,32,2,2
19744,57563,443,58695,443,allow,10044,2134,7910,42,34,23,19
19745,58895,443,48917,443,allow,13440,8354,5086,39,20,20,19
19746,60910,443,19521,443,allow,3862,2679,1183,28,46,15,13
19747,64003,38926,55687,38926,allow,66,66,0,1,5,1,0
19748,50309,443,46447,443,allow,5955,1619,4336,23,15,13,10
19749,60909,443,5719,443,allow,5150,3651,1499,34,46,18,16
19750,58902,443,55109,443,allow,8119,5152,2967,29,18,14,15
19751,5588,5588,0,0,allow,3562,1936,1626,48,194,24,24
19752,65180,53,33252,53,allow,751,95,656,2,30,1,1
19753,57314,53,61726,53,allow,190,97,93,2,31,1,1
19754,57334,53,10038,53,allow,184,94,90,2,30,1,1
19755,65139,53,15314,53,allow,216,110,106,2,30,1,1
19756,48833,443,62502,443,allow,1348406,28891,1319515,1247,31,340,907
19757,34879,443,57316,443,allow,167,107,60,2,5,1,1
19758,55147,53,40257,53,allow,776,102,674,2,30,1,1
19759,49408,443,42776,443,allow,4189,2286,1903,35,256,17,18
19760,57430,53,32678,53,allow,200,102,98,2,30,1,1
19761,65420,443,40711,443,allow,3213,2242,971,19,25,9,10
19762,49519,443,49519,443,allow,15064,2611,12453,43,76,23,20
19763,28742,53,28742,53,allow,365,233,132,3,32,2,1
19764,38664,443,19990,443,allow,8195,1780,6415,23,60,12,11
19765,60906,443,59580,443,allow,11543,5375,6168,45,47,24,21
19766,61356,53,61356,53,allow,235,90,145,2,32,1,1
19767,55305,53,52264,53,allow,1448,103,1345,4,54,2,2
19768,52159,80,40700,80,allow,1278,731,547,10,15,6,4
19769,64002,2880,14112,2880,allow,66,66,0,1,5,1,0
19770,65344,53,21017,53,allow,90,90,0,1,30,1,0
19771,58900,443,22833,443,allow,8547,5209,3338,30,19,15,15
19772,42974,53,0,0,allow,82,82,0,1,30,1,0
19773,57323,53,18058,53,allow,188,96,92,2,31,1,1
19774,56431,53,36582,53,allow,778,103,675,2,31,1,1
19775,51038,443,30038,443,allow,7263,1830,5433,27,16,15,12
19776,31680,53,31680,53,allow,404,259,145,3,32,2,1
19777,49765,53,55763,53,allow,188,96,92,2,31,1,1
19778,39858,443,36124,443,allow,167,107,60,2,5,1,1
19779,64344,53,46040,53,allow,286,102,184,4,45,2,2
19780,52712,443,61572,443,allow,348281,20002,328279,401,350,153,248
19781,38334,22,38334,22,allow,9022,3349,5673,57,43,26,31
19782,63987,58476,60558,58476,allow,504,382,122,8,16,6,2
19783,63116,53,14772,53,allow,578,286,292,9,15,5,4
19784,9233,443,25219,443,allow,5955,728,5227,17,15,8,9
19785,58904,443,20613,443,allow,4732,3142,1590,20,18,9,11
19786,55693,45341,14771,45341,allow,70,70,0,2,8,2,0
19787,60911,443,41186,443,allow,3862,2679,1183,28,46,15,13
19788,47281,443,8413,443,allow,190,70,120,4,15,2,2
19789,48834,443,52235,443,allow,655052,13866,641186,599,31,150,449
19790,56439,53,22467,53,allow,751,95,656,2,30,1,1
19791,48847,443,57026,443,allow,2478246,45190,2433056,2175,27,520,1655
19792,41432,53,63040,53,allow,202,83,119,2,30,1,1
19793,65437,53,48894,53,allow,1386,85,1301,4,53,2,2
19794,49253,53,20812,53,allow,198,101,97,2,30,1,1
19795,54973,53,46622,53,allow,178,91,87,2,31,1,1
19796,14205,53,14205,53,allow,233,91,142,2,31,1,1
19797,55127,53,55127,53,allow,220,100,120,2,31,1,1
19798,22394,53,22394,53,allow,233,91,142,2,31,1,1
19799,13160,53,13160,53,allow,198,89,109,2,31,1,1
19800,53404,443,26776,443,allow,8437,4827,3610,50,180,25,25
19801,62009,443,59530,443,allow,5017,1969,3048,14,136,7,7
19802,57470,16288,57203,16288,allow,924,924,0,15,1200,15,0
19803,57340,53,3053,53,allow,747,92,655,2,31,1,1
19804,55141,53,13525,53,allow,184,94,90,2,31,1,1
19805,55268,53,37193,53,allow,186,95,91,2,31,1,1
19806,56964,53,11967,53,allow,774,101,673,2,31,1,1
19807,65204,53,50970,53,allow,182,93,89,2,31,1,1
19808,57351,53,37431,53,allow,184,94,90,2,31,1,1
19809,55056,53,12643,53,allow,202,103,99,2,31,1,1
19810,55220,53,9691,53,allow,186,95,91,2,31,1,1
19811,56711,53,31656,53,allow,202,103,99,2,31,1,1
19812,56126,53,16372,53,allow,774,101,673,2,31,1,1
19813,33133,443,21005,443,allow,8138,2101,6037,17,121,9,8
19814,57416,53,37012,53,allow,771,101,670,2,31,1,1
19815,56819,53,59960,53,allow,202,103,99,2,31,1,1
19816,64020,53,44407,53,allow,192,98,94,2,31,1,1
19817,64896,53,10637,53,allow,716,95,621,2,31,1,1
19818,29076,53,29076,53,allow,231,90,141,2,31,1,1
19819,49636,53,21781,53,allow,176,90,86,2,31,1,1
19820,56857,53,63903,53,allow,190,97,93,2,31,1,1
19821,59899,53,59899,53,allow,194,87,107,2,31,1,1
19822,55415,53,34000,53,allow,182,93,89,2,31,1,1
19823,65132,53,11821,53,allow,166,85,81,2,31,1,1
19824,55123,53,64230,53,allow,196,100,96,2,31,1,1
19825,55577,53,45509,53,allow,198,101,97,2,31,1,1
19826,55688,53,29259,53,allow,184,94,90,2,31,1,1
19827,65505,53,12322,53,allow,164,84,80,2,31,1,1
19828,49628,53,48622,53,allow,168,86,82,2,31,1,1
19829,50353,443,15424,443,allow,1775,169,1606,7,121,3,4
19830,50357,443,38830,443,allow,1786,172,1614,7,121,3,4
19831,11601,53,11601,53,allow,233,91,142,2,31,1,1
19832,20336,53,20336,53,allow,233,91,142,2,31,1,1
19833,55003,53,14075,53,allow,192,98,94,2,31,1,1
19834,64816,53,1997,53,allow,164,84,80,2,31,1,1
19835,23980,53,23980,53,allow,220,100,120,2,31,1,1
19836,64853,53,19289,53,allow,198,101,97,2,31,1,1
19837,27005,27015,65390,27015,allow,891,126,765,2,31,1,1
19838,65495,53,9784,53,allow,202,103,99,2,31,1,1
19839,53144,53,53144,53,allow,231,90,141,2,31,1,1
19840,25434,53,25434,53,allow,231,90,141,2,31,1,1
19841,55224,53,59301,53,allow,180,92,88,2,31,1,1
19842,59919,53,59919,53,allow,231,90,141,2,31,1,1
19843,57386,53,9687,53,allow,186,95,91,2,31,1,1
19844,56532,53,51264,53,allow,186,95,91,2,31,1,1
19845,56543,53,0,0,allow,82,82,0,1,31,1,0
19846,57834,443,16694,443,allow,6214,1733,4481,13,121,6,7
19847,49466,53,56538,53,allow,202,103,99,2,31,1,1
19848,56912,53,37939,53,allow,753,96,657,2,31,1,1
19849,54711,443,40588,443,allow,3663,1136,2527,13,136,6,7
19850,52102,443,38740,443,allow,6903,3076,3827,20,136,10,10
19851,30960,45759,38428,45759,allow,330,330,0,6,3609,6,0
19852,48706,23393,0,0,deny,60,60,0,1,0,1,0
19853,32976,37965,0,0,deny,66,66,0,1,0,1,0
19854,59786,25174,0,0,deny,66,66,0,1,0,1,0
19855,62548,445,0,0,drop,70,70,0,1,0,1,0
19856,58511,50584,0,0,deny,62,62,0,1,0,1,0
19857,50984,445,0,0,drop,70,70,0,1,0,1,0
19858,50979,445,0,0,drop,70,70,0,1,0,1,0
19859,50973,445,0,0,drop,70,70,0,1,0,1,0
19860,50968,445,0,0,drop,70,70,0,1,0,1,0
19861,57479,56205,0,0,deny,66,66,0,1,0,1,0
19862,45205,25174,0,0,deny,146,146,0,1,0,1,0
19863,62729,445,0,0,drop,66,66,0,1,0,1,0
19864,62728,445,0,0,drop,66,66,0,1,0,1,0
19865,62726,445,0,0,drop,66,66,0,1,0,1,0
19866,59696,57470,0,0,deny,62,62,0,1,0,1,0
19867,19944,22114,0,0,deny,66,66,0,1,0,1,0
19868,33502,5529,0,0,deny,143,143,0,1,0,1,0
19869,62541,445,0,0,drop,70,70,0,1,0,1,0
19870,57323,53,27696,53,allow,194,102,92,2,30,1,1
19871,62540,445,0,0,drop,70,70,0,1,0,1,0
19872,57220,26467,0,0,deny,66,66,0,1,0,1,0
19873,50967,445,0,0,drop,70,70,0,1,0,1,0
19874,50965,445,0,0,drop,70,70,0,1,0,1,0
19875,50964,445,0,0,drop,70,70,0,1,0,1,0
19876,1024,37450,0,0,deny,62,62,0,1,0,1,0
19877,50957,445,0,0,drop,70,70,0,1,0,1,0
19878,2062,35440,0,0,deny,66,66,0,1,0,1,0
19879,47727,25174,0,0,deny,62,62,0,1,0,1,0
19880,62535,445,0,0,drop,70,70,0,1,0,1,0
19881,52925,64147,0,0,deny,62,62,0,1,0,1,0
19882,62533,445,0,0,drop,70,70,0,1,0,1,0
19883,22530,25174,0,0,deny,62,62,0,1,0,1,0
19884,40687,64147,0,0,deny,62,62,0,1,0,1,0
19885,45964,2225,0,0,deny,60,60,0,1,0,1,0
19886,26658,25174,0,0,deny,62,62,0,1,0,1,0
19887,61550,5529,0,0,deny,145,145,0,1,0,1,0
19888,55678,32468,0,0,deny,66,66,0,1,0,1,0
19889,6881,6881,0,0,deny,62,62,0,1,0,1,0
19890,55839,56535,0,0,deny,62,62,0,1,0,1,0
19891,62529,445,0,0,drop,70,70,0,1,0,1,0
19892,42231,57470,0,0,deny,78,78,0,1,0,1,0
19893,62527,445,0,0,drop,70,70,0,1,0,1,0
19894,50949,445,0,0,drop,70,70,0,1,0,1,0
19895,50947,445,0,0,drop,70,70,0,1,0,1,0
19896,50944,445,0,0,drop,70,70,0,1,0,1,0
19897,62717,445,0,0,drop,66,66,0,1,0,1,0
19898,36641,25174,0,0,deny,66,66,0,1,0,1,0
19899,44612,25174,0,0,deny,66,66,0,1,0,1,0
19900,64155,60043,0,0,deny,62,62,0,1,0,1,0
19901,14397,37965,0,0,deny,62,62,0,1,0,1,0
19902,62523,445,0,0,drop,70,70,0,1,0,1,0
19903,11136,15503,0,0,deny,62,62,0,1,0,1,0
19904,60403,22114,0,0,deny,66,66,0,1,0,1,0
19905,50940,445,0,0,drop,70,70,0,1,0,1,0
19906,50938,445,0,0,drop,70,70,0,1,0,1,0
19907,39416,443,35535,443,allow,32732,6260,26472,69,217,34,35
19908,52177,443,57914,443,allow,7659,3234,4425,35,288,17,18
19909,64585,53,5921,53,allow,198,102,96,2,30,1,1
19910,49448,53,48392,53,allow,210,102,108,2,30,1,1
19911,64585,53,62482,53,allow,821,102,719,2,30,1,1
19912,51644,53,17659,53,allow,195,78,117,2,30,1,1
19913,49241,53,22091,53,allow,785,110,675,2,30,1,1
19914,55180,53,29558,53,allow,209,110,99,2,30,1,1
19915,44847,20101,53137,20101,allow,150,150,0,1,1200,1,0
19916,65274,53,10401,53,allow,295,101,194,4,32,2,2
19917,55979,53,16779,53,allow,184,102,82,2,29,1,1
19918,57023,53,46258,53,allow,179,94,85,2,29,1,1
19919,57430,53,55125,53,allow,185,102,83,2,29,1,1
19920,56127,53,58620,53,allow,167,86,81,2,29,1,1
19921,55520,53,58665,53,allow,194,102,92,2,29,1,1
19922,49580,53,43364,53,allow,782,110,672,2,30,1,1
19923,49723,53,26637,53,allow,209,110,99,2,30,1,1
19924,49990,53,43468,53,allow,198,102,96,2,30,1,1
19925,50646,443,35425,443,allow,6789,1020,5769,20,101,11,9
19926,64344,53,51510,53,allow,286,102,184,4,45,2,2
19927,53762,53,52593,53,allow,168,78,90,2,30,1,1
19928,19924,53,19924,53,allow,235,90,145,2,32,1,1
19929,46834,53,46834,53,allow,235,90,145,2,32,1,1
19930,50679,80,31597,80,allow,62,62,0,1,4,1,0
19931,63984,53,63454,53,allow,264,110,154,2,30,1,1
19932,60270,443,24845,443,allow,6155,1709,4446,29,1710,15,14
19933,50651,80,37006,80,allow,1555,1103,452,9,21,5,4
19934,63999,10552,38263,10552,allow,70,70,0,1,4,1,0
19935,63995,15396,40455,15396,allow,70,70,0,1,4,1,0
19936,53269,443,51596,443,allow,5766,1925,3841,22,17,14,8
19937,59473,80,31869,80,allow,1052,612,440,10,15,5,5
19938,50623,443,64489,443,allow,1350,773,577,15,107,8,7
19939,64344,53,14813,53,allow,568,192,376,6,71,3,3
19940,53864,24874,8342,24874,allow,320,140,180,6,6,3,3
19941,54969,53,12796,53,allow,199,102,97,2,29,1,1
19942,64000,14441,58412,14441,allow,70,70,0,1,4,1,0
19943,55816,53,14968,53,allow,214,110,104,2,29,1,1
19944,49599,53,2987,53,allow,732,86,646,2,29,1,1
19945,49291,53,35462,53,allow,212,102,110,2,29,1,1
19946,57382,53,23125,53,allow,184,94,90,2,29,1,1
19947,57053,53,14057,53,allow,173,94,79,2,29,1,1
19948,55889,53,50897,53,allow,199,102,97,2,29,1,1
19949,55690,53,21416,53,allow,183,94,89,2,29,1,1
19950,49723,53,9926,53,allow,209,110,99,2,30,1,1
19951,46948,443,43691,443,allow,6374,2446,3928,26,217,13,13
19952,43733,443,15802,443,allow,27525,2389,25136,47,27,22,25
19953,39050,443,47247,443,allow,26692,5527,21165,54,31,28,26
19954,50295,443,29927,443,allow,18401,4536,13865,48,27,24,24
19955,65477,53,50858,53,allow,209,110,99,2,30,1,1
19956,55628,53,3702,53,allow,198,102,96,2,30,1,1
19957,56313,53,27206,53,allow,198,102,96,2,30,1,1
19958,49446,53,1735,53,allow,403,142,261,2,30,1,1
19959,56247,53,6224,53,allow,215,102,113,2,30,1,1
19960,64231,53,19664,53,allow,196,94,102,2,30,1,1
19961,63920,443,64654,443,allow,3192,633,2559,17,135,7,10
19962,43154,53,41451,53,allow,168,78,90,2,30,1,1
19963,55141,53,55990,53,allow,184,94,90,2,30,1,1
19964,64020,53,34722,53,allow,196,102,94,2,30,1,1
19965,56756,53,38135,53,allow,167,86,81,2,30,1,1
19966,39827,443,61705,443,allow,6128,3746,2382,48,46,25,23
19967,52057,34664,13510,34664,allow,70,70,0,2,8,2,0
19968,56632,443,17597,443,allow,13148,2310,10838,29,80,16,13
19969,64307,53,12624,53,allow,463,90,373,4,34,2,2
19970,57139,53,12753,53,allow,816,102,714,2,30,1,1
19971,64853,53,20032,53,allow,199,102,97,2,30,1,1
19972,38643,443,11641,443,allow,1468,893,575,15,62,8,7
19973,65477,53,46159,53,allow,209,110,99,2,30,1,1
19974,44791,443,29863,443,allow,3181,1647,1534,18,31,10,8
19975,56436,80,34544,80,allow,17067,1439,15628,23,25,8,15
19976,55855,53,27713,53,allow,182,102,80,2,30,1,1
19977,57603,443,1218,443,allow,2614,1689,925,18,23,10,8
19978,56756,53,60834,53,allow,167,86,81,2,30,1,1
19979,58088,8765,45865,8765,allow,336,150,186,6,89,3,3
19980,41269,443,34077,443,allow,234,234,0,4,12,4,0
19981,57314,53,53459,53,allow,195,102,93,2,30,1,1
19982,56973,53,50381,53,allow,193,102,91,2,30,1,1
19983,35333,80,8364,80,allow,1432,663,769,10,19,6,4
19984,55180,53,4513,53,allow,209,110,99,2,30,1,1
19985,38432,53,33848,53,allow,336,231,105,3,30,2,1
19986,65501,53,61730,53,allow,774,102,672,2,30,1,1
19987,37645,443,51983,443,allow,23266,18300,4966,56,27,33,23
19988,65228,53,28840,53,allow,200,102,98,2,30,1,1
19989,49713,53,34138,53,allow,198,94,104,2,30,1,1
19990,49693,53,65326,53,allow,209,110,99,2,30,1,1
19991,56117,53,20260,53,allow,178,94,84,2,30,1,1
19992,53739,53,43732,53,allow,168,78,90,2,30,1,1
19993,54372,80,17871,80,allow,3517,1612,1905,17,186,10,7
19994,65204,53,43316,53,allow,183,94,89,2,30,1,1
19995,49213,53,0,0,allow,333,102,231,2,30,1,1
19996,56226,53,33247,53,allow,200,102,98,2,30,1,1
19997,64748,53,54501,53,allow,183,94,89,2,30,1,1
19998,50933,443,10395,443,allow,10546,2453,8093,28,15,16,12
19999,38621,443,27614,443,allow,1593,946,647,15,64,8,7
20000,50293,443,61876,443,allow,12677,3097,9580,37,26,19,18
20001,60948,53,22265,53,allow,168,78,90,2,30,1,1
20002,45932,53,57917,53,allow,199,94,105,2,30,1,1
20003,56313,53,23049,53,allow,198,102,96,2,30,1,1
20004,59124,443,18887,443,allow,9612,1720,7892,32,130,15,17
20005,15503,8624,29745,8624,allow,491,150,341,2,1200,1,1
20006,56062,53,55161,53,allow,537,98,439,4,40,2,2
20007,50292,443,41099,443,allow,183024,16754,166270,247,28,114,133
20008,39053,443,36119,443,allow,6699,4494,2205,27,29,14,13
20009,56756,53,14084,53,allow,167,86,81,2,30,1,1
20010,50010,53,37943,53,allow,205,86,119,2,30,1,1
20011,36936,53,30039,53,allow,78,78,0,1,30,1,0
20012,60211,53,51487,53,allow,205,86,119,2,30,1,1
20013,65316,53,39745,53,allow,225,110,115,2,30,1,1
20014,54973,53,20292,53,allow,181,94,87,2,30,1,1
20015,64748,53,6781,53,allow,183,94,89,2,30,1,1
20016,65228,53,28438,53,allow,200,102,98,2,30,1,1
20017,49765,53,11309,53,allow,194,102,92,2,30,1,1
20018,56266,53,11208,53,allow,193,102,91,2,30,1,1
20019,56468,53,49469,53,allow,209,110,99,2,30,1,1
20020,55686,44049,11130,44049,allow,504,318,186,8,15,5,3
20021,55525,443,64786,443,allow,5200,2825,2375,18,155,9,9
20022,64004,48339,32132,48339,allow,70,70,0,1,4,1,0
20023,63994,47013,15711,47013,allow,70,70,0,1,4,1,0
20024,64493,53,56892,53,allow,280,97,183,4,58,2,2
20025,49521,443,49521,443,allow,25081,3001,22080,55,75,29,26
20026,49754,443,12620,443,allow,17243,5482,11761,82,316,41,41
20027,49909,53,17902,53,allow,1410,95,1315,4,57,2,2
20028,56163,53,14069,53,allow,265,85,180,4,42,2,2
20029,65503,443,44158,443,allow,429890,12640,417250,442,16,155,287
20030,37614,80,61486,80,allow,1399,406,993,15,43,5,10
20031,64001,13051,4222,13051,allow,70,70,0,1,4,1,0
20032,57440,443,35509,443,allow,8200,2465,5735,30,18,14,16
20033,65274,53,29709,53,allow,295,101,194,4,31,2,2
20034,38644,443,44476,443,allow,8165,1664,6501,30,62,14,16
20035,53832,56005,63005,56005,allow,70,70,0,1,4,1,0
20036,53286,80,26328,80,allow,3096,1001,2095,12,150,7,5
20037,62593,7010,62593,7010,allow,4231,2106,2125,15,15,8,7
20038,60022,80,60022,80,allow,2959,1505,1454,10,15,6,4
20039,49452,443,53461,443,allow,13184,2507,10677,27,64,14,13
20040,52347,443,62894,443,allow,7847,2985,4862,30,337,16,14
20041,27076,80,27076,80,allow,6337,947,5390,15,17,8,7
20042,57259,53,43490,53,allow,167,86,81,2,29,1,1
20043,63989,20939,6044,20939,allow,504,382,122,8,15,6,2
20044,5588,5588,0,0,allow,3354,1792,1562,46,193,23,23
20045,53832,53,28034,53,allow,211,78,133,2,29,1,1
20046,49476,53,24497,53,allow,402,118,284,2,29,1,1
20047,65010,53,7971,53,allow,758,102,656,2,29,1,1
20048,49574,53,41987,53,allow,193,102,91,2,29,1,1
20049,54969,53,41747,53,allow,199,102,97,2,29,1,1
20050,57430,53,65274,53,allow,177,94,83,2,30,1,1
20051,43725,443,24670,443,allow,82838,3838,79000,104,31,42,62
20052,57139,53,30822,53,allow,193,102,91,2,30,1,1
20053,65291,53,57485,53,allow,195,102,93,2,29,1,1
20054,57314,53,31776,53,allow,195,102,93,2,30,1,1
20055,55463,53,39462,53,allow,816,102,714,2,29,1,1
20056,32939,443,44702,443,allow,3312,1936,1376,19,29,10,9
20057,57259,53,28924,53,allow,167,86,81,2,29,1,1
20058,65142,53,52775,53,allow,167,86,81,2,29,1,1
20059,57430,53,14392,53,allow,200,102,98,2,29,1,1
20060,64554,53,13352,53,allow,199,102,97,2,29,1,1
20061,55367,53,40346,53,allow,195,102,93,2,30,1,1
20062,64097,53,23639,53,allow,308,91,217,4,56,2,2
20063,55889,53,44791,53,allow,199,102,97,2,30,1,1
20064,56973,53,45728,53,allow,193,102,91,2,30,1,1
20065,64658,53,30936,53,allow,785,110,675,2,30,1,1
20066,64661,53,48759,53,allow,216,102,114,2,30,1,1
20067,64816,53,50725,53,allow,166,86,80,2,30,1,1
20068,57023,53,56230,53,allow,179,94,85,2,30,1,1
20069,55220,53,13554,53,allow,193,102,91,2,30,1,1
20070,57314,53,2474,53,allow,195,102,93,2,31,1,1
20071,54973,53,16224,53,allow,181,94,87,2,31,1,1
20072,53092,443,35345,443,allow,7676,1577,6099,28,395,9,19
20073,57835,443,21443,443,allow,9125,3736,5389,19,120,10,9
20074,65132,53,27212,53,allow,167,86,81,2,30,1,1
20075,64205,53,1901,53,allow,178,94,84,2,30,1,1
20076,49324,53,24551,53,allow,258,94,164,2,30,1,1
20077,56973,53,9162,53,allow,193,102,91,2,30,1,1
20078,65495,53,16317,53,allow,209,110,99,2,30,1,1
20079,53185,443,52524,443,allow,4442408,142153,4300255,4731,235,1574,3157
20080,55056,53,39813,53,allow,209,110,99,2,30,1,1
20081,65204,53,23706,53,allow,183,94,89,2,30,1,1
20082,58753,443,18417,443,allow,10379,2361,8018,27,20,16,11
20083,51963,443,38927,443,allow,14602,6734,7868,46,56,26,20
20084,38660,443,61188,443,allow,7031,1824,5207,23,60,12,11
20085,43361,443,8514,443,allow,13275,10536,2739,50,101,27,23
20086,65504,443,39358,443,allow,92275,4799,87476,107,16,43,64
20087,43732,443,8555,443,allow,19123,2319,16804,39,28,21,18
20088,39058,443,63912,443,allow,8028,5439,2589,32,27,16,16
20089,39051,443,15445,443,allow,7082,4527,2555,31,31,16,15
20090,64493,53,34209,53,allow,280,97,183,4,59,2,2
20091,49253,53,32297,53,allow,593,188,405,6,59,3,3
20092,55628,53,5942,53,allow,821,102,719,2,30,1,1
20093,49693,53,49502,53,allow,209,110,99,2,30,1,1
20094,55268,53,2485,53,allow,193,102,91,2,30,1,1
20095,55003,53,31448,53,allow,196,102,94,2,30,1,1
20096,54371,80,58322,80,allow,3623,1718,1905,17,186,10,7
20097,54731,443,46644,443,allow,9498,2578,6920,28,19,16,12
20098,47531,8080,0,0,allow,184,78,106,3,10,2,1
20099,50294,443,54513,443,allow,9999,2316,7683,30,26,15,15
20100,48436,443,64004,443,allow,9744,1958,7786,25,18,13,12
20101,43731,443,32992,443,allow,10930,1759,9171,27,28,13,14
20102,39062,443,32900,443,allow,11360,8326,3034,36,22,19,17
20103,32934,443,9755,443,allow,7623,3362,4261,26,31,14,12
20104,64724,53,45753,53,allow,336,110,226,2,30,1,1
20105,49253,53,44015,53,allow,199,102,97,2,30,1,1
20106,55855,53,25503,53,allow,182,102,80,2,30,1,1
20107,57351,53,34146,53,allow,184,94,90,2,30,1,1
20108,64816,53,25047,53,allow,166,86,80,2,30,1,1
20109,56127,53,41688,53,allow,167,86,81,2,30,1,1
20110,64554,53,27674,53,allow,199,102,97,2,30,1,1
20111,54973,53,14051,53,allow,181,94,87,2,30,1,1
20112,55046,53,35740,53,allow,198,102,96,2,30,1,1
20113,52189,443,16564,443,allow,36007,4328,31679,65,217,33,32
20114,38642,443,33643,443,allow,1468,893,575,15,62,8,7
20115,63988,43365,3645,43365,allow,624,382,242,10,15,6,4
20116,58905,443,1469,443,allow,6370,706,5664,19,16,7,12
20117,57333,53,60768,53,allow,167,86,81,2,30,1,1
20118,64569,53,4728,53,allow,413,170,243,6,30,3,3
20119,49253,53,58276,53,allow,199,102,97,2,30,1,1
20120,49990,53,60528,53,allow,198,102,96,2,30,1,1
20121,56819,53,1488,53,allow,209,110,99,2,30,1,1
20122,56468,53,56108,53,allow,209,110,99,2,30,1,1
20123,55245,53,36514,53,allow,209,110,99,2,30,1,1
20124,55367,53,11900,53,allow,195,102,93,2,30,1,1
20125,55688,53,25850,53,allow,184,94,90,2,31,1,1
20126,55816,53,3790,53,allow,214,110,104,2,31,1,1
20127,65132,53,40938,53,allow,167,86,81,2,31,1,1
20128,55577,53,15503,53,allow,199,102,97,2,31,1,1
20129,65020,53,14135,53,allow,184,94,90,2,31,1,1
20130,50584,51414,36185,51414,allow,475,150,325,2,1200,1,1
20131,55688,53,51379,53,allow,184,94,90,2,30,1,1
20132,64810,53,57933,53,allow,199,102,97,2,30,1,1
20133,55056,53,20306,53,allow,209,110,99,2,30,1,1
20134,49206,53,3418,53,allow,448,184,264,6,30,3,3
20135,49656,53,55066,53,allow,193,102,91,2,30,1,1
20136,57244,53,57244,53,allow,240,98,142,2,30,1,1
20137,30584,53,30584,53,allow,241,98,143,2,30,1,1
20138,60346,53,60346,53,allow,241,98,143,2,30,1,1
20139,57323,53,38814,53,allow,194,102,92,2,31,1,1
20140,41931,443,53560,443,allow,8579,2273,6306,17,136,8,9
20141,30188,33285,47903,33285,allow,502,150,352,2,1200,1,1
20142,49628,53,6846,53,allow,168,86,82,2,31,1,1
20143,55415,53,31153,53,allow,183,94,89,2,31,1,1
20144,65241,53,22089,53,allow,200,102,98,2,31,1,1
20145,55220,53,48038,53,allow,193,102,91,2,31,1,1
20146,55003,53,40085,53,allow,196,102,94,2,30,1,1
20147,65229,53,50750,53,allow,193,102,91,2,31,1,1
20148,49656,53,53430,53,allow,193,102,91,2,30,1,1
20149,55415,53,7035,53,allow,183,94,89,2,30,1,1
20150,49374,53,42809,53,allow,197,94,103,2,30,1,1
20151,57386,53,13419,53,allow,193,102,91,2,31,1,1
20152,49765,53,24395,53,allow,194,102,92,2,31,1,1
20153,56711,53,61949,53,allow,209,110,99,2,31,1,1
20154,55123,53,57840,53,allow,198,102,96,2,31,1,1
20155,65495,53,62386,53,allow,209,110,99,2,31,1,1
20156,64205,53,47320,53,allow,178,94,84,2,31,1,1
20157,27005,27016,42013,27016,allow,893,126,767,2,31,1,1
20158,57470,20015,34460,20015,allow,150,150,0,1,1199,1,0
20159,50358,443,36799,443,allow,1786,172,1614,7,121,3,4
20160,56637,53,33997,53,allow,199,102,97,2,31,1,1
20161,55159,53,6565,53,allow,200,102,98,2,30,1,1
20162,56821,53,60054,53,allow,199,102,97,2,30,1,1
20163,65505,53,15527,53,allow,166,86,80,2,31,1,1
20164,63932,53,16188,53,allow,179,94,85,2,31,1,1
20165,64520,53,30136,53,allow,198,102,96,2,31,1,1
20166,63949,53,18113,53,allow,195,102,93,2,31,1,1
20167,65291,53,60855,53,allow,335,97,238,4,31,2,2
20168,2371,53,52292,53,allow,164,86,78,2,31,1,1
20169,61419,443,21446,443,allow,1664127,116770,1547357,2028,401,736,1292
20170,49247,53,4260,53,allow,194,102,92,2,31,1,1
20171,65274,53,37017,53,allow,295,101,194,4,31,2,2
20172,37965,1052,51562,1052,allow,132,132,0,3,1199,3,0
20173,44314,443,36123,443,allow,1268867,60489,1208378,1558,141,557,1001
20174,51221,51413,55208,51413,allow,460,150,310,2,1201,1,1
20175,64053,53,8111,53,allow,276,94,182,4,56,2,2
20176,56665,80,42041,80,allow,234,234,0,4,12,4,0
20177,52040,2524,48292,2524,allow,70,70,0,1,5,1,0
20178,37592,443,51917,443,allow,9000,2566,6434,29,47,17,12
20179,52040,80,45485,80,allow,4185,3462,723,14,16,7,7
20180,53152,27367,49089,27367,allow,758,320,438,11,20,6,5
20181,44984,443,57604,443,allow,4499,2807,1692,24,95,13,11
20182,51957,80,56020,80,allow,486,300,186,9,27,6,3
20183,58858,443,41294,443,allow,318,192,126,6,26,4,2
20184,60171,443,39238,443,allow,1059,556,503,12,25,6,6
20185,51951,80,50498,80,allow,366,240,126,7,28,5,2
20186,37582,443,5548,443,allow,15901,7016,8885,37,49,22,15
20187,51933,80,40922,80,allow,3676,2136,1540,15,40,10,5
20188,56561,53,57177,53,allow,183,94,89,2,30,1,1
20189,65040,53,64754,53,allow,749,94,655,2,30,1,1
20190,65241,53,55089,53,allow,200,102,98,2,31,1,1
20191,63949,53,30252,53,allow,195,102,93,2,31,1,1
20192,53722,443,52101,443,allow,327838,13327,314511,355,127,121,234
20193,55836,443,59611,443,allow,7519,2177,5342,16,136,8,8
20194,10151,49001,62928,49001,allow,481,150,331,2,1201,1,1
20195,47096,443,23148,443,allow,6211,1753,4458,43,215,15,28
20196,64998,27037,52668,27037,allow,3573,2238,1335,16,34,8,8
20197,37594,443,15585,443,allow,60339,4689,55650,79,47,35,44
20198,51952,443,19528,443,allow,11367,3820,7547,28,28,16,12
20199,52183,443,15080,443,allow,69339,4124,65215,96,22,45,51
20200,56226,53,49033,53,allow,200,102,98,2,30,1,1
20201,55603,443,55603,443,allow,4684,1777,2907,19,12,11,8
20202,1066,16464,0,0,deny,60,60,0,1,0,1,0
20203,44611,23,0,0,deny,60,60,0,1,0,1,0
20204,53640,25174,0,0,deny,66,66,0,1,0,1,0
20205,40481,22114,0,0,deny,66,66,0,1,0,1,0
20206,22924,25174,0,0,deny,62,62,0,1,0,1,0
20207,62699,445,0,0,drop,66,66,0,1,0,1,0
20208,62698,445,0,0,drop,66,66,0,1,0,1,0
20209,52340,64147,0,0,deny,66,66,0,1,0,1,0
20210,34932,38608,0,0,deny,62,62,0,1,0,1,0
20211,51413,10387,0,0,deny,139,139,0,1,0,1,0
20212,53554,1433,0,0,deny,60,60,0,1,0,1,0
20213,62510,445,0,0,drop,70,70,0,1,0,1,0
20214,16454,25174,0,0,deny,66,66,0,1,0,1,0
20215,53160,25174,0,0,deny,146,146,0,1,0,1,0
20216,50566,22114,0,0,deny,62,62,0,1,0,1,0
20217,50928,445,0,0,drop,70,70,0,1,0,1,0
20218,50927,445,0,0,drop,70,70,0,1,0,1,0
20219,50925,445,0,0,drop,70,70,0,1,0,1,0
20220,50919,445,0,0,drop,70,70,0,1,0,1,0
20221,15345,36829,0,0,deny,62,62,0,1,0,1,0
20222,62348,57470,0,0,deny,109,109,0,1,0,1,0
20223,62507,445,0,0,drop,70,70,0,1,0,1,0
20224,62694,445,0,0,drop,66,66,0,1,0,1,0
20225,54601,26467,0,0,deny,62,62,0,1,0,1,0
20226,32736,22114,0,0,deny,66,66,0,1,0,1,0
20227,25150,25174,0,0,deny,62,62,0,1,0,1,0
20228,50046,22114,0,0,deny,66,66,0,1,0,1,0
20229,3937,36829,0,0,deny,62,62,0,1,0,1,0
20230,54530,46776,0,0,deny,66,66,0,1,0,1,0
20231,62690,445,0,0,drop,66,66,0,1,0,1,0
20232,62684,445,0,0,drop,66,66,0,1,0,1,0
20233,62687,445,0,0,drop,66,66,0,1,0,1,0
20234,62681,445,0,0,drop,66,66,0,1,0,1,0
20235,62683,445,0,0,drop,66,66,0,1,0,1,0
20236,62682,445,0,0,drop,66,66,0,1,0,1,0
20237,62688,445,0,0,drop,66,66,0,1,0,1,0
20238,65404,36237,0,0,deny,62,62,0,1,0,1,0
20239,50916,445,0,0,drop,70,70,0,1,0,1,0
20240,51706,25174,0,0,deny,66,66,0,1,0,1,0
20241,62502,445,0,0,drop,70,70,0,1,0,1,0
20242,50911,445,0,0,drop,70,70,0,1,0,1,0
20243,50910,445,0,0,drop,70,70,0,1,0,1,0
20244,49730,443,47083,443,allow,4484,1063,3421,15,10,7,8
20245,55012,25174,0,0,deny,66,66,0,1,0,1,0
20246,50907,445,0,0,drop,70,70,0,1,0,1,0
20247,1027,25174,0,0,deny,62,62,0,1,0,1,0
20248,1027,25174,0,0,deny,146,146,0,1,0,1,0
20249,62501,445,0,0,drop,70,70,0,1,0,1,0
20250,63554,44847,0,0,deny,62,62,0,1,0,1,0
20251,53323,35253,0,0,deny,62,62,0,1,0,1,0
20252,24378,5169,24378,5169,deny,507,507,0,1,0,1,0
20253,62489,23117,0,0,deny,66,66,0,1,0,1,0
20254,62499,445,0,0,drop,70,70,0,1,0,1,0
20255,51479,25174,0,0,deny,66,66,0,1,0,1,0
20256,2849,30188,0,0,deny,66,66,0,1,0,1,0
20257,55570,44847,0,0,deny,66,66,0,1,0,1,0
20258,25878,25174,0,0,deny,66,66,0,1,0,1,0
20259,27197,22114,0,0,deny,146,146,0,1,0,1,0
20260,15227,26467,0,0,deny,66,66,0,1,0,1,0
20261,33941,37807,0,0,deny,62,62,0,1,0,1,0
20262,33941,37807,0,0,deny,146,146,0,1,0,1,0
20263,50905,445,0,0,drop,70,70,0,1,0,1,0
20264,50903,445,0,0,drop,70,70,0,1,0,1,0
20265,50902,445,0,0,drop,70,70,0,1,0,1,0
20266,62671,445,0,0,drop,66,66,0,1,0,1,0
20267,6882,51505,0,0,deny,66,66,0,1,0,1,0
20268,50898,445,0,0,drop,70,70,0,1,0,1,0
20269,16358,50584,0,0,deny,146,146,0,1,0,1,0
20270,62492,445,0,0,drop,70,70,0,1,0,1,0
20271,62670,445,0,0,drop,66,66,0,1,0,1,0
20272,38093,11392,0,0,deny,62,62,0,1,0,1,0
20273,54121,25174,0,0,deny,66,66,0,1,0,1,0
20274,62668,445,0,0,drop,66,66,0,1,0,1,0
20275,62666,445,0,0,drop,66,66,0,1,0,1,0
20276,62490,445,0,0,drop,70,70,0,1,0,1,0
20277,56676,37965,0,0,deny,66,66,0,1,0,1,0
20278,53140,51221,0,0,deny,74,74,0,1,0,1,0
20279,62665,445,0,0,drop,66,66,0,1,0,1,0
20280,58627,25174,0,0,deny,62,62,0,1,0,1,0
20281,62489,445,0,0,drop,70,70,0,1,0,1,0
20282,30149,23,0,0,deny,60,60,0,1,0,1,0
20283,11136,15503,0,0,deny,62,62,0,1,0,1,0
20284,62488,445,0,0,drop,70,70,0,1,0,1,0
20285,62487,445,0,0,drop,70,70,0,1,0,1,0
20286,60558,51221,0,0,deny,62,62,0,1,0,1,0
20287,62485,445,0,0,drop,70,70,0,1,0,1,0
20288,62483,445,0,0,drop,70,70,0,1,0,1,0
20289,22168,25174,0,0,deny,146,146,0,1,0,1,0
20290,40312,55442,0,0,deny,62,62,0,1,0,1,0
20291,50893,445,0,0,drop,70,70,0,1,0,1,0
20292,44388,63874,0,0,deny,62,62,0,1,0,1,0
20293,41197,30188,0,0,deny,62,62,0,1,0,1,0
20294,53841,37965,0,0,deny,66,66,0,1,0,1,0
20295,50888,445,0,0,drop,70,70,0,1,0,1,0
20296,50880,445,0,0,drop,70,70,0,1,0,1,0
20297,2476,6881,0,0,deny,62,62,0,1,0,1,0
20298,28636,25174,0,0,deny,146,146,0,1,0,1,0
20299,0,0,0,0,deny,98,98,0,1,0,1,0
20300,0,0,0,0,deny,98,98,0,1,0,1,0
20301,0,0,0,0,deny,98,98,0,1,0,1,0
20302,0,0,0,0,deny,98,98,0,1,0,1,0
20303,0,0,0,0,deny,98,98,0,1,0,1,0
20304,0,0,0,0,deny,98,98,0,1,0,1,0
20305,0,0,0,0,deny,98,98,0,1,0,1,0
20306,0,0,0,0,allow,244,244,0,2,0,2,0
20307,0,0,0,0,deny,98,98,0,1,0,1,0
20308,1025,50584,0,0,deny,146,146,0,1,0,1,0
20309,56127,37965,0,0,deny,66,66,0,1,0,1,0
20310,52038,50584,0,0,deny,66,66,0,1,0,1,0
20311,23719,22114,0,0,deny,146,146,0,1,0,1,0
20312,14692,25174,0,0,deny,62,62,0,1,0,1,0
20313,62469,445,0,0,drop,70,70,0,1,0,1,0
20314,62468,445,0,0,drop,70,70,0,1,0,1,0
20315,62465,445,0,0,drop,70,70,0,1,0,1,0
20316,24144,57470,0,0,deny,62,62,0,1,0,1,0
20317,62458,445,0,0,drop,70,70,0,1,0,1,0
20318,62459,445,0,0,drop,70,70,0,1,0,1,0
20319,62653,445,0,0,drop,66,66,0,1,0,1,0
20320,60058,25174,0,0,deny,66,66,0,1,0,1,0
20321,7372,25773,0,0,reset-both,139,139,0,1,0,1,0
20322,23131,25174,0,0,deny,62,62,0,1,0,1,0
20323,1943,48817,0,0,deny,66,66,0,1,0,1,0
20324,62646,445,0,0,drop,66,66,0,1,0,1,0
20325,50870,445,0,0,drop,70,70,0,1,0,1,0
20326,50734,37965,0,0,deny,62,62,0,1,0,1,0
20327,34073,37965,0,0,deny,62,62,0,1,0,1,0
20328,50327,1433,0,0,deny,60,60,0,1,0,1,0
20329,42986,25174,0,0,deny,66,66,0,1,0,1,0
20330,62447,445,0,0,drop,70,70,0,1,0,1,0
20331,52988,53567,0,0,deny,62,62,0,1,0,1,0
20332,60097,22114,0,0,deny,66,66,0,1,0,1,0
20333,62643,445,0,0,drop,66,66,0,1,0,1,0
20334,45118,39004,0,0,deny,74,74,0,1,0,1,0
20335,3399,25174,0,0,deny,66,66,0,1,0,1,0
20336,61190,21247,0,0,deny,62,62,0,1,0,1,0
20337,36663,22114,0,0,deny,62,62,0,1,0,1,0
20338,42285,57470,0,0,deny,62,62,0,1,0,1,0
20339,55232,25174,0,0,deny,146,146,0,1,0,1,0
20340,55629,42873,0,0,deny,74,74,0,1,0,1,0
20341,26192,23,0,0,deny,60,60,0,1,0,1,0
20342,62635,445,0,0,drop,66,66,0,1,0,1,0
20343,36804,25174,0,0,deny,66,66,0,1,0,1,0
20344,54299,28081,0,0,deny,143,143,0,1,0,1,0
20345,15677,64147,0,0,deny,145,145,0,1,0,1,0
20346,52238,26467,0,0,deny,62,62,0,1,0,1,0
20347,64036,23718,0,0,deny,66,66,0,1,0,1,0
20348,56289,25174,0,0,deny,66,66,0,1,0,1,0
20349,55508,64147,0,0,deny,62,62,0,1,0,1,0
20350,62630,445,0,0,drop,66,66,0,1,0,1,0
20351,62443,445,0,0,drop,70,70,0,1,0,1,0
20352,63595,51050,0,0,deny,66,66,0,1,0,1,0
20353,22408,22114,0,0,deny,66,66,0,1,0,1,0
20354,55167,48817,0,0,deny,66,66,0,1,0,1,0
20355,25207,48817,0,0,deny,62,62,0,1,0,1,0
20356,35894,17,0,0,deny,60,60,0,1,0,1,0
20357,3615,53,3615,53,allow,231,90,141,2,30,1,1
20358,54221,443,30270,443,allow,8327,4890,3437,23,316,12,11
20359,55691,16410,1413,16410,allow,70,70,0,1,5,1,0
20360,16012,53,16012,53,allow,235,90,145,2,32,1,1
20361,62591,7000,62591,7000,allow,3530,2027,1503,16,15,9,7
20362,51934,443,29764,443,allow,550,310,240,10,35,6,4
20363,62590,7000,62590,7000,allow,2163,676,1487,14,15,7,7
20364,55687,47613,14281,47613,allow,164,70,94,2,5,1,1
20365,51390,53,51390,53,allow,398,255,143,3,31,2,1
20366,37591,443,4877,443,allow,62657,4444,58213,83,46,37,46
20367,5588,5588,0,0,allow,3562,1936,1626,48,193,24,24
20368,65241,53,18449,53,allow,200,102,98,2,31,1,1
20369,54968,53,43880,53,allow,198,101,97,2,30,1,1
20370,51936,443,23888,443,allow,4940,3363,1577,27,34,16,11
20371,5588,5588,0,0,allow,3354,1792,1562,46,192,23,23
20372,5588,5588,0,0,allow,3354,1792,1562,46,194,23,23
20373,63949,53,59282,53,allow,190,97,93,2,31,1,1
20374,63932,53,54885,53,allow,174,89,85,2,31,1,1
20375,55152,53,27991,53,allow,176,90,86,2,30,1,1
20376,65472,53,63288,53,allow,202,103,99,2,31,1,1
20377,63968,53,37221,53,allow,200,102,98,2,30,1,1
20378,65133,53,56873,53,allow,196,100,96,2,31,1,1
20379,64205,53,12061,53,allow,172,88,84,2,30,1,1
20380,65229,53,55495,53,allow,186,95,91,2,30,1,1
20381,64053,53,64602,53,allow,276,94,182,4,55,2,2
20382,51935,443,8500,443,allow,2780,1797,983,21,35,11,10
20383,48326,53,48326,53,allow,398,255,143,3,33,2,1
20384,49526,53,35749,53,allow,272,97,175,4,58,2,2
20385,35195,443,7133,443,allow,153,93,60,2,5,1,1
20386,64959,53,64959,53,allow,398,255,143,3,33,2,1
20387,52039,38541,32643,38541,allow,66,66,0,1,5,1,0
20388,37851,443,37851,443,allow,4691,1784,2907,19,27,11,8
20389,65363,53,30865,53,allow,178,91,87,2,31,1,1
20390,49532,53,4849,53,allow,190,97,93,2,31,1,1
20391,49521,53,26950,53,allow,182,93,89,2,30,1,1
20392,51591,80,40282,80,allow,12683,8567,4116,53,271,33,20
20393,61440,443,7179,443,allow,7896,1207,6689,20,26,10,10
20394,52054,50513,38403,50513,allow,70,70,0,2,9,2,0
20395,55689,37558,18058,37558,allow,70,70,0,1,5,1,0
20396,56163,53,47516,53,allow,265,85,180,4,41,2,2
20397,57035,53,11215,53,allow,1414,95,1319,4,41,2,2
20398,46744,53,46744,53,allow,404,259,145,3,32,2,1
20399,7198,53,7198,53,allow,398,255,143,3,32,2,1
20400,19789,53,19789,53,allow,371,237,134,3,33,2,1
20401,24692,53,24692,53,allow,235,90,145,2,32,1,1
20402,56740,53,17032,53,allow,716,95,621,2,30,1,1
20403,47357,443,6177,443,allow,153,93,60,2,5,1,1
20404,52038,14487,65073,14487,allow,66,66,0,1,5,1,0
20405,55159,53,29512,53,allow,200,102,98,2,30,1,1
20406,33424,53,33424,53,allow,233,91,142,2,30,1,1
20407,49533,53,65286,53,allow,771,101,670,2,30,1,1
20408,50534,53,50534,53,allow,216,88,128,2,30,1,1
20409,18238,53,18238,53,allow,240,96,144,2,30,1,1
20410,14885,53,14885,53,allow,220,100,120,2,30,1,1
20411,50263,53,61533,53,allow,753,96,657,2,30,1,1
20412,64520,53,59126,53,allow,196,100,96,2,30,1,1
20413,65020,53,8823,53,allow,184,94,90,2,31,1,1
20414,55384,53,37937,53,allow,188,96,92,2,31,1,1
20415,49862,53,25145,53,allow,176,90,86,2,30,1,1
20416,56625,53,59531,53,allow,186,95,91,2,31,1,1
20417,57212,53,19775,53,allow,780,104,676,2,31,1,1
20418,64567,53,31447,53,allow,186,95,91,2,31,1,1
20419,49556,443,19377,443,allow,198375,6279,192096,205,153,69,136
20420,64780,53,55734,53,allow,186,95,91,2,31,1,1
20421,16693,53,16693,53,allow,217,87,130,2,31,1,1
20422,64833,53,14951,53,allow,166,85,81,2,31,1,1
20423,35229,443,14508,443,allow,9488,4114,5374,27,363,14,13
20424,65376,53,45808,53,allow,184,94,90,2,31,1,1
20425,57792,53,57792,53,allow,215,87,128,2,31,1,1
20426,63992,53,33581,53,allow,198,101,97,2,31,1,1
20427,49290,53,14935,53,allow,184,94,90,2,31,1,1
20428,57397,53,42252,53,allow,735,88,647,2,31,1,1
20429,55547,53,9428,53,allow,774,101,673,2,31,1,1
20430,56032,443,63053,443,allow,1775,169,1606,7,120,3,4
20431,50355,443,1395,443,allow,1786,172,1614,7,120,3,4
20432,63991,53,7704,53,allow,186,95,91,2,31,1,1
20433,49752,50584,0,0,deny,62,62,0,1,0,1,0
20434,62432,445,0,0,drop,70,70,0,1,0,1,0
20435,62431,445,0,0,drop,70,70,0,1,0,1,0
20436,62433,445,0,0,drop,70,70,0,1,0,1,0
20437,62429,445,0,0,drop,70,70,0,1,0,1,0
20438,62427,445,0,0,drop,70,70,0,1,0,1,0
20439,13178,37965,0,0,deny,62,62,0,1,0,1,0
20440,80,65095,0,0,deny,66,66,0,1,0,1,0
20441,6881,6881,0,0,deny,146,146,0,1,0,1,0
20442,56381,25174,0,0,deny,62,62,0,1,0,1,0
20443,50862,445,0,0,drop,70,70,0,1,0,1,0
20444,50858,445,0,0,drop,70,70,0,1,0,1,0
20445,50859,445,0,0,drop,70,70,0,1,0,1,0
20446,9836,22114,0,0,deny,66,66,0,1,0,1,0
20447,62614,445,0,0,drop,66,66,0,1,0,1,0
20448,62620,445,0,0,drop,66,66,0,1,0,1,0
20449,62619,445,0,0,drop,66,66,0,1,0,1,0
20450,62616,445,0,0,drop,66,66,0,1,0,1,0
20451,62618,445,0,0,drop,66,66,0,1,0,1,0
20452,62621,445,0,0,drop,66,66,0,1,0,1,0
20453,62617,445,0,0,drop,66,66,0,1,0,1,0
20454,62613,445,0,0,drop,66,66,0,1,0,1,0
20455,47944,50584,0,0,deny,62,62,0,1,0,1,0
20456,55435,25174,0,0,deny,62,62,0,1,0,1,0
20457,49290,53,62128,53,allow,184,94,90,2,30,1,1
20458,56163,53,45369,53,allow,265,85,180,4,41,2,2
20459,64947,53,61833,53,allow,275,96,179,4,41,2,2
20460,45547,53,15973,53,allow,199,94,105,2,30,1,1
20461,55056,53,51122,53,allow,209,110,99,2,30,1,1
20462,65277,53,40732,53,allow,199,102,97,2,30,1,1
20463,57363,53,63578,53,allow,193,102,91,2,30,1,1
20464,55123,53,56989,53,allow,198,102,96,2,30,1,1
20465,40226,53,63320,53,allow,258,78,180,4,30,2,2
20466,56637,53,46210,53,allow,199,102,97,2,30,1,1
20467,65495,53,27520,53,allow,209,110,99,2,30,1,1
20468,64816,53,50363,53,allow,166,86,80,2,30,1,1
20469,64520,53,48129,53,allow,198,102,96,2,30,1,1
20470,65363,53,10698,53,allow,181,94,87,2,30,1,1
20471,49862,53,40662,53,allow,180,94,86,2,30,1,1
20472,38269,80,33887,80,allow,190,70,120,4,14,2,2
20473,37595,443,31654,443,allow,34423,3999,30424,52,46,24,28
20474,57737,53,57737,53,allow,374,240,134,3,32,2,1
20475,10283,53,10283,53,allow,370,238,132,3,31,2,1
20476,56430,443,45343,443,allow,10956,4863,6093,47,82,22,25
20477,57386,53,23091,53,allow,193,102,91,2,29,1,1
20478,64284,53,55514,53,allow,229,110,119,2,30,1,1
20479,56625,53,47756,53,allow,193,102,91,2,30,1,1
20480,56161,53,4993,53,allow,817,102,715,2,30,1,1
20481,49532,53,13697,53,allow,195,102,93,2,30,1,1
20482,49247,53,61621,53,allow,817,102,715,2,30,1,1
20483,51954,80,41489,80,allow,18285,8756,9529,29,27,15,14
20484,51943,80,43908,80,allow,306,120,186,6,27,3,3
20485,53852,14099,17770,14099,allow,320,140,180,6,6,3,3
20486,51938,80,16530,80,allow,4424,3281,1143,12,27,8,4
20487,51940,80,37296,80,allow,366,240,126,7,27,5,2
20488,57061,53,39332,53,allow,1780,674,1106,18,68,9,9
20489,60907,443,25513,443,allow,7477,3022,4455,27,45,15,12
20490,64810,53,23866,53,allow,199,102,97,2,29,1,1
20491,47652,443,53871,443,allow,1058,571,487,10,24,6,4
20492,55046,53,11757,53,allow,198,102,96,2,29,1,1
20493,55451,53,40344,53,allow,816,102,714,2,29,1,1
20494,56550,53,53287,53,allow,166,86,80,2,29,1,1
20495,17206,53,17206,53,allow,240,98,142,2,29,1,1
20496,56271,53,27532,53,allow,195,102,93,2,29,1,1
20497,57351,53,48672,53,allow,184,94,90,2,29,1,1
20498,49276,53,39804,53,allow,199,102,97,2,29,1,1
20499,56561,53,8736,53,allow,183,94,89,2,29,1,1
20500,57430,53,16018,53,allow,200,102,98,2,29,1,1
20501,64308,53,11059,53,allow,258,102,156,2,29,1,1
20502,56819,53,44720,53,allow,209,110,99,2,29,1,1
20503,55688,53,8374,53,allow,184,94,90,2,30,1,1
20504,49532,53,40570,53,allow,195,102,93,2,30,1,1
20505,56161,53,2092,53,allow,194,102,92,2,30,1,1
20506,51036,80,2227,80,allow,1514,480,1034,11,16,6,5
20507,55224,53,48169,53,allow,182,94,88,2,30,1,1
20508,27005,27015,51372,27015,allow,884,126,758,2,30,1,1
20509,65133,53,55111,53,allow,198,102,96,2,30,1,1
20510,65472,53,43093,53,allow,209,110,99,2,30,1,1
20511,45754,80,60037,80,allow,1282,650,632,9,127,5,4
20512,65229,53,46914,53,allow,193,102,91,2,30,1,1
20513,54968,53,59501,53,allow,199,102,97,2,30,1,1
20514,9097,5228,6402,5228,allow,6138,1256,4882,22,58,11,11
20515,64020,53,53035,53,allow,196,102,94,2,30,1,1
20516,49244,80,49244,80,allow,661753,15722,646031,683,17,235,448
20517,49591,80,27431,80,allow,314,128,186,6,27,3,3
20518,60471,19776,35509,19776,allow,70,70,0,2,8,2,0
20519,54805,80,8562,80,allow,448,78,370,6,24,1,5
20520,57386,53,39494,53,allow,193,102,91,2,30,1,1
20521,61438,443,9604,443,allow,4933,771,4162,18,28,8,10
20522,63959,15922,28893,15922,allow,2136,1536,600,18,22,12,6
20523,51606,443,26654,443,allow,2895,2046,849,14,134,8,6
20524,46410,80,31458,80,allow,1163,705,458,10,15,6,4
20525,57398,443,53104,443,allow,1056,569,487,10,24,6,4
20526,55688,33958,16437,33958,allow,70,70,0,1,5,1,0
20527,60377,443,19236,443,allow,10101,2782,7319,22,78,10,12
20528,53468,443,36235,443,allow,3153,2232,921,15,15,8,7
20529,37648,443,15216,443,allow,9618,7387,2231,30,26,18,12
20530,21456,53,21456,53,allow,240,98,142,2,30,1,1
20531,50970,80,61956,80,allow,11340,3061,8279,31,115,12,19
20532,37651,443,4131,443,allow,4162,3001,1161,20,25,12,8
20533,56857,53,15955,53,allow,195,102,93,2,30,1,1
20534,49549,443,14886,443,allow,19491,14463,5028,50,224,26,24
20535,55245,53,25152,53,allow,193,102,91,2,30,1,1
20536,56532,53,25649,53,allow,193,102,91,2,30,1,1
20537,49654,53,46255,53,allow,775,102,673,2,30,1,1
20538,60684,53,9516,53,allow,199,94,105,2,30,1,1
20539,56857,53,39377,53,allow,195,102,93,2,30,1,1
20540,55729,53,3509,53,allow,199,102,97,2,30,1,1
20541,55159,53,29350,53,allow,200,102,98,2,30,1,1
20542,49521,53,40316,53,allow,183,94,89,2,30,1,1
20543,55308,53,65535,53,allow,194,94,100,2,30,1,1
20544,65277,53,48607,53,allow,199,102,97,2,30,1,1
20545,65133,53,34896,53,allow,198,102,96,2,30,1,1
20546,27005,27015,64415,27015,allow,875,126,749,2,30,1,1
20547,49205,53,3818,53,allow,720,94,626,2,30,1,1
20548,59859,443,59054,443,allow,27510,4470,23040,67,122,34,33
20549,1956,53,1956,53,allow,240,98,142,2,30,1,1
20550,60365,443,29839,443,allow,13649,6567,7082,29,127,14,15
20551,51604,443,15214,443,allow,2911,2062,849,14,134,8,6
20552,49792,53,55353,53,allow,755,202,553,6,61,3,3
20553,10049,5222,44592,5222,allow,6103,3081,3022,63,616,34,29
20554,49268,53,9594,53,allow,200,94,106,2,30,1,1
20555,37683,53,37683,53,allow,240,98,142,2,30,1,1
20556,56857,53,28297,53,allow,195,102,93,2,30,1,1
20557,27005,27015,33669,27015,allow,876,126,750,2,30,1,1
20558,57363,53,3624,53,allow,193,102,91,2,30,1,1
20559,55003,53,61767,53,allow,196,102,94,2,30,1,1
20560,55224,53,43043,53,allow,182,94,88,2,30,1,1
20561,49505,443,22158,443,allow,3182,1568,1614,8,120,4,4
20562,48625,443,33941,443,allow,29988,20891,9097,170,598,95,75
20563,61435,443,45257,443,allow,1401,940,461,11,29,7,4
20564,53724,443,35083,443,allow,7759,1476,6283,24,19,14,10
20565,56728,443,11785,443,allow,8652,2148,6504,20,15,11,9
20566,55224,53,2332,53,allow,182,94,88,2,30,1,1
20567,58868,443,25875,443,allow,1826093,48237,1777856,1873,71,599,1274
20568,55317,53,30681,53,allow,216,102,114,2,30,1,1
20569,49466,53,24088,53,allow,209,110,99,2,30,1,1
20570,55141,53,24444,53,allow,184,94,90,2,30,1,1
20571,56625,53,55820,53,allow,193,102,91,2,30,1,1
20572,65020,53,48553,53,allow,184,94,90,2,30,1,1
20573,49776,53,42364,53,allow,182,94,88,2,30,1,1
20574,49526,53,12720,53,allow,272,97,175,4,58,2,2
20575,65136,53,56323,53,allow,458,104,354,4,57,2,2
20576,57396,443,55887,443,allow,1054,567,487,10,24,6,4
20577,61436,443,20457,443,allow,1401,940,461,11,29,7,4
20578,51937,80,32427,80,allow,37552,16143,21409,54,28,26,28
20579,47650,443,28162,443,allow,1056,569,487,10,24,6,4
20580,51919,80,35345,80,allow,16004,8270,7734,32,57,17,15
20581,39456,443,56286,443,allow,6944,1650,5294,24,40,14,10
20582,51850,80,53740,80,allow,2188,1421,767,11,61,7,4
20583,51947,80,31823,80,allow,1582,866,716,11,27,7,4
20584,50402,8080,50402,8080,allow,378,180,198,7,78,4,3
20585,50639,80,20616,80,allow,318,192,126,6,25,4,2
20586,41538,443,31150,443,allow,8090,2462,5628,22,21,12,10
20587,61404,443,64202,443,allow,4526,2655,1871,24,98,14,10
20588,50608,80,12728,80,allow,10029,8683,1346,20,36,11,9
20589,50309,53,29176,53,allow,193,102,91,2,29,1,1
20590,51955,80,57774,80,allow,366,240,126,7,27,5,2
20591,55159,53,20403,53,allow,200,102,98,2,29,1,1
20592,60789,40010,35327,40010,allow,316,136,180,6,6,3,3
20593,64020,53,31935,53,allow,196,102,94,2,29,1,1
20594,57334,53,51470,53,allow,184,94,90,2,29,1,1
20595,55123,53,29393,53,allow,198,102,96,2,29,1,1
20596,55245,53,15511,53,allow,193,102,91,2,30,1,1
20597,51605,443,22416,443,allow,2013,1363,650,12,134,7,5
20598,53268,443,33392,443,allow,13176,4779,8397,47,17,29,18
20599,51602,443,19598,443,allow,2013,1363,650,12,134,7,5
20600,55268,53,12955,53,allow,193,102,91,2,29,1,1
20601,50309,53,52592,53,allow,816,102,714,2,29,1,1
20602,57061,53,28599,53,allow,1780,674,1106,18,68,9,9
20603,65091,53,53299,53,allow,212,102,110,2,29,1,1
20604,49276,53,23238,53,allow,199,102,97,2,29,1,1
20605,55245,53,61157,53,allow,209,110,99,2,29,1,1
20606,65139,53,18725,53,allow,216,110,106,2,29,1,1
20607,55451,53,24181,53,allow,193,102,91,2,29,1,1
20608,57382,53,10173,53,allow,184,94,90,2,29,1,1
20609,27005,23010,48268,23010,allow,881,126,755,2,30,1,1
20610,56821,53,37054,53,allow,199,102,97,2,29,1,1
20611,54960,53,7818,53,allow,448,184,264,6,30,3,3
20612,27005,27015,22346,27015,allow,869,126,743,2,30,1,1
20613,56271,53,40470,53,allow,195,102,93,2,30,1,1
20614,65204,53,50425,53,allow,183,94,89,2,29,1,1
20615,27005,27015,56487,27015,allow,892,126,766,2,30,1,1
20616,56313,53,7170,53,allow,198,102,96,2,29,1,1
20617,55325,53,53505,53,allow,199,102,97,2,30,1,1
20618,64985,53,53017,53,allow,196,102,94,2,30,1,1
20619,65132,53,29079,53,allow,167,86,81,2,30,1,1
20620,65023,53,44980,53,allow,761,102,659,2,30,1,1
20621,64489,53,32733,53,allow,215,102,113,2,30,1,1
20622,34814,53,64232,53,allow,168,78,90,2,30,1,1
20623,65363,53,10206,53,allow,181,94,87,2,30,1,1
20624,49636,53,23682,53,allow,180,94,86,2,30,1,1
20625,55577,53,20988,53,allow,199,102,97,2,30,1,1
20626,65376,53,60931,53,allow,184,94,90,2,30,1,1
20627,55384,53,24803,53,allow,194,102,92,2,30,1,1
20628,49628,53,54412,53,allow,168,86,82,2,30,1,1
20629,64853,53,39005,53,allow,199,102,97,2,30,1,1
20630,64695,53,7882,53,allow,275,118,157,2,30,1,1
20631,49290,53,50836,53,allow,184,94,90,2,30,1,1
20632,52850,443,36065,443,allow,5743,1339,4404,18,180,8,10
20633,60840,53,50587,53,allow,255,86,169,2,31,1,1
20634,55384,53,49003,53,allow,194,102,92,2,31,1,1
20635,51973,12321,46700,12321,allow,1260,636,624,9,30,5,4
20636,53277,80,34172,80,allow,4374,1724,2650,16,150,9,7
20637,37538,443,35991,443,allow,14826,7220,7606,53,94,29,24
20638,56729,443,23413,443,allow,8652,2148,6504,20,15,11,9
20639,46270,7700,51894,7700,allow,1440,956,484,15,35,8,7
20640,33830,443,20220,443,allow,130,70,60,2,15,1,1
20641,51603,443,62273,443,allow,2927,2062,865,14,134,8,6
20642,60875,443,41853,443,allow,7251,2098,5153,27,25,15,12
20643,60369,443,30950,443,allow,12859,2557,10302,25,80,10,15
20644,55729,53,33239,53,allow,199,102,97,2,30,1,1
20645,56532,53,39559,53,allow,193,102,91,2,30,1,1
20646,25209,53,25209,53,allow,240,98,142,2,30,1,1
20647,17855,53,17855,53,allow,240,98,142,2,30,1,1
20648,63968,53,26432,53,allow,200,102,98,2,30,1,1
20649,49466,53,47860,53,allow,209,110,99,2,30,1,1
20650,63932,53,27137,53,allow,179,94,85,2,30,1,1
20651,63968,53,62729,53,allow,200,102,98,2,30,1,1
20652,59133,443,44471,443,allow,2863,1501,1362,20,315,10,10
20653,63984,15847,44273,15847,allow,1344,819,525,14,15,8,6
20654,60469,60092,64603,60092,allow,70,70,0,2,8,2,0
20655,37650,443,41900,443,allow,6898,5202,1696,25,25,15,10
20656,64053,53,64715,53,allow,276,94,182,4,55,2,2
20657,55577,53,26571,53,allow,199,102,97,2,30,1,1
20658,54968,53,43253,53,allow,199,102,97,2,30,1,1
20659,57351,53,35105,53,allow,184,94,90,2,30,1,1
20660,56711,53,25495,53,allow,209,110,99,2,30,1,1
20661,54968,53,59116,53,allow,199,102,97,2,30,1,1
20662,55388,53,5023,53,allow,720,94,626,2,30,1,1
20663,65472,53,51115,53,allow,209,110,99,2,30,1,1
20664,32879,443,46058,443,allow,8137,2110,6027,29,394,10,19
20665,50631,80,34721,80,allow,14784,7048,7736,31,27,18,13
20666,61437,443,53093,443,allow,4872,771,4101,17,28,8,9
20667,40140,53,40140,53,allow,404,259,145,3,32,2,1
20668,60472,20273,1767,20273,allow,70,70,0,2,8,2,0
20669,36368,80,58408,80,allow,78,78,0,1,5,1,0
20670,49526,53,27945,53,allow,272,97,175,4,57,2,2
20671,56711,53,8899,53,allow,209,110,99,2,30,1,1
20672,57707,53,34372,53,allow,70,70,0,1,30,1,0
20673,65505,53,13490,53,allow,166,86,80,2,30,1,1
20674,55415,53,9661,53,allow,183,94,89,2,30,1,1
20675,49521,53,3193,53,allow,183,94,89,2,30,1,1
20676,49452,53,60984,53,allow,244,110,134,2,30,1,1
20677,55220,53,22108,53,allow,193,102,91,2,30,1,1
20678,65229,53,52095,53,allow,193,102,91,2,30,1,1
20679,49521,53,30278,53,allow,183,94,89,2,30,1,1
20680,49838,443,59419,443,allow,6915,3106,3809,21,144,10,11
20681,65472,53,45041,53,allow,209,110,99,2,30,1,1
20682,64833,53,41021,53,allow,167,86,81,2,31,1,1
20683,63999,53,20780,53,allow,193,102,91,2,31,1,1
20684,64985,53,7448,53,allow,196,102,94,2,31,1,1
20685,64449,53,34818,53,allow,255,102,153,2,31,1,1
20686,64780,53,40708,53,allow,193,102,91,2,31,1,1
20687,27005,27015,28442,27015,allow,881,126,755,2,31,1,1
20688,65026,53,29362,53,allow,193,102,91,2,31,1,1
20689,63932,53,25694,53,allow,179,94,85,2,31,1,1
20690,60478,443,17919,443,allow,5045,2009,3036,14,120,7,7
20691,56523,443,55087,443,allow,8130,2093,6037,17,120,9,8
20692,49971,443,5852,443,allow,62,62,0,1,120,1,0
20693,57176,443,31036,443,allow,12844,2619,10225,23,120,10,13
20694,6881,55981,51460,55981,allow,228,118,110,2,1200,1,1
20695,26467,6969,47386,6969,allow,192,192,0,4,1200,4,0
20696,58386,443,63968,443,allow,15705,3421,12284,53,360,23,30
20697,65363,53,1138,53,allow,181,94,87,2,31,1,1
20698,27005,27025,22813,27025,allow,887,126,761,2,31,1,1
20699,63991,53,25716,53,allow,193,102,91,2,31,1,1
20700,50354,443,29554,443,allow,1786,172,1614,7,120,3,4
20701,50228,443,34666,443,allow,1775,169,1606,7,120,3,4
20702,49696,443,49696,443,allow,4871,1623,3248,18,137,8,10
20703,65020,53,24466,53,allow,290,94,196,4,55,2,2
20704,49466,53,63958,53,allow,324,103,221,4,46,2,2
20705,63949,53,2589,53,allow,338,97,241,4,43,2,2
20706,65241,53,13968,53,allow,484,102,382,4,36,2,2
20707,49526,53,6376,53,allow,272,97,175,4,58,2,2
20708,64205,53,39534,53,allow,327,88,239,4,52,2,2
20709,51813,443,18719,443,allow,130,70,60,3,5,2,1
20710,32888,80,22913,80,allow,1542,831,711,7,16,5,2
20711,9231,443,14526,443,allow,4942,429,4513,12,15,6,6
20712,60226,443,32684,443,allow,1907736,31488,1876248,1747,21,470,1277
20713,49265,53,25625,53,allow,211,102,109,2,30,1,1
20714,64567,53,64760,53,allow,193,102,91,2,30,1,1
20715,5227,50584,0,0,deny,62,62,0,1,0,1,0
20716,49577,57470,0,0,deny,66,66,0,1,0,1,0
20717,54578,26467,0,0,deny,66,66,0,1,0,1,0
20718,54373,26467,0,0,deny,62,62,0,1,0,1,0
20719,62421,445,0,0,drop,70,70,0,1,0,1,0
20720,24236,26296,0,0,deny,148,148,0,1,0,1,0
20721,3077,50584,0,0,deny,146,146,0,1,0,1,0
20722,50853,445,0,0,drop,70,70,0,1,0,1,0
20723,50852,445,0,0,drop,70,70,0,1,0,1,0
20724,50850,445,0,0,drop,70,70,0,1,0,1,0
20725,50842,445,0,0,drop,70,70,0,1,0,1,0
20726,53376,22114,0,0,deny,62,62,0,1,0,1,0
20727,62413,445,0,0,drop,70,70,0,1,0,1,0
20728,62600,445,0,0,drop,66,66,0,1,0,1,0
20729,62598,445,0,0,drop,66,66,0,1,0,1,0
20730,62599,445,0,0,drop,66,66,0,1,0,1,0
20731,42231,57470,0,0,deny,78,78,0,1,0,1,0
20732,58120,25174,0,0,deny,66,66,0,1,0,1,0
20733,63717,37965,0,0,deny,66,66,0,1,0,1,0
20734,50839,445,0,0,drop,70,70,0,1,0,1,0
20735,62991,51221,0,0,deny,66,66,0,1,0,1,0
20736,62407,445,0,0,drop,70,70,0,1,0,1,0
20737,57131,31061,0,0,deny,145,145,0,1,0,1,0
20738,50830,445,0,0,drop,70,70,0,1,0,1,0
20739,50828,445,0,0,drop,70,70,0,1,0,1,0
20740,50826,445,0,0,drop,70,70,0,1,0,1,0
20741,62405,445,0,0,drop,70,70,0,1,0,1,0
20742,23519,25174,0,0,deny,146,146,0,1,0,1,0
20743,45941,23386,0,0,deny,60,60,0,1,0,1,0
20744,14000,14914,0,0,deny,157,157,0,1,0,1,0
20745,63852,25174,0,0,deny,62,62,0,1,0,1,0
20746,63385,25174,0,0,deny,66,66,0,1,0,1,0
20747,50563,37965,0,0,deny,66,66,0,1,0,1,0
20748,62401,445,0,0,drop,70,70,0,1,0,1,0
20749,64306,64147,0,0,deny,62,62,0,1,0,1,0
20750,11815,30188,0,0,deny,146,146,0,1,0,1,0
20751,19747,37965,0,0,deny,62,62,0,1,0,1,0
20752,18683,26467,0,0,deny,62,62,0,1,0,1,0
20753,2837,25174,0,0,deny,66,66,0,1,0,1,0
20754,54277,22114,0,0,deny,146,146,0,1,0,1,0
20755,11136,19910,0,0,deny,62,62,0,1,0,1,0
20756,3717,25174,0,0,deny,62,62,0,1,0,1,0
20757,50549,43890,0,0,deny,66,66,0,1,0,1,0
20758,40840,21247,0,0,deny,62,62,0,1,0,1,0
20759,62400,445,0,0,drop,70,70,0,1,0,1,0
20760,56249,55442,0,0,deny,66,66,0,1,0,1,0
20761,36992,25174,0,0,deny,146,146,0,1,0,1,0
20762,51310,64147,0,0,deny,66,66,0,1,0,1,0
20763,50821,445,0,0,drop,70,70,0,1,0,1,0
20764,50817,445,0,0,drop,70,70,0,1,0,1,0
20765,50815,445,0,0,drop,70,70,0,1,0,1,0
20766,65006,26467,0,0,deny,66,66,0,1,0,1,0
20767,62586,445,0,0,drop,66,66,0,1,0,1,0
20768,23349,30188,0,0,deny,62,62,0,1,0,1,0
20769,34914,26467,0,0,deny,62,62,0,1,0,1,0
20770,50857,26467,0,0,deny,66,66,0,1,0,1,0
20771,62395,445,0,0,drop,70,70,0,1,0,1,0
20772,51045,25174,0,0,deny,66,66,0,1,0,1,0
20773,63982,25174,0,0,deny,66,66,0,1,0,1,0
20774,22677,25174,0,0,deny,66,66,0,1,0,1,0
20775,1827,64147,0,0,deny,66,66,0,1,0,1,0
20776,14614,25174,0,0,deny,66,66,0,1,0,1,0
20777,7356,25174,0,0,deny,66,66,0,1,0,1,0
20778,55529,44847,0,0,deny,66,66,0,1,0,1,0
20779,52232,53,0,0,deny,71,71,0,1,0,1,0
20780,50812,445,0,0,drop,70,70,0,1,0,1,0
20781,50810,445,0,0,drop,70,70,0,1,0,1,0
20782,61840,25174,0,0,deny,66,66,0,1,0,1,0
20783,63888,25174,0,0,deny,66,66,0,1,0,1,0
20784,53546,46824,0,0,deny,66,66,0,1,0,1,0
20785,52809,56205,0,0,deny,146,146,0,1,0,1,0
20786,21604,50201,0,0,deny,66,66,0,1,0,1,0
20787,55987,53,22591,53,allow,733,85,648,2,0,1,1
20788,56816,11392,0,0,deny,62,62,0,1,0,1,0
20789,35812,1,0,0,deny,146,146,0,1,0,1,0
20790,56334,1433,0,0,deny,60,60,0,1,0,1,0
20791,54418,22114,0,0,deny,66,66,0,1,0,1,0
20792,62571,445,0,0,drop,66,66,0,1,0,1,0
20793,29509,25174,0,0,deny,62,62,0,1,0,1,0
20794,51602,22114,0,0,deny,66,66,0,1,0,1,0
20795,62382,445,0,0,drop,70,70,0,1,0,1,0
20796,51094,35440,0,0,deny,62,62,0,1,0,1,0
20797,56590,25174,0,0,deny,66,66,0,1,0,1,0
20798,11967,57470,0,0,deny,62,62,0,1,0,1,0
20799,3766,25174,0,0,deny,62,62,0,1,0,1,0
20800,3766,25174,0,0,deny,146,146,0,1,0,1,0
20801,62379,445,0,0,drop,70,70,0,1,0,1,0
20802,50803,445,0,0,drop,70,70,0,1,0,1,0
20803,50799,445,0,0,drop,70,70,0,1,0,1,0
20804,50798,445,0,0,drop,70,70,0,1,0,1,0
20805,50791,445,0,0,drop,70,70,0,1,0,1,0
20806,62566,445,0,0,drop,66,66,0,1,0,1,0
20807,15442,22114,0,0,deny,66,66,0,1,0,1,0
20808,25296,51505,0,0,deny,66,66,0,1,0,1,0
20809,7810,25174,0,0,deny,66,66,0,1,0,1,0
20810,62554,445,0,0,drop,66,66,0,1,0,1,0
20811,62557,445,0,0,drop,66,66,0,1,0,1,0
20812,62558,445,0,0,drop,66,66,0,1,0,1,0
20813,62562,445,0,0,drop,66,66,0,1,0,1,0
20814,62556,445,0,0,drop,66,66,0,1,0,1,0
20815,62553,445,0,0,drop,66,66,0,1,0,1,0
20816,62551,445,0,0,drop,66,66,0,1,0,1,0
20817,27300,6881,0,0,deny,66,66,0,1,0,1,0
20818,62374,445,0,0,drop,70,70,0,1,0,1,0
20819,50786,445,0,0,drop,70,70,0,1,0,1,0
20820,62373,445,0,0,drop,70,70,0,1,0,1,0
20821,50782,445,0,0,drop,70,70,0,1,0,1,0
20822,50783,445,0,0,drop,70,70,0,1,0,1,0
20823,50779,445,0,0,drop,70,70,0,1,0,1,0
20824,28221,37965,0,0,deny,62,62,0,1,0,1,0
20825,62371,445,0,0,drop,70,70,0,1,0,1,0
20826,53140,51221,0,0,deny,74,74,0,1,0,1,0
20827,6666,2222,0,0,deny,60,60,0,1,0,1,0
20828,56397,26467,0,0,deny,66,66,0,1,0,1,0
20829,22547,23,0,0,deny,60,60,0,1,0,1,0
20830,62769,25174,0,0,deny,146,146,0,1,0,1,0
20831,53539,44847,0,0,deny,62,62,0,1,0,1,0
20832,50777,445,0,0,drop,70,70,0,1,0,1,0
20833,50773,445,0,0,drop,70,70,0,1,0,1,0
20834,50772,445,0,0,drop,70,70,0,1,0,1,0
20835,62364,445,0,0,drop,70,70,0,1,0,1,0
20836,64955,53,11149,53,allow,761,100,661,2,0,1,1
20837,0,0,0,0,allow,320,320,0,5,0,5,0
20838,62544,445,0,0,drop,66,66,0,1,0,1,0
20839,50770,445,0,0,drop,70,70,0,1,0,1,0
20840,62362,445,0,0,drop,70,70,0,1,0,1,0
20841,53577,35894,0,0,deny,66,66,0,1,0,1,0
20842,62541,445,0,0,drop,66,66,0,1,0,1,0
20843,6652,25174,0,0,deny,62,62,0,1,0,1,0
20844,62539,445,0,0,drop,66,66,0,1,0,1,0
20845,62538,445,0,0,drop,66,66,0,1,0,1,0
20846,53495,37807,0,0,deny,66,66,0,1,0,1,0
20847,62361,445,0,0,drop,70,70,0,1,0,1,0
20848,62536,445,0,0,drop,66,66,0,1,0,1,0
20849,62360,445,0,0,drop,70,70,0,1,0,1,0
20850,16037,25174,0,0,deny,62,62,0,1,0,1,0
20851,62359,445,0,0,drop,70,70,0,1,0,1,0
20852,16037,25174,0,0,deny,146,146,0,1,0,1,0
20853,62356,445,0,0,drop,70,70,0,1,0,1,0
20854,62353,445,0,0,drop,70,70,0,1,0,1,0
20855,53199,30188,0,0,deny,66,66,0,1,0,1,0
20856,56629,25174,0,0,deny,66,66,0,1,0,1,0
20857,25961,55783,0,0,deny,60,60,0,1,0,1,0
20858,49893,25174,0,0,deny,66,66,0,1,0,1,0
20859,48826,25174,0,0,deny,66,66,0,1,0,1,0
20860,55826,42771,0,0,deny,66,66,0,1,0,1,0
20861,55825,52700,0,0,deny,66,66,0,1,0,1,0
20862,53022,25174,0,0,deny,66,66,0,1,0,1,0
20863,50764,445,0,0,drop,70,70,0,1,0,1,0
20864,1024,25174,0,0,deny,62,62,0,1,0,1,0
20865,11488,22114,0,0,deny,66,66,0,1,0,1,0
20866,50755,445,0,0,drop,70,70,0,1,0,1,0
20867,50751,445,0,0,drop,70,70,0,1,0,1,0
20868,62341,445,0,0,drop,70,70,0,1,0,1,0
20869,62340,445,0,0,drop,70,70,0,1,0,1,0
20870,40400,22114,0,0,deny,62,62,0,1,0,1,0
20871,62337,445,0,0,drop,70,70,0,1,0,1,0
20872,62331,445,0,0,drop,70,70,0,1,0,1,0
20873,62330,445,0,0,drop,70,70,0,1,0,1,0
20874,30598,37965,0,0,deny,62,62,0,1,0,1,0
20875,62525,445,0,0,drop,66,66,0,1,0,1,0
20876,50927,44847,0,0,deny,146,146,0,1,0,1,0
20877,48019,22114,0,0,deny,66,66,0,1,0,1,0
20878,61017,64147,0,0,deny,66,66,0,1,0,1,0
20879,1733,65448,0,0,deny,66,66,0,1,0,1,0
20880,42238,25174,0,0,deny,66,66,0,1,0,1,0
20881,55629,42873,0,0,deny,74,74,0,1,0,1,0
20882,42034,28189,0,0,deny,62,62,0,1,0,1,0
20883,47513,23,0,0,deny,60,60,0,1,0,1,0
20884,62792,53,0,0,deny,88,88,0,1,0,1,0
20885,10273,21247,0,0,deny,66,66,0,1,0,1,0
20886,62518,445,0,0,drop,66,66,0,1,0,1,0
20887,27144,25174,0,0,deny,66,66,0,1,0,1,0
20888,50742,445,0,0,drop,70,70,0,1,0,1,0
20889,62319,445,0,0,drop,70,70,0,1,0,1,0
20890,55045,443,26442,443,allow,5541,2778,2763,24,15,14,10
20891,14597,53,14597,53,allow,404,259,145,3,32,2,1
20892,39704,53,39704,53,allow,398,255,143,3,33,2,1
20893,45844,443,26065,443,allow,44232,11223,33009,97,460,50,47
20894,63999,53,43877,53,allow,186,95,91,2,30,1,1
20895,64985,53,36411,53,allow,192,98,94,2,30,1,1
20896,53917,80,62681,80,allow,1829,755,1074,10,15,6,4
20897,48908,53,48908,53,allow,398,255,143,3,32,2,1
20898,42488,53,42488,53,allow,235,90,145,2,32,1,1
20899,46025,80,38311,80,allow,5037,1911,3126,18,86,10,8
20900,49705,22,49705,22,allow,1108,66,1042,3,15,2,1
20901,26842,443,13375,443,allow,7219,2522,4697,21,20,10,11
20902,51964,443,11131,443,allow,5363,2713,2650,26,53,14,12
20903,58703,443,1950,443,allow,15202,6356,8846,40,119,22,18
20904,55325,53,48577,53,allow,198,101,97,2,30,1,1
20905,49182,53,44027,53,allow,198,101,97,2,30,1,1
20906,49595,53,17154,53,allow,176,90,86,2,30,1,1
20907,57705,443,65472,443,allow,7915,1994,5921,31,270,15,16
20908,55262,443,33483,443,allow,28633618,753499,27880119,30116,102,8846,21270
20909,50381,443,49531,443,allow,316,136,180,6,6,3,3
20910,60463,6890,27604,6890,allow,70,70,0,1,5,1,0
20911,49317,53,41699,53,allow,168,78,90,2,30,1,1
20912,65026,53,32654,53,allow,186,95,91,2,30,1,1
20913,49171,443,58850,443,allow,13649,6228,7421,28,30,15,13
20914,64444,53,59792,53,allow,93,93,0,1,30,1,0
20915,58971,443,47268,443,allow,2702,1593,1109,21,23,11,10
20916,64947,53,18048,53,allow,275,96,179,4,41,2,2
20917,48020,53,48020,53,allow,404,259,145,3,33,2,1
20918,29047,80,29047,80,allow,10148,1458,8690,23,25,11,12
20919,62964,53,62964,53,allow,404,259,145,3,33,2,1
20920,59420,443,36806,443,allow,7913,5787,2126,28,316,14,14
20921,46028,80,31228,80,allow,1176793,65077,1111716,1528,85,788,740
20922,49165,53,64334,53,allow,780,104,676,2,30,1,1
20923,45116,80,45116,80,allow,24787,1571,23216,40,21,20,20
20924,64790,53,58871,53,allow,88,88,0,1,30,1,0
20925,58878,443,22672,443,allow,25575,16682,8893,57,21,31,26
20926,46029,80,61068,80,allow,111564,6775,104789,160,85,86,74
20927,50370,443,23415,443,allow,316,136,180,6,6,3,3
20928,18686,53,18686,53,allow,235,90,145,2,32,1,1
20929,39861,80,23505,80,allow,1056,682,374,10,15,6,4
20930,19116,53,19116,53,allow,398,255,143,3,33,2,1
20931,51638,80,49602,80,allow,19232,1830,17402,35,49,19,16
20932,2402,7000,2402,7000,allow,1236,676,560,13,22,7,6
20933,57089,443,54231,443,allow,5574,999,4575,21,256,11,10
20934,55044,443,54771,443,allow,5549,2777,2772,24,16,14,10
20935,56423,443,49453,443,allow,6294,1494,4800,22,17,11,11
20936,54958,443,14997,443,allow,6578,1571,5007,24,17,13,11
20937,56410,53,65347,53,allow,757,98,659,2,30,1,1
20938,49776,53,56083,53,allow,180,92,88,2,30,1,1
20939,32346,53,32346,53,allow,200,90,110,2,30,1,1
20940,30834,53,30834,53,allow,194,87,107,2,30,1,1
20941,49558,53,30601,53,allow,184,94,90,2,30,1,1
20942,56433,53,16233,53,allow,204,104,100,2,30,1,1
20943,18194,53,18194,53,allow,225,87,138,2,31,1,1
20944,30960,45756,31120,45756,allow,396,396,0,7,3616,7,0
20945,56604,443,22617,443,allow,2904,662,2242,13,135,6,7
20946,40204,40007,54780,40007,allow,140,78,62,2,31,1,1
20947,65487,53,62751,53,allow,204,104,100,2,31,1,1
20948,56327,53,49632,53,allow,172,88,84,2,31,1,1
20949,64034,53,21913,53,allow,188,96,92,2,31,1,1
20950,27005,27015,63024,27015,allow,897,126,771,2,31,1,1
20951,49380,53,50592,53,allow,377,110,267,2,31,1,1
20952,5588,5588,0,0,allow,3354,1792,1562,46,195,23,23
20953,14721,53,14721,53,allow,217,87,130,2,31,1,1
20954,27005,27016,61455,27016,allow,881,126,755,2,31,1,1
20955,27233,53,27233,53,allow,213,87,126,2,31,1,1
20956,56927,53,19352,53,allow,182,93,89,2,31,1,1
20957,49916,53,52400,53,allow,395,111,284,2,31,1,1
20958,55693,53,60577,53,allow,748,95,653,2,31,1,1
20959,27005,27018,40028,27018,allow,891,126,765,2,31,1,1
20960,49969,53,49918,53,allow,198,101,97,2,31,1,1
20961,64290,53,55058,53,allow,192,98,94,2,31,1,1
20962,53822,25174,0,0,deny,66,66,0,1,0,1,0
20963,63888,57470,0,0,deny,62,62,0,1,0,1,0
20964,58228,53733,0,0,deny,66,66,0,1,0,1,0
20965,55732,5900,0,0,deny,60,60,0,1,0,1,0
20966,62516,445,0,0,drop,66,66,0,1,0,1,0
20967,20706,37965,0,0,deny,62,62,0,1,0,1,0
20968,6666,16010,0,0,deny,60,60,0,1,0,1,0
20969,20576,37965,0,0,deny,62,62,0,1,0,1,0
20970,7222,57470,0,0,deny,62,62,0,1,0,1,0
20971,62580,25174,0,0,deny,62,62,0,1,0,1,0
20972,27063,25174,0,0,deny,62,62,0,1,0,1,0
20973,51298,57470,0,0,deny,66,66,0,1,0,1,0
20974,31404,46232,0,0,deny,100,100,0,1,0,1,0
20975,47357,50584,0,0,deny,66,66,0,1,0,1,0
20976,10072,25174,0,0,deny,62,62,0,1,0,1,0
20977,60721,22114,0,0,deny,66,66,0,1,0,1,0
20978,62315,445,0,0,drop,70,70,0,1,0,1,0
20979,62509,445,0,0,drop,66,66,0,1,0,1,0
20980,51600,443,3011,443,allow,12552,2564,9988,29,16,17,12
20981,62716,2323,0,0,deny,60,60,0,1,0,1,0
20982,1882,43890,0,0,deny,62,62,0,1,0,1,0
20983,62506,445,0,0,drop,66,66,0,1,0,1,0
20984,57655,56205,0,0,deny,66,66,0,1,0,1,0
20985,62424,37965,0,0,deny,62,62,0,1,0,1,0
20986,31404,52955,0,0,deny,100,100,0,1,0,1,0
20987,50956,25174,0,0,deny,146,146,0,1,0,1,0
20988,62306,445,0,0,drop,70,70,0,1,0,1,0
20989,62303,445,0,0,drop,70,70,0,1,0,1,0
20990,62305,445,0,0,drop,70,70,0,1,0,1,0
20991,31404,12082,0,0,deny,100,100,0,1,0,1,0
20992,31404,36778,0,0,deny,100,100,0,1,0,1,0
20993,31404,59961,0,0,deny,100,100,0,1,0,1,0
20994,31404,36841,0,0,deny,100,100,0,1,0,1,0
20995,62301,445,0,0,drop,70,70,0,1,0,1,0
20996,49417,38558,0,0,deny,66,66,0,1,0,1,0
20997,62299,445,0,0,drop,70,70,0,1,0,1,0
20998,50126,23117,0,0,deny,66,66,0,1,0,1,0
20999,62796,37807,0,0,deny,66,66,0,1,0,1,0
21000,49931,25174,0,0,deny,66,66,0,1,0,1,0
21001,50211,51050,0,0,deny,62,62,0,1,0,1,0
21002,59192,25174,0,0,deny,66,66,0,1,0,1,0
21003,45908,33330,0,0,deny,60,60,0,1,0,1,0
21004,64035,25174,0,0,deny,62,62,0,1,0,1,0
21005,2090,50265,0,0,deny,145,145,0,1,0,1,0
21006,50735,445,0,0,drop,70,70,0,1,0,1,0
21007,50732,445,0,0,drop,70,70,0,1,0,1,0
21008,50730,445,0,0,drop,70,70,0,1,0,1,0
21009,62488,445,0,0,drop,66,66,0,1,0,1,0
21010,55008,21247,0,0,deny,62,62,0,1,0,1,0
21011,54280,3398,0,0,deny,60,60,0,1,0,1,0
21012,62492,445,0,0,drop,66,66,0,1,0,1,0
21013,62493,445,0,0,drop,66,66,0,1,0,1,0
21014,62491,445,0,0,drop,66,66,0,1,0,1,0
21015,62486,445,0,0,drop,66,66,0,1,0,1,0
21016,62489,445,0,0,drop,66,66,0,1,0,1,0
21017,62487,445,0,0,drop,66,66,0,1,0,1,0
21018,62485,445,0,0,drop,66,66,0,1,0,1,0
21019,10949,22114,0,0,deny,146,146,0,1,0,1,0
21020,60075,41705,0,0,deny,66,66,0,1,0,1,0
21021,33761,25174,0,0,deny,62,62,0,1,0,1,0
21022,62292,445,0,0,drop,70,70,0,1,0,1,0
21023,44903,80,37166,80,allow,918,461,457,9,16,6,3
21024,32975,443,44703,443,allow,4648,1885,2763,20,95,10,10
21025,55384,53,51117,53,allow,194,102,92,2,30,1,1
21026,57252,53,26443,53,allow,229,102,127,2,30,1,1
21027,57558,443,4202,443,allow,42986,7555,35431,69,125,29,40
21028,51295,80,40456,80,allow,6702,5879,823,19,135,10,9
21029,44911,80,9577,80,allow,1492,1050,442,7,15,5,2
21030,49590,80,22848,80,allow,314,128,186,6,26,3,3
21031,43016,53,43016,53,allow,235,90,145,2,32,1,1
21032,64672,53,41499,53,allow,576,195,381,6,51,3,3
21033,65220,53,7032,53,allow,371,97,274,4,53,2,2
21034,49182,53,41433,53,allow,199,102,97,2,29,1,1
21035,49776,53,43757,53,allow,182,94,88,2,29,1,1
21036,49558,53,61450,53,allow,184,94,90,2,29,1,1
21037,64053,53,32861,53,allow,276,94,182,4,54,2,2
21038,49947,53,36871,53,allow,264,102,162,2,30,1,1
21039,49166,443,48248,443,allow,9022,1416,7606,25,31,11,14
21040,47873,443,44942,443,allow,12813,5036,7777,40,383,20,20
21041,47191,443,13970,443,allow,8756,2298,6458,39,314,18,21
21042,52053,34411,20997,34411,allow,70,70,0,2,7,2,0
21043,50362,80,15549,80,allow,3907,880,3027,11,15,5,6
21044,36628,80,36628,80,allow,5529,713,4816,15,15,8,7
21045,53465,443,55749,443,allow,3166,2245,921,15,15,8,7
21046,43683,443,23640,443,allow,6941,1551,5390,25,200,12,13
21047,58068,443,17873,443,allow,543,303,240,8,5,4,4
21048,49320,53,42245,53,allow,331,90,241,4,38,2,2
21049,55325,53,47399,53,allow,199,102,97,2,29,1,1
21050,56625,53,48390,53,allow,193,102,91,2,29,1,1
21051,55152,53,21399,53,allow,180,94,86,2,29,1,1
21052,65505,53,17210,53,allow,166,86,80,2,29,1,1
21053,49233,53,56407,53,allow,196,102,94,2,29,1,1
21054,64520,53,16253,53,allow,198,102,96,2,29,1,1
21055,64790,53,41901,53,allow,178,94,84,2,29,1,1
21056,55236,53,27697,53,allow,196,102,94,2,29,1,1
21057,65026,53,34108,53,allow,193,102,91,2,29,1,1
21058,64011,53,28636,53,allow,288,94,194,2,29,1,1
21059,65376,53,47204,53,allow,184,94,90,2,29,1,1
21060,64567,53,8117,53,allow,193,102,91,2,29,1,1
21061,65167,53,26450,53,allow,212,102,110,2,29,1,1
21062,50535,53,14934,53,allow,210,110,100,2,29,1,1
21063,55236,53,12241,53,allow,819,102,717,2,29,1,1
21064,65376,53,8405,53,allow,184,94,90,2,30,1,1
21065,60874,443,9716,443,allow,4479,788,3691,17,25,9,8
21066,61491,443,56385,443,allow,5628,1716,3912,26,109,16,10
21067,53253,443,36100,443,allow,8662,1469,7193,28,66,15,13
21068,64833,53,62978,53,allow,167,86,81,2,30,1,1
21069,27005,27018,61540,27018,allow,881,126,755,2,30,1,1
21070,49595,53,9542,53,allow,180,94,86,2,30,1,1
21071,63992,53,39861,53,allow,199,102,97,2,30,1,1
21072,49489,53,23234,53,allow,241,118,123,2,30,1,1
21073,57536,443,25705,443,allow,232,172,60,3,5,2,1
21074,55682,32765,50295,32765,allow,3529,1769,1760,11,15,6,5
21075,59999,443,10266,443,allow,1571,660,911,13,18,7,6
21076,53263,443,23949,443,allow,11175,1078,10097,25,41,11,14
21077,55054,80,54288,80,allow,67750,4451,63299,78,60,32,46
21078,49182,53,13161,53,allow,199,102,97,2,30,1,1
21079,55684,80,48603,80,allow,70,70,0,1,5,1,0
21080,27005,27016,10139,27016,allow,887,126,761,2,30,1,1
21081,49534,53,17481,53,allow,315,84,231,4,40,2,2
21082,64312,53,41455,53,allow,225,110,115,2,30,1,1
21083,59996,443,60855,443,allow,1641,730,911,14,18,8,6
21084,52094,443,44037,443,allow,2983,1667,1316,25,153,12,13
21085,49903,53,41942,53,allow,194,94,100,2,30,1,1
21086,44380,443,20721,443,allow,5624,2556,3068,29,80,15,14
21087,65507,53,44287,53,allow,199,102,97,2,30,1,1
21088,36575,443,29496,443,allow,412,140,272,7,25,3,4
21089,53252,443,20191,443,allow,6053,974,5079,20,66,10,10
21090,61490,443,7323,443,allow,4561,1129,3432,22,109,13,9
21091,65216,53,8359,53,allow,775,102,673,2,30,1,1
21092,49248,53,1565,53,allow,301,90,211,4,46,2,2
21093,56433,53,47561,53,allow,210,110,100,2,30,1,1
21094,35350,443,47252,443,allow,13168,2505,10663,21,121,9,12
21095,42792,443,30288,443,allow,7102,1857,5245,28,95,15,13
21096,56453,53,58094,53,allow,243,94,149,2,30,1,1
21097,19473,61397,60276,61397,allow,323,150,173,2,1200,1,1
21098,17860,53,17860,53,allow,216,90,126,2,30,1,1
21099,51221,41939,7547,41939,allow,3917,1584,2333,50,3325,25,25
21100,51388,443,13575,443,allow,6703,3312,3391,31,145,14,17
21101,42568,443,34410,443,allow,8049,2043,6006,23,360,11,12
21102,65121,443,49060,443,allow,11416,4745,6671,45,256,22,23
21103,53035,80,53035,80,allow,373926,8227,365699,379,143,130,249
21104,49835,443,51050,443,allow,8754,2616,6138,34,96,19,15
21105,56288,53,63412,53,allow,210,110,100,2,30,1,1
21106,63992,53,62838,53,allow,199,102,97,2,30,1,1
21107,27005,27015,24846,27015,allow,878,126,752,2,30,1,1
21108,57514,53,51498,53,allow,168,78,90,2,30,1,1
21109,50359,80,14465,80,allow,1770,961,809,10,15,5,5
21110,60000,443,63999,443,allow,1641,730,911,14,18,8,6
21111,50857,3389,50857,3389,allow,3613,1594,2019,19,18,10,9
21112,63988,53,50282,53,allow,559,193,366,6,67,3,3
21113,56288,53,18039,53,allow,210,110,100,2,30,1,1
21114,64833,53,29927,53,allow,167,86,81,2,30,1,1
21115,27005,27016,36126,27016,allow,883,126,757,2,30,1,1
21116,44119,53,25337,53,allow,168,78,90,2,30,1,1
21117,65507,53,53628,53,allow,199,102,97,2,30,1,1
21118,49595,53,47380,53,allow,180,94,86,2,30,1,1
21119,65133,53,1707,53,allow,339,100,239,4,51,2,2
21120,37663,80,36231,80,allow,974,481,493,8,15,5,3
21121,57904,80,60274,80,allow,6453,1210,5243,14,23,8,6
21122,53153,17639,25846,17639,allow,698,320,378,10,18,6,4
21123,48440,443,28168,443,allow,6945,1551,5394,25,200,12,13
21124,44907,80,29624,80,allow,1514,962,552,7,16,5,2
21125,50391,80,25680,80,allow,2837,582,2255,12,17,7,5
21126,51950,80,61236,80,allow,3648,1775,1873,13,26,7,6
21127,49589,80,33481,80,allow,314,128,186,6,26,3,3
21128,46773,443,61841,443,allow,10812,3429,7383,39,315,20,19
21129,53851,23650,26484,23650,allow,320,140,180,6,5,3,3
21130,64947,53,23514,53,allow,275,96,179,4,41,2,2
21131,57695,443,41532,443,allow,9493,2266,7227,24,14,13,11
21132,52036,52608,31210,52608,allow,70,70,0,1,4,1,0
21133,6666,2222,6666,2222,allow,130,66,64,2,5,1,1
21134,56163,53,10376,53,allow,624,188,436,6,60,3,3
21135,43807,80,36292,80,allow,138,78,60,2,4,1,1
21136,64947,53,11296,53,allow,275,96,179,4,41,2,2
21137,59997,443,42772,443,allow,1571,660,911,13,18,7,6
21138,50357,80,43010,80,allow,764,698,66,6,15,5,1
21139,45775,443,19122,443,allow,8706,1430,7276,23,316,9,14
21140,58903,443,20018,443,allow,6033,770,5263,18,15,8,10
21141,50594,80,50594,80,allow,9937,4191,5746,27,17,13,14
21142,10014,443,17937,443,allow,3876,2012,1864,21,315,10,11
21143,49558,53,47394,53,allow,184,94,90,2,30,1,1
21144,63999,53,37511,53,allow,193,102,91,2,29,1,1
21145,49233,53,6991,53,allow,819,102,717,2,29,1,1
21146,41812,443,33083,443,allow,6617,1705,4912,24,331,11,13
21147,64780,53,50803,53,allow,193,102,91,2,29,1,1
21148,27005,27015,62179,27015,allow,889,126,763,2,30,1,1
21149,49277,53,5788,53,allow,199,86,113,2,29,1,1
21150,27005,27017,42100,27017,allow,891,126,765,2,30,1,1
21151,49570,53,16357,53,allow,196,94,102,2,29,1,1
21152,64497,53,35440,53,allow,232,110,122,2,29,1,1
21153,63991,53,55633,53,allow,193,102,91,2,29,1,1
21154,49182,53,3761,53,allow,199,102,97,2,29,1,1
21155,55325,53,5383,53,allow,199,102,97,2,30,1,1
21156,50535,53,65134,53,allow,210,110,100,2,29,1,1
21157,53261,443,44593,443,allow,5025,973,4052,19,53,10,9
21158,51939,53,4042,53,allow,222,94,128,2,30,1,1
21159,65403,53,26978,53,allow,178,94,84,2,30,1,1
21160,53258,443,7093,443,allow,5124,979,4145,19,54,10,9
21161,53249,443,44486,443,allow,11150,2012,9138,29,67,14,15
21162,65026,53,30024,53,allow,193,102,91,2,30,1,1
21163,59868,443,9732,443,allow,6869,3351,3518,22,135,11,11
21164,49942,53,17734,53,allow,741,94,647,2,30,1,1
21165,64271,53,22789,53,allow,198,94,104,2,30,1,1
21166,49290,53,29478,53,allow,184,94,90,2,30,1,1
21167,49160,6889,59737,6889,allow,834,150,684,4,1200,2,2
21168,60462,47821,9617,47821,allow,70,70,0,1,5,1,0
21169,57537,443,24448,443,allow,130,70,60,3,5,2,1
21170,27005,27017,7414,27017,allow,882,126,756,2,30,1,1
21171,63069,443,57757,443,allow,2523249,58976,2464273,2483,33,820,1663
21172,53264,443,4162,443,allow,41321,1491,39830,52,41,15,37
21173,53262,443,44480,443,allow,7608,1340,6268,27,53,13,14
21174,49762,443,52270,443,allow,7479,2226,5253,29,151,15,14
21175,49939,53,35576,53,allow,229,102,127,2,30,1,1
21176,64444,53,10743,53,allow,183,94,89,2,30,1,1
21177,55058,80,17892,80,allow,48751,3044,45707,57,60,23,34
21178,50723,80,33475,80,allow,1546,1109,437,7,15,5,2
21179,53036,80,53036,80,allow,2954,720,2234,13,143,6,7
21180,50912,443,13273,443,allow,5159,1080,4079,20,255,10,10
21181,60420,443,16410,443,allow,7330,1565,5765,20,134,10,10
21182,45885,80,47215,80,allow,23259,2769,20490,36,143,19,17
21183,56937,7150,12270,7150,allow,126,126,0,1,30,1,0
21184,27005,27015,1536,27015,allow,883,126,757,2,30,1,1
21185,53242,443,3574,443,allow,5993,974,5019,19,70,10,9
21186,56433,53,24075,53,allow,210,110,100,2,30,1,1
21187,63991,53,7605,53,allow,193,102,91,2,30,1,1
21188,65403,53,51244,53,allow,178,94,84,2,30,1,1
21189,40428,53,46586,53,allow,168,78,90,2,30,1,1
21190,56462,53,3765,53,allow,168,78,90,2,30,1,1
21191,56327,53,4067,53,allow,178,94,84,2,30,1,1
21192,61387,443,3059,443,allow,12231,6846,5385,38,160,19,19
21193,51738,7000,51738,7000,allow,3550,1983,1567,15,16,8,7
21194,63992,53,19496,53,allow,199,102,97,2,30,1,1
21195,55273,53,2212,53,allow,168,78,90,2,30,1,1
21196,64567,53,13390,53,allow,193,102,91,2,30,1,1
21197,53259,443,63565,443,allow,27501,3878,23623,57,54,24,33
21198,53243,443,50839,443,allow,242426,7999,234427,277,70,100,177
21199,48694,123,37842,123,allow,184,94,90,2,30,1,1
21200,49595,53,24473,53,allow,180,94,86,2,30,1,1
21201,64396,53,16886,53,allow,231,102,129,2,30,1,1
21202,55387,53,41194,53,allow,164,86,78,2,30,1,1
21203,64290,53,18678,53,allow,196,102,94,2,31,1,1
21204,58781,443,55654,443,allow,6133,1655,4478,12,120,5,7
21205,50038,53,4648,53,allow,281,78,203,2,31,1,1
21206,51653,443,13431,443,allow,6660,1542,5118,21,305,11,10
21207,57291,53,29680,53,allow,178,94,84,2,30,1,1
21208,65293,53,30071,53,allow,349,110,239,2,30,1,1
21209,40204,40012,25675,40012,allow,148,86,62,2,30,1,1
21210,40204,40026,38971,40026,allow,148,86,62,2,30,1,1
21211,56938,53,56411,53,allow,199,102,97,2,31,1,1
21212,49776,53,15280,53,allow,289,92,197,4,31,2,2
21213,64034,53,39969,53,allow,194,102,92,2,31,1,1
21214,55569,443,40443,443,allow,8867,3511,5356,20,120,9,11
21215,34478,443,59065,443,allow,9107,2253,6854,22,185,11,11
21216,63789,443,32462,443,allow,4407024,140001,4267023,4628,124,1546,3082
21217,52055,20019,40122,20019,allow,316,136,180,6,7,3,3
21218,53826,10168,43672,10168,allow,70,70,0,1,5,1,0
21219,63985,43081,52828,43081,allow,70,70,0,1,5,1,0
21220,52048,44059,61296,44059,allow,258,70,188,4,8,2,2
21221,52050,31648,17402,31648,allow,70,70,0,2,8,2,0
21222,45720,443,24721,443,allow,1625,1038,587,14,26,8,6
21223,44885,443,54078,443,allow,1849,1130,719,17,38,9,8
21224,34431,443,7506,443,allow,1701,1048,653,15,39,8,7
21225,48008,443,47118,443,allow,10665,3059,7606,28,17,16,12
21226,53250,443,16467,443,allow,70319,5815,64504,146,67,52,94
21227,52049,52557,35035,52557,allow,70,70,0,2,8,2,0
21228,52051,29868,56419,29868,allow,70,70,0,2,8,2,0
21229,36403,443,54491,443,allow,1149,709,440,13,39,8,5
21230,51667,443,62904,443,allow,1203,703,500,14,42,8,6
21231,54188,443,5906,443,allow,2895,1646,1249,17,16,8,9
21232,57291,53,9525,53,allow,178,94,84,2,30,1,1
21233,58509,21247,0,0,deny,66,66,0,1,0,1,0
21234,63565,22114,0,0,deny,146,146,0,1,0,1,0
21235,16387,51369,0,0,deny,60,60,0,1,0,1,0
21236,39132,44847,0,0,deny,62,62,0,1,0,1,0
21237,42231,57470,0,0,deny,78,78,0,1,0,1,0
21238,50265,23,0,0,deny,60,60,0,1,0,1,0
21239,30280,37965,0,0,deny,66,66,0,1,0,1,0
21240,50729,445,0,0,drop,70,70,0,1,0,1,0
21241,50725,445,0,0,drop,70,70,0,1,0,1,0
21242,50712,445,0,0,drop,70,70,0,1,0,1,0
21243,50714,445,0,0,drop,70,70,0,1,0,1,0
21244,62285,445,0,0,drop,70,70,0,1,0,1,0
21245,53257,37450,0,0,deny,66,66,0,1,0,1,0
21246,38134,8497,0,0,deny,143,143,0,1,0,1,0
21247,11599,25174,0,0,deny,146,146,0,1,0,1,0
21248,55136,11392,0,0,deny,62,62,0,1,0,1,0
21249,62282,445,0,0,drop,70,70,0,1,0,1,0
21250,62471,445,0,0,drop,66,66,0,1,0,1,0
21251,62473,445,0,0,drop,66,66,0,1,0,1,0
21252,62470,445,0,0,drop,66,66,0,1,0,1,0
21253,58791,25174,0,0,deny,62,62,0,1,0,1,0
21254,59451,50584,0,0,deny,62,62,0,1,0,1,0
21255,64755,31573,0,0,deny,66,66,0,1,0,1,0
21256,62278,445,0,0,drop,70,70,0,1,0,1,0
21257,63813,26467,0,0,deny,66,66,0,1,0,1,0
21258,62277,445,0,0,drop,70,70,0,1,0,1,0
21259,50711,445,0,0,drop,70,70,0,1,0,1,0
21260,50707,445,0,0,drop,70,70,0,1,0,1,0
21261,50706,445,0,0,drop,70,70,0,1,0,1,0
21262,50700,445,0,0,drop,70,70,0,1,0,1,0
21263,50197,64147,0,0,deny,62,62,0,1,0,1,0
21264,42796,22114,0,0,deny,146,146,0,1,0,1,0
21265,39086,53733,0,0,deny,146,146,0,1,0,1,0
21266,62273,445,0,0,drop,70,70,0,1,0,1,0
21267,9528,44847,0,0,deny,62,62,0,1,0,1,0
21268,43891,8497,0,0,deny,148,148,0,1,0,1,0
21269,56328,36237,0,0,deny,66,66,0,1,0,1,0
21270,2422,62507,0,0,deny,66,66,0,1,0,1,0
21271,52781,57470,0,0,deny,66,66,0,1,0,1,0
21272,50851,25864,0,0,deny,74,74,0,1,0,1,0
21273,31281,57470,0,0,deny,145,145,0,1,0,1,0
21274,80,57411,0,0,deny,1514,1514,0,1,0,1,0
21275,16387,45121,0,0,deny,60,60,0,1,0,1,0
21276,62272,445,0,0,drop,70,70,0,1,0,1,0
21277,54048,25174,0,0,deny,66,66,0,1,0,1,0
21278,16387,41860,0,0,deny,60,60,0,1,0,1,0
21279,65015,22114,0,0,deny,66,66,0,1,0,1,0
21280,31738,51505,0,0,deny,62,62,0,1,0,1,0
21281,41908,1433,0,0,deny,60,60,0,1,0,1,0
21282,53567,64147,0,0,deny,66,66,0,1,0,1,0
21283,7423,22114,0,0,deny,62,62,0,1,0,1,0
21284,80,36466,0,0,deny,1514,1514,0,1,0,1,0
21285,50442,25174,0,0,deny,66,66,0,1,0,1,0
21286,24040,22114,0,0,deny,62,62,0,1,0,1,0
21287,7482,57470,0,0,deny,66,66,0,1,0,1,0
21288,50692,445,0,0,drop,70,70,0,1,0,1,0
21289,50690,445,0,0,drop,70,70,0,1,0,1,0
21290,50687,445,0,0,drop,70,70,0,1,0,1,0
21291,25469,81,0,0,deny,60,60,0,1,0,1,0
21292,46774,51050,0,0,deny,62,62,0,1,0,1,0
21293,62267,445,0,0,drop,70,70,0,1,0,1,0
21294,62459,445,0,0,drop,66,66,0,1,0,1,0
21295,34166,22114,0,0,deny,62,62,0,1,0,1,0
21296,61961,11392,0,0,deny,66,66,0,1,0,1,0
21297,13684,25174,0,0,deny,62,62,0,1,0,1,0
21298,27348,22114,0,0,deny,66,66,0,1,0,1,0
21299,56052,53,55355,53,allow,1392,85,1307,4,12,2,2
21300,49797,25174,0,0,deny,66,66,0,1,0,1,0
21301,26435,39004,0,0,deny,62,62,0,1,0,1,0
21302,14692,25174,0,0,deny,62,62,0,1,0,1,0
21303,22240,22114,0,0,deny,62,62,0,1,0,1,0
21304,62911,36237,0,0,deny,66,66,0,1,0,1,0
21305,30304,64147,0,0,deny,66,66,0,1,0,1,0
21306,35011,37965,0,0,deny,62,62,0,1,0,1,0
21307,50683,445,0,0,drop,70,70,0,1,0,1,0
21308,50682,445,0,0,drop,70,70,0,1,0,1,0
21309,7067,22114,0,0,deny,62,62,0,1,0,1,0
21310,44546,32468,0,0,deny,62,62,0,1,0,1,0
21311,63708,25174,0,0,deny,66,66,0,1,0,1,0
21312,26752,64147,0,0,deny,62,62,0,1,0,1,0
21313,55161,37807,0,0,deny,66,66,0,1,0,1,0
21314,62254,445,0,0,drop,70,70,0,1,0,1,0
21315,5,47993,0,0,deny,62,62,0,1,0,1,0
21316,62446,445,0,0,drop,66,66,0,1,0,1,0
21317,62442,445,0,0,drop,66,66,0,1,0,1,0
21318,63460,55160,0,0,deny,62,62,0,1,0,1,0
21319,62251,445,0,0,drop,70,70,0,1,0,1,0
21320,21108,25174,0,0,deny,62,62,0,1,0,1,0
21321,50673,445,0,0,drop,70,70,0,1,0,1,0
21322,50674,445,0,0,drop,70,70,0,1,0,1,0
21323,50672,445,0,0,deny,70,70,0,1,0,1,0
21324,50663,445,0,0,drop,70,70,0,1,0,1,0
21325,56131,37807,0,0,deny,62,62,0,1,0,1,0
21326,55130,25174,0,0,deny,66,66,0,1,0,1,0
21327,30861,46783,0,0,deny,62,62,0,1,0,1,0
21328,62440,445,0,0,drop,66,66,0,1,0,1,0
21329,49540,50584,0,0,deny,66,66,0,1,0,1,0
21330,54166,25174,0,0,deny,66,66,0,1,0,1,0
21331,59745,25174,0,0,deny,146,146,0,1,0,1,0
21332,62247,445,0,0,drop,70,70,0,1,0,1,0
21333,52471,22114,0,0,deny,62,62,0,1,0,1,0
21334,62245,445,0,0,drop,70,70,0,1,0,1,0
21335,62433,445,0,0,drop,66,66,0,1,0,1,0
21336,62423,445,0,0,drop,66,66,0,1,0,1,0
21337,62434,445,0,0,drop,66,66,0,1,0,1,0
21338,62431,445,0,0,drop,66,66,0,1,0,1,0
21339,62425,445,0,0,drop,66,66,0,1,0,1,0
21340,62424,445,0,0,drop,66,66,0,1,0,1,0
21341,44285,25174,0,0,deny,62,62,0,1,0,1,0
21342,62243,445,0,0,drop,70,70,0,1,0,1,0
21343,50659,445,0,0,drop,70,70,0,1,0,1,0
21344,50655,445,0,0,drop,70,70,0,1,0,1,0
21345,50652,445,0,0,drop,70,70,0,1,0,1,0
21346,50651,445,0,0,drop,70,70,0,1,0,1,0
21347,59949,44847,0,0,deny,66,66,0,1,0,1,0
21348,63840,36829,0,0,deny,62,62,0,1,0,1,0
21349,19330,25174,0,0,deny,62,62,0,1,0,1,0
21350,52024,25174,0,0,deny,66,66,0,1,0,1,0
21351,51155,56205,0,0,deny,62,62,0,1,0,1,0
21352,7877,22114,0,0,deny,66,66,0,1,0,1,0
21353,63347,25174,0,0,deny,66,66,0,1,0,1,0
21354,8903,23,0,0,deny,60,60,0,1,0,1,0
21355,18061,25174,0,0,deny,62,62,0,1,0,1,0
21356,6881,37965,0,0,deny,146,146,0,1,0,1,0
21357,51834,35440,0,0,deny,66,66,0,1,0,1,0
21358,6666,138,0,0,deny,60,60,0,1,0,1,0
21359,45144,25174,0,0,deny,62,62,0,1,0,1,0
21360,17676,23,0,0,deny,60,60,0,1,0,1,0
21361,62236,445,0,0,drop,70,70,0,1,0,1,0
21362,51609,37807,0,0,deny,66,66,0,1,0,1,0
21363,3800,5223,0,0,deny,146,146,0,1,0,1,0
21364,62234,445,0,0,drop,70,70,0,1,0,1,0
21365,50648,445,0,0,drop,70,70,0,1,0,1,0
21366,50647,445,0,0,drop,70,70,0,1,0,1,0
21367,50645,445,0,0,drop,70,70,0,1,0,1,0
21368,21542,57470,0,0,deny,74,74,0,1,0,1,0
21369,62418,445,0,0,drop,66,66,0,1,0,1,0
21370,50642,445,0,0,drop,70,70,0,1,0,1,0
21371,62413,445,0,0,drop,66,66,0,1,0,1,0
21372,62233,445,0,0,drop,70,70,0,1,0,1,0
21373,6666,990,0,0,deny,60,60,0,1,0,1,0
21374,62232,445,0,0,drop,70,70,0,1,0,1,0
21375,62411,445,0,0,drop,66,66,0,1,0,1,0
21376,62410,445,0,0,drop,66,66,0,1,0,1,0
21377,62231,445,0,0,drop,70,70,0,1,0,1,0
21378,61400,64147,0,0,deny,66,66,0,1,0,1,0
21379,6036,51505,0,0,deny,66,66,0,1,0,1,0
21380,62225,445,0,0,drop,70,70,0,1,0,1,0
21381,62229,445,0,0,drop,70,70,0,1,0,1,0
21382,62885,62413,0,0,deny,66,66,0,1,0,1,0
21383,63474,48817,0,0,deny,66,66,0,1,0,1,0
21384,62409,445,0,0,drop,66,66,0,1,0,1,0
21385,59988,64147,0,0,deny,66,66,0,1,0,1,0
21386,32704,25174,0,0,deny,62,62,0,1,0,1,0
21387,45964,3111,0,0,deny,60,60,0,1,0,1,0
21388,62408,50584,0,0,deny,62,62,0,1,0,1,0
21389,62637,42873,0,0,deny,66,66,0,1,0,1,0
21390,51396,56205,0,0,deny,66,66,0,1,0,1,0
21391,61738,2767,0,0,deny,66,66,0,1,0,1,0
21392,7811,44847,0,0,deny,62,62,0,1,0,1,0
21393,8229,22114,0,0,deny,66,66,0,1,0,1,0
21394,23021,25174,0,0,deny,66,66,0,1,0,1,0
21395,62213,445,0,0,drop,70,70,0,1,0,1,0
21396,62212,445,0,0,drop,70,70,0,1,0,1,0
21397,50637,445,0,0,drop,70,70,0,1,0,1,0
21398,62210,445,0,0,drop,70,70,0,1,0,1,0
21399,51999,37965,0,0,deny,62,62,0,1,0,1,0
21400,39195,25174,0,0,deny,62,62,0,1,0,1,0
21401,62202,445,0,0,drop,70,70,0,1,0,1,0
21402,62203,445,0,0,drop,70,70,0,1,0,1,0
21403,54828,53,54828,53,allow,404,259,145,3,33,2,1
21404,37460,443,43570,443,allow,5674,3900,1774,29,80,15,14
21405,55040,443,30969,443,allow,15722,5108,10614,39,16,22,17
21406,49337,443,20876,443,allow,3185,2263,922,18,26,9,9
21407,39966,53,39966,53,allow,235,90,145,2,32,1,1
21408,61817,80,50485,80,allow,3373,591,2782,11,45,6,5
21409,55692,18319,26451,18319,allow,320,140,180,6,7,3,3
21410,57125,53,40271,53,allow,745,93,652,2,30,1,1
21411,27005,27017,4986,27017,allow,881,126,755,2,30,1,1
21412,27005,27015,43445,27015,allow,882,126,756,2,30,1,1
21413,27721,53,27721,53,allow,404,259,145,3,32,2,1
21414,58849,443,61655,443,allow,36920,24591,12329,80,24,47,33
21415,58993,443,47340,443,allow,6414,1614,4800,24,17,13,11
21416,52190,80,11921,80,allow,3223,843,2380,12,30,7,5
21417,49511,443,49511,443,allow,150713,27113,123600,199,82,104,95
21418,53246,443,31450,443,allow,6066,1046,5020,20,69,11,9
21419,53247,443,42679,443,allow,7461,1789,5672,25,69,14,11
21420,54828,443,24747,443,allow,6296,1556,4740,22,16,12,10
21421,46423,443,25968,443,allow,1340,760,580,14,39,8,6
21422,45627,443,27902,443,allow,6410,1610,4800,24,17,13,11
21423,52034,48856,38527,48856,allow,66,66,0,1,5,1,0
21424,61818,80,36349,80,allow,4454,591,3863,12,45,6,6
21425,49377,443,6065,443,allow,6350,1550,4800,23,19,12,11
21426,32782,80,6482,80,allow,1495,779,716,10,30,6,4
21427,54306,443,48186,443,allow,6376,1576,4800,24,19,13,11
21428,53241,443,12408,443,allow,6058,1038,5020,20,69,11,9
21429,56708,443,9469,443,allow,6155,919,5236,18,55,10,8
21430,53240,443,55808,443,allow,14932,1671,13261,31,69,15,16
21431,46424,443,29456,443,allow,1340,760,580,14,39,8,6
21432,58899,443,33038,443,allow,3690,2585,1105,17,16,9,8
21433,27345,53,27345,53,allow,398,255,143,3,33,2,1
21434,41858,443,41858,443,allow,4350,1443,2907,19,26,11,8
21435,53155,28206,56023,28206,allow,70,70,0,1,5,1,0
21436,46780,443,9186,443,allow,9801,3049,6752,29,20,15,14
21437,61816,80,7127,80,allow,2058,589,1469,10,45,6,4
21438,61815,80,10742,80,allow,4268,653,3615,13,45,7,6
21439,49320,443,28886,443,allow,2371,1839,532,14,45,8,6
21440,49846,443,49846,443,allow,4693,1786,2907,19,27,11,8
21441,56938,53,41054,53,allow,198,101,97,2,30,1,1
21442,51539,443,4046,443,allow,6359,1559,4800,24,19,13,11
21443,49636,443,58848,443,allow,9790,1841,7949,24,136,12,12
21444,64798,53,2925,53,allow,172,88,84,2,30,1,1
21445,51594,53,0,0,allow,206,95,111,2,31,1,1
21446,54306,443,20116,443,allow,13053,5216,7837,25,135,11,14
21447,60985,443,19268,443,allow,20423,4091,16332,33,122,15,18
21448,37736,443,59185,443,allow,16925,11562,5363,36,363,19,17
21449,44361,443,44674,443,allow,424,210,214,7,132,4,3
21450,50792,443,51398,443,allow,144115,19017,125098,229,400,112,117
21451,6881,6889,31599,6889,allow,221,111,110,2,1200,1,1
21452,21133,8535,17822,8535,allow,490,149,341,2,1200,1,1
21453,50633,445,0,0,drop,70,70,0,1,0,1,0
21454,50625,445,0,0,drop,70,70,0,1,0,1,0
21455,50251,35440,0,0,deny,66,66,0,1,0,1,0
21456,27677,22114,0,0,deny,62,62,0,1,0,1,0
21457,7210,22114,0,0,deny,66,66,0,1,0,1,0
21458,62397,445,0,0,drop,66,66,0,1,0,1,0
21459,58303,22114,0,0,deny,62,62,0,1,0,1,0
21460,60786,25174,0,0,deny,66,66,0,1,0,1,0
21461,60806,51050,0,0,deny,62,62,0,1,0,1,0
21462,56067,25174,0,0,deny,146,146,0,1,0,1,0
21463,34932,38608,0,0,deny,62,62,0,1,0,1,0
21464,25600,23684,0,0,deny,159,159,0,1,0,1,0
21465,59147,25174,0,0,deny,62,62,0,1,0,1,0
21466,54438,62413,0,0,deny,66,66,0,1,0,1,0
21467,46492,50584,0,0,deny,62,62,0,1,0,1,0
21468,62191,445,0,0,drop,70,70,0,1,0,1,0
21469,62390,445,0,0,drop,66,66,0,1,0,1,0
21470,50615,445,0,0,drop,70,70,0,1,0,1,0
21471,59324,17,0,0,deny,60,60,0,1,0,1,0
21472,1537,22114,0,0,deny,146,146,0,1,0,1,0
21473,62388,445,0,0,drop,66,66,0,1,0,1,0
21474,47727,25174,0,0,deny,62,62,0,1,0,1,0
21475,62187,445,0,0,drop,70,70,0,1,0,1,0
21476,46162,25174,0,0,deny,146,146,0,1,0,1,0
21477,54021,25174,0,0,deny,146,146,0,1,0,1,0
21478,62381,445,0,0,drop,66,66,0,1,0,1,0
21479,41541,25174,0,0,deny,66,66,0,1,0,1,0
21480,22530,25174,0,0,deny,62,62,0,1,0,1,0
21481,19944,22114,0,0,deny,66,66,0,1,0,1,0
21482,62373,445,0,0,drop,66,66,0,1,0,1,0
21483,62175,445,0,0,drop,70,70,0,1,0,1,0
21484,62177,445,0,0,drop,70,70,0,1,0,1,0
21485,62178,445,0,0,drop,70,70,0,1,0,1,0
21486,6461,25174,0,0,deny,66,66,0,1,0,1,0
21487,62173,445,0,0,drop,70,70,0,1,0,1,0
21488,34674,41864,0,0,deny,145,145,0,1,0,1,0
21489,56720,443,60130,443,allow,4989,1014,3975,16,53,9,7
21490,58901,443,21819,443,allow,5168,700,4468,16,15,7,9
21491,63969,57635,11400,57635,allow,504,382,122,8,17,6,2
21492,27005,27015,53679,27015,allow,894,126,768,2,30,1,1
21493,64137,53,46613,53,allow,276,126,150,2,30,1,1
21494,54492,80,36549,80,allow,1384,937,447,9,360,5,4
21495,53245,443,58724,443,allow,4595,1038,3557,19,69,11,8
21496,51535,443,24359,443,allow,322,262,60,2,4,1,1
21497,53825,58968,36842,58968,allow,70,70,0,1,4,1,0
21498,55159,53,49513,53,allow,199,102,97,2,29,1,1
21499,40204,40010,8959,40010,allow,148,86,62,2,29,1,1
21500,56927,53,35589,53,allow,183,94,89,2,30,1,1
21501,56936,53,1448,53,allow,244,94,150,2,30,1,1
21502,53248,443,8243,443,allow,5995,974,5021,19,66,10,9
21503,53256,443,33969,443,allow,6181,1040,5141,22,65,11,11
21504,53239,443,57625,443,allow,84664,6099,78565,140,70,56,84
21505,53254,443,6395,443,allow,310549,9420,301129,339,65,122,217
21506,53251,443,19794,443,allow,5025,973,4052,19,66,10,9
21507,53257,443,20854,443,allow,7422,1563,5859,32,53,15,17
21508,47950,443,47950,443,allow,9159,1627,7532,19,150,11,8
21509,53255,443,13217,443,allow,6244,1104,5140,23,65,12,11
21510,63062,443,18661,443,allow,26697,7168,19529,74,213,39,35
21511,45386,5222,47309,5222,allow,4579,2357,2222,46,114,26,20
21512,36405,443,39201,443,allow,1149,709,440,13,38,8,5
21513,41832,5222,27749,5222,allow,3823,1878,1945,39,309,22,17
21514,34429,443,39079,443,allow,1701,1048,653,15,38,8,7
21515,48936,443,24863,443,allow,494,280,214,8,49,5,3
21516,45721,443,58682,443,allow,1925,1120,805,16,25,9,7
21517,51671,443,38152,443,allow,1143,703,440,13,38,8,5
21518,42804,80,7713,80,allow,1115,534,581,12,15,7,5
21519,40102,443,45271,443,allow,29714,2090,27624,43,97,17,26
21520,56664,80,50394,80,allow,234,234,0,4,11,4,0
21521,33827,443,18177,443,allow,696,152,544,11,48,3,8
21522,53827,5889,39241,5889,allow,70,70,0,1,4,1,0
21523,60627,443,41376,443,allow,5663,1711,3952,22,17,13,9
21524,56433,53,33860,53,allow,210,110,100,2,29,1,1
21525,64034,53,38664,53,allow,194,102,92,2,29,1,1
21526,65487,53,2041,53,allow,210,110,100,2,29,1,1
21527,64238,53,7198,53,allow,211,102,109,2,29,1,1
21528,55159,53,25315,53,allow,199,102,97,2,29,1,1
21529,56327,53,21642,53,allow,178,94,84,2,29,1,1
21530,56240,53,1263,53,allow,226,94,132,2,29,1,1
21531,55387,53,44046,53,allow,172,94,78,2,29,1,1
21532,65487,53,41710,53,allow,210,110,100,2,29,1,1
21533,56534,53,33541,53,allow,276,94,182,2,30,1,1
21534,56938,53,31467,53,allow,452,101,351,4,36,2,2
21535,54772,443,51519,443,allow,3388,894,2494,19,154,8,11
21536,49834,443,52390,443,allow,8332,3418,4914,31,95,17,14
21537,27005,27016,5470,27016,allow,879,126,753,2,30,1,1
21538,50647,443,3164,443,allow,3201,1812,1389,15,19,9,6
21539,12573,53,12573,53,allow,235,90,145,2,32,1,1
21540,37998,49152,32246,49152,allow,156,156,0,3,8,3,0
21541,37567,443,51638,443,allow,13774,4989,8785,35,51,20,15
21542,39133,5223,14877,5223,allow,4113,1213,2900,22,713,12,10
21543,59911,80,3482,80,allow,2025658,45348,1980310,1992,44,640,1352
21544,48844,443,50866,443,allow,36383,29447,6936,103,163,51,52
21545,53812,45694,7999,45694,allow,3156,1011,2145,16,16,8,8
21546,57442,66,49848,66,allow,70,70,0,2,8,2,0
21547,49620,443,22598,443,allow,4565,3479,1086,13,138,8,5
21548,50642,80,53491,80,allow,27013,3578,23435,36,21,15,21
21549,27005,27015,27381,27015,allow,887,126,761,2,30,1,1
21550,50351,80,28696,80,allow,1083,653,430,8,15,5,3
21551,64331,53,13624,53,allow,226,110,116,2,30,1,1
21552,64874,53,59017,53,allow,323,110,213,2,30,1,1
21553,49541,53,16544,53,allow,745,215,530,6,51,3,3
21554,37575,443,11902,443,allow,11095,3227,7868,30,47,17,13
21555,49969,53,31598,53,allow,199,102,97,2,30,1,1
21556,36843,443,62939,443,allow,1988,1348,640,16,30,9,7
21557,59928,80,12349,80,allow,5755,3943,1812,24,31,13,11
21558,64404,53,27516,53,allow,250,102,148,2,30,1,1
21559,55543,53,20770,53,allow,402,118,284,2,30,1,1
21560,56327,53,13541,53,allow,178,94,84,2,30,1,1
21561,27005,27018,44540,27018,allow,882,126,756,2,30,1,1
21562,59595,53,23581,53,allow,164,78,86,2,30,1,1
21563,54461,443,55522,443,allow,7548,2583,4965,26,362,12,14
21564,62336,443,4923,443,allow,8217,2075,6142,31,76,15,16
21565,65344,53,52002,53,allow,190,90,100,3,60,2,1
21566,55875,53,25979,53,allow,296,110,186,2,30,1,1
21567,27005,27015,38295,27015,allow,874,126,748,2,30,1,1
21568,60399,443,57774,443,allow,8061,1926,6135,24,361,11,13
21569,59948,80,1436,80,allow,1756,414,1342,12,15,6,6
21570,56725,443,7873,443,allow,6481,972,5509,17,52,10,7
21571,55374,25,55374,25,allow,130,66,64,2,5,1,1
21572,50653,80,52730,80,allow,1658,1247,411,8,15,5,3
21573,34953,443,6409,443,allow,9415,3482,5933,57,16,29,28
21574,53460,443,30062,443,allow,30688,2660,28028,51,31,23,28
21575,65487,53,56832,53,allow,210,110,100,2,30,1,1
21576,64798,53,7114,53,allow,178,94,84,2,30,1,1
21577,64078,443,31734,443,allow,4458,1569,2889,24,138,10,14
21578,53136,443,65509,443,allow,3028365,2245986,782379,11999,627,7647,4352
21579,53260,443,48140,443,allow,4885,983,3902,21,53,10,11
21580,51670,443,38480,443,allow,1203,703,500,14,38,8,6
21581,33147,443,60062,443,allow,7639,948,6691,25,395,9,16
21582,36406,443,50079,443,allow,1149,709,440,13,38,8,5
21583,54354,443,10906,443,allow,18848,10436,8412,42,33,20,22
21584,60575,443,23365,443,allow,5994,1594,4400,23,42,12,11
21585,36407,443,52772,443,allow,1149,709,440,13,38,8,5
21586,53244,443,63773,443,allow,57649,2489,55160,66,69,23,43
21587,5588,5588,0,0,allow,3354,1792,1562,46,194,23,23
21588,34430,443,8333,443,allow,1701,1048,653,15,38,8,7
21589,10013,443,27326,443,allow,10336,4760,5576,37,315,18,19
21590,43726,443,52371,443,allow,1201,707,494,12,35,7,5
21591,53828,51354,58095,51354,allow,70,70,0,1,4,1,0
21592,54017,443,16478,443,allow,33220,3819,29401,77,255,39,38
21593,53824,41482,6861,41482,allow,70,70,0,1,4,1,0
21594,49624,443,29597,443,allow,2899,1813,1086,12,136,7,5
21595,63140,30685,24929,30685,allow,70,70,0,1,5,1,0
21596,53158,17234,26675,17234,allow,70,70,0,2,8,2,0
21597,63999,53,50492,53,allow,193,102,91,2,29,1,1
21598,50990,53,51984,53,allow,232,94,138,2,29,1,1
21599,56938,53,8399,53,allow,199,102,97,2,29,1,1
21600,62339,443,17791,443,allow,9125,2616,6509,30,76,14,16
21601,50717,80,28545,80,allow,1649,963,686,7,15,5,2
21602,59926,80,37542,80,allow,2615,830,1785,10,32,6,4
21603,53458,443,17930,443,allow,144165,6110,138055,170,31,67,103
21604,50949,80,11302,80,allow,942,527,415,11,342,6,5
21605,49498,443,65049,443,allow,5394,2785,2609,14,134,7,7
21606,39639,80,40156,80,allow,1143,401,742,9,360,5,4
21607,60329,443,10695,443,allow,2859,1499,1360,20,315,10,10
21608,51472,80,52276,80,allow,1410,797,613,10,302,6,4
21609,55532,80,33980,80,allow,12971,971,12000,22,15,12,10
21610,62322,80,60035,80,allow,384,384,0,7,34,7,0
21611,56256,80,30485,80,allow,25043,1750,23293,44,30,23,21
21612,64290,53,4027,53,allow,302,98,204,4,47,2,2
21613,56927,53,57127,53,allow,183,94,89,2,30,1,1
21614,64798,53,14494,53,allow,178,94,84,2,30,1,1
21615,56732,443,47503,443,allow,6205,986,5219,16,48,10,6
21616,64584,443,62186,443,allow,24682,1935,22747,36,19,17,19
21617,64034,53,27312,53,allow,194,102,92,2,30,1,1
21618,49969,53,27742,53,allow,199,102,97,2,30,1,1
21619,33148,443,29475,443,allow,7639,948,6691,25,395,9,16
21620,6881,6881,37501,6881,allow,259,150,109,2,1200,1,1
21621,61542,443,4330,443,allow,6049,1986,4063,23,19,12,11
21622,37997,49152,15013,49152,allow,156,156,0,3,8,3,0
21623,49700,443,48800,443,allow,64,64,0,2,5,2,0
21624,59931,80,27664,80,allow,1272,786,486,8,31,5,3
21625,53811,8999,57709,8999,allow,1322,799,523,13,16,8,5
21626,60868,80,60868,80,allow,5973,779,5194,17,16,9,8
21627,50950,80,33535,80,allow,942,527,415,11,342,6,5
21628,64290,53,4374,53,allow,196,102,94,2,30,1,1
21629,65065,53,58024,53,allow,209,110,99,2,30,1,1
21630,63241,443,59120,443,allow,5248,2550,2698,21,178,10,11
21631,36821,443,62805,443,allow,6164,3172,2992,28,141,12,16
21632,36674,443,40100,443,allow,11882,3450,8432,39,120,19,20
21633,57470,6969,5895,6969,allow,132,132,0,3,1199,3,0
21634,46031,443,52828,443,allow,12395,2182,10213,21,122,10,11
21635,61546,443,4493,443,allow,208,60,148,4,13,2,2
21636,53225,443,9099,443,allow,6597,1798,4799,28,80,12,16
21637,50348,80,25254,80,allow,4929,2773,2156,17,42,9,8
21638,53841,8999,55229,8999,allow,70,70,0,2,8,2,0
21639,52867,443,11328,443,allow,15730,2196,13534,32,436,17,15
21640,62311,443,64602,443,allow,598,598,0,8,41,8,0
21641,52056,50328,8366,50328,allow,70,70,0,1,5,1,0
21642,50344,80,51584,80,allow,3132,730,2402,13,42,7,6
21643,50216,443,23002,443,allow,6796,1796,5000,26,257,14,12
21644,49690,53,46468,53,allow,198,94,104,2,30,1,1
21645,1030,64147,0,0,deny,62,62,0,1,0,1,0
21646,62170,445,0,0,drop,70,70,0,1,0,1,0
21647,60104,30188,0,0,deny,66,66,0,1,0,1,0
21648,51560,46783,0,0,deny,66,66,0,1,0,1,0
21649,26658,25174,0,0,deny,62,62,0,1,0,1,0
21650,42231,57470,0,0,deny,78,78,0,1,0,1,0
21651,59696,57470,0,0,deny,62,62,0,1,0,1,0
21652,50606,445,0,0,drop,70,70,0,1,0,1,0
21653,50605,445,0,0,drop,70,70,0,1,0,1,0
21654,50603,445,0,0,drop,70,70,0,1,0,1,0
21655,47256,37807,0,0,deny,62,62,0,1,0,1,0
21656,62365,445,0,0,drop,66,66,0,1,0,1,0
21657,62363,445,0,0,drop,66,66,0,1,0,1,0
21658,62361,445,0,0,drop,66,66,0,1,0,1,0
21659,62362,445,0,0,drop,66,66,0,1,0,1,0
21660,62360,445,0,0,drop,66,66,0,1,0,1,0
21661,62364,445,0,0,drop,66,66,0,1,0,1,0
21662,62359,445,0,0,drop,66,66,0,1,0,1,0
21663,62358,445,0,0,drop,66,66,0,1,0,1,0
21664,62164,445,0,0,drop,70,70,0,1,0,1,0
21665,41490,25174,0,0,deny,62,62,0,1,0,1,0
21666,51705,22114,0,0,deny,62,62,0,1,0,1,0
21667,60403,22114,0,0,deny,66,66,0,1,0,1,0
21668,36641,25174,0,0,deny,66,66,0,1,0,1,0
21669,64214,25174,0,0,deny,66,66,0,1,0,1,0
21670,23763,23,0,0,deny,60,60,0,1,0,1,0
21671,62157,445,0,0,drop,70,70,0,1,0,1,0
21672,53197,25174,0,0,deny,66,66,0,1,0,1,0
21673,62156,445,0,0,drop,70,70,0,1,0,1,0
21674,54769,50584,0,0,deny,62,62,0,1,0,1,0
21675,52925,64147,0,0,deny,62,62,0,1,0,1,0
21676,52340,64147,0,0,deny,66,66,0,1,0,1,0
21677,50596,445,0,0,drop,70,70,0,1,0,1,0
21678,50597,445,0,0,drop,70,70,0,1,0,1,0
21679,50589,445,0,0,drop,70,70,0,1,0,1,0
21680,50584,445,0,0,drop,70,70,0,1,0,1,0
21681,53470,22114,0,0,deny,66,66,0,1,0,1,0
21682,16454,25174,0,0,deny,66,66,0,1,0,1,0
21683,62345,445,0,0,drop,66,66,0,1,0,1,0
21684,62344,445,0,0,drop,66,66,0,1,0,1,0
21685,62342,445,0,0,deny,66,66,0,1,0,1,0
21686,22924,25174,0,0,deny,62,62,0,1,0,1,0
21687,62150,445,0,0,drop,70,70,0,1,0,1,0
21688,50822,50584,0,0,deny,66,66,0,1,0,1,0
21689,62149,445,0,0,drop,70,70,0,1,0,1,0
21690,62813,25174,0,0,deny,62,62,0,1,0,1,0
21691,50046,22114,0,0,deny,66,66,0,1,0,1,0
21692,58914,37965,0,0,deny,66,66,0,1,0,1,0
21693,50582,445,0,0,drop,70,70,0,1,0,1,0
21694,63878,22114,0,0,deny,62,62,0,1,0,1,0
21695,26717,25174,0,0,deny,62,62,0,1,0,1,0
21696,50574,445,0,0,drop,70,70,0,1,0,1,0
21697,50573,445,0,0,drop,70,70,0,1,0,1,0
21698,50572,445,0,0,drop,70,70,0,1,0,1,0
21699,52459,3399,0,0,deny,60,60,0,1,0,1,0
21700,62145,445,0,0,drop,70,70,0,1,0,1,0
21701,32736,22114,0,0,deny,66,66,0,1,0,1,0
21702,58511,50584,0,0,deny,62,62,0,1,0,1,0
21703,62144,445,0,0,drop,70,70,0,1,0,1,0
21704,2849,30188,0,0,deny,66,66,0,1,0,1,0
21705,32997,50584,0,0,deny,62,62,0,1,0,1,0
21706,27000,23117,0,0,deny,62,62,0,1,0,1,0
21707,25878,25174,0,0,deny,66,66,0,1,0,1,0
21708,20962,22114,0,0,deny,62,62,0,1,0,1,0
21709,54518,25174,0,0,deny,146,146,0,1,0,1,0
21710,62139,445,0,0,drop,70,70,0,1,0,1,0
21711,443,18177,0,0,deny,66,66,0,1,0,1,0
21712,50563,445,0,0,drop,70,70,0,1,0,1,0
21713,50561,445,0,0,drop,70,70,0,1,0,1,0
21714,50559,445,0,0,drop,70,70,0,1,0,1,0
21715,60260,22114,0,0,deny,66,66,0,1,0,1,0
21716,62331,445,0,0,drop,66,66,0,1,0,1,0
21717,6882,51505,0,0,deny,66,66,0,1,0,1,0
21718,55711,26467,0,0,deny,66,66,0,1,0,1,0
21719,51746,25174,0,0,deny,66,66,0,1,0,1,0
21720,58131,29072,0,0,deny,146,146,0,1,0,1,0
21721,43828,44847,0,0,deny,66,66,0,1,0,1,0
21722,50459,62413,0,0,deny,66,66,0,1,0,1,0
21723,50557,445,0,0,drop,70,70,0,1,0,1,0
21724,50556,445,0,0,drop,70,70,0,1,0,1,0
21725,62126,445,0,0,drop,70,70,0,1,0,1,0
21726,28286,22114,0,0,deny,62,62,0,1,0,1,0
21727,14397,37965,0,0,deny,62,62,0,1,0,1,0
21728,13285,29892,0,0,deny,145,145,0,1,0,1,0
21729,41197,30188,0,0,deny,62,62,0,1,0,1,0
21730,443,64347,0,0,deny,131,131,0,1,0,1,0
21731,3399,25174,0,0,deny,66,66,0,1,0,1,0
21732,15605,50265,0,0,deny,62,62,0,1,0,1,0
21733,62316,445,0,0,drop,66,66,0,1,0,1,0
21734,62315,445,0,0,drop,66,66,0,1,0,1,0
21735,62123,445,0,0,drop,70,70,0,1,0,1,0
21736,56127,37965,0,0,deny,66,66,0,1,0,1,0
21737,52038,50584,0,0,deny,66,66,0,1,0,1,0
21738,40312,55442,0,0,deny,62,62,0,1,0,1,0
21739,58627,25174,0,0,deny,62,62,0,1,0,1,0
21740,64190,2767,0,0,deny,66,66,0,1,0,1,0
21741,12700,57470,0,0,deny,145,145,0,1,0,1,0
21742,23131,25174,0,0,deny,62,62,0,1,0,1,0
21743,50547,445,0,0,drop,70,70,0,1,0,1,0
21744,50544,445,0,0,drop,70,70,0,1,0,1,0
21745,50543,445,0,0,drop,70,70,0,1,0,1,0
21746,50535,445,0,0,drop,70,70,0,1,0,1,0
21747,23131,25174,0,0,deny,146,146,0,1,0,1,0
21748,57284,22114,0,0,deny,66,66,0,1,0,1,0
21749,21119,31573,0,0,deny,146,146,0,1,0,1,0
21750,60823,25174,0,0,deny,66,66,0,1,0,1,0
21751,1943,48817,0,0,deny,66,66,0,1,0,1,0
21752,62309,445,0,0,drop,66,66,0,1,0,1,0
21753,62117,445,0,0,drop,70,70,0,1,0,1,0
21754,35450,23,0,0,deny,60,60,0,1,0,1,0
21755,62064,22114,0,0,deny,66,66,0,1,0,1,0
21756,64392,25174,0,0,deny,66,66,0,1,0,1,0
21757,29139,64147,0,0,deny,62,62,0,1,0,1,0
21758,62115,445,0,0,drop,70,70,0,1,0,1,0
21759,61523,37807,0,0,deny,66,66,0,1,0,1,0
21760,62306,445,0,0,drop,66,66,0,1,0,1,0
21761,62304,445,0,0,drop,66,66,0,1,0,1,0
21762,62303,445,0,0,drop,66,66,0,1,0,1,0
21763,62298,445,0,0,drop,66,66,0,1,0,1,0
21764,62295,445,0,0,drop,66,66,0,1,0,1,0
21765,62297,445,0,0,drop,66,66,0,1,0,1,0
21766,62296,445,0,0,drop,66,66,0,1,0,1,0
21767,28306,25604,0,0,deny,62,62,0,1,0,1,0
21768,60097,22114,0,0,deny,66,66,0,1,0,1,0
21769,45313,64147,0,0,deny,62,62,0,1,0,1,0
21770,42986,25174,0,0,deny,66,66,0,1,0,1,0
21771,50530,445,0,0,drop,70,70,0,1,0,1,0
21772,50527,445,0,0,drop,70,70,0,1,0,1,0
21773,50525,445,0,0,drop,70,70,0,1,0,1,0
21774,50523,445,0,0,drop,70,70,0,1,0,1,0
21775,45118,39004,0,0,deny,74,74,0,1,0,1,0
21776,36663,22114,0,0,deny,62,62,0,1,0,1,0
21777,48706,23393,0,0,deny,60,60,0,1,0,1,0
21778,57090,51505,0,0,deny,62,62,0,1,0,1,0
21779,59051,27520,0,0,deny,62,62,0,1,0,1,0
21780,19875,30170,0,0,deny,145,145,0,1,0,1,0
21781,62273,50584,0,0,deny,62,62,0,1,0,1,0
21782,50757,64147,0,0,deny,62,62,0,1,0,1,0
21783,34073,37965,0,0,deny,62,62,0,1,0,1,0
21784,36804,25174,0,0,deny,66,66,0,1,0,1,0
21785,62108,445,0,0,drop,70,70,0,1,0,1,0
21786,56289,25174,0,0,deny,66,66,0,1,0,1,0
21787,62106,445,0,0,drop,70,70,0,1,0,1,0
21788,17573,44847,0,0,deny,146,146,0,1,0,1,0
21789,59938,443,27868,443,allow,1820,1303,517,13,26,7,6
21790,47664,3389,47664,3389,allow,4575,2400,2175,20,19,11,9
21791,45551,443,26442,443,allow,7764,1734,6030,23,20,13,10
21792,55039,443,45987,443,allow,7993,677,7316,16,16,8,8
21793,62919,993,20862,993,allow,134,60,74,3,11,2,1
21794,49306,443,46343,443,allow,83411,4586,78825,94,47,30,64
21795,56425,53,0,0,allow,82,82,0,1,30,1,0
21796,58992,53,0,0,allow,273,86,187,2,30,1,1
21797,58129,80,58129,80,allow,23462,3780,19682,49,47,24,25
21798,49308,443,39770,443,allow,4256,2975,1281,23,47,12,11
21799,49309,443,31644,443,allow,4250,2969,1281,23,47,12,11
21800,54815,3389,54815,3389,allow,3428,1714,1714,16,32,8,8
21801,59945,80,11723,80,allow,1197,419,778,9,16,5,4
21802,49633,443,51430,443,allow,4348,911,3437,14,135,8,6
21803,27005,27019,44528,27019,allow,880,126,754,2,30,1,1
21804,65379,53,64746,53,allow,376,126,250,2,30,1,1
21805,55437,443,56917,443,allow,24415,1491,22924,34,131,14,20
21806,55085,443,57915,443,allow,5803,4960,843,19,124,11,8
21807,44739,443,37697,443,allow,6220,1790,4430,19,120,10,9
21808,57470,41071,64833,41071,allow,1716,1716,0,27,1598,27,0
21809,58643,443,8549,443,allow,4801,2506,2295,12,121,6,6
21810,36889,80,51153,80,allow,1584,1130,454,15,39,10,5
21811,58891,443,55777,443,allow,7641,5165,2476,25,18,13,12
21812,13095,80,13095,80,allow,32613,1160,31453,38,16,13,25
21813,52045,16853,65490,16853,allow,70,70,0,2,8,2,0
21814,44358,443,57886,443,allow,502,288,214,8,131,5,3
21815,53816,42459,30480,42459,allow,552,306,246,9,16,5,4
21816,64728,443,31234,443,allow,25423484,377367,25046117,21027,1082,2865,18162
21817,46862,15000,28105,15000,allow,130,70,60,2,5,1,1
21818,58970,443,57205,443,allow,3715,1958,1757,23,21,12,11
21819,50583,80,50583,80,allow,17375,11554,5821,52,27,32,20
21820,51594,53,0,0,allow,206,95,111,2,30,1,1
21821,50340,80,53882,80,allow,8924,872,8052,19,41,9,10
21822,61281,443,15563,443,allow,3169,979,2190,14,135,7,7
21823,50341,80,19405,80,allow,306,180,126,6,41,4,2
21824,43177,443,43177,443,allow,4493,1586,2907,19,26,11,8
21825,52031,20301,50759,20301,allow,66,66,0,1,5,1,0
21826,49647,53,49647,53,allow,404,259,145,3,32,2,1
21827,57602,443,32129,443,allow,7527,1788,5739,23,20,13,10
21828,35466,443,44428,443,allow,7409,1702,5707,23,20,13,10
21829,58889,443,6054,443,allow,7871,5455,2416,24,18,13,11
21830,27005,27016,63308,27016,allow,887,126,761,2,30,1,1
21831,50116,22,0,0,allow,60,60,0,1,90,1,0
21832,40410,443,37656,443,allow,2975,719,2256,14,136,7,7
21833,30960,45754,34064,45754,allow,396,396,0,7,3615,7,0
21834,50521,445,0,0,drop,70,70,0,1,0,1,0
21835,50517,445,0,0,drop,70,70,0,1,0,1,0
21836,50516,445,0,0,drop,70,70,0,1,0,1,0
21837,6889,65473,0,0,deny,143,143,0,1,0,1,0
21838,62105,445,0,0,drop,70,70,0,1,0,1,0
21839,62288,445,0,0,drop,66,66,0,1,0,1,0
21840,55554,22114,0,0,deny,62,62,0,1,0,1,0
21841,50514,445,0,0,drop,70,70,0,1,0,1,0
21842,62104,445,0,0,drop,70,70,0,1,0,1,0
21843,62103,445,0,0,drop,70,70,0,1,0,1,0
21844,62101,445,0,0,drop,70,70,0,1,0,1,0
21845,62099,445,0,0,drop,70,70,0,1,0,1,0
21846,62286,445,0,0,drop,66,66,0,1,0,1,0
21847,62283,445,0,0,drop,66,66,0,1,0,1,0
21848,62282,445,0,0,drop,66,66,0,1,0,1,0
21849,62281,445,0,0,drop,66,66,0,1,0,1,0
21850,47944,50584,0,0,deny,62,62,0,1,0,1,0
21851,61299,25174,0,0,deny,146,146,0,1,0,1,0
21852,57338,443,31270,443,allow,222159,52803,169356,361,26,173,188
21853,61550,5529,0,0,deny,145,145,0,1,0,1,0
21854,49164,25174,0,0,deny,62,62,0,1,0,1,0
21855,42285,57470,0,0,deny,62,62,0,1,0,1,0
21856,62085,445,0,0,drop,70,70,0,1,0,1,0
21857,62084,445,0,0,drop,70,70,0,1,0,1,0
21858,62082,445,0,0,drop,70,70,0,1,0,1,0
21859,26425,22114,0,0,deny,62,62,0,1,0,1,0
21860,62075,445,0,0,drop,70,70,0,1,0,1,0
21861,62074,445,0,0,drop,70,70,0,1,0,1,0
21862,44383,30188,0,0,deny,66,66,0,1,0,1,0
21863,49577,57470,0,0,deny,66,66,0,1,0,1,0
21864,50511,445,0,0,drop,70,70,0,1,0,1,0
21865,61140,27520,0,0,deny,62,62,0,1,0,1,0
21866,24144,57470,0,0,deny,62,62,0,1,0,1,0
21867,50500,445,0,0,drop,70,70,0,1,0,1,0
21868,50497,445,0,0,drop,70,70,0,1,0,1,0
21869,52230,50265,0,0,deny,66,66,0,1,0,1,0
21870,62269,445,0,0,drop,66,66,0,1,0,1,0
21871,27005,27015,25452,27015,allow,887,126,761,2,30,1,1
21872,34937,443,49817,443,allow,10059,2039,8020,23,186,12,11
21873,50265,43178,20188,43178,allow,481,150,331,2,1200,1,1
21874,63974,80,35530,80,allow,314,192,122,6,15,4,2
21875,50587,80,50587,80,allow,1711,1011,700,11,21,6,5
21876,62158,443,35160,443,allow,4975,2828,2147,14,135,7,7
21877,52052,27427,24815,27427,allow,316,136,180,6,6,3,3
21878,8917,443,55362,443,allow,7308,864,6444,26,394,9,17
21879,60461,10138,64431,10138,allow,70,70,0,1,5,1,0
21880,53365,80,32049,80,allow,405,285,120,5,15,3,2
21881,50346,80,22819,80,allow,502,250,252,9,41,5,4
21882,52047,42805,9664,42805,allow,164,70,94,3,7,2,1
21883,64798,53,32594,53,allow,303,88,215,4,40,2,2
21884,56927,53,28530,53,allow,183,94,89,2,29,1,1
21885,49578,53,60840,53,allow,212,102,110,2,29,1,1
21886,57103,53,61295,53,allow,193,102,91,2,29,1,1
21887,27005,27018,14110,27018,allow,881,126,755,2,30,1,1
21888,49508,53,61449,53,allow,370,102,268,2,30,1,1
21889,58856,80,5930,80,allow,1614,1300,314,10,15,5,5
21890,60026,443,10175,443,allow,8382,2454,5928,44,86,26,18
21891,60967,443,57765,443,allow,11529,8753,2776,41,120,22,19
21892,57089,53,62761,53,allow,226,110,116,2,30,1,1
21893,46831,53,55820,53,allow,391,102,289,2,30,1,1
21894,27005,27017,41161,27017,allow,883,126,757,2,30,1,1
21895,38698,443,50432,443,allow,90261,3545,86716,96,16,32,64
21896,60466,64337,52523,64337,allow,70,70,0,2,8,2,0
21897,36000,443,6421,443,allow,68705,5084,63621,93,172,36,57
21898,57341,443,25399,443,allow,7551,2807,4744,42,26,22,20
21899,36003,443,8954,443,allow,70007,4677,65330,92,172,36,56
21900,48742,443,35072,443,allow,5378,1423,3955,19,49,11,8
21901,53222,53,43522,53,allow,165,78,87,2,30,1,1
21902,53223,53,33950,53,allow,165,78,87,2,30,1,1
21903,27005,27015,43819,27015,allow,868,126,742,2,30,1,1
21904,53455,443,54035,443,allow,240325,8131,232194,262,31,100,162
21905,53457,443,28376,443,allow,26693,2059,24634,42,30,18,24
21906,64698,53,59784,53,allow,430,106,324,4,58,2,2
21907,49444,53,22362,53,allow,212,102,110,2,30,1,1
21908,55739,443,5145,443,allow,47102,3841,43261,59,121,25,34
21909,43112,443,57880,443,allow,7192,1772,5420,25,305,13,12
21910,63139,12311,39911,12311,allow,70,70,0,1,5,1,0
21911,52089,443,56891,443,allow,4408,801,3607,16,34,8,8
21912,57339,443,47908,443,allow,1495,768,727,16,26,9,7
21913,57345,443,32367,443,allow,55537,4477,51060,81,22,38,43
21914,52884,443,37471,443,allow,4466,1914,2552,32,116,18,14
21915,27005,27017,10039,27017,allow,891,126,765,2,30,1,1
21916,54324,27016,3441,27016,allow,924,924,0,3,30,3,0
21917,49429,443,33645,443,allow,8861,3484,5377,19,120,9,10
21918,37572,443,26829,443,allow,30365,21942,8423,58,50,32,26
21919,50343,80,37536,80,allow,1192,658,534,11,41,6,5
21920,50339,80,14820,80,allow,306,180,126,6,41,4,2
21921,53140,80,7687,80,allow,2560,2083,477,13,15,7,6
21922,49220,2710,39360,2710,allow,70,70,0,2,8,2,0
21923,58898,443,10940,443,allow,5108,700,4408,15,15,7,8
21924,52046,59791,37077,59791,allow,70,70,0,2,7,2,0
21925,62061,445,0,0,drop,70,70,0,1,0,1,0
21926,36548,25174,0,0,deny,62,62,0,1,0,1,0
21927,63895,44847,0,0,deny,62,62,0,1,0,1,0
21928,38093,11392,0,0,deny,62,62,0,1,0,1,0
21929,60419,61248,0,0,reset-both,145,145,0,1,0,1,0
21930,55338,11744,0,0,deny,145,145,0,1,0,1,0
21931,51023,443,24793,443,allow,26189,8238,17951,72,18,39,33
21932,50338,80,24125,80,allow,2475,723,1752,12,41,6,6
21933,58718,80,58718,80,allow,106571,3881,102690,128,16,56,72
21934,43169,443,5370,443,allow,8615,2156,6459,37,315,16,21
21935,6259,25,6259,25,allow,130,66,64,2,5,1,1
21936,37710,443,47259,443,allow,13986,9199,4787,59,94,24,35
21937,50759,443,24454,443,allow,19782,3596,16186,38,256,21,17
21938,53456,443,13197,443,allow,25555,2220,23335,44,30,20,24
21939,49219,51237,3510,51237,allow,624,318,306,10,15,5,5
21940,65384,443,21164,443,allow,8613,1465,7148,22,15,13,9
21941,57346,443,34868,443,allow,1547,960,587,14,22,8,6
21942,57599,80,28045,80,allow,808,485,323,8,75,5,3
21943,56512,443,45161,443,allow,155750,151462,4288,169,215,112,57
21944,49470,443,50216,443,allow,2772,1777,995,16,124,9,7
21945,57103,53,56809,53,allow,193,102,91,2,30,1,1
21946,43089,443,26098,443,allow,9737,6695,3042,45,81,24,21
21947,50586,80,50586,80,allow,5320,3428,1892,22,21,12,10
21948,27005,27015,24724,27015,allow,878,126,752,2,30,1,1
21949,50588,80,50588,80,allow,2765,1835,930,14,21,8,6
21950,53537,53,1672,53,allow,391,102,289,2,29,1,1
21951,56903,53,50850,53,allow,232,94,138,2,30,1,1
21952,49515,53,21422,53,allow,226,110,116,2,29,1,1
21953,54325,27016,47516,27016,allow,924,924,0,3,30,3,0
21954,54323,27016,29153,27016,allow,924,924,0,3,30,3,0
21955,54326,27054,42842,27054,allow,924,924,0,3,30,3,0
21956,58614,443,16756,443,allow,12164,4840,7324,29,198,16,13
21957,17750,60780,57502,60780,allow,481,150,331,2,1200,1,1
21958,49626,443,3697,443,allow,35474,2800,32674,56,135,27,29
21959,50589,80,50589,80,allow,1714,1014,700,11,21,6,5
21960,48735,443,54377,443,allow,77050,5353,71697,113,95,46,67
21961,27005,27015,60875,27015,allow,881,126,755,2,30,1,1
21962,55901,53,32764,53,allow,226,110,116,2,30,1,1
21963,63310,443,15095,443,allow,1481,701,780,20,120,10,10
21964,57288,443,16066,443,allow,7427,2084,5343,24,361,12,12
21965,1100,27540,45452,27540,allow,132,70,62,2,31,1,1
21966,53202,443,56977,443,allow,23323,1589,21734,27,85,10,17
21967,40492,1488,40492,1488,allow,156,156,0,3,8,3,0
21968,39771,443,64614,443,allow,6903,1273,5630,25,255,13,12
21969,7634,80,7634,80,allow,1845,523,1322,10,15,6,4
21970,35989,443,62539,443,allow,2840032,64781,2775251,2709,292,769,1940
21971,33894,80,31956,80,allow,1376,788,588,10,35,6,4
21972,37680,443,40317,443,allow,16742,3383,13359,57,309,28,29
21973,57344,53,44764,53,allow,228,110,118,2,30,1,1
21974,27005,27015,45199,27015,allow,892,126,766,2,30,1,1
21975,57398,53,47898,53,allow,232,110,122,2,30,1,1
21976,57344,443,31123,443,allow,30232,22633,7599,77,23,46,31
21977,60457,16881,27690,16881,allow,1948,891,1057,16,18,8,8
21978,53151,34935,46356,34935,allow,698,320,378,10,17,6,4
21979,49598,80,65095,80,allow,400,70,330,6,24,1,5
21980,38699,443,63342,443,allow,759586,14873,744713,719,16,209,510
21981,52094,443,12498,443,allow,2960,1982,978,15,16,9,6
21982,62481,80,55007,80,allow,890,440,450,10,33,6,4
21983,42732,53,10027,53,allow,86,86,0,1,30,1,0
21984,62187,443,25960,443,allow,36473,7710,28763,63,124,27,36
21985,6881,6881,34169,6881,allow,502,150,352,2,1200,1,1
21986,27005,27035,11763,27035,allow,891,126,765,2,31,1,1
21987,52029,52093,64487,52093,allow,70,70,0,1,5,1,0
21988,53819,9472,3134,9472,allow,70,70,0,1,5,1,0
21989,57427,443,63478,443,allow,5337,1085,4252,14,76,8,6
21990,65048,53,24505,53,allow,396,84,312,4,54,2,2
21991,63965,53,50907,53,allow,306,94,212,2,30,1,1
21992,27005,52013,10619,52013,allow,901,126,775,2,31,1,1
21993,65353,53,55498,53,allow,351,105,246,4,57,2,2
21994,63975,24874,47562,24874,allow,70,70,0,1,5,1,0
21995,45764,443,11581,443,allow,57543,2347,55196,68,16,26,42
21996,44864,25,44864,25,allow,130,66,64,2,5,1,1
21997,55012,64147,0,0,deny,62,62,0,1,0,1,0
21998,50734,37965,0,0,deny,62,62,0,1,0,1,0
21999,62769,25174,0,0,deny,62,62,0,1,0,1,0
22000,51414,22,0,0,deny,60,60,0,1,0,1,0
22001,62262,445,0,0,drop,66,66,0,1,0,1,0
22002,50487,445,0,0,drop,70,70,0,1,0,1,0
22003,63717,37965,0,0,deny,66,66,0,1,0,1,0
22004,3717,25174,0,0,deny,62,62,0,1,0,1,0
22005,62260,445,0,0,drop,66,66,0,1,0,1,0
22006,62057,445,0,0,drop,70,70,0,1,0,1,0
22007,42951,22114,0,0,deny,66,66,0,1,0,1,0
22008,22530,23718,0,0,deny,66,66,0,1,0,1,0
22009,62045,445,0,0,drop,70,70,0,1,0,1,0
22010,62048,445,0,0,drop,70,70,0,1,0,1,0
22011,64673,6881,0,0,deny,66,66,0,1,0,1,0
22012,62253,445,0,0,drop,66,66,0,1,0,1,0
22013,62044,445,0,0,drop,70,70,0,1,0,1,0
22014,62654,35440,0,0,deny,62,62,0,1,0,1,0
22015,62041,445,0,0,drop,70,70,0,1,0,1,0
22016,62245,445,0,0,drop,66,66,0,1,0,1,0
22017,51310,64147,0,0,deny,66,66,0,1,0,1,0
22018,52238,26467,0,0,deny,62,62,0,1,0,1,0
22019,65006,26467,0,0,deny,66,66,0,1,0,1,0
22020,50316,25604,0,0,deny,66,66,0,1,0,1,0
22021,23349,30188,0,0,deny,62,62,0,1,0,1,0
22022,63083,25174,0,0,deny,66,66,0,1,0,1,0
22023,7356,25174,0,0,deny,66,66,0,1,0,1,0
22024,51045,25174,0,0,deny,66,66,0,1,0,1,0
22025,50478,445,0,0,drop,70,70,0,1,0,1,0
22026,50474,445,0,0,drop,70,70,0,1,0,1,0
22027,50475,445,0,0,drop,70,70,0,1,0,1,0
22028,23710,41615,0,0,deny,145,145,0,1,0,1,0
22029,62035,445,0,0,drop,70,70,0,1,0,1,0
22030,62237,445,0,0,drop,66,66,0,1,0,1,0
22031,62230,445,0,0,drop,66,66,0,1,0,1,0
22032,62234,445,0,0,drop,66,66,0,1,0,1,0
22033,62233,445,0,0,drop,66,66,0,1,0,1,0
22034,62235,445,0,0,drop,66,66,0,1,0,1,0
22035,62236,445,0,0,drop,66,66,0,1,0,1,0
22036,62229,445,0,0,drop,66,66,0,1,0,1,0
22037,62231,445,0,0,drop,66,66,0,1,0,1,0
22038,14614,25174,0,0,deny,66,66,0,1,0,1,0
22039,51109,11392,0,0,deny,66,66,0,1,0,1,0
22040,52973,57470,0,0,deny,74,74,0,1,0,1,0
22041,35570,22114,0,0,deny,62,62,0,1,0,1,0
22042,61840,25174,0,0,deny,66,66,0,1,0,1,0
22043,16618,52952,0,0,deny,146,146,0,1,0,1,0
22044,24560,25174,0,0,deny,62,62,0,1,0,1,0
22045,21604,50201,0,0,deny,66,66,0,1,0,1,0
22046,62027,445,0,0,drop,70,70,0,1,0,1,0
22047,63878,22114,0,0,deny,146,146,0,1,0,1,0
22048,56249,55442,0,0,deny,66,66,0,1,0,1,0
22049,62558,20170,0,0,deny,145,145,0,1,0,1,0
22050,51769,51505,0,0,deny,62,62,0,1,0,1,0
22051,62025,445,0,0,drop,70,70,0,1,0,1,0
22052,32395,30188,0,0,deny,146,146,0,1,0,1,0
22053,54418,22114,0,0,deny,66,66,0,1,0,1,0
22054,63982,25174,0,0,deny,66,66,0,1,0,1,0
22055,29509,25174,0,0,deny,62,62,0,1,0,1,0
22056,50465,445,0,0,drop,70,70,0,1,0,1,0
22057,50464,445,0,0,drop,70,70,0,1,0,1,0
22058,50458,445,0,0,drop,70,70,0,1,0,1,0
22059,50456,445,0,0,drop,70,70,0,1,0,1,0
22060,37011,25174,0,0,deny,146,146,0,1,0,1,0
22061,62020,445,0,0,drop,70,70,0,1,0,1,0
22062,31683,35440,0,0,deny,146,146,0,1,0,1,0
22063,62019,445,0,0,drop,70,70,0,1,0,1,0
22064,62217,445,0,0,drop,66,66,0,1,0,1,0
22065,62215,445,0,0,drop,66,66,0,1,0,1,0
22066,62214,445,0,0,drop,66,66,0,1,0,1,0
22067,5841,22114,0,0,deny,62,62,0,1,0,1,0
22068,15442,22114,0,0,deny,66,66,0,1,0,1,0
22069,62015,445,0,0,drop,70,70,0,1,0,1,0
22070,64002,15503,0,0,deny,146,146,0,1,0,1,0
22071,50455,445,0,0,drop,70,70,0,1,0,1,0
22072,7810,25174,0,0,deny,66,66,0,1,0,1,0
22073,50446,445,0,0,drop,70,70,0,1,0,1,0
22074,50445,445,0,0,drop,70,70,0,1,0,1,0
22075,50444,445,0,0,drop,70,70,0,1,0,1,0
22076,62512,25174,0,0,deny,146,146,0,1,0,1,0
22077,62014,445,0,0,drop,70,70,0,1,0,1,0
22078,27309,6881,0,0,deny,62,62,0,1,0,1,0
22079,63023,51505,0,0,deny,66,66,0,1,0,1,0
22080,10540,25174,0,0,deny,146,146,0,1,0,1,0
22081,52644,57209,0,0,deny,66,66,0,1,0,1,0
22082,16092,50265,0,0,deny,62,62,0,1,0,1,0
22083,52143,37807,0,0,deny,66,66,0,1,0,1,0
22084,56397,26467,0,0,deny,66,66,0,1,0,1,0
22085,63569,62413,0,0,deny,62,62,0,1,0,1,0
22086,11842,23,0,0,deny,60,60,0,1,0,1,0
22087,62009,445,0,0,drop,70,70,0,1,0,1,0
22088,11136,19910,0,0,deny,62,62,0,1,0,1,0
22089,14740,26467,0,0,deny,62,62,0,1,0,1,0
22090,63116,22114,0,0,deny,62,62,0,1,0,1,0
22091,33556,25174,0,0,deny,146,146,0,1,0,1,0
22092,50432,445,0,0,drop,70,70,0,1,0,1,0
22093,50434,445,0,0,drop,70,70,0,1,0,1,0
22094,50431,445,0,0,drop,70,70,0,1,0,1,0
22095,59424,50265,0,0,deny,74,74,0,1,0,1,0
22096,63467,37807,0,0,deny,62,62,0,1,0,1,0
22097,31627,64147,0,0,deny,62,62,0,1,0,1,0
22098,62203,445,0,0,drop,66,66,0,1,0,1,0
22099,0,0,0,0,deny,74,74,0,1,0,1,0
22100,53577,35894,0,0,deny,66,66,0,1,0,1,0
22101,6652,25174,0,0,deny,62,62,0,1,0,1,0
22102,63852,25174,0,0,deny,62,62,0,1,0,1,0
22103,5223,14446,0,0,deny,220,220,0,1,0,1,0
22104,43578,15503,0,0,deny,74,74,0,1,0,1,0
22105,5223,22981,0,0,deny,60,60,0,1,0,1,0
22106,45908,33330,0,0,deny,60,60,0,1,0,1,0
22107,8889,30434,0,0,deny,60,60,0,1,0,1,0
22108,2731,25174,0,0,deny,146,146,0,1,0,1,0
22109,61996,445,0,0,drop,70,70,0,1,0,1,0
22110,53199,30188,0,0,deny,66,66,0,1,0,1,0
22111,52210,51505,0,0,deny,66,66,0,1,0,1,0
22112,11488,22114,0,0,deny,66,66,0,1,0,1,0
22113,49893,25174,0,0,deny,66,66,0,1,0,1,0
22114,60342,36237,0,0,deny,66,66,0,1,0,1,0
22115,15499,22114,0,0,deny,62,62,0,1,0,1,0
22116,50427,445,0,0,drop,70,70,0,1,0,1,0
22117,50428,445,0,0,drop,70,70,0,1,0,1,0
22118,53022,25174,0,0,deny,66,66,0,1,0,1,0
22119,55826,42771,0,0,deny,66,66,0,1,0,1,0
22120,55825,52700,0,0,deny,66,66,0,1,0,1,0
22121,48826,25174,0,0,deny,66,66,0,1,0,1,0
22122,63242,50584,0,0,deny,62,62,0,1,0,1,0
22123,21542,57470,0,0,deny,74,74,0,1,0,1,0
22124,61993,445,0,0,drop,70,70,0,1,0,1,0
22125,50977,56205,0,0,deny,66,66,0,1,0,1,0
22126,2278,25174,0,0,deny,62,62,0,1,0,1,0
22127,62186,445,0,0,drop,66,66,0,1,0,1,0
22128,12143,56205,0,0,deny,62,62,0,1,0,1,0
22129,42238,25174,0,0,deny,66,66,0,1,0,1,0
22130,61017,64147,0,0,deny,66,66,0,1,0,1,0
22131,1733,65448,0,0,deny,66,66,0,1,0,1,0
22132,50415,445,0,0,drop,70,70,0,1,0,1,0
22133,10462,25174,0,0,deny,62,62,0,1,0,1,0
22134,50413,445,0,0,drop,70,70,0,1,0,1,0
22135,50412,445,0,0,drop,70,70,0,1,0,1,0
22136,50408,445,0,0,drop,70,70,0,1,0,1,0
22137,61989,445,0,0,drop,70,70,0,1,0,1,0
22138,11716,37965,0,0,deny,62,62,0,1,0,1,0
22139,61987,445,0,0,drop,70,70,0,1,0,1,0
22140,62184,445,0,0,drop,66,66,0,1,0,1,0
22141,61985,445,0,0,drop,70,70,0,1,0,1,0
22142,33886,52255,0,0,deny,162,162,0,1,0,1,0
22143,50573,22114,0,0,deny,62,62,0,1,0,1,0
22144,62172,445,0,0,drop,66,66,0,1,0,1,0
22145,62176,445,0,0,drop,66,66,0,1,0,1,0
22146,62177,445,0,0,drop,66,66,0,1,0,1,0
22147,62178,445,0,0,drop,66,66,0,1,0,1,0
22148,62173,445,0,0,drop,66,66,0,1,0,1,0
22149,62171,445,0,0,drop,66,66,0,1,0,1,0
22150,62167,445,0,0,drop,66,66,0,1,0,1,0
22151,63578,35440,0,0,deny,66,66,0,1,0,1,0
22152,52235,443,52235,443,allow,4892,844,4048,19,21,9,10
22153,58968,443,55462,443,allow,4934,1351,3583,21,21,11,10
22154,13171,53,13171,53,allow,404,259,145,3,32,2,1
22155,59944,80,51806,80,allow,1186,390,796,9,16,5,4
22156,55056,80,55056,80,allow,2959,1505,1454,10,16,6,4
22157,47322,80,21803,80,allow,75931,3459,72472,97,43,38,59
22158,52237,443,52237,443,allow,7718,2030,5688,23,20,11,12
22159,18166,53,18166,53,allow,825,99,726,2,30,1,1
22160,40800,443,27923,443,allow,19403,4043,15360,36,48,19,17
22161,49319,443,42333,443,allow,3191,2313,878,17,44,10,7
22162,53589,53,45469,53,allow,578,286,292,9,15,5,4
22163,58876,443,42159,443,allow,19357,12948,6409,47,18,26,21
22164,58610,443,32629,443,allow,6345,1545,4800,23,18,12,11
22165,49217,52769,38751,52769,allow,2189,1143,1046,10,16,6,4
22166,53843,17556,3555,17556,allow,320,140,180,6,7,3,3
22167,53821,7788,40501,7788,allow,70,70,0,1,5,1,0
22168,37665,443,54006,443,allow,8134,2717,5417,24,16,15,9
22169,61432,443,52750,443,allow,2959,1819,1140,19,86,10,9
22170,49656,443,50043,443,allow,11810,2769,9041,29,47,15,14
22171,63118,7000,63118,7000,allow,3310,1535,1775,15,15,8,7
22172,34256,443,33618,443,allow,67835,6280,61555,96,108,45,51
22173,27005,27020,4875,27020,allow,898,126,772,2,30,1,1
22174,34097,443,35195,443,allow,5241,860,4381,17,15,9,8
22175,43324,22,43324,22,allow,8157,3445,4712,59,43,28,31
22176,59517,443,5605,443,allow,6285,1545,4740,22,17,12,10
22177,57428,443,23700,443,allow,6277,1727,4550,16,75,9,7
22178,54902,80,36045,80,allow,1107,630,477,10,16,6,4
22179,52030,43068,29971,43068,allow,66,66,0,1,5,1,0
22180,63976,25725,20832,25725,allow,66,66,0,1,5,1,0
22181,46439,443,34571,443,allow,8246,1739,6507,21,17,11,10
22182,63977,54486,15705,54486,allow,66,66,0,1,5,1,0
22183,40998,80,36819,80,allow,103213,8726,94487,178,38,109,69
22184,60055,53,0,0,allow,82,82,0,1,30,1,0
22185,58969,443,56637,443,allow,2768,1593,1175,22,21,11,11
22186,27005,27018,6738,27018,allow,888,126,762,2,30,1,1
22187,60805,443,29197,443,allow,7983,4398,3585,17,121,8,9
22188,45602,443,17240,443,allow,4417,3084,1333,17,361,9,8
22189,27005,27016,8684,27016,allow,898,126,772,2,31,1,1
22190,61666,443,28189,443,allow,1786,172,1614,7,120,3,4
22191,45141,443,63115,443,allow,4497,2208,2289,15,137,7,8
22192,48389,443,33224,443,allow,6616,3644,2972,18,122,9,9
22193,51426,443,3125,443,allow,15947,5526,10421,38,622,16,22
22194,56381,25174,0,0,deny,62,62,0,1,0,1,0
22195,52811,44847,0,0,deny,66,66,0,1,0,1,0
22196,13414,23,0,0,deny,60,60,0,1,0,1,0
22197,50404,445,0,0,drop,70,70,0,1,0,1,0
22198,50399,445,0,0,drop,70,70,0,1,0,1,0
22199,50398,445,0,0,drop,70,70,0,1,0,1,0
22200,50395,445,0,0,drop,70,70,0,1,0,1,0
22201,62580,25174,0,0,deny,62,62,0,1,0,1,0
22202,55464,22114,0,0,deny,146,146,0,1,0,1,0
22203,10088,37807,0,0,deny,66,66,0,1,0,1,0
22204,61978,445,0,0,drop,70,70,0,1,0,1,0
22205,10072,25174,0,0,deny,62,62,0,1,0,1,0
22206,50358,443,18545,443,allow,5133,2154,2979,26,81,13,13
22207,61923,80,14146,80,allow,4295,719,3576,16,125,8,8
22208,61976,445,0,0,drop,70,70,0,1,0,1,0
22209,56268,44847,0,0,deny,66,66,0,1,0,1,0
22210,57655,56205,0,0,deny,66,66,0,1,0,1,0
22211,61975,445,0,0,drop,70,70,0,1,0,1,0
22212,1027,64147,0,0,deny,62,62,0,1,0,1,0
22213,61974,445,0,0,drop,70,70,0,1,0,1,0
22214,61973,445,0,0,drop,70,70,0,1,0,1,0
22215,50392,445,0,0,drop,70,70,0,1,0,1,0
22216,50391,445,0,0,drop,70,70,0,1,0,1,0
22217,50389,445,0,0,drop,70,70,0,1,0,1,0
22218,61968,445,0,0,drop,70,70,0,1,0,1,0
22219,61967,445,0,0,drop,70,70,0,1,0,1,0
22220,62160,445,0,0,drop,66,66,0,1,0,1,0
22221,49417,38558,0,0,deny,66,66,0,1,0,1,0
22222,49931,25174,0,0,deny,66,66,0,1,0,1,0
22223,50386,445,0,0,drop,70,70,0,1,0,1,0
22224,7099,51505,0,0,deny,62,62,0,1,0,1,0
22225,51944,56205,0,0,deny,66,66,0,1,0,1,0
22226,62157,445,0,0,drop,66,66,0,1,0,1,0
22227,48335,25174,0,0,deny,146,146,0,1,0,1,0
22228,64035,25174,0,0,deny,62,62,0,1,0,1,0
22229,59192,25174,0,0,deny,66,66,0,1,0,1,0
22230,62155,445,0,0,drop,66,66,0,1,0,1,0
22231,62156,445,0,0,drop,66,66,0,1,0,1,0
22232,62153,445,0,0,drop,66,66,0,1,0,1,0
22233,61955,445,0,0,drop,70,70,0,1,0,1,0
22234,61954,445,0,0,drop,70,70,0,1,0,1,0
22235,61950,445,0,0,drop,70,70,0,1,0,1,0
22236,60075,41705,0,0,deny,66,66,0,1,0,1,0
22237,61945,445,0,0,drop,70,70,0,1,0,1,0
22238,61944,445,0,0,drop,70,70,0,1,0,1,0
22239,58844,51505,0,0,deny,66,66,0,1,0,1,0
22240,1024,25174,0,0,deny,146,146,0,1,0,1,0
22241,50381,445,0,0,drop,70,70,0,1,0,1,0
22242,30280,37965,0,0,deny,66,66,0,1,0,1,0
22243,50376,445,0,0,drop,70,70,0,1,0,1,0
22244,50370,445,0,0,drop,70,70,0,1,0,1,0
22245,30598,37965,0,0,deny,62,62,0,1,0,1,0
22246,18203,23,0,0,deny,60,60,0,1,0,1,0
22247,13021,25174,0,0,deny,62,62,0,1,0,1,0
22248,47461,50584,0,0,deny,62,62,0,1,0,1,0
22249,62141,445,0,0,drop,66,66,0,1,0,1,0
22250,61933,445,0,0,drop,70,70,0,1,0,1,0
22251,15235,36237,0,0,deny,62,62,0,1,0,1,0
22252,63346,53,0,0,deny,75,75,0,1,0,1,0
22253,54721,22114,0,0,deny,66,66,0,1,0,1,0
22254,46640,55443,0,0,deny,60,60,0,1,0,1,0
22255,57982,25174,0,0,deny,62,62,0,1,0,1,0
22256,57073,57470,0,0,deny,62,62,0,1,0,1,0
22257,64755,31573,0,0,deny,66,66,0,1,0,1,0
22258,58791,25174,0,0,deny,62,62,0,1,0,1,0
22259,11136,57587,0,0,deny,62,62,0,1,0,1,0
22260,58791,25174,0,0,deny,146,146,0,1,0,1,0
22261,1538,50584,0,0,deny,146,146,0,1,0,1,0
22262,56704,80,26438,80,allow,1146417,29701,1116716,1218,54,422,796
22263,63978,63776,58166,63776,allow,70,70,0,1,4,1,0
22264,63980,4804,25300,4804,allow,70,70,0,1,4,1,0
22265,53800,59950,39242,59950,allow,1973,1021,952,10,15,6,4
22266,53624,53,53624,53,allow,832,106,726,2,29,1,1
22267,54365,443,56544,443,allow,3970,1726,2244,13,134,6,7
22268,43405,443,52895,443,allow,5977,1326,4651,18,30,11,7
22269,49902,443,36938,443,allow,109400,8787,100613,159,81,78,81
22270,52025,42442,45647,42442,allow,70,70,0,1,4,1,0
22271,52027,49743,23707,49743,allow,70,70,0,1,4,1,0
22272,40784,443,40784,443,allow,4378,1471,2907,19,25,11,8
22273,57437,443,10192,443,allow,9539,3344,6195,36,17,17,19
22274,60788,40010,33720,40010,allow,316,136,180,6,5,3,3
22275,50267,80,27570,80,allow,12364,548,11816,17,46,6,11
22276,58897,443,22242,443,allow,5167,700,4467,16,14,7,9
22277,52028,35097,53575,35097,allow,206,136,70,4,13,3,1
22278,50211,1688,3994,1688,allow,70,70,0,1,4,1,0
22279,27005,27016,21347,27016,allow,902,126,776,2,30,1,1
22280,58018,443,65091,443,allow,8828,2193,6635,38,99,17,21
22281,61924,80,25773,80,allow,2170,472,1698,10,125,6,4
22282,27005,27017,42794,27017,allow,880,126,754,2,30,1,1
22283,56445,53,19322,53,allow,374,94,280,2,30,1,1
22284,49282,53,18906,53,allow,197,94,103,2,30,1,1
22285,52003,443,46194,443,allow,18400,6207,12193,60,212,32,28
22286,58893,443,9531,443,allow,5107,700,4407,15,15,7,8
22287,61416,443,34403,443,allow,6437,1994,4443,22,87,12,10
22288,52042,38074,53103,38074,allow,70,70,0,2,8,2,0
22289,46640,443,38435,443,allow,10768,1726,9042,35,199,17,18
22290,58896,443,22104,443,allow,5168,700,4468,16,15,7,9
22291,65501,443,33887,443,allow,416348,12360,403988,429,16,151,278
22292,14199,443,14199,443,allow,416,198,218,7,27,4,3
22293,42430,443,21880,443,allow,3927,1425,2502,18,121,8,10
22294,50584,6881,18955,6881,allow,502,150,352,2,1200,1,1
22295,63971,42759,55186,42759,allow,504,382,122,8,15,6,2
22296,53683,443,41886,443,allow,9880,1687,8193,23,15,12,11
22297,46966,5222,45433,5222,allow,12521,2892,9629,64,356,27,37
22298,49846,80,38683,80,allow,3215,2272,943,15,38,9,6
22299,64088,53,9032,53,allow,434,108,326,4,51,2,2
22300,55722,53,10365,53,allow,229,110,119,2,30,1,1
22301,56809,53,8718,53,allow,232,94,138,2,30,1,1
22302,56663,80,6268,80,allow,234,234,0,4,12,4,0
22303,65502,443,12498,443,allow,92573,4519,88054,105,16,39,66
22304,64157,53,10043,53,allow,323,90,233,4,48,2,2
22305,27005,27015,3156,27015,allow,878,126,752,2,30,1,1
22306,49210,80,26357,80,allow,2965,715,2250,9,75,5,4
22307,63117,7000,63117,7000,allow,4067,1750,2317,16,15,9,7
22308,28000,443,52315,443,allow,5746,1271,4475,25,105,12,13
22309,52041,48103,36252,48103,allow,70,70,0,2,8,2,0
22310,49907,443,10260,443,allow,3787,2434,1353,29,72,16,13
22311,53820,7488,54828,7488,allow,70,70,0,1,4,1,0
22312,60467,51095,40128,51095,allow,320,140,180,6,7,3,3
22313,58171,80,42934,80,allow,1651,550,1101,13,15,7,6
22314,52134,443,44449,443,allow,473832,22822,451010,464,109,139,325
22315,52044,5824,18446,5824,allow,70,70,0,2,8,2,0
22316,52026,12523,4758,12523,allow,70,70,0,1,4,1,0
22317,63981,34250,52912,34250,allow,70,70,0,1,4,1,0
22318,53822,18716,19485,18716,allow,70,70,0,1,4,1,0
22319,63138,51452,7117,51452,allow,70,70,0,1,5,1,0
22320,50700,80,27825,80,allow,142,142,0,1,5,1,0
22321,48111,443,2939,443,allow,214,140,74,4,15,3,1
22322,60265,53,3375,53,allow,215,86,129,2,30,1,1
22323,58890,80,3070,80,allow,1883,1448,435,11,16,6,5
22324,64941,53,51178,53,allow,216,94,122,2,30,1,1
22325,65191,53,55910,53,allow,294,102,192,2,30,1,1
22326,27005,27015,15191,27015,allow,889,126,763,2,30,1,1
22327,27005,27017,27810,27017,allow,890,126,764,2,30,1,1
22328,40940,443,19885,443,allow,9856,1973,7883,32,140,17,15
22329,37965,34591,32228,34591,allow,820,152,668,4,1199,2,2
22330,37912,443,38909,443,allow,2738,1475,1263,19,275,10,9
22331,57470,51413,34007,51413,allow,460,150,310,2,1199,1,1
22332,6882,25021,51756,25021,allow,509,150,359,2,1200,1,1
22333,33227,443,20860,443,allow,8888,1757,7131,26,174,15,11
22334,54184,443,12378,443,allow,2786,1537,1249,17,16,8,9
22335,46592,53,27919,53,allow,168,78,90,2,30,1,1
22336,47876,443,34439,443,allow,996037,37114,958923,1187,271,459,728
22337,59676,53,12870,53,allow,195,94,101,2,30,1,1
22338,50638,80,16658,80,allow,21873,2252,19621,27,21,10,17
22339,50116,22,50116,22,allow,152,66,86,2,9,1,1
22340,61925,80,57280,80,allow,2418,495,1923,11,125,6,5
22341,58894,443,36068,443,allow,5168,700,4468,16,15,7,9
22342,49356,53,31614,53,allow,209,102,107,2,30,1,1
22343,58914,53,2441,53,allow,244,86,158,2,30,1,1
22344,40071,443,38223,443,allow,7855,1850,6005,24,187,14,10
22345,59518,80,10090,80,allow,14862,1091,13771,26,135,14,12
22346,47668,443,3195,443,allow,69732,65832,3900,104,316,55,49
22347,53453,443,41566,443,allow,6824,2097,4727,19,15,11,8
22348,5588,5588,0,0,allow,3354,1792,1562,46,194,23,23
22349,64812,53,57206,53,allow,347,91,256,4,56,2,2
22350,50688,53,22980,53,allow,78,78,0,1,30,1,0
22351,27005,27016,64097,27016,allow,880,126,754,2,30,1,1
22352,53610,443,29299,443,allow,3096,962,2134,13,135,6,7
22353,56713,53,30137,53,allow,226,110,116,2,30,1,1
22354,65265,53,48964,53,allow,207,86,121,2,30,1,1
22355,50345,53,44210,53,allow,193,102,91,2,30,1,1
22356,39098,443,35056,443,allow,5519,1493,4026,20,121,9,11
22357,47127,443,18899,443,allow,7166,2377,4789,16,122,7,9
22358,59661,443,56024,443,allow,9055,2404,6651,24,126,13,11
22359,30188,31063,61312,31063,allow,502,150,352,2,1200,1,1
22360,64463,53,25750,53,allow,183,94,89,2,31,1,1
22361,27005,27018,28436,27018,allow,895,126,769,2,31,1,1
22362,53832,56005,15467,56005,allow,70,70,0,2,8,2,0
22363,59105,443,52375,443,allow,8742,3785,4957,21,16,12,9
22364,54271,80,5783,80,allow,6006,861,5145,18,19,10,8
22365,44097,80,3259,80,allow,36152,2792,33360,55,19,29,26
22366,47894,443,25578,443,allow,52038,3333,48705,74,157,30,44
22367,63994,47013,54250,47013,allow,66,66,0,2,8,2,0
22368,63996,45759,55251,45759,allow,66,66,0,2,8,2,0
22369,59580,443,31817,443,allow,10200,2180,8020,26,19,15,11
22370,37858,443,14705,443,allow,10281,2251,8030,25,17,14,11
22371,56574,443,10843,443,allow,6974,1513,5461,21,81,11,10
22372,63999,10552,13138,10552,allow,66,66,0,2,8,2,0
22373,50679,80,21512,80,allow,132,132,0,2,8,2,0
22374,35821,80,40158,80,allow,34712,2489,32223,52,19,27,25
22375,64617,53,10590,53,allow,301,102,199,2,30,1,1
22376,62134,445,0,0,drop,66,66,0,1,0,1,0
22377,28085,36237,0,0,deny,66,66,0,1,0,1,0
22378,29988,44847,0,0,deny,66,66,0,1,0,1,0
22379,50358,445,0,0,drop,70,70,0,1,0,1,0
22380,5223,7851,0,0,deny,66,66,0,1,0,1,0
22381,51564,50584,0,0,deny,66,66,0,1,0,1,0
22382,1024,25174,0,0,deny,62,62,0,1,0,1,0
22383,61929,445,0,0,drop,70,70,0,1,0,1,0
22384,40400,22114,0,0,deny,62,62,0,1,0,1,0
22385,40086,22114,0,0,deny,62,62,0,1,0,1,0
22386,62132,445,0,0,drop,66,66,0,1,0,1,0
22387,54377,56205,0,0,deny,66,66,0,1,0,1,0
22388,55920,25174,0,0,deny,62,62,0,1,0,1,0
22389,61917,445,0,0,drop,70,70,0,1,0,1,0
22390,61919,445,0,0,drop,70,70,0,1,0,1,0
22391,61920,445,0,0,drop,70,70,0,1,0,1,0
22392,2422,62507,0,0,deny,66,66,0,1,0,1,0
22393,61915,445,0,0,drop,70,70,0,1,0,1,0
22394,61913,445,0,0,drop,70,70,0,1,0,1,0
22395,7482,57470,0,0,deny,66,66,0,1,0,1,0
22396,54048,25174,0,0,deny,66,66,0,1,0,1,0
22397,62125,445,0,0,drop,66,66,0,1,0,1,0
22398,22924,25174,0,0,deny,146,146,0,1,0,1,0
22399,2886,35440,0,0,deny,66,66,0,1,0,1,0
22400,7222,57470,0,0,deny,62,62,0,1,0,1,0
22401,20576,37965,0,0,deny,62,62,0,1,0,1,0
22402,53567,64147,0,0,deny,66,66,0,1,0,1,0
22403,62122,445,0,0,drop,66,66,0,1,0,1,0
22404,30800,25174,0,0,deny,62,62,0,1,0,1,0
22405,10688,25174,0,0,deny,62,62,0,1,0,1,0
22406,37617,443,47875,443,allow,499,425,74,4,0,3,1
22407,31609,25174,0,0,deny,146,146,0,1,0,1,0
22408,24560,25174,0,0,deny,146,146,0,1,0,1,0
22409,24040,22114,0,0,deny,62,62,0,1,0,1,0
22410,46774,51050,0,0,deny,62,62,0,1,0,1,0
22411,49482,22,0,0,deny,60,60,0,1,0,1,0
22412,57669,64147,0,0,deny,66,66,0,1,0,1,0
22413,61906,445,0,0,drop,70,70,0,1,0,1,0
22414,50350,445,0,0,drop,70,70,0,1,0,1,0
22415,50346,445,0,0,drop,70,70,0,1,0,1,0
22416,50347,445,0,0,drop,70,70,0,1,0,1,0
22417,50442,25174,0,0,deny,66,66,0,1,0,1,0
22418,62109,445,0,0,drop,66,66,0,1,0,1,0
22419,62102,445,0,0,drop,66,66,0,1,0,1,0
22420,62105,445,0,0,drop,66,66,0,1,0,1,0
22421,62107,445,0,0,drop,66,66,0,1,0,1,0
22422,62101,445,0,0,drop,66,66,0,1,0,1,0
22423,62103,445,0,0,drop,66,66,0,1,0,1,0
22424,62108,445,0,0,drop,66,66,0,1,0,1,0
22425,62106,445,0,0,drop,66,66,0,1,0,1,0
22426,33215,37965,0,0,deny,62,62,0,1,0,1,0
22427,22240,22114,0,0,deny,62,62,0,1,0,1,0
22428,33183,23,0,0,deny,60,60,0,1,0,1,0
22429,61899,445,0,0,drop,70,70,0,1,0,1,0
22430,26435,39004,0,0,deny,62,62,0,1,0,1,0
22431,61898,445,0,0,drop,70,70,0,1,0,1,0
22432,63708,25174,0,0,deny,66,66,0,1,0,1,0
22433,44147,64147,0,0,deny,62,62,0,1,0,1,0
22434,61892,445,0,0,drop,70,70,0,1,0,1,0
22435,50344,445,0,0,drop,70,70,0,1,0,1,0
22436,50339,445,0,0,drop,70,70,0,1,0,1,0
22437,50330,445,0,0,drop,70,70,0,1,0,1,0
22438,50328,445,0,0,drop,70,70,0,1,0,1,0
22439,61891,445,0,0,drop,70,70,0,1,0,1,0
22440,67,68,0,0,deny,346,346,0,1,0,1,0
22441,57797,64147,0,0,deny,66,66,0,1,0,1,0
22442,62088,445,0,0,drop,66,66,0,1,0,1,0
22443,62089,445,0,0,drop,66,66,0,1,0,1,0
22444,62086,445,0,0,drop,66,66,0,1,0,1,0
22445,63400,57470,0,0,deny,66,66,0,1,0,1,0
22446,45908,33330,0,0,deny,60,60,0,1,0,1,0
22447,61887,445,0,0,drop,70,70,0,1,0,1,0
22448,7877,22114,0,0,deny,66,66,0,1,0,1,0
22449,50327,445,0,0,drop,70,70,0,1,0,1,0
22450,61886,445,0,0,drop,70,70,0,1,0,1,0
22451,50318,445,0,0,drop,70,70,0,1,0,1,0
22452,50322,445,0,0,drop,70,70,0,1,0,1,0
22453,50317,445,0,0,drop,70,70,0,1,0,1,0
22454,13285,29892,0,0,deny,145,145,0,1,0,1,0
22455,0,0,0,0,allow,480,244,236,4,0,2,2
22456,54876,25174,0,0,deny,62,62,0,1,0,1,0
22457,59949,44847,0,0,deny,66,66,0,1,0,1,0
22458,52024,25174,0,0,deny,66,66,0,1,0,1,0
22459,19330,25174,0,0,deny,62,62,0,1,0,1,0
22460,61881,445,0,0,drop,70,70,0,1,0,1,0
22461,63347,25174,0,0,deny,66,66,0,1,0,1,0
22462,18061,25174,0,0,deny,62,62,0,1,0,1,0
22463,63084,64147,0,0,deny,62,62,0,1,0,1,0
22464,50309,445,0,0,drop,70,70,0,1,0,1,0
22465,50308,445,0,0,drop,70,70,0,1,0,1,0
22466,50304,445,0,0,drop,70,70,0,1,0,1,0
22467,56770,26467,0,0,deny,66,66,0,1,0,1,0
22468,52321,26467,0,0,deny,62,62,0,1,0,1,0
22469,62077,445,0,0,drop,66,66,0,1,0,1,0
22470,62014,35440,0,0,deny,66,66,0,1,0,1,0
22471,49001,40108,0,0,deny,161,161,0,1,0,1,0
22472,49686,44847,0,0,deny,62,62,0,1,0,1,0
22473,49001,40108,0,0,deny,161,161,0,1,0,1,0
22474,53756,50584,0,0,deny,62,62,0,1,0,1,0
22475,53257,37450,0,0,deny,66,66,0,1,0,1,0
22476,61400,64147,0,0,deny,66,66,0,1,0,1,0
22477,55562,50584,0,0,deny,66,66,0,1,0,1,0
22478,49994,26467,0,0,deny,66,66,0,1,0,1,0
22479,47771,25174,0,0,deny,62,62,0,1,0,1,0
22480,61868,445,0,0,drop,70,70,0,1,0,1,0
22481,62637,42873,0,0,deny,66,66,0,1,0,1,0
22482,32704,25174,0,0,deny,62,62,0,1,0,1,0
22483,51396,56205,0,0,deny,66,66,0,1,0,1,0
22484,46864,25174,0,0,deny,146,146,0,1,0,1,0
22485,22733,26467,0,0,deny,62,62,0,1,0,1,0
22486,59988,64147,0,0,deny,66,66,0,1,0,1,0
22487,26752,64147,0,0,deny,62,62,0,1,0,1,0
22488,3584,25174,0,0,deny,62,62,0,1,0,1,0
22489,57604,32480,0,0,deny,62,62,0,1,0,1,0
22490,14489,25174,0,0,deny,62,62,0,1,0,1,0
22491,58250,35440,0,0,deny,66,66,0,1,0,1,0
22492,46367,36237,0,0,deny,66,66,0,1,0,1,0
22493,61865,445,0,0,drop,70,70,0,1,0,1,0
22494,50298,445,0,0,drop,70,70,0,1,0,1,0
22495,50293,445,0,0,drop,70,70,0,1,0,1,0
22496,62792,53,0,0,deny,88,88,0,1,0,1,0
22497,56161,62413,0,0,deny,66,66,0,1,0,1,0
22498,49514,52255,0,0,deny,162,162,0,1,0,1,0
22499,12632,25174,0,0,deny,62,62,0,1,0,1,0
22500,29016,25174,0,0,deny,62,62,0,1,0,1,0
22501,32976,37965,0,0,deny,66,66,0,1,0,1,0
22502,49086,443,34505,443,allow,8535,2139,6396,25,394,9,16
22503,38223,443,38223,443,allow,4782,1875,2907,19,29,11,8
22504,55254,443,18308,443,allow,8431,2584,5847,25,46,14,11
22505,54278,53,0,0,allow,82,82,0,1,30,1,0
22506,26867,443,1450,443,allow,11115,3034,8081,35,19,18,17
22507,39192,80,42667,80,allow,62592,60966,1626,63,16,47,16
22508,53817,59216,40309,59216,allow,164,70,94,2,5,1,1
22509,63970,28423,20673,28423,allow,564,382,182,9,15,6,3
22510,61505,443,24914,443,allow,4820,863,3957,18,31,10,8
22511,61506,443,7741,443,allow,15255,2304,12951,30,31,13,17
22512,64002,2880,57977,2880,allow,66,66,0,2,8,2,0
22513,60456,58675,9788,58675,allow,1307,786,521,15,16,8,7
22514,60901,443,60901,443,allow,24367,4634,19733,52,49,26,26
22515,63968,37264,37420,37264,allow,504,382,122,8,15,6,2
22516,49994,443,12654,443,allow,378,82,296,5,17,1,4
22517,56449,443,10507,443,allow,3182,1568,1614,8,120,4,4
22518,63062,53,6744,53,allow,303,85,218,2,30,1,1
22519,55835,443,26347,443,allow,10087,3968,6119,32,271,17,15
22520,63063,443,23701,443,allow,303,85,218,2,30,1,1
22521,57334,443,4953,443,allow,11347,2434,8913,28,62,15,13
22522,40030,443,25382,443,allow,2651,1331,1320,18,17,10,8
22523,40803,443,57775,443,allow,1093,662,431,10,46,6,4
22524,53149,47383,18287,47383,allow,694,320,374,10,18,6,4
22525,52907,443,48453,443,allow,9303,3133,6170,26,22,13,13
22526,60454,18359,20909,18359,allow,1842,1017,825,19,16,9,10
22527,60413,80,20847,80,allow,958,543,415,11,315,6,5
22528,60412,80,59747,80,allow,958,543,415,11,315,6,5
22529,49812,443,22276,443,allow,6128,1356,4772,20,978,10,10
22530,58870,443,34912,443,allow,21207,14062,7145,50,19,28,22
22531,64003,38926,33075,38926,allow,66,66,0,2,8,2,0
22532,41339,443,20728,443,allow,7450,1203,6247,22,16,12,10
22533,53232,80,53232,80,allow,6385,778,5607,17,16,9,8
22534,54054,443,22271,443,allow,12268,7082,5186,26,85,15,11
22535,58967,443,57759,443,allow,9225,1878,7347,28,21,14,14
22536,10808,443,10808,443,allow,4902,861,4041,15,16,7,8
22537,53018,443,37160,443,allow,6352,1552,4800,23,17,12,11
22538,54031,443,8430,443,allow,350,210,140,6,25,4,2
22539,63961,53,35480,53,allow,184,86,98,2,30,1,1
22540,48817,6889,48817,6889,allow,480,149,331,2,1200,1,1
22541,36420,443,54908,443,allow,7018,1381,5637,24,17,14,10
22542,64115,80,27951,80,allow,2575,635,1940,12,36,7,5
22543,5588,5588,0,0,allow,3354,1792,1562,46,196,23,23
22544,5588,5588,0,0,allow,3354,1792,1562,46,194,23,23
22545,27005,27016,57447,27016,allow,885,126,759,2,30,1,1
22546,60903,443,60903,443,allow,13557,3307,10250,43,47,25,18
22547,64827,53,64827,53,allow,288,83,205,2,30,1,1
22548,63071,443,65203,443,allow,569,164,405,2,30,1,1
22549,5588,5588,0,0,allow,3354,1792,1562,46,193,23,23
22550,63070,53,63583,53,allow,446,164,282,2,30,1,1
22551,52062,443,2872,443,allow,61141,52577,8564,102,363,50,52
22552,27005,27017,35476,27017,allow,882,126,756,2,31,1,1
22553,27005,27017,28274,27017,allow,880,126,754,2,31,1,1
22554,55647,443,60557,443,allow,90956,83597,7359,106,127,70,36
22555,62061,445,0,0,drop,66,66,0,1,0,1,0
22556,62057,445,0,0,drop,66,66,0,1,0,1,0
22557,12183,22114,0,0,deny,62,62,0,1,0,1,0
22558,62885,62413,0,0,deny,66,66,0,1,0,1,0
22559,27677,22114,0,0,deny,62,62,0,1,0,1,0
22560,50251,35440,0,0,deny,66,66,0,1,0,1,0
22561,18608,11392,0,0,deny,62,62,0,1,0,1,0
22562,61861,445,0,0,drop,70,70,0,1,0,1,0
22563,54438,62413,0,0,deny,66,66,0,1,0,1,0
22564,36456,25174,0,0,deny,62,62,0,1,0,1,0
22565,57479,56205,0,0,deny,66,66,0,1,0,1,0
22566,61859,445,0,0,drop,70,70,0,1,0,1,0
22567,51210,50584,0,0,deny,146,146,0,1,0,1,0
22568,60786,25174,0,0,deny,66,66,0,1,0,1,0
22569,59147,25174,0,0,deny,62,62,0,1,0,1,0
22570,63910,44847,0,0,deny,62,62,0,1,0,1,0
22571,50285,445,0,0,drop,70,70,0,1,0,1,0
22572,50289,445,0,0,drop,70,70,0,1,0,1,0
22573,50283,445,0,0,drop,70,70,0,1,0,1,0
22574,50282,445,0,0,drop,70,70,0,1,0,1,0
22575,30782,36237,0,0,deny,146,146,0,1,0,1,0
22576,58251,36237,0,0,deny,62,62,0,1,0,1,0
22577,61857,445,0,0,drop,70,70,0,1,0,1,0
22578,62053,445,0,0,drop,66,66,0,1,0,1,0
22579,49591,53,54188,53,allow,408,86,322,4,31,2,2
22580,63056,443,24879,443,allow,304,86,218,2,30,1,1
22581,63068,443,50738,443,allow,571,166,405,2,30,1,1
22582,50632,80,1606,80,allow,1559,1107,452,9,22,5,4
22583,60438,53,27899,53,allow,154,154,0,3,46,3,0
22584,63242,443,5586,443,allow,9042,4612,4430,31,175,17,14
22585,61691,53,19669,53,allow,256,94,162,2,30,1,1
22586,59625,443,5961,443,allow,6703,1307,5396,28,18,14,14
22587,56569,443,12304,443,allow,340595,9013,331582,345,80,119,226
22588,53818,15337,26034,15337,allow,164,70,94,2,4,1,1
22589,50995,53,51013,53,allow,168,78,90,2,30,1,1
22590,38100,53,30457,53,allow,168,78,90,2,30,1,1
22591,53764,443,39809,443,allow,8115,1962,6153,24,18,14,10
22592,52618,80,60049,80,allow,1141,529,612,10,18,6,4
22593,55026,443,39326,443,allow,3591,1906,1685,22,80,11,11
22594,37235,443,30384,443,allow,8877,1380,7497,30,18,15,15
22595,53424,443,24039,443,allow,9953,1605,8348,35,18,19,16
22596,53814,6725,20985,6725,allow,70,70,0,1,4,1,0
22597,64000,14441,35024,14441,allow,66,66,0,2,7,2,0
22598,53815,17290,25400,17290,allow,70,70,0,1,4,1,0
22599,53808,56215,4312,56215,allow,70,70,0,1,4,1,0
22600,50635,80,60349,80,allow,3722,1504,2218,13,20,7,6
22601,51553,443,28429,443,allow,6662,522,6140,15,16,5,10
22602,54136,443,42387,443,allow,1053,566,487,10,16,6,4
22603,50374,53,63648,53,allow,755,102,653,2,29,1,1
22604,63075,53,54531,53,allow,571,166,405,2,29,1,1
22605,63074,443,53301,443,allow,384,166,218,2,29,1,1
22606,58726,53,60102,53,allow,247,102,145,2,30,1,1
22607,50345,53,41743,53,allow,193,102,91,2,30,1,1
22608,63059,53,39205,53,allow,304,86,218,2,30,1,1
22609,54657,6881,47052,6881,allow,1682,716,966,12,15,6,6
22610,56566,443,19189,443,allow,343737,9198,334539,348,80,121,227
22611,64406,53,46788,53,allow,204,204,0,3,46,3,0
22612,64124,53,32205,53,allow,236,86,150,2,30,1,1
22613,63069,53,35959,53,allow,384,166,218,2,30,1,1
22614,63058,443,54083,443,allow,304,86,218,2,30,1,1
22615,60458,61473,34807,61473,allow,1587,935,652,14,16,8,6
22616,60946,443,58938,443,allow,1373,712,661,14,18,8,6
22617,56570,443,57405,443,allow,4722,1330,3392,18,80,9,9
22618,56565,443,50266,443,allow,52157,3066,49091,65,80,26,39
22619,49634,53,43147,53,allow,344,126,218,2,30,1,1
22620,40603,80,57176,80,allow,1104,475,629,10,15,6,4
22621,20954,53,64122,53,allow,223,78,145,2,30,1,1
22622,65064,53,44516,53,allow,338,110,228,2,30,1,1
22623,39607,443,22667,443,allow,559339,545011,14328,595,316,388,207
22624,60949,443,41744,443,allow,1598,794,804,16,18,9,7
22625,27005,27016,52333,27016,allow,892,126,766,2,30,1,1
22626,33936,443,61935,443,allow,9880,2011,7869,38,256,17,21
22627,49732,443,11249,443,allow,592433,191668,400765,1555,1157,608,947
22628,56450,443,16622,443,allow,1786,172,1614,7,120,3,4
22629,56654,53,7518,53,allow,306,306,0,4,47,4,0
22630,59813,53,1465,53,allow,355,118,237,2,30,1,1
22631,65016,443,10524,443,allow,5957,2481,3476,14,120,8,6
22632,1399,53,11703,53,allow,256,94,162,2,30,1,1
22633,54699,53,18510,53,allow,236,86,150,2,30,1,1
22634,60448,443,25494,443,allow,17060,10614,6446,52,132,25,27
22635,44136,53,62801,53,allow,220,78,142,2,30,1,1
22636,50265,12656,39117,12656,allow,402,132,270,6,1209,3,3
22637,58892,443,12440,443,allow,5167,700,4467,16,15,7,9
22638,55008,443,6262,443,allow,7679,2605,5074,26,45,15,11
22639,35879,443,58250,443,allow,6108,3916,2192,51,1143,31,20
22640,61637,53,50085,53,allow,246,246,0,4,47,4,0
22641,27005,27016,17194,27016,allow,878,126,752,2,30,1,1
22642,50265,40448,36258,40448,allow,2118,858,1260,28,1274,14,14
22643,48144,443,29490,443,allow,16198,9822,6376,54,35,28,26
22644,60956,443,57163,443,allow,13342,9687,3655,53,17,28,25
22645,60944,443,6650,443,allow,59999,8737,51262,95,18,43,52
22646,42319,443,8708,443,allow,6664,1570,5094,23,18,13,10
22647,59779,443,38576,443,allow,142,142,0,1,5,1,0
22648,45511,443,41466,443,allow,130,70,60,2,15,1,1
22649,55445,53,39762,53,allow,192,192,0,3,46,3,0
22650,53434,53,32877,53,allow,261,261,0,4,47,4,0
22651,60473,8765,34134,8765,allow,199,75,124,4,59,2,2
22652,27005,27018,49128,27018,allow,879,126,753,2,30,1,1
22653,63067,53,20594,53,allow,384,166,218,2,30,1,1
22654,8893,123,39834,123,allow,94,94,0,1,30,1,0
22655,63060,53,7236,53,allow,304,86,218,2,30,1,1
22656,35506,80,16634,80,allow,120,60,60,3,3600,2,1
22657,55305,53,27046,53,allow,176,176,0,3,46,3,0
22658,60945,443,60187,443,allow,1373,712,661,14,18,8,6
22659,54056,443,63986,443,allow,8340,3417,4923,20,75,11,9
22660,40656,443,51290,443,allow,10293,1331,8962,22,255,12,10
22661,56576,443,12093,443,allow,6971,1510,5461,21,80,11,10
22662,64001,13051,20049,13051,allow,66,66,0,2,7,2,0
22663,46683,443,6885,443,allow,234,234,0,4,12,4,0
22664,64004,48339,7779,48339,allow,66,66,0,2,7,2,0
22665,60953,443,32015,443,allow,103580,4856,98724,133,17,56,77
22666,42574,443,64198,443,allow,130,70,60,3,5,2,1
22667,64828,53,47016,53,allow,881,243,638,6,39,3,3
22668,59942,80,31955,80,allow,2241,1549,692,9,15,5,4
22669,53753,443,14141,443,allow,6973,2166,4807,20,15,11,9
22670,42137,443,46635,443,allow,9173,2080,7093,22,18,13,9
22671,60950,443,63675,443,allow,7431,2753,4678,40,18,21,19
22672,62995,53,20908,53,allow,202,202,0,3,46,3,0
22673,37663,443,39550,443,allow,8493,2314,6179,33,15,18,15
22674,2089,7000,2089,7000,allow,2227,676,1551,15,14,7,8
22675,63995,15396,7460,15396,allow,66,66,0,2,7,2,0
22676,55348,53,14185,53,allow,332,94,238,2,29,1,1
22677,51923,443,5090,443,allow,8964,6357,2607,44,163,23,21
22678,63073,53,51318,53,allow,304,86,218,2,30,1,1
22679,54553,53,62342,53,allow,202,202,0,3,46,3,0
22680,27005,27018,51393,27018,allow,881,126,755,2,30,1,1
22681,65501,53,1213,53,allow,226,94,132,2,29,1,1
22682,63072,443,30970,443,allow,304,86,218,2,30,1,1
22683,63066,443,9445,443,allow,448,166,282,2,30,1,1
22684,46676,443,54715,443,allow,16425,3923,12502,37,156,19,18
22685,60580,53,24695,53,allow,229,94,135,2,30,1,1
22686,63064,443,8160,443,allow,448,166,282,2,30,1,1
22687,49897,53,22937,53,allow,384,94,290,2,30,1,1
22688,63057,53,17577,53,allow,304,86,218,2,30,1,1
22689,45387,443,38103,443,allow,3999,2255,1744,37,1122,19,18
22690,60955,443,4042,443,allow,40105,2847,37258,61,17,28,33
22691,27005,27016,52967,27016,allow,879,126,753,2,30,1,1
22692,46404,53,18296,53,allow,240,86,154,2,30,1,1
22693,63061,443,64217,443,allow,304,86,218,2,30,1,1
22694,60958,443,2953,443,allow,1547,960,587,14,17,8,6
22695,60947,443,46012,443,allow,1373,712,661,14,18,8,6
22696,60460,54233,13899,54233,allow,70,70,0,1,5,1,0
22697,45510,443,22832,443,allow,130,70,60,2,15,1,1
22698,41000,443,2288,443,allow,6237,1811,4426,22,22,12,10
22699,61071,1053,14234,1053,allow,1139,878,261,2,30,1,1
22700,27005,27015,13591,27015,allow,880,126,754,2,30,1,1
22701,27005,27025,23287,27025,allow,895,126,769,2,30,1,1
22702,52989,53,36046,53,allow,406,94,312,2,30,1,1
22703,40204,40016,4435,40016,allow,148,86,62,2,30,1,1
22704,60952,443,35261,443,allow,391561,17125,374436,478,17,213,265
22705,60948,443,3715,443,allow,1373,712,661,14,18,8,6
22706,54181,443,63427,443,allow,9283,2154,7129,22,15,12,10
22707,50116,22,50116,22,allow,66,66,0,1,5,1,0
22708,62074,443,56208,443,allow,350,210,140,6,15,4,2
22709,53791,53,58724,53,allow,204,204,0,3,46,3,0
22710,61072,53,60652,53,allow,1139,878,261,2,30,1,1
22711,63065,53,14429,53,allow,448,166,282,2,30,1,1
22712,54672,443,56107,443,allow,2285,1130,1155,25,120,12,13
22713,59984,443,65136,443,allow,2419,330,2089,12,135,5,7
22714,56485,443,48158,443,allow,5711,1208,4503,21,121,11,10
22715,57470,50321,52574,50321,allow,1584,1584,0,25,1537,25,0
22716,37526,443,48276,443,allow,10637,4761,5876,30,145,17,13
22717,55877,56148,26245,56148,allow,481,150,331,2,1200,1,1
22718,42207,443,33313,443,allow,7870,2945,4925,19,136,9,10
22719,60455,65054,62710,65054,allow,624,318,306,10,16,5,5
22720,58731,443,5711,443,allow,2383,1460,923,18,201,10,8
22721,64463,53,17671,53,allow,183,94,89,2,30,1,1
22722,55427,53,42725,53,allow,442,110,332,4,44,2,2
22723,55078,80,14305,80,allow,265275,25834,239441,366,101,182,184
22724,65071,53,49896,53,allow,93,93,0,2,60,2,0
22725,52178,443,8092,443,allow,414,140,274,7,26,3,4
22726,59489,53,5531,53,allow,168,78,90,2,30,1,1
22727,62709,57470,0,0,deny,62,62,0,1,0,1,0
22728,62048,445,0,0,drop,66,66,0,1,0,1,0
22729,62047,445,0,0,drop,66,66,0,1,0,1,0
22730,62042,445,0,0,drop,66,66,0,1,0,1,0
22731,62050,445,0,0,drop,66,66,0,1,0,1,0
22732,62049,445,0,0,drop,66,66,0,1,0,1,0
22733,62044,445,0,0,drop,66,66,0,1,0,1,0
22734,62038,445,0,0,drop,66,66,0,1,0,1,0
22735,55435,25174,0,0,deny,146,146,0,1,0,1,0
22736,7977,25174,0,0,deny,146,146,0,1,0,1,0
22737,7977,25174,0,0,deny,62,62,0,1,0,1,0
22738,50274,445,0,0,drop,70,70,0,1,0,1,0
22739,10632,25174,0,0,deny,146,146,0,1,0,1,0
22740,50271,445,0,0,drop,70,70,0,1,0,1,0
22741,50270,445,0,0,drop,70,70,0,1,0,1,0
22742,50267,445,0,0,drop,70,70,0,1,0,1,0
22743,55839,56535,0,0,deny,62,62,0,1,0,1,0
22744,61850,445,0,0,drop,70,70,0,1,0,1,0
22745,21108,25174,0,0,deny,62,62,0,1,0,1,0
22746,61848,445,0,0,drop,70,70,0,1,0,1,0
22747,44285,25174,0,0,deny,62,62,0,1,0,1,0
22748,15400,47807,0,0,deny,159,159,0,1,0,1,0
22749,37633,44847,0,0,deny,62,62,0,1,0,1,0
22750,2717,31573,0,0,deny,62,62,0,1,0,1,0
22751,47727,25174,0,0,deny,146,146,0,1,0,1,0
22752,41541,25174,0,0,deny,66,66,0,1,0,1,0
22753,61847,445,0,0,drop,70,70,0,1,0,1,0
22754,61846,445,0,0,drop,70,70,0,1,0,1,0
22755,15249,22114,0,0,deny,62,62,0,1,0,1,0
22756,61845,445,0,0,drop,70,70,0,1,0,1,0
22757,61843,445,0,0,drop,70,70,0,1,0,1,0
22758,61841,445,0,0,drop,70,70,0,1,0,1,0
22759,59213,25174,0,0,deny,66,66,0,1,0,1,0
22760,60104,30188,0,0,deny,66,66,0,1,0,1,0
22761,50264,445,0,0,drop,70,70,0,1,0,1,0
22762,50263,445,0,0,drop,70,70,0,1,0,1,0
22763,50261,445,0,0,drop,70,70,0,1,0,1,0
22764,30861,46783,0,0,deny,62,62,0,1,0,1,0
22765,51560,46783,0,0,deny,66,66,0,1,0,1,0
22766,62033,445,0,0,drop,66,66,0,1,0,1,0
22767,39873,23,0,0,deny,60,60,0,1,0,1,0
22768,50258,445,0,0,drop,70,70,0,1,0,1,0
22769,35828,8970,0,0,reset-both,146,146,0,1,0,1,0
22770,54876,25174,0,0,deny,146,146,0,1,0,1,0
22771,62029,445,0,0,drop,66,66,0,1,0,1,0
22772,60558,51221,0,0,deny,62,62,0,1,0,1,0
22773,64155,60043,0,0,deny,66,66,0,1,0,1,0
22774,5926,25174,0,0,deny,62,62,0,1,0,1,0
22775,61827,445,0,0,drop,70,70,0,1,0,1,0
22776,6881,35894,0,0,deny,62,62,0,1,0,1,0
22777,61826,445,0,0,drop,70,70,0,1,0,1,0
22778,61820,445,0,0,drop,70,70,0,1,0,1,0
22779,62027,445,0,0,drop,66,66,0,1,0,1,0
22780,62026,445,0,0,drop,66,66,0,1,0,1,0
22781,18091,32480,0,0,deny,62,62,0,1,0,1,0
22782,61816,445,0,0,drop,70,70,0,1,0,1,0
22783,61817,445,0,0,drop,70,70,0,1,0,1,0
22784,62025,445,0,0,drop,66,66,0,1,0,1,0
22785,47256,37807,0,0,deny,62,62,0,1,0,1,0
22786,11136,15503,0,0,deny,62,62,0,1,0,1,0
22787,41490,25174,0,0,deny,62,62,0,1,0,1,0
22788,57994,30188,0,0,deny,62,62,0,1,0,1,0
22789,60941,25174,0,0,deny,62,62,0,1,0,1,0
22790,33074,5900,0,0,deny,60,60,0,1,0,1,0
22791,50255,445,0,0,drop,70,70,0,1,0,1,0
22792,64214,25174,0,0,deny,66,66,0,1,0,1,0
22793,50240,445,0,0,drop,70,70,0,1,0,1,0
22794,50242,445,0,0,drop,70,70,0,1,0,1,0
22795,40687,64147,0,0,deny,62,62,0,1,0,1,0
22796,53197,25174,0,0,deny,66,66,0,1,0,1,0
22797,56309,22114,0,0,deny,62,62,0,1,0,1,0
22798,50822,50584,0,0,deny,66,66,0,1,0,1,0
22799,61805,445,0,0,drop,70,70,0,1,0,1,0
22800,57131,31061,0,0,deny,145,145,0,1,0,1,0
22801,62013,445,0,0,drop,66,66,0,1,0,1,0
22802,3937,36829,0,0,deny,62,62,0,1,0,1,0
22803,53470,22114,0,0,deny,66,66,0,1,0,1,0
22804,2946,25174,0,0,deny,62,62,0,1,0,1,0
22805,46808,25174,0,0,deny,146,146,0,1,0,1,0
22806,6881,8305,0,0,deny,143,143,0,1,0,1,0
22807,51948,17372,0,0,deny,62,62,0,1,0,1,0
22808,15345,36829,0,0,deny,66,66,0,1,0,1,0
22809,56922,29434,0,0,deny,107,107,0,1,0,1,0
22810,53906,17372,0,0,deny,145,145,0,1,0,1,0
22811,54601,26467,0,0,deny,66,66,0,1,0,1,0
22812,62006,445,0,0,drop,66,66,0,1,0,1,0
22813,61801,445,0,0,drop,70,70,0,1,0,1,0
22814,39195,25174,0,0,deny,62,62,0,1,0,1,0
22815,50233,445,0,0,deny,70,70,0,1,0,1,0
22816,62813,25174,0,0,deny,62,62,0,1,0,1,0
22817,19455,25174,0,0,deny,62,62,0,1,0,1,0
22818,63878,22114,0,0,deny,62,62,0,1,0,1,0
22819,1266,57470,0,0,deny,146,146,0,1,0,1,0
22820,49163,22114,0,0,deny,62,62,0,1,0,1,0
22821,65400,36237,0,0,deny,66,66,0,1,0,1,0
22822,61792,445,0,0,drop,70,70,0,1,0,1,0
22823,33804,443,22331,443,allow,5815,1128,4687,19,0,9,10
22824,61791,445,0,0,drop,70,70,0,1,0,1,0
22825,61790,445,0,0,drop,70,70,0,1,0,1,0
22826,62003,445,0,0,drop,66,66,0,1,0,1,0
22827,61788,445,0,0,drop,70,70,0,1,0,1,0
22828,61784,445,0,0,drop,70,70,0,1,0,1,0
22829,54280,3398,0,0,deny,60,60,0,1,0,1,0
22830,27000,23117,0,0,deny,62,62,0,1,0,1,0
22831,63554,44847,0,0,deny,66,66,0,1,0,1,0
22832,61997,445,0,0,drop,66,66,0,1,0,1,0
22833,26469,26348,0,0,deny,62,62,0,1,0,1,0
22834,32997,50584,0,0,deny,62,62,0,1,0,1,0
22835,61993,445,0,0,drop,66,66,0,1,0,1,0
22836,25756,22114,0,0,deny,146,146,0,1,0,1,0
22837,20962,22114,0,0,deny,62,62,0,1,0,1,0
22838,60438,17372,0,0,deny,66,66,0,1,0,1,0
22839,53323,35253,0,0,deny,66,66,0,1,0,1,0
22840,61779,445,0,0,drop,70,70,0,1,0,1,0
22841,17270,44847,0,0,deny,146,146,0,1,0,1,0
22842,24504,37965,0,0,deny,62,62,0,1,0,1,0
22843,43332,81,0,0,deny,60,60,0,1,0,1,0
22844,50254,2323,0,0,deny,60,60,0,1,0,1,0
22845,55711,26467,0,0,deny,66,66,0,1,0,1,0
22846,51746,25174,0,0,deny,66,66,0,1,0,1,0
22847,23274,50584,0,0,deny,146,146,0,1,0,1,0
22848,52459,5555,0,0,deny,60,60,0,1,0,1,0
22849,48335,25174,0,0,deny,62,62,0,1,0,1,0
22850,4500,4500,0,0,deny,862,862,0,1,0,1,0
22851,43828,44847,0,0,deny,66,66,0,1,0,1,0
22852,50222,445,0,0,drop,70,70,0,1,0,1,0
22853,50218,445,0,0,drop,70,70,0,1,0,1,0
22854,50219,445,0,0,drop,70,70,0,1,0,1,0
22855,15513,25174,0,0,deny,62,62,0,1,0,1,0
22856,61979,445,0,0,drop,66,66,0,1,0,1,0
22857,61981,445,0,0,drop,66,66,0,1,0,1,0
22858,61977,445,0,0,drop,66,66,0,1,0,1,0
22859,61976,445,0,0,drop,66,66,0,1,0,1,0
22860,61978,445,0,0,drop,66,66,0,1,0,1,0
22861,61975,445,0,0,drop,66,66,0,1,0,1,0
22862,61974,445,0,0,drop,66,66,0,1,0,1,0
22863,61973,445,0,0,drop,66,66,0,1,0,1,0
22864,5222,46866,0,0,deny,66,66,0,1,0,1,0
22865,61771,445,0,0,drop,70,70,0,1,0,1,0
22866,53841,37965,0,0,deny,66,66,0,1,0,1,0
22867,61770,445,0,0,drop,70,70,0,1,0,1,0
22868,50459,62413,0,0,deny,66,66,0,1,0,1,0
22869,60260,22114,0,0,deny,66,66,0,1,0,1,0
22870,52630,1433,0,0,deny,60,60,0,1,0,1,0
22871,6355,25174,0,0,deny,62,62,0,1,0,1,0
22872,39661,53733,0,0,deny,146,146,0,1,0,1,0
22873,12965,37965,0,0,deny,66,66,0,1,0,1,0
22874,9588,37965,0,0,deny,62,62,0,1,0,1,0
22875,44388,63874,0,0,deny,66,66,0,1,0,1,0
22876,61764,445,0,0,drop,70,70,0,1,0,1,0
22877,61763,445,0,0,drop,70,70,0,1,0,1,0
22878,53513,56205,0,0,deny,146,146,0,1,0,1,0
22879,50211,445,0,0,drop,70,70,0,1,0,1,0
22880,50209,445,0,0,drop,70,70,0,1,0,1,0
22881,50201,445,0,0,drop,70,70,0,1,0,1,0
22882,50199,445,0,0,drop,70,70,0,1,0,1,0
22883,37455,50584,0,0,deny,62,62,0,1,0,1,0
22884,64190,2767,0,0,deny,66,66,0,1,0,1,0
22885,2394,55108,0,0,deny,159,159,0,1,0,1,0
22886,61959,445,0,0,drop,66,66,0,1,0,1,0
22887,61960,445,0,0,drop,66,66,0,1,0,1,0
22888,61961,445,0,0,drop,66,66,0,1,0,1,0
22889,61759,445,0,0,drop,70,70,0,1,0,1,0
22890,2475,6881,0,0,deny,66,66,0,1,0,1,0
22891,57284,22114,0,0,deny,66,66,0,1,0,1,0
22892,25961,55783,0,0,deny,62,62,0,1,0,1,0
22893,61758,445,0,0,drop,70,70,0,1,0,1,0
22894,60823,25174,0,0,deny,66,66,0,1,0,1,0
22895,38549,22114,0,0,deny,146,146,0,1,0,1,0
22896,6712,44818,0,0,deny,66,66,0,1,0,1,0
22897,50197,445,0,0,drop,70,70,0,1,0,1,0
22898,64392,25174,0,0,deny,66,66,0,1,0,1,0
22899,62064,22114,0,0,deny,66,66,0,1,0,1,0
22900,61523,37807,0,0,deny,66,66,0,1,0,1,0
22901,50192,445,0,0,drop,70,70,0,1,0,1,0
22902,50191,445,0,0,drop,70,70,0,1,0,1,0
22903,50187,445,0,0,drop,70,70,0,1,0,1,0
22904,48513,44847,0,0,deny,146,146,0,1,0,1,0
22905,52988,53567,0,0,deny,66,66,0,1,0,1,0
22906,61753,445,0,0,drop,70,70,0,1,0,1,0
22907,61190,21247,0,0,deny,66,66,0,1,0,1,0
22908,37834,45129,0,0,deny,145,145,0,1,0,1,0
22909,13840,37965,0,0,deny,146,146,0,1,0,1,0
22910,50180,445,0,0,drop,70,70,0,1,0,1,0
22911,50178,445,0,0,drop,70,70,0,1,0,1,0
22912,50176,445,0,0,drop,70,70,0,1,0,1,0
22913,26717,25174,0,0,deny,62,62,0,1,0,1,0
22914,1262,23,0,0,deny,60,60,0,1,0,1,0
22915,27195,21247,0,0,deny,146,146,0,1,0,1,0
22916,55554,22114,0,0,deny,62,62,0,1,0,1,0
22917,61948,445,0,0,drop,66,66,0,1,0,1,0
22918,61740,445,0,0,drop,70,70,0,1,0,1,0
22919,57333,443,55597,443,allow,12837,1681,11156,30,62,16,14
22920,36754,443,36754,443,allow,4699,1792,2907,19,30,11,8
22921,52043,43578,45799,43578,allow,316,136,180,6,6,3,3
22922,27005,27015,49738,27015,allow,893,126,767,2,30,1,1
22923,27005,27018,4129,27018,allow,881,126,755,2,30,1,1
22924,35555,53,35555,53,allow,194,87,107,2,30,1,1
22925,52022,53657,53149,53657,allow,66,66,0,1,5,1,0
22926,52037,45647,32087,45647,allow,316,136,180,6,7,3,3
22927,63965,11785,30846,11785,allow,66,66,0,1,5,1,0
22928,35955,5228,64424,5228,allow,6776,1542,5234,21,3600,12,9
22929,51149,443,26017,443,allow,5092,2574,2518,14,135,7,7
22930,42749,53,42749,53,allow,847,110,737,2,30,1,1
22931,26229,80,26229,80,allow,7372,954,6418,17,18,9,8
22932,55691,16410,58376,16410,allow,70,70,0,2,8,2,0
22933,53803,17637,39254,17637,allow,70,70,0,1,5,1,0
22934,58874,443,12303,443,allow,10630,6981,3649,31,17,17,14
22935,64612,53,64612,53,allow,213,87,126,2,30,1,1
22936,27005,27015,45876,27015,allow,886,126,760,2,30,1,1
22937,15503,51413,47539,51413,allow,459,149,310,2,1200,1,1
22938,51463,53,0,0,allow,82,82,0,1,30,1,0
22939,48013,53,0,0,allow,82,82,0,1,30,1,0
22940,47892,443,19816,443,allow,6454,1447,5007,22,17,11,11
22941,52038,14487,18653,14487,allow,70,70,0,2,7,2,0
22942,57228,8525,57228,8525,allow,138,78,60,2,5,1,1
22943,52039,38541,31838,38541,allow,70,70,0,2,7,2,0
22944,52035,36498,46508,36498,allow,70,70,0,2,9,2,0
22945,55687,47613,13232,47613,allow,258,70,188,4,8,2,2
22946,52021,32202,28754,32202,allow,66,66,0,1,5,1,0
22947,41395,443,34255,443,allow,6292,1492,4800,22,17,11,11
22948,54666,443,61385,443,allow,3648,1080,2568,18,135,8,10
22949,56222,5228,31508,5228,allow,2531,1513,1018,17,3601,8,9
22950,58886,443,39424,443,allow,3989,2585,1404,17,15,9,8
22951,52649,443,45569,443,allow,6292,1492,4800,22,17,11,11
22952,50649,80,63151,80,allow,1366,865,501,8,15,5,3
22953,59940,80,29186,80,allow,1169137,23501,1145636,1104,22,344,760
22954,53614,443,48622,443,allow,6352,1552,4800,23,17,12,11
22955,61099,443,33626,443,allow,492,492,0,7,15,7,0
22956,55689,37558,21710,37558,allow,70,70,0,2,8,2,0
22957,63961,51641,64148,51641,allow,504,382,122,8,16,6,2
22958,49199,8106,41963,8106,allow,370,190,180,6,15,3,3
22959,49566,80,12827,80,allow,1268,703,565,11,23,6,5
22960,27005,27014,42282,27014,allow,882,126,756,2,30,1,1
22961,33063,443,10345,443,allow,6411,1611,4800,24,17,13,11
22962,27005,27016,41906,27016,allow,882,126,756,2,30,1,1
22963,22263,53,22263,53,allow,288,83,205,2,30,1,1
22964,53502,443,33693,443,allow,10893,6516,4377,36,131,16,20
22965,57470,58695,5572,58695,allow,726,726,0,12,1200,12,0
22966,26651,25174,0,0,deny,146,146,0,1,0,1,0
22967,13159,37965,0,0,deny,66,66,0,1,0,1,0
22968,52227,64147,0,0,deny,66,66,0,1,0,1,0
22969,29139,64147,0,0,deny,62,62,0,1,0,1,0
22970,40797,25174,0,0,deny,62,62,0,1,0,1,0
22971,27860,23,0,0,deny,60,60,0,1,0,1,0
22972,49521,80,17385,80,allow,1653,831,822,13,93,7,6
22973,45630,443,4110,443,allow,2996,1629,1367,17,21,9,8
22974,53799,6881,10719,6881,allow,70,70,0,1,4,1,0
22975,52024,47600,3124,47600,allow,70,70,0,1,4,1,0
22976,64891,53,61433,53,allow,320,97,223,4,34,2,2
22977,57470,64738,24802,64738,allow,1577,594,983,20,1582,10,10
22978,34297,443,14287,443,allow,65853,31390,34463,203,694,105,98
22979,38675,443,37452,443,allow,13929,2854,11075,43,128,22,21
22980,57587,443,15184,443,allow,7150,1958,5192,28,144,14,14
22981,52179,443,47721,443,allow,414,140,274,7,25,3,4
22982,42164,80,6790,80,allow,1658,1344,314,10,15,5,5
22983,49440,443,59866,443,allow,5141,896,4245,17,69,8,9
22984,51053,80,62409,80,allow,1638,1324,314,10,14,5,5
22985,8291,23,8291,23,allow,66,66,0,1,4,1,0
22986,53798,62166,25360,62166,allow,164,70,94,2,4,1,1
22987,53807,28630,23692,28630,allow,70,70,0,1,4,1,0
22988,53804,24067,28773,24067,allow,70,70,0,1,4,1,0
22989,53805,34155,22730,34155,allow,70,70,0,1,4,1,0
22990,63966,42532,2551,42532,allow,70,70,0,1,4,1,0
22991,45768,80,41776,80,allow,2784,1804,980,17,20,9,8
22992,49214,58485,20411,58485,allow,70,70,0,1,5,1,0
22993,65245,53,10432,53,allow,479,98,381,4,57,2,2
22994,39197,443,22296,443,allow,65158,3519,61639,89,200,41,48
22995,50619,443,52531,443,allow,10483,1021,9462,30,100,11,19
22996,64063,53,31532,53,allow,339,110,229,2,29,1,1
22997,19328,53,26253,53,allow,236,86,150,2,29,1,1
22998,49997,53,41448,53,allow,284,94,190,2,29,1,1
22999,49581,80,58944,80,allow,2339,1107,1232,11,21,6,5
23000,38957,443,58777,443,allow,7457,1333,6124,18,200,10,8
23001,57082,80,34844,80,allow,2944,1074,1870,12,75,7,5
23002,55012,443,47170,443,allow,3388,2236,1152,28,904,16,12
23003,60787,40010,15005,40010,allow,316,136,180,6,6,3,3
23004,65469,53,60792,53,allow,327,110,217,2,30,1,1
23005,49216,63752,26927,63752,allow,70,70,0,1,5,1,0
23006,52023,41791,57379,41791,allow,70,70,0,1,5,1,0
23007,49443,80,19440,80,allow,3642,1460,2182,23,143,12,11
23008,50710,443,41434,443,allow,6141,1268,4873,22,18,12,10
23009,49558,80,45042,80,allow,39679,7315,32364,45,24,17,28
23010,49212,38306,22542,38306,allow,70,70,0,1,5,1,0
23011,36803,53,44440,53,allow,243,86,157,2,30,1,1
23012,58046,443,58046,443,allow,4682,1775,2907,19,29,11,8
23013,54677,443,15752,443,allow,3704,1428,2276,14,135,7,7
23014,54819,443,51937,443,allow,9035,1873,7162,28,124,14,14
23015,52609,443,37495,443,allow,24091,7349,16742,75,162,36,39
23016,52036,52608,61881,52608,allow,70,70,0,2,8,2,0
23017,50648,80,9788,80,allow,1717,1247,470,9,15,5,4
23018,54548,7000,54548,7000,allow,4487,2090,2397,15,15,8,7
23019,37573,443,7707,443,allow,13637,6347,7290,34,46,20,14
23020,49319,53,53546,53,allow,260,102,158,2,30,1,1
23021,48717,443,44246,443,allow,232,172,60,3,5,2,1
23022,50169,53,35420,53,allow,223,78,145,2,30,1,1
23023,49160,6889,25152,6889,allow,834,150,684,4,1200,2,2
23024,53270,443,30676,443,allow,6894,1556,5338,23,3601,13,10
23025,60993,443,45715,443,allow,7201,2107,5094,23,61,13,10
23026,58887,443,25823,443,allow,5167,700,4467,16,15,7,9
23027,45767,80,42626,80,allow,2768,1722,1046,17,20,8,9
23028,55360,443,39812,443,allow,6379,1762,4617,27,27,14,13
23029,49196,443,53527,443,allow,789207,20847,768360,812,23,294,518
23030,58813,80,56191,80,allow,2393,551,1842,10,21,6,4
23031,50181,443,54274,443,allow,8113,2063,6050,23,255,11,12
23032,59758,443,17824,443,allow,4114,2557,1557,22,418,9,13
23033,58888,443,9606,443,allow,5166,700,4466,16,14,7,9
23034,52040,2524,8539,2524,allow,70,70,0,2,7,2,0
23035,37672,5223,41244,5223,allow,220,220,0,3,6,3,0
23036,53806,37267,20623,37267,allow,70,70,0,1,4,1,0
23037,64214,53,1437,53,allow,337,106,231,4,43,2,2
23038,46405,80,41634,80,allow,1213,755,458,10,15,6,4
23039,37833,80,26930,80,allow,2087,729,1358,10,15,5,5
23040,33642,443,1036,443,allow,8533,4446,4087,65,160,32,33
23041,55310,53,40255,53,allow,168,78,90,2,29,1,1
23042,65134,53,41256,53,allow,273,102,171,2,30,1,1
23043,39442,123,6602,123,allow,184,94,90,2,30,1,1
23044,20254,53,7951,53,allow,223,78,145,2,29,1,1
23045,64463,53,2430,53,allow,183,94,89,2,29,1,1
23046,27005,27015,6059,27015,allow,881,126,755,2,30,1,1
23047,27988,40021,42591,40021,allow,245,182,63,2,30,1,1
23048,49380,53,7490,53,allow,110,110,0,1,30,1,0
23049,38886,53,39118,53,allow,223,78,145,2,30,1,1
23050,64494,53,62617,53,allow,402,118,284,2,30,1,1
23051,51487,443,12254,443,allow,828,390,438,11,60,4,7
23052,49215,52611,6615,52611,allow,70,70,0,1,5,1,0
23053,58885,443,57111,443,allow,5167,700,4467,16,15,7,9
23054,41231,443,41940,443,allow,65667,5371,60296,89,85,36,53
23055,48063,80,21248,80,allow,1638,1324,314,10,15,5,5
23056,61100,80,15206,80,allow,1516,481,1035,11,15,6,5
23057,60222,443,18964,443,allow,4308,1658,2650,14,16,7,7
23058,27005,27015,5411,27015,allow,887,126,761,2,30,1,1
23059,27005,27017,58319,27017,allow,883,126,757,2,30,1,1
23060,55688,33958,47150,33958,allow,70,70,0,2,8,2,0
23061,56662,80,65360,80,allow,234,234,0,4,12,4,0
23062,49986,53,37815,53,allow,312,93,219,4,37,2,2
23063,47282,443,1990,443,allow,130,70,60,2,15,1,1
23064,61737,445,0,0,drop,70,70,0,1,0,1,0
23065,49164,25174,0,0,deny,62,62,0,1,0,1,0
23066,50172,445,0,0,drop,70,70,0,1,0,1,0
23067,50170,445,0,0,drop,70,70,0,1,0,1,0
23068,26425,22114,0,0,deny,62,62,0,1,0,1,0
23069,16270,56205,0,0,deny,62,62,0,1,0,1,0
23070,49916,53,53241,53,allow,118,118,0,1,30,1,0
23071,46694,443,30947,443,allow,3680,1777,1903,18,34,8,10
23072,64711,53,30437,53,allow,179,86,93,2,30,1,1
23073,64906,53,18657,53,allow,209,110,99,2,30,1,1
23074,64921,53,46383,53,allow,238,102,136,2,31,1,1
23075,49211,15576,30482,15576,allow,70,70,0,1,5,1,0
23076,40561,443,22594,443,allow,3167,2456,711,15,16,10,5
23077,65149,443,54688,443,allow,2963,1304,1659,28,120,14,14
23078,53796,48019,63153,48019,allow,70,70,0,1,5,1,0
23079,58933,80,48784,80,allow,2055,1651,404,8,76,5,3
23080,35595,80,11916,80,allow,1566,684,882,10,15,5,5
23081,37802,80,16566,80,allow,1702,1388,314,10,16,5,5
23082,39297,443,18589,443,allow,21690,2882,18808,59,197,30,29
23083,51245,443,54725,443,allow,9847,4746,5101,43,16,24,19
23084,55056,443,52975,443,allow,8309,1561,6748,26,204,14,12
23085,38076,80,55546,80,allow,15538,1307,14231,27,45,15,12
23086,38956,443,38557,443,allow,9096,4245,4851,29,121,14,15
23087,27005,30000,27515,30000,allow,913,126,787,2,31,1,1
23088,44182,443,55726,443,allow,8241,1810,6431,25,20,14,11
23089,58879,443,4460,443,allow,5168,700,4468,16,15,7,9
23090,49546,443,43053,443,allow,1346,918,428,10,23,6,4
23091,49547,443,35951,443,allow,1346,918,428,10,23,6,4
23092,54374,443,53616,443,allow,7402,1350,6052,24,16,13,11
23093,41228,443,9093,443,allow,9161,2210,6951,23,187,11,12
23094,10552,25174,0,0,deny,62,62,0,1,0,1,0
23095,60163,26467,0,0,deny,66,66,0,1,0,1,0
23096,40742,2967,0,0,deny,62,62,0,1,0,1,0
23097,63577,30188,0,0,deny,66,66,0,1,0,1,0
23098,55653,23,0,0,deny,60,60,0,1,0,1,0
23099,61933,445,0,0,drop,66,66,0,1,0,1,0
23100,61931,445,0,0,drop,66,66,0,1,0,1,0
23101,49324,64147,0,0,deny,66,66,0,1,0,1,0
23102,61733,445,0,0,drop,70,70,0,1,0,1,0
23103,61731,445,0,0,drop,70,70,0,1,0,1,0
23104,63895,44847,0,0,deny,62,62,0,1,0,1,0
23105,15605,50265,0,0,deny,62,62,0,1,0,1,0
23106,52230,50265,0,0,deny,66,66,0,1,0,1,0
23107,61729,445,0,0,drop,70,70,0,1,0,1,0
23108,50159,445,0,0,drop,70,70,0,1,0,1,0
23109,50160,445,0,0,drop,70,70,0,1,0,1,0
23110,50154,445,0,0,drop,70,70,0,1,0,1,0
23111,50152,445,0,0,drop,70,70,0,1,0,1,0
23112,13508,15503,0,0,deny,66,66,0,1,0,1,0
23113,61927,445,0,0,drop,66,66,0,1,0,1,0
23114,61918,445,0,0,drop,66,66,0,1,0,1,0
23115,61911,445,0,0,drop,66,66,0,1,0,1,0
23116,61917,445,0,0,drop,66,66,0,1,0,1,0
23117,61916,445,0,0,drop,66,66,0,1,0,1,0
23118,61912,445,0,0,drop,66,66,0,1,0,1,0
23119,61910,445,0,0,drop,66,66,0,1,0,1,0
23120,62991,51221,0,0,deny,66,66,0,1,0,1,0
23121,22461,34021,0,0,reset-both,62,62,0,1,0,1,0
23122,61722,445,0,0,drop,70,70,0,1,0,1,0
23123,50145,445,0,0,drop,70,70,0,1,0,1,0
23124,40840,21247,0,0,deny,62,62,0,1,0,1,0
23125,22530,23718,0,0,deny,66,66,0,1,0,1,0
23126,42951,22114,0,0,deny,66,66,0,1,0,1,0
23127,33380,48817,0,0,deny,146,146,0,1,0,1,0
23128,50142,445,0,0,drop,70,70,0,1,0,1,0
23129,50140,445,0,0,drop,70,70,0,1,0,1,0
23130,53883,443,37691,443,allow,495,421,74,4,0,3,1
23131,53879,443,22578,443,allow,499,425,74,4,1,3,1
23132,53874,443,50535,443,allow,499,425,74,4,1,3,1
23133,53877,443,42282,443,allow,499,425,74,4,1,3,1
23134,53875,443,27415,443,allow,499,425,74,4,1,3,1
23135,53872,443,24185,443,allow,499,425,74,4,1,3,1
23136,50138,445,0,0,drop,70,70,0,1,0,1,0
23137,61720,445,0,0,drop,70,70,0,1,0,1,0
23138,49001,40108,0,0,deny,161,161,0,1,0,1,0
23139,61719,445,0,0,drop,70,70,0,1,0,1,0
23140,64306,64147,0,0,deny,66,66,0,1,0,1,0
23141,13518,25174,0,0,deny,62,62,0,1,0,1,0
23142,61718,445,0,0,drop,70,70,0,1,0,1,0
23143,21817,22114,0,0,deny,62,62,0,1,0,1,0
23144,54206,25174,0,0,deny,62,62,0,1,0,1,0
23145,61717,445,0,0,drop,70,70,0,1,0,1,0
23146,64673,6881,0,0,deny,66,66,0,1,0,1,0
23147,61714,445,0,0,drop,70,70,0,1,0,1,0
23148,61711,445,0,0,drop,70,70,0,1,0,1,0
23149,49001,40108,0,0,deny,161,161,0,1,0,1,0
23150,12164,22114,0,0,deny,62,62,0,1,0,1,0
23151,17262,25174,0,0,deny,146,146,0,1,0,1,0
23152,25961,55783,0,0,deny,60,60,0,1,0,1,0
23153,62654,35440,0,0,deny,62,62,0,1,0,1,0
23154,28306,25604,0,0,deny,62,62,0,1,0,1,0
23155,50137,445,0,0,drop,70,70,0,1,0,1,0
23156,50133,445,0,0,drop,70,70,0,1,0,1,0
23157,50132,445,0,0,drop,70,70,0,1,0,1,0
23158,50316,25604,0,0,deny,66,66,0,1,0,1,0
23159,61903,445,0,0,drop,66,66,0,1,0,1,0
23160,61699,445,0,0,drop,70,70,0,1,0,1,0
23161,61698,445,0,0,drop,70,70,0,1,0,1,0
23162,21322,25174,0,0,deny,146,146,0,1,0,1,0
23163,50129,445,0,0,drop,70,70,0,1,0,1,0
23164,61692,445,0,0,drop,70,70,0,1,0,1,0
23165,8239,37965,0,0,deny,146,146,0,1,0,1,0
23166,61902,445,0,0,drop,66,66,0,1,0,1,0
23167,61689,445,0,0,drop,70,70,0,1,0,1,0
23168,61688,445,0,0,drop,70,70,0,1,0,1,0
23169,49001,40108,0,0,deny,161,161,0,1,0,1,0
23170,61899,445,0,0,drop,66,66,0,1,0,1,0
23171,61898,445,0,0,drop,66,66,0,1,0,1,0
23172,2946,25174,0,0,deny,146,146,0,1,0,1,0
23173,63083,25174,0,0,deny,66,66,0,1,0,1,0
23174,61897,445,0,0,drop,66,66,0,1,0,1,0
23175,59366,35440,0,0,deny,62,62,0,1,0,1,0
23176,37431,25174,0,0,deny,146,146,0,1,0,1,0
23177,51109,11392,0,0,deny,66,66,0,1,0,1,0
23178,53873,443,46663,443,allow,499,425,74,4,1,3,1
23179,53878,443,30400,443,allow,499,425,74,4,1,3,1
23180,53876,443,64698,443,allow,499,425,74,4,1,3,1
23181,53868,443,61364,443,allow,499,425,74,4,1,3,1
23182,53871,443,16922,443,allow,499,425,74,4,1,3,1
23183,53863,443,62778,443,allow,499,425,74,4,1,3,1
23184,53869,443,21669,443,allow,499,425,74,4,1,3,1
23185,53865,443,28083,443,allow,499,425,74,4,1,3,1
23186,53862,443,35996,443,allow,499,425,74,4,1,3,1
23187,53870,443,3316,443,allow,499,425,74,4,1,3,1
23188,53864,443,39351,443,allow,499,425,74,4,1,3,1
23189,53861,443,51732,443,allow,499,425,74,4,1,3,1
23190,53867,443,58511,443,allow,499,425,74,4,1,3,1
23191,53860,443,61776,443,allow,499,425,74,4,1,3,1
23192,53858,443,59816,443,allow,499,425,74,4,1,3,1
23193,53866,443,56444,443,allow,499,425,74,4,1,3,1
23194,53857,443,11803,443,allow,499,425,74,4,1,3,1
23195,53859,443,52772,443,allow,499,425,74,4,1,3,1
23196,53906,17372,0,0,deny,62,62,0,1,0,1,0
23197,50123,445,0,0,drop,70,70,0,1,0,1,0
23198,24560,25174,0,0,deny,62,62,0,1,0,1,0
23199,56816,11392,0,0,deny,66,66,0,1,0,1,0
23200,61677,445,0,0,drop,70,70,0,1,0,1,0
23201,51490,1,0,0,deny,100,100,0,1,0,1,0
23202,59424,50265,0,0,deny,74,74,0,1,0,1,0
23203,50118,445,0,0,drop,70,70,0,1,0,1,0
23204,55529,44847,0,0,deny,66,66,0,1,0,1,0
23205,50112,445,0,0,drop,70,70,0,1,0,1,0
23206,2238,22114,0,0,deny,146,146,0,1,0,1,0
23207,16092,50265,0,0,deny,62,62,0,1,0,1,0
23208,58357,62413,0,0,deny,62,62,0,1,0,1,0
23209,51094,35440,0,0,deny,66,66,0,1,0,1,0
23210,61885,445,0,0,drop,66,66,0,1,0,1,0
23211,54280,3385,0,0,deny,60,60,0,1,0,1,0
23212,16376,35440,0,0,deny,62,62,0,1,0,1,0
23213,6881,6881,0,0,deny,62,62,0,1,0,1,0
23214,8108,55108,0,0,deny,157,157,0,1,0,1,0
23215,1025,25174,0,0,deny,62,62,0,1,0,1,0
23216,61673,445,0,0,drop,70,70,0,1,0,1,0
23217,58488,37965,0,0,deny,62,62,0,1,0,1,0
23218,61878,445,0,0,drop,66,66,0,1,0,1,0
23219,50106,445,0,0,drop,70,70,0,1,0,1,0
23220,5841,22114,0,0,deny,62,62,0,1,0,1,0
23221,26698,57470,0,0,deny,62,62,0,1,0,1,0
23222,61661,445,0,0,drop,70,70,0,1,0,1,0
23223,61664,445,0,0,drop,70,70,0,1,0,1,0
23224,61662,445,0,0,drop,70,70,0,1,0,1,0
23225,61659,445,0,0,drop,70,70,0,1,0,1,0
23226,54752,31573,0,0,deny,62,62,0,1,0,1,0
23227,61657,445,0,0,drop,70,70,0,1,0,1,0
23228,52644,57209,0,0,deny,66,66,0,1,0,1,0
23229,61875,445,0,0,drop,66,66,0,1,0,1,0
23230,63116,22114,0,0,deny,62,62,0,1,0,1,0
23231,63023,51505,0,0,deny,66,66,0,1,0,1,0
23232,52143,37807,0,0,deny,66,66,0,1,0,1,0
23233,61869,445,0,0,drop,66,66,0,1,0,1,0
23234,36548,25174,0,0,deny,62,62,0,1,0,1,0
23235,57762,25174,0,0,deny,62,62,0,1,0,1,0
23236,47910,7461,0,0,deny,60,60,0,1,0,1,0
23237,61865,445,0,0,drop,66,66,0,1,0,1,0
23238,62769,25174,0,0,deny,62,62,0,1,0,1,0
23239,61650,445,0,0,drop,70,70,0,1,0,1,0
23240,42252,33303,0,0,deny,60,60,0,1,0,1,0
23241,53539,44847,0,0,deny,66,66,0,1,0,1,0
23242,59745,25174,0,0,deny,62,62,0,1,0,1,0
23243,13285,29892,0,0,deny,145,145,0,1,0,1,0
23244,0,0,0,0,allow,320,320,0,5,0,5,0
23245,0,0,0,0,deny,70,70,0,1,0,1,0
23246,22150,6881,0,0,deny,146,146,0,1,0,1,0
23247,12184,56205,0,0,deny,146,146,0,1,0,1,0
23248,61643,445,0,0,drop,70,70,0,1,0,1,0
23249,50093,445,0,0,drop,70,70,0,1,0,1,0
23250,50090,445,0,0,drop,70,70,0,1,0,1,0
23251,50089,445,0,0,drop,70,70,0,1,0,1,0
23252,61642,445,0,0,drop,70,70,0,1,0,1,0
23253,61848,445,0,0,drop,66,66,0,1,0,1,0
23254,61852,445,0,0,drop,66,66,0,1,0,1,0
23255,61851,445,0,0,drop,66,66,0,1,0,1,0
23256,61850,445,0,0,drop,66,66,0,1,0,1,0
23257,61853,445,0,0,drop,66,66,0,1,0,1,0
23258,61849,445,0,0,drop,66,66,0,1,0,1,0
23259,61846,445,0,0,drop,66,66,0,1,0,1,0
23260,65018,7302,0,0,deny,146,146,0,1,0,1,0
23261,40977,21247,0,0,deny,62,62,0,1,0,1,0
23262,17251,10387,0,0,deny,159,159,0,1,0,1,0
23263,52210,51505,0,0,deny,66,66,0,1,0,1,0
23264,57459,51505,0,0,deny,62,62,0,1,0,1,0
23265,60342,36237,0,0,deny,66,66,0,1,0,1,0
23266,15499,22114,0,0,deny,62,62,0,1,0,1,0
23267,49160,59033,0,0,deny,146,146,0,1,0,1,0
23268,25187,31573,0,0,deny,62,62,0,1,0,1,0
23269,61635,445,0,0,drop,70,70,0,1,0,1,0
23270,46856,25174,0,0,deny,62,62,0,1,0,1,0
23271,23475,25174,0,0,deny,146,146,0,1,0,1,0
23272,50977,56205,0,0,deny,66,66,0,1,0,1,0
23273,80,37649,0,0,deny,60,60,0,1,0,1,0
23274,15451,25174,0,0,deny,146,146,0,1,0,1,0
23275,50651,25174,0,0,deny,62,62,0,1,0,1,0
23276,14023,37965,0,0,deny,62,62,0,1,0,1,0
23277,50082,445,0,0,drop,70,70,0,1,0,1,0
23278,50080,445,0,0,drop,70,70,0,1,0,1,0
23279,50073,445,0,0,drop,70,70,0,1,0,1,0
23280,50071,445,0,0,drop,70,70,0,1,0,1,0
23281,35291,44847,0,0,deny,62,62,0,1,0,1,0
23282,61631,445,0,0,drop,70,70,0,1,0,1,0
23283,48706,23393,0,0,deny,60,60,0,1,0,1,0
23284,19875,30170,0,0,deny,145,145,0,1,0,1,0
23285,10462,25174,0,0,deny,62,62,0,1,0,1,0
23286,61833,445,0,0,drop,66,66,0,1,0,1,0
23287,61832,445,0,0,drop,66,66,0,1,0,1,0
23288,61831,445,0,0,drop,66,66,0,1,0,1,0
23289,2278,25174,0,0,deny,62,62,0,1,0,1,0
23290,14740,26467,0,0,deny,62,62,0,1,0,1,0
23291,52318,22114,0,0,deny,62,62,0,1,0,1,0
23292,61630,445,0,0,drop,70,70,0,1,0,1,0
23293,31017,50584,0,0,deny,62,62,0,1,0,1,0
23294,31627,64147,0,0,deny,62,62,0,1,0,1,0
23295,35570,22114,0,0,deny,62,62,0,1,0,1,0
23296,62792,53,0,0,deny,88,88,0,1,0,1,0
23297,50069,445,0,0,drop,70,70,0,1,0,1,0
23298,50573,22114,0,0,deny,62,62,0,1,0,1,0
23299,50068,445,0,0,drop,70,70,0,1,0,1,0
23300,50064,445,0,0,drop,70,70,0,1,0,1,0
23301,50059,445,0,0,drop,70,70,0,1,0,1,0
23302,63578,35440,0,0,deny,66,66,0,1,0,1,0
23303,59813,53,59813,53,allow,228,97,131,2,30,1,1
23304,21184,53,21184,53,allow,194,87,107,2,30,1,1
23305,37382,80,11429,80,allow,1221,781,440,11,16,6,5
23306,52016,80,9292,80,allow,124703,6134,118569,147,125,64,83
23307,56539,443,14998,443,allow,52465,2787,49678,66,80,26,40
23308,60463,6890,23297,6890,allow,164,70,94,3,8,2,1
23309,41173,443,28924,443,allow,11771,2624,9147,50,19,25,25
23310,50593,443,49390,443,allow,6292,1492,4800,22,16,11,11
23311,27005,27016,3846,27016,allow,889,126,763,2,30,1,1
23312,34616,443,64459,443,allow,9265,4429,4836,23,18,14,9
23313,40147,443,40147,443,allow,1092,575,517,10,145,5,5
23314,11350,3389,11350,3389,allow,3850,1745,2105,19,18,11,8
23315,64771,53,46292,53,allow,793,101,692,2,30,1,1
23316,57367,443,57367,443,allow,4381,1474,2907,19,29,11,8
23317,53795,22719,46314,22719,allow,164,70,94,2,6,1,1
23318,49680,80,4197,80,allow,1548,847,701,10,16,5,5
23319,32959,443,7767,443,allow,9262,2792,6470,53,616,28,25
23320,55511,443,12800,443,allow,10499,2421,8078,28,15,14,14
23321,56415,53,16835,53,allow,740,93,647,2,30,1,1
23322,49532,443,49532,443,allow,20488,16649,3839,30,24,18,12
23323,56525,443,51595,443,allow,14108,2487,11621,32,81,18,14
23324,52017,26175,30441,26175,allow,66,66,0,1,5,1,0
23325,49201,17852,10581,17852,allow,66,66,0,1,5,1,0
23326,52034,48856,21980,48856,allow,70,70,0,2,9,2,0
23327,49209,52030,14863,52030,allow,66,66,0,1,5,1,0
23328,37244,53,37244,53,allow,172,76,96,2,30,1,1
23329,4738,53,4738,53,allow,213,87,126,2,30,1,1
23330,11786,53,11786,53,allow,194,87,107,2,30,1,1
23331,60341,443,14614,443,allow,54103,3190,50913,68,362,27,41
23332,61289,53,61289,53,allow,197,76,121,2,30,1,1
23333,49681,80,35209,80,allow,4584,3642,942,15,15,8,7
23334,57119,80,41470,80,allow,5774,783,4991,17,75,10,7
23335,40620,443,2727,443,allow,7049,1412,5637,24,16,14,10
23336,58818,443,11066,443,allow,1413,876,537,12,25,6,6
23337,56538,443,45521,443,allow,7760,1599,6161,23,80,13,10
23338,65484,443,65484,443,allow,4640,1733,2907,19,27,11,8
23339,58817,443,7616,443,allow,1413,876,537,12,25,6,6
23340,2954,443,2954,443,allow,6915,882,6033,16,149,9,7
23341,58483,443,25541,443,allow,3024,709,2315,13,120,6,7
23342,58877,443,18145,443,allow,2577,1550,1027,15,15,7,8
23343,47368,443,14689,443,allow,7057,2186,4871,25,316,13,12
23344,46716,443,30978,443,allow,7298,2661,4637,21,17,11,10
23345,49208,6881,5366,6881,allow,66,66,0,1,5,1,0
23346,49533,443,49533,443,allow,20402,16563,3839,29,24,17,12
23347,49901,53,49901,53,allow,194,87,107,2,30,1,1
23348,54989,443,11421,443,allow,34038,16039,17999,79,63,43,36
23349,16814,53,16814,53,allow,217,87,130,2,30,1,1
23350,60166,443,38227,443,allow,8198,2252,5946,29,318,14,15
23351,31011,53,31011,53,allow,197,76,121,2,30,1,1
23352,27005,27015,44783,27015,allow,939,126,813,2,30,1,1
23353,6881,38554,27434,38554,allow,221,111,110,2,1200,1,1
23354,59319,53,47365,53,allow,285,106,179,2,31,1,1
23355,59247,53,59247,53,allow,825,99,726,2,31,1,1
23356,60505,53,0,0,allow,340,90,250,2,31,1,1
23357,50820,443,59076,443,allow,6133,1655,4478,12,121,5,7
23358,52332,443,60314,443,allow,15746,4302,11444,17,122,5,12
23359,60505,53,0,0,allow,340,90,250,2,31,1,1
23360,55269,53,20584,53,allow,186,95,91,2,31,1,1
23361,58279,53,58279,53,allow,847,110,737,2,31,1,1
23362,11859,64147,0,0,deny,62,62,0,1,0,1,0
23363,41499,23,0,0,deny,60,60,0,1,0,1,0
23364,61625,445,0,0,drop,70,70,0,1,0,1,0
23365,2598,23718,0,0,deny,62,62,0,1,0,1,0
23366,63888,57470,0,0,deny,62,62,0,1,0,1,0
23367,55484,25174,0,0,deny,62,62,0,1,0,1,0
23368,1882,43890,0,0,deny,62,62,0,1,0,1,0
23369,55689,37965,0,0,deny,66,66,0,1,0,1,0
23370,10701,11392,0,0,deny,146,146,0,1,0,1,0
23371,20706,37965,0,0,deny,62,62,0,1,0,1,0
23372,10088,37807,0,0,deny,66,66,0,1,0,1,0
23373,51298,57470,0,0,deny,66,66,0,1,0,1,0
23374,51800,80,7944,80,allow,2169,472,1697,10,77,6,4
23375,54355,443,13555,443,allow,15334,4707,10627,28,24,14,14
23376,54538,80,35235,80,allow,4162,3455,707,14,15,8,6
23377,38077,80,35599,80,allow,1484,601,883,9,44,6,3
23378,60132,443,39833,443,allow,350,210,140,6,25,4,2
23379,33459,80,37833,80,allow,1658,1344,314,10,14,5,5
23380,53132,443,53588,443,allow,7271,2540,4731,32,20,18,14
23381,64327,53,59589,53,allow,214,102,112,2,29,1,1
23382,64782,53,60235,53,allow,212,102,110,2,29,1,1
23383,27005,27016,28994,27016,allow,880,126,754,2,30,1,1
23384,27005,31000,15120,31000,allow,898,126,772,2,30,1,1
23385,64160,53,55275,53,allow,258,110,148,2,30,1,1
23386,56941,443,33358,443,allow,4581,2831,1750,29,96,15,14
23387,42661,80,47037,80,allow,78310,9243,69067,109,93,57,52
23388,63997,59512,17767,59512,allow,312,132,180,6,5,3,3
23389,58926,80,29286,80,allow,1291,887,404,8,89,5,3
23390,42663,80,49274,80,allow,5562,1204,4358,11,91,7,4
23391,42665,80,22230,80,allow,7651,2046,5605,16,91,10,6
23392,52019,40689,33926,40689,allow,70,70,0,1,5,1,0
23393,64451,53,26294,53,allow,363,92,271,4,31,2,2
23394,5385,22,5385,22,allow,66,66,0,1,4,1,0
23395,9204,443,60040,443,allow,5399,368,5031,18,31,5,13
23396,27005,27020,19187,27020,allow,890,126,764,2,30,1,1
23397,27005,27016,54195,27016,allow,876,126,750,2,30,1,1
23398,37635,443,24027,443,allow,9406,2044,7362,27,21,16,11
23399,5588,5588,0,0,allow,3354,1792,1562,46,192,23,23
23400,54808,443,25043,443,allow,9657,1944,7713,31,82,15,16
23401,41593,53,64892,53,allow,243,86,157,2,29,1,1
23402,35047,53,53594,53,allow,70657,70002,655,845,88,839,6
23403,64581,443,64560,443,allow,9221,2109,7112,28,32,15,13
23404,52020,28704,61808,28704,allow,70,70,0,1,5,1,0
23405,52033,37905,61391,37905,allow,70,70,0,2,8,2,0
23406,64394,53,6864,53,allow,226,102,124,2,30,1,1
23407,52002,53,64717,53,allow,289,86,203,2,30,1,1
23408,49206,12242,47287,12242,allow,70,70,0,1,5,1,0
23409,53268,443,58840,443,allow,4241,706,3535,14,25,8,6
23410,49202,31719,26471,31719,allow,70,70,0,1,5,1,0
23411,49200,38001,12165,38001,allow,70,70,0,1,5,1,0
23412,56059,80,49532,80,allow,1151,711,440,10,15,5,5
23413,58875,443,10382,443,allow,5168,700,4468,16,15,7,9
23414,60394,11136,28099,11136,allow,7512,2276,5236,39,94,21,18
23415,60462,47821,34484,47821,allow,70,70,0,2,8,2,0
23416,64515,53,64413,53,allow,231,86,145,2,30,1,1
23417,33060,443,63569,443,allow,25617,6531,19086,87,220,46,41
23418,49198,64509,55959,64509,allow,70,70,0,1,5,1,0
23419,55269,53,18249,53,allow,102,102,0,1,30,1,0
23420,54348,443,11963,443,allow,8863,3511,5352,20,120,9,11
23421,57354,443,9548,443,allow,28807,2716,26091,54,466,21,33
23422,56695,53,7335,53,allow,183,94,89,2,30,1,1
23423,42454,443,47292,443,allow,3513,795,2718,11,120,5,6
23424,60136,443,22877,443,allow,3647,1221,2426,13,135,6,7
23425,65379,443,37475,443,allow,76625,63648,12977,139,83,79,60
23426,60431,443,1098,443,allow,3260,1646,1614,9,120,5,4
23427,65224,443,29038,443,allow,18887,8273,10614,42,62,22,20
23428,48542,80,42394,80,allow,811,671,140,6,32,4,2
23429,57903,80,16780,80,allow,6457,1210,5247,14,17,8,6
23430,48550,80,64861,80,allow,811,671,140,6,22,4,2
23431,37097,80,49884,80,allow,1114,534,580,12,15,7,5
23432,39840,443,35916,443,allow,6097,1540,4557,25,191,13,12
23433,51393,443,1567,443,allow,4721,2724,1997,35,130,19,16
23434,42664,80,62788,80,allow,63654,7979,55675,90,91,49,41
23435,50353,443,5439,443,allow,130,70,60,3,4,2,1
23436,49548,443,37968,443,allow,1346,918,428,10,22,6,4
23437,65127,443,61568,443,allow,648,648,0,7,15,7,0
23438,49725,53,18742,53,allow,211,102,109,2,29,1,1
23439,64359,53,13819,53,allow,230,102,128,2,30,1,1
23440,51244,443,19950,443,allow,8024,2572,5452,39,15,23,16
23441,50590,53,53774,53,allow,889,404,485,10,30,5,5
23442,52065,443,43327,443,allow,7851,2487,5364,35,383,16,19
23443,65281,53,27234,53,allow,216,94,122,2,30,1,1
23444,49642,53,3732,53,allow,302,110,192,2,30,1,1
23445,27005,27015,27369,27015,allow,889,126,763,2,30,1,1
23446,57157,53,58237,53,allow,458,188,270,6,30,3,3
23447,56695,53,47655,53,allow,183,94,89,2,30,1,1
23448,64683,53,6623,53,allow,168,78,90,2,30,1,1
23449,65129,53,16453,53,allow,324,110,214,2,30,1,1
23450,55684,80,6722,80,allow,70,70,0,2,8,2,0
23451,52018,2425,48269,2425,allow,70,70,0,1,5,1,0
23452,45454,80,45454,80,allow,42171,1901,40270,57,16,26,31
23453,62885,443,65198,443,allow,8097,2684,5413,22,248,12,10
23454,38805,443,57310,443,allow,6686,1197,5489,23,16,12,11
23455,37643,443,56932,443,allow,10517,2926,7591,29,20,16,13
23456,49207,58751,38431,58751,allow,70,70,0,1,5,1,0
23457,64152,53,18184,53,allow,232,110,122,2,30,1,1
23458,56607,443,26886,443,allow,133596,5859,127737,148,120,51,97
23459,55269,53,51344,53,allow,193,102,91,2,30,1,1
23460,65080,53,46581,53,allow,741,94,647,2,30,1,1
23461,33994,443,56656,443,allow,19547,2951,16596,42,82,21,21
23462,52032,55505,56842,55505,allow,70,70,0,2,8,2,0
23463,49210,33757,6282,33757,allow,70,70,0,1,5,1,0
23464,8108,80,8108,80,allow,7972,840,7132,16,50,6,10
23465,49416,80,5310,80,allow,318,192,126,6,28,4,2
23466,35047,53,40543,53,allow,214830,214584,246,2594,88,2591,3
23467,54033,443,12852,443,allow,5260,2704,2556,13,121,7,6
23468,50821,443,29846,443,allow,7619,3064,4555,14,121,6,8
23469,53545,443,54715,443,allow,7330,2295,5035,19,135,9,10
23470,36983,80,48738,80,allow,1143,401,742,9,360,5,4
23471,49366,443,29757,443,allow,5777400,184445,5592955,6224,332,2268,3956
23472,40238,443,22315,443,allow,7283,2384,4899,25,361,12,13
23473,10151,6881,1638,6881,allow,460,150,310,2,1200,1,1
23474,27005,27015,1344,27015,allow,880,126,754,3,31,2,1
23475,27005,27017,49884,27017,allow,877,126,751,2,31,1,1
23476,27005,27015,55780,27015,allow,873,126,747,3,31,2,1
23477,55245,443,43023,443,allow,7725129,126824,7598305,6259,607,740,5519
23478,33555,443,31836,443,allow,10856,3151,7705,34,361,16,18
23479,6881,6882,46322,6882,allow,324,150,174,2,1200,1,1
23480,51221,51413,15223,51413,allow,460,150,310,2,1200,1,1
23481,40326,443,22959,443,allow,7937,3883,4054,65,4602,25,40
23482,5588,5588,0,0,allow,3354,1792,1562,46,195,23,23
23483,60743,443,59766,443,allow,7028,2639,4389,23,16,12,11
23484,27005,49000,16886,49000,allow,887,126,761,2,31,1,1
23485,53824,41482,38792,41482,allow,70,70,0,2,8,2,0
23486,53790,21011,8352,21011,allow,70,70,0,1,5,1,0
23487,8243,443,8243,443,allow,1024,539,485,10,58,5,5
23488,50619,80,32397,80,allow,499,192,307,6,26,4,2
23489,49073,443,9351,443,allow,7032,2643,4389,23,16,12,11
23490,57117,53,8258,53,allow,209,102,107,2,31,1,1
23491,43788,80,23555,80,allow,2597,699,1898,11,181,6,5
23492,53828,51354,7216,51354,allow,70,70,0,2,8,2,0
23493,10012,40009,21244,40009,allow,253,190,63,2,30,1,1
23494,56268,44847,0,0,deny,66,66,0,1,0,1,0
23495,31991,23,0,0,deny,60,60,0,1,0,1,0
23496,50051,445,0,0,drop,70,70,0,1,0,1,0
23497,50050,445,0,0,drop,70,70,0,1,0,1,0
23498,50049,445,0,0,drop,70,70,0,1,0,1,0
23499,62424,37965,0,0,deny,66,66,0,1,0,1,0
23500,49036,44847,0,0,deny,146,146,0,1,0,1,0
23501,61612,445,0,0,drop,70,70,0,1,0,1,0
23502,61550,5529,0,0,deny,145,145,0,1,0,1,0
23503,61819,445,0,0,drop,66,66,0,1,0,1,0
23504,50280,38558,0,0,deny,62,62,0,1,0,1,0
23505,42898,25174,0,0,deny,62,62,0,1,0,1,0
23506,50211,51050,0,0,deny,66,66,0,1,0,1,0
23507,61609,445,0,0,drop,70,70,0,1,0,1,0
23508,55008,21247,0,0,deny,66,66,0,1,0,1,0
23509,51944,56205,0,0,deny,66,66,0,1,0,1,0
23510,59592,37965,0,0,deny,62,62,0,1,0,1,0
23511,58844,51505,0,0,deny,66,66,0,1,0,1,0
23512,50044,445,0,0,drop,70,70,0,1,0,1,0
23513,50036,445,0,0,drop,70,70,0,1,0,1,0
23514,22530,25174,0,0,deny,146,146,0,1,0,1,0
23515,3212,22114,0,0,deny,62,62,0,1,0,1,0
23516,59451,50584,0,0,deny,66,66,0,1,0,1,0
23517,26553,57470,0,0,deny,62,62,0,1,0,1,0
23518,3341,23117,0,0,deny,62,62,0,1,0,1,0
23519,61605,445,0,0,drop,70,70,0,1,0,1,0
23520,61589,21247,0,0,deny,62,62,0,1,0,1,0
23521,61603,445,0,0,drop,70,70,0,1,0,1,0
23522,13021,25174,0,0,deny,62,62,0,1,0,1,0
23523,26658,25174,0,0,deny,146,146,0,1,0,1,0
23524,61806,445,0,0,drop,66,66,0,1,0,1,0
23525,61803,445,0,0,drop,66,66,0,1,0,1,0
23526,25565,13556,0,0,deny,60,60,0,1,0,1,0
23527,39132,44847,0,0,deny,66,66,0,1,0,1,0
23528,61601,445,0,0,drop,70,70,0,1,0,1,0
23529,47461,50584,0,0,deny,62,62,0,1,0,1,0
23530,55136,11392,0,0,deny,66,66,0,1,0,1,0
23531,54721,22114,0,0,deny,66,66,0,1,0,1,0
23532,50026,445,0,0,drop,70,70,0,1,0,1,0
23533,50024,445,0,0,drop,70,70,0,1,0,1,0
23534,50021,445,0,0,drop,70,70,0,1,0,1,0
23535,50020,445,0,0,drop,70,70,0,1,0,1,0
23536,56711,25174,0,0,deny,146,146,0,1,0,1,0
23537,3875,25174,0,0,deny,146,146,0,1,0,1,0
23538,10333,22114,0,0,deny,62,62,0,1,0,1,0
23539,54614,37807,0,0,deny,62,62,0,1,0,1,0
23540,11136,17500,0,0,deny,62,62,0,1,0,1,0
23541,45941,23386,0,0,deny,60,60,0,1,0,1,0
23542,61800,445,0,0,drop,66,66,0,1,0,1,0
23543,15113,25174,0,0,deny,62,62,0,1,0,1,0
23544,55713,25174,0,0,deny,62,62,0,1,0,1,0
23545,8108,47807,0,0,deny,157,157,0,1,0,1,0
23546,29988,44847,0,0,deny,66,66,0,1,0,1,0
23547,61594,445,0,0,drop,70,70,0,1,0,1,0
23548,61790,445,0,0,drop,66,66,0,1,0,1,0
23549,61784,445,0,0,drop,66,66,0,1,0,1,0
23550,61793,445,0,0,drop,66,66,0,1,0,1,0
23551,61788,445,0,0,drop,66,66,0,1,0,1,0
23552,61791,445,0,0,drop,66,66,0,1,0,1,0
23553,61786,445,0,0,drop,66,66,0,1,0,1,0
23554,61782,445,0,0,drop,66,66,0,1,0,1,0
23555,63984,25174,0,0,deny,62,62,0,1,0,1,0
23556,57131,8055,0,0,deny,145,145,0,1,0,1,0
23557,14618,6881,0,0,deny,62,62,0,1,0,1,0
23558,61592,445,0,0,drop,70,70,0,1,0,1,0
23559,30179,23,0,0,deny,60,60,0,1,0,1,0
23560,50017,445,0,0,drop,70,70,0,1,0,1,0
23561,50197,64147,0,0,deny,66,66,0,1,0,1,0
23562,54377,56205,0,0,deny,66,66,0,1,0,1,0
23563,50013,445,0,0,drop,70,70,0,1,0,1,0
23564,50010,445,0,0,drop,70,70,0,1,0,1,0
23565,50009,445,0,0,drop,70,70,0,1,0,1,0
23566,51564,50584,0,0,deny,66,66,0,1,0,1,0
23567,40086,22114,0,0,deny,62,62,0,1,0,1,0
23568,61591,445,0,0,drop,70,70,0,1,0,1,0
23569,61590,445,0,0,drop,70,70,0,1,0,1,0
23570,61589,445,0,0,drop,70,70,0,1,0,1,0
23571,61583,445,0,0,drop,70,70,0,1,0,1,0
23572,61586,445,0,0,drop,70,70,0,1,0,1,0
23573,50478,51505,0,0,deny,62,62,0,1,0,1,0
23574,65249,25864,0,0,deny,72,72,0,1,0,1,0
23575,30800,25174,0,0,deny,62,62,0,1,0,1,0
23576,18029,50584,0,0,deny,66,66,0,1,0,1,0
23577,10688,25174,0,0,deny,62,62,0,1,0,1,0
23578,52973,57470,0,0,deny,74,74,0,1,0,1,0
23579,61571,445,0,0,drop,70,70,0,1,0,1,0
23580,61570,445,0,0,drop,70,70,0,1,0,1,0
23581,61566,445,0,0,drop,70,70,0,1,0,1,0
23582,56874,67,0,0,deny,60,60,0,1,0,1,0
23583,50007,445,0,0,drop,70,70,0,1,0,1,0
23584,50006,445,0,0,drop,70,70,0,1,0,1,0
23585,50004,445,0,0,drop,70,70,0,1,0,1,0
23586,61561,445,0,0,drop,70,70,0,1,0,1,0
23587,61560,445,0,0,drop,70,70,0,1,0,1,0
23588,42252,33306,0,0,deny,60,60,0,1,0,1,0
23589,51903,26467,0,0,deny,62,62,0,1,0,1,0
23590,61777,445,0,0,drop,66,66,0,1,0,1,0
23591,50000,445,0,0,drop,70,70,0,1,0,1,0
23592,1027,64147,0,0,deny,62,62,0,1,0,1,0
23593,57669,64147,0,0,deny,66,66,0,1,0,1,0
23594,61773,445,0,0,drop,66,66,0,1,0,1,0
23595,61772,445,0,0,drop,66,66,0,1,0,1,0
23596,61770,445,0,0,drop,66,66,0,1,0,1,0
23597,30575,11119,0,0,deny,148,148,0,1,0,1,0
23598,54365,64147,0,0,deny,62,62,0,1,0,1,0
23599,61768,445,0,0,drop,66,66,0,1,0,1,0
23600,12465,11392,0,0,deny,146,146,0,1,0,1,0
23601,38971,25174,0,0,deny,146,146,0,1,0,1,0
23602,51414,22,0,0,deny,60,60,0,1,0,1,0
23603,29697,51221,0,0,deny,62,62,0,1,0,1,0
23604,61549,445,0,0,drop,70,70,0,1,0,1,0
23605,59422,51221,0,0,deny,62,62,0,1,0,1,0
23606,49993,445,0,0,drop,70,70,0,1,0,1,0
23607,27343,55839,0,0,deny,137,137,0,1,0,1,0
23608,60155,23718,0,0,deny,66,66,0,1,0,1,0
23609,49988,445,0,0,drop,70,70,0,1,0,1,0
23610,49987,445,0,0,drop,70,70,0,1,0,1,0
23611,40095,23,0,0,deny,60,60,0,1,0,1,0
23612,63460,55160,0,0,deny,66,66,0,1,0,1,0
23613,7099,51505,0,0,deny,62,62,0,1,0,1,0
23614,29016,25174,0,0,deny,62,62,0,1,0,1,0
23615,56943,44847,0,0,deny,62,62,0,1,0,1,0
23616,80,53945,0,0,deny,60,60,0,1,0,1,0
23617,61757,445,0,0,drop,66,66,0,1,0,1,0
23618,443,9986,0,0,deny,669,669,0,1,0,1,0
23619,61545,445,0,0,drop,70,70,0,1,0,1,0
23620,44147,64147,0,0,deny,62,62,0,1,0,1,0
23621,67,68,0,0,deny,346,346,0,1,0,1,0
23622,57797,64147,0,0,deny,66,66,0,1,0,1,0
23623,57917,44847,0,0,deny,62,62,0,1,0,1,0
23624,57073,57470,0,0,deny,62,62,0,1,0,1,0
23625,63400,57470,0,0,deny,66,66,0,1,0,1,0
23626,56131,37807,0,0,deny,66,66,0,1,0,1,0
23627,443,62732,0,0,deny,332,332,0,1,0,1,0
23628,61534,445,0,0,drop,70,70,0,1,0,1,0
23629,61533,445,0,0,drop,70,70,0,1,0,1,0
23630,61536,445,0,0,drop,70,70,0,1,0,1,0
23631,49540,50584,0,0,deny,66,66,0,1,0,1,0
23632,61750,445,0,0,drop,66,66,0,1,0,1,0
23633,61530,445,0,0,drop,70,70,0,1,0,1,0
23634,49974,445,0,0,drop,70,70,0,1,0,1,0
23635,61528,445,0,0,drop,70,70,0,1,0,1,0
23636,52471,22114,0,0,deny,66,66,0,1,0,1,0
23637,60818,37965,0,0,deny,62,62,0,1,0,1,0
23638,0,0,0,0,deny,156,156,0,2,0,2,0
23639,0,0,0,0,deny,156,156,0,2,0,2,0
23640,0,0,0,0,deny,156,156,0,2,0,2,0
23641,0,0,0,0,deny,156,156,0,2,0,2,0
23642,61747,445,0,0,drop,66,66,0,1,0,1,0
23643,6703,21247,0,0,deny,62,62,0,1,0,1,0
23644,19882,22114,0,0,deny,62,62,0,1,0,1,0
23645,39996,23,0,0,deny,60,60,0,1,0,1,0
23646,11688,23718,0,0,deny,62,62,0,1,0,1,0
23647,62799,25174,0,0,deny,146,146,0,1,0,1,0
23648,57982,25174,0,0,deny,62,62,0,1,0,1,0
23649,63840,36829,0,0,deny,66,66,0,1,0,1,0
23650,51155,56205,0,0,deny,66,66,0,1,0,1,0
23651,50052,65008,0,0,deny,60,60,0,1,0,1,0
23652,61739,445,0,0,drop,66,66,0,1,0,1,0
23653,61522,445,0,0,drop,70,70,0,1,0,1,0
23654,61735,445,0,0,drop,66,66,0,1,0,1,0
23655,63084,64147,0,0,deny,62,62,0,1,0,1,0
23656,62341,26467,0,0,deny,62,62,0,1,0,1,0
23657,56770,26467,0,0,deny,66,66,0,1,0,1,0
23658,61515,445,0,0,drop,70,70,0,1,0,1,0
23659,55920,25174,0,0,deny,62,62,0,1,0,1,0
23660,61512,445,0,0,drop,70,70,0,1,0,1,0
23661,41848,23,0,0,deny,60,60,0,1,0,1,0
23662,62014,35440,0,0,deny,66,66,0,1,0,1,0
23663,55920,25174,0,0,deny,146,146,0,1,0,1,0
23664,49964,445,0,0,drop,70,70,0,1,0,1,0
23665,49961,445,0,0,drop,70,70,0,1,0,1,0
23666,49960,445,0,0,drop,70,70,0,1,0,1,0
23667,64124,25174,0,0,deny,62,62,0,1,0,1,0
23668,17205,41864,0,0,deny,143,143,0,1,0,1,0
23669,55562,50584,0,0,deny,66,66,0,1,0,1,0
23670,61725,445,0,0,drop,66,66,0,1,0,1,0
23671,61723,445,0,0,drop,66,66,0,1,0,1,0
23672,61721,445,0,0,drop,66,66,0,1,0,1,0
23673,61719,445,0,0,drop,66,66,0,1,0,1,0
23674,61720,445,0,0,drop,66,66,0,1,0,1,0
23675,61718,445,0,0,drop,66,66,0,1,0,1,0
23676,61717,445,0,0,drop,66,66,0,1,0,1,0
23677,49994,26467,0,0,deny,66,66,0,1,0,1,0
23678,52321,26467,0,0,deny,62,62,0,1,0,1,0
23679,61508,445,0,0,drop,70,70,0,1,0,1,0
23680,62408,50584,0,0,deny,66,66,0,1,0,1,0
23681,58250,35440,0,0,deny,66,66,0,1,0,1,0
23682,61507,445,0,0,drop,70,70,0,1,0,1,0
23683,443,60040,0,0,deny,60,60,0,1,0,1,0
23684,7720,44847,0,0,deny,66,66,0,1,0,1,0
23685,46367,36237,0,0,deny,66,66,0,1,0,1,0
23686,26531,25174,0,0,deny,146,146,0,1,0,1,0
23687,62792,53,0,0,deny,88,88,0,1,0,1,0
23688,56161,62413,0,0,deny,66,66,0,1,0,1,0
23689,2681,48817,0,0,deny,146,146,0,1,0,1,0
23690,47040,25174,0,0,deny,146,146,0,1,0,1,0
23691,62792,53,0,0,deny,88,88,0,1,0,1,0
23692,64790,443,36803,443,allow,53280,3270,50010,78,142,31,47
23693,55406,53,15179,53,allow,768,99,669,2,30,1,1
23694,51959,443,18601,443,allow,20648,4726,15922,40,48,19,21
23695,53789,47191,38332,47191,allow,70,70,0,1,5,1,0
23696,56931,443,32343,443,allow,34750,2997,31753,61,95,29,32
23697,64636,3389,64636,3389,allow,3424,1710,1714,16,32,8,8
23698,52030,443,52030,443,allow,4400,1493,2907,19,30,11,8
23699,40219,443,6179,443,allow,2387,979,1408,15,36,6,9
23700,63962,10115,25745,10115,allow,66,66,0,1,5,1,0
23701,58865,443,15727,443,allow,10775,7126,3649,31,17,17,14
23702,1831,53,1831,53,allow,194,87,107,2,30,1,1
23703,46216,443,47226,443,allow,13769,11153,2616,30,361,16,14
23704,40472,443,17256,443,allow,317215,285998,31217,436,982,244,192
23705,52016,58318,42027,58318,allow,66,66,0,1,5,1,0
23706,52031,20301,11089,20301,allow,70,70,0,2,8,2,0
23707,58281,53,0,0,allow,82,82,0,2,40,2,0
23708,35437,443,7147,443,allow,53756,46525,7231,82,275,51,31
23709,58869,443,7982,443,allow,4052,2588,1464,18,16,9,9
23710,50607,443,39884,443,allow,25263,2606,22657,41,90,19,22
23711,52830,443,59305,443,allow,12577,3687,8890,63,415,30,33
23712,50981,443,20620,443,allow,5553,1179,4374,24,80,13,11
23713,53155,28206,42266,28206,allow,70,70,0,2,8,2,0
23714,53794,39607,26801,39607,allow,70,70,0,1,5,1,0
23715,2547,53,2547,53,allow,194,87,107,2,30,1,1
23716,27005,27013,23327,27013,allow,869,126,743,2,30,1,1
23717,51961,443,54912,443,allow,2600,1396,1204,18,48,10,8
23718,26978,443,38800,443,allow,7547,2728,4819,26,20,13,13
23719,50982,443,1681,443,allow,5552,1179,4373,24,80,13,11
23720,62854,443,62854,443,allow,4579,1672,2907,19,29,11,8
23721,54063,80,60737,80,allow,2545,515,2030,12,17,6,6
23722,53793,20468,19761,20468,allow,70,70,0,1,5,1,0
23723,53156,57780,14557,57780,allow,320,140,180,6,7,3,3
23724,56968,53,34326,53,allow,762,97,665,2,30,1,1
23725,50116,22,50116,22,allow,60,60,0,1,5,1,0
23726,50560,53,62139,53,allow,755,94,661,2,30,1,1
23727,50859,53,0,0,allow,286,79,207,2,30,1,1
23728,52189,53,52189,53,allow,825,99,726,2,30,1,1
23729,50235,53,32276,53,allow,768,99,669,2,30,1,1
23730,54630,53,54630,53,allow,825,99,726,2,30,1,1
23731,19473,41049,5316,41049,allow,149,149,0,1,1200,1,0
23732,50269,443,37644,443,allow,8272,2455,5817,29,391,10,19
23733,53788,1,42504,1,allow,70,70,0,1,5,1,0
23734,58845,443,51619,443,allow,22402,14820,7582,52,20,29,23
23735,33809,80,12746,80,allow,1052,612,440,10,15,5,5
23736,64547,53,37211,53,allow,762,97,665,2,30,1,1
23737,10307,53,10307,53,allow,213,87,126,2,30,1,1
23738,53791,16881,2744,16881,allow,70,70,0,1,5,1,0
23739,24270,53,24270,53,allow,825,99,726,2,30,1,1
23740,52013,35185,29346,35185,allow,66,66,0,1,5,1,0
23741,58344,53,58344,53,allow,847,110,737,2,30,1,1
23742,27005,27015,60571,27015,allow,902,126,776,2,30,1,1
23743,56571,53,30480,53,allow,749,94,655,2,31,1,1
23744,62121,443,9258,443,allow,1864,250,1614,8,120,4,4
23745,27005,27017,40940,27017,allow,600,126,474,2,31,1,1
23746,56941,443,11257,443,allow,8304,2968,5336,24,362,13,11
23747,61503,445,0,0,drop,70,70,0,1,0,1,0
23748,33215,37965,0,0,deny,62,62,0,1,0,1,0
23749,32976,37965,0,0,deny,66,66,0,1,0,1,0
23750,51655,26467,0,0,deny,62,62,0,1,0,1,0
23751,49958,445,0,0,drop,70,70,0,1,0,1,0
23752,49946,445,0,0,drop,70,70,0,1,0,1,0
23753,49942,445,0,0,drop,70,70,0,1,0,1,0
23754,36456,25174,0,0,deny,62,62,0,1,0,1,0
23755,12632,25174,0,0,deny,62,62,0,1,0,1,0
23756,51999,37965,0,0,deny,62,62,0,1,0,1,0
23757,61501,445,0,0,drop,70,70,0,1,0,1,0
23758,51756,64147,0,0,deny,62,62,0,1,0,1,0
23759,45964,3111,0,0,deny,60,60,0,1,0,1,0
23760,57479,56205,0,0,deny,66,66,0,1,0,1,0
23761,2990,64147,0,0,deny,62,62,0,1,0,1,0
23762,61702,445,0,0,drop,66,66,0,1,0,1,0
23763,61704,445,0,0,drop,66,66,0,1,0,1,0
23764,61703,445,0,0,drop,66,66,0,1,0,1,0
23765,60806,51050,0,0,deny,66,66,0,1,0,1,0
23766,6666,16010,0,0,deny,60,60,0,1,0,1,0
23767,59663,37965,0,0,deny,62,62,0,1,0,1,0
23768,59147,25174,0,0,deny,146,146,0,1,0,1,0
23769,34932,38608,0,0,deny,62,62,0,1,0,1,0
23770,33193,50584,0,0,deny,146,146,0,1,0,1,0
23771,49676,53,32954,53,allow,197,102,95,2,30,1,1
23772,49656,53,53745,53,allow,309,118,191,2,30,1,1
23773,27005,27016,18981,27016,allow,884,126,758,2,30,1,1
23774,48840,443,52863,443,allow,3297,2327,970,22,51,11,11
23775,55839,56535,0,0,deny,62,62,0,1,0,1,0
23776,49941,445,0,0,drop,70,70,0,1,0,1,0
23777,61497,445,0,0,drop,70,70,0,1,0,1,0
23778,49938,445,0,0,drop,70,70,0,1,0,1,0
23779,49934,445,0,0,drop,70,70,0,1,0,1,0
23780,49933,445,0,0,drop,70,70,0,1,0,1,0
23781,7977,25174,0,0,deny,62,62,0,1,0,1,0
23782,25510,48817,0,0,deny,140,140,0,1,0,1,0
23783,46491,50584,0,0,deny,66,66,0,1,0,1,0
23784,38592,57209,0,0,deny,62,62,0,1,0,1,0
23785,12550,37807,0,0,deny,62,62,0,1,0,1,0
23786,49923,445,0,0,drop,70,70,0,1,0,1,0
23787,64463,53,5557,53,allow,182,93,89,2,0,1,1
23788,60951,443,8364,443,allow,11464,5499,5965,54,15,29,25
23789,55685,48407,34505,48407,allow,320,140,180,6,6,3,3
23790,50939,443,29204,443,allow,134,60,74,3,5,2,1
23791,49531,443,49531,443,allow,95223,30803,64420,107,23,50,57
23792,49676,53,40519,53,allow,197,102,95,2,30,1,1
23793,50585,80,50585,80,allow,9588,4478,5110,28,21,16,12
23794,53785,33324,8660,33324,allow,70,70,0,1,4,1,0
23795,62724,53,2730,53,allow,195,78,117,2,29,1,1
23796,57033,443,35994,443,allow,1092898,42451,1050447,1213,155,423,790
23797,63985,43081,42263,43081,allow,66,66,0,2,7,2,0
23798,53826,10168,29575,10168,allow,70,70,0,2,7,2,0
23799,53784,16671,31656,16671,allow,70,70,0,1,4,1,0
23800,51607,53,46424,53,allow,322,102,220,2,29,1,1
23801,64005,53,33305,53,allow,226,102,124,2,30,1,1
23802,46072,443,46479,443,allow,16656,3094,13562,29,271,14,15
23803,64907,53,3413,53,allow,168,86,82,2,30,1,1
23804,65244,53,58540,53,allow,378,99,279,4,45,2,2
23805,60451,17432,27417,17432,allow,504,318,186,8,17,5,3
23806,51226,7275,28428,7275,allow,416,210,206,7,16,4,3
23807,62884,5223,41292,5223,allow,11427,6608,4819,37,248,21,16
23808,50544,53,44871,53,allow,969,86,883,2,30,1,1
23809,55680,23711,32600,23711,allow,70,70,0,1,5,1,0
23810,52014,20524,7082,20524,allow,70,70,0,1,5,1,0
23811,51844,443,37014,443,allow,6752,1387,5365,21,115,10,11
23812,55269,53,35707,53,allow,193,102,91,2,31,1,1
23813,55956,443,61641,443,allow,6058,1749,4309,22,200,13,9
23814,16689,53,15770,53,allow,199,94,105,2,30,1,1
23815,64572,53,23687,53,allow,561,104,457,4,57,2,2
23816,53782,42855,3816,42855,allow,70,70,0,1,5,1,0
23817,44173,53,9700,53,allow,168,78,90,2,30,1,1
23818,55681,31948,14765,31948,allow,70,70,0,1,5,1,0
23819,49351,53,18900,53,allow,212,102,110,2,30,1,1
23820,56864,15646,57596,15646,allow,70,70,0,1,5,1,0
23821,55853,53,55965,53,allow,197,102,95,2,30,1,1
23822,58873,443,46096,443,allow,5166,700,4466,16,15,7,9
23823,51174,443,12417,443,allow,786014,23908,762106,803,47,276,527
23824,55509,53,37936,53,allow,215,102,113,2,30,1,1
23825,27005,27015,9880,27015,allow,937,126,811,2,30,1,1
23826,49194,443,50497,443,allow,159850,5338,154512,179,200,64,115
23827,50632,443,61474,443,allow,10084,2145,7939,36,120,18,18
23828,56432,53,38041,53,allow,195,102,93,2,30,1,1
23829,60199,443,60774,443,allow,8958,1697,7261,18,15,9,9
23830,65121,53,39585,53,allow,440,94,346,4,37,2,2
23831,38696,443,18796,443,allow,1069542,21337,1048205,1028,16,310,718
23832,51212,443,57861,443,allow,18745,11713,7032,67,77,37,30
23833,53605,443,11722,443,allow,8738,2628,6110,23,154,11,12
23834,48098,80,19717,80,allow,1638,1324,314,10,15,5,5
23835,37176,80,24453,80,allow,941,526,415,11,315,6,5
23836,59377,53,59377,53,allow,216,98,118,2,30,1,1
23837,55570,53,55501,53,allow,341,134,207,2,30,1,1
23838,27005,27016,17329,27016,allow,883,126,757,2,30,1,1
23839,37058,80,51116,80,allow,1056,682,374,10,15,6,4
23840,9223,443,33719,443,allow,4081,443,3638,12,15,6,6
23841,34768,443,44621,443,allow,21905,3249,18656,38,271,18,20
23842,52093,443,48994,443,allow,3687037,41923,3645114,3002,34,534,2468
23843,55690,54233,5574,54233,allow,320,140,180,6,6,3,3
23844,63140,30685,55473,30685,allow,70,70,0,2,8,2,0
23845,51099,443,34189,443,allow,11482,3696,7786,28,62,15,13
23846,53827,5889,21032,5889,allow,70,70,0,2,7,2,0
23847,53792,1,64543,1,allow,70,70,0,1,4,1,0
23848,34341,28678,47024,28678,allow,1806,1806,0,22,224,22,0
23849,42522,80,42522,80,allow,29727,1571,28156,44,16,21,23
23850,49369,443,63066,443,allow,6277395,184853,6092542,6543,317,2262,4281
23851,48068,443,12098,443,allow,10418,1427,8991,27,16,12,15
23852,63996,443,19057,443,allow,122293139,3727246,118565893,125460,331,39649,85811
23853,63957,80,57502,80,allow,314,192,122,6,15,4,2
23854,49424,443,6642,443,allow,77408,4295,73113,106,271,52,54
23855,57405,443,36790,443,allow,5734,1543,4191,24,26,13,11
23856,49203,53,34232,53,allow,195,102,93,2,30,1,1
23857,33990,443,59264,443,allow,11404,1948,9456,30,81,15,15
23858,37075,80,46978,80,allow,1678,1364,314,10,15,5,5
23859,43356,443,48473,443,allow,79561,11513,68048,183,94,95,88
23860,53825,58968,28988,58968,allow,70,70,0,2,7,2,0
23861,49421,53,13940,53,allow,215,94,121,2,29,1,1
23862,16768,53,24708,53,allow,199,94,105,2,30,1,1
23863,65379,53,2143,53,allow,126,126,0,1,29,1,0
23864,64905,53,22894,53,allow,458,188,270,6,29,3,3
23865,55323,443,19578,443,allow,229587,8510,221077,245,121,82,163
23866,49393,443,42342,443,allow,62,62,0,1,5,1,0
23867,52015,25487,39642,25487,allow,70,70,0,1,5,1,0
23868,49203,53,1575,53,allow,195,102,93,2,30,1,1
23869,64711,53,31035,53,allow,273,118,155,2,30,1,1
23870,56661,80,6258,80,allow,234,234,0,4,12,4,0
23871,65524,53,9019,53,allow,386,122,264,4,52,2,2
23872,64683,53,44457,53,allow,370,126,244,2,30,1,1
23873,10011,40005,27073,40005,allow,148,86,62,2,30,1,1
23874,27005,27015,13852,27015,allow,881,126,755,2,30,1,1
23875,56199,53,59192,53,allow,227,110,117,2,30,1,1
23876,55679,1024,62004,1024,allow,70,70,0,1,5,1,0
23877,49247,53,64384,53,allow,776,283,493,8,82,4,4
23878,33062,53,30187,53,allow,86,86,0,1,30,1,0
23879,44815,443,9189,443,allow,7570,1955,5615,24,1179,12,12
23880,38420,80,16840,80,allow,4535,1637,2898,23,2899,14,9
23881,50542,443,2915,443,allow,6787,1846,4941,24,361,11,13
23882,6881,6881,44839,6881,allow,238,118,120,2,1200,1,1
23883,27005,27017,47675,27017,allow,878,126,752,2,31,1,1
23884,49380,443,11402,443,allow,2382775,72482,2310293,2485,252,843,1642
23885,49340,443,62697,443,allow,7492336,235716,7256620,8119,428,3022,5097
23886,51195,443,30169,443,allow,291595,261981,29614,587,206,339,248
23887,34788,443,32056,443,allow,8230,2275,5955,18,135,8,10
23888,44704,443,31142,443,allow,7228,3478,3750,37,164,17,20
23889,33149,5228,22043,5228,allow,15651,3559,12092,63,6557,28,35
23890,51547,443,55970,443,allow,642,582,60,2,5,1,1
23891,60194,443,58489,443,allow,8894,1633,7261,18,16,9,9
23892,58872,443,35466,443,allow,5166,700,4466,16,15,7,9
23893,50641,80,49164,80,allow,1658,1247,411,8,15,5,3
23894,51098,443,32791,443,allow,7250,2813,4437,21,62,12,9
23895,56432,53,16819,53,allow,195,102,93,2,30,1,1
23896,10003,40811,32278,40811,allow,292,158,134,2,30,1,1
23897,21133,24035,37028,24035,allow,481,150,331,2,1200,1,1
23898,38662,443,42991,443,allow,6525,1695,4830,19,51,8,11
23899,57038,53,18190,53,allow,240,86,154,2,30,1,1
23900,34150,443,7922,443,allow,12564,9272,3292,66,107,31,35
23901,46434,443,35412,443,allow,14879,4981,9898,43,121,21,22
23902,49922,445,0,0,drop,70,70,0,1,0,1,0
23903,49919,445,0,0,drop,70,70,0,1,0,1,0
23904,61482,445,0,0,drop,70,70,0,1,0,1,0
23905,19455,25174,0,0,deny,62,62,0,1,0,1,0
23906,61690,445,0,0,drop,66,66,0,1,0,1,0
23907,37249,25174,0,0,deny,146,146,0,1,0,1,0
23908,61479,445,0,0,drop,70,70,0,1,0,1,0
23909,54876,25174,0,0,deny,62,62,0,1,0,1,0
23910,12545,25174,0,0,deny,146,146,0,1,0,1,0
23911,64155,60043,0,0,deny,66,66,0,1,0,1,0
23912,42615,25174,0,0,deny,146,146,0,1,0,1,0
23913,49913,445,0,0,drop,70,70,0,1,0,1,0
23914,49907,445,0,0,drop,70,70,0,1,0,1,0
23915,61474,445,0,0,drop,70,70,0,1,0,1,0
23916,51705,22114,0,0,deny,66,66,0,1,0,1,0
23917,60941,25174,0,0,deny,62,62,0,1,0,1,0
23918,61473,445,0,0,drop,70,70,0,1,0,1,0
23919,45981,51505,0,0,deny,62,62,0,1,0,1,0
23920,33710,22114,0,0,deny,146,146,0,1,0,1,0
23921,53469,36237,0,0,deny,62,62,0,1,0,1,0
23922,6881,35894,0,0,deny,62,62,0,1,0,1,0
23923,61471,445,0,0,drop,70,70,0,1,0,1,0
23924,36903,56205,0,0,deny,62,62,0,1,0,1,0
23925,61677,445,0,0,drop,66,66,0,1,0,1,0
23926,61676,445,0,0,drop,66,66,0,1,0,1,0
23927,57894,44847,0,0,deny,62,62,0,1,0,1,0
23928,27507,25174,0,0,deny,146,146,0,1,0,1,0
23929,2946,25174,0,0,deny,62,62,0,1,0,1,0
23930,15249,22114,0,0,deny,62,62,0,1,0,1,0
23931,47771,25174,0,0,deny,62,62,0,1,0,1,0
23932,3928,64147,0,0,deny,62,62,0,1,0,1,0
23933,49905,445,0,0,drop,70,70,0,1,0,1,0
23934,49904,445,0,0,drop,70,70,0,1,0,1,0
23935,49903,445,0,0,drop,70,70,0,1,0,1,0
23936,49895,445,0,0,drop,70,70,0,1,0,1,0
23937,3937,36829,0,0,deny,62,62,0,1,0,1,0
23938,14489,25174,0,0,deny,62,62,0,1,0,1,0
23939,15345,36829,0,0,deny,66,66,0,1,0,1,0
23940,3584,25174,0,0,deny,62,62,0,1,0,1,0
23941,61671,445,0,0,drop,66,66,0,1,0,1,0
23942,3584,25174,0,0,deny,146,146,0,1,0,1,0
23943,61464,445,0,0,drop,70,70,0,1,0,1,0
23944,49629,26467,0,0,deny,62,62,0,1,0,1,0
23945,47910,7454,0,0,deny,60,60,0,1,0,1,0
23946,47910,7454,0,0,deny,60,60,0,1,0,1,0
23947,1030,64147,0,0,deny,62,62,0,1,0,1,0
23948,61462,445,0,0,drop,70,70,0,1,0,1,0
23949,54601,26467,0,0,deny,66,66,0,1,0,1,0
23950,50383,443,21192,443,allow,452,386,66,4,1,3,1
23951,58914,37965,0,0,deny,66,66,0,1,0,1,0
23952,64649,81,0,0,deny,60,60,0,1,0,1,0
23953,61666,445,0,0,drop,66,66,0,1,0,1,0
23954,61665,445,0,0,drop,66,66,0,1,0,1,0
23955,61664,445,0,0,drop,66,66,0,1,0,1,0
23956,61661,445,0,0,drop,66,66,0,1,0,1,0
23957,61658,445,0,0,drop,66,66,0,1,0,1,0
23958,61655,445,0,0,drop,66,66,0,1,0,1,0
23959,61656,445,0,0,drop,66,66,0,1,0,1,0
23960,53012,51050,0,0,deny,62,62,0,1,0,1,0
23961,43461,35440,0,0,deny,62,62,0,1,0,1,0
23962,61461,445,0,0,drop,70,70,0,1,0,1,0
23963,49888,445,0,0,drop,70,70,0,1,0,1,0
23964,12183,22114,0,0,deny,62,62,0,1,0,1,0
23965,61460,445,0,0,drop,70,70,0,1,0,1,0
23966,65400,36237,0,0,deny,66,66,0,1,0,1,0
23967,61459,445,0,0,drop,70,70,0,1,0,1,0
23968,49885,445,0,0,drop,70,70,0,1,0,1,0
23969,49884,445,0,0,drop,70,70,0,1,0,1,0
23970,49881,445,0,0,drop,70,70,0,1,0,1,0
23971,61457,445,0,0,drop,70,70,0,1,0,1,0
23972,61455,445,0,0,drop,70,70,0,1,0,1,0
23973,15105,25174,0,0,deny,146,146,0,1,0,1,0
23974,63554,44847,0,0,deny,66,66,0,1,0,1,0
23975,32551,51221,0,0,deny,62,62,0,1,0,1,0
23976,40687,64147,0,0,deny,62,62,0,1,0,1,0
23977,62415,57470,0,0,deny,66,66,0,1,0,1,0
23978,61441,445,0,0,drop,70,70,0,1,0,1,0
23979,61440,445,0,0,drop,70,70,0,1,0,1,0
23980,13166,57470,0,0,deny,62,62,0,1,0,1,0
23981,59599,62413,0,0,deny,62,62,0,1,0,1,0
23982,61437,445,0,0,drop,70,70,0,1,0,1,0
23983,2622,25174,0,0,deny,146,146,0,1,0,1,0
23984,61431,445,0,0,drop,70,70,0,1,0,1,0
23985,61430,445,0,0,drop,70,70,0,1,0,1,0
23986,50570,57470,0,0,deny,66,66,0,1,0,1,0
23987,3585,64147,0,0,deny,62,62,0,1,0,1,0
23988,49879,445,0,0,drop,70,70,0,1,0,1,0
23989,53323,35253,0,0,deny,66,66,0,1,0,1,0
23990,49875,445,0,0,drop,70,70,0,1,0,1,0
23991,49874,445,0,0,drop,70,70,0,1,0,1,0
23992,61647,445,0,0,drop,66,66,0,1,0,1,0
23993,1024,26296,0,0,deny,159,159,0,1,0,1,0
23994,49872,445,0,0,drop,70,70,0,1,0,1,0
23995,61645,445,0,0,drop,66,66,0,1,0,1,0
23996,61644,445,0,0,drop,66,66,0,1,0,1,0
23997,61642,445,0,0,drop,66,66,0,1,0,1,0
23998,19286,25174,0,0,deny,146,146,0,1,0,1,0
23999,61640,445,0,0,drop,66,66,0,1,0,1,0
24000,15513,25174,0,0,deny,62,62,0,1,0,1,0
24001,61419,445,0,0,drop,70,70,0,1,0,1,0
24002,24066,25174,0,0,deny,146,146,0,1,0,1,0
24003,11136,15503,0,0,deny,62,62,0,1,0,1,0
24004,61230,22114,0,0,deny,62,62,0,1,0,1,0
24005,49867,445,0,0,drop,70,70,0,1,0,1,0
24006,49861,445,0,0,drop,70,70,0,1,0,1,0
24007,49860,445,0,0,drop,70,70,0,1,0,1,0
24008,44388,63874,0,0,deny,66,66,0,1,0,1,0
24009,53841,37965,0,0,deny,66,66,0,1,0,1,0
24010,52146,1433,0,0,deny,60,60,0,1,0,1,0
24011,0,0,0,0,deny,82,82,0,1,0,1,0
24012,0,0,0,0,allow,124,64,60,2,0,1,1
24013,61415,445,0,0,drop,70,70,0,1,0,1,0
24014,56278,52752,0,0,deny,62,62,0,1,0,1,0
24015,61630,445,0,0,drop,66,66,0,1,0,1,0
24016,47788,12250,0,0,deny,146,146,0,1,0,1,0
24017,42429,22114,0,0,deny,62,62,0,1,0,1,0
24018,61405,445,0,0,drop,70,70,0,1,0,1,0
24019,61406,445,0,0,drop,70,70,0,1,0,1,0
24020,61404,445,0,0,drop,70,70,0,1,0,1,0
24021,33582,44847,0,0,deny,62,62,0,1,0,1,0
24022,61402,445,0,0,drop,70,70,0,1,0,1,0
24023,2475,6881,0,0,deny,66,66,0,1,0,1,0
24024,57994,30188,0,0,deny,62,62,0,1,0,1,0
24025,12240,48817,0,0,deny,146,146,0,1,0,1,0
24026,61399,445,0,0,drop,70,70,0,1,0,1,0
24027,56309,22114,0,0,deny,62,62,0,1,0,1,0
24028,61622,445,0,0,drop,66,66,0,1,0,1,0
24029,49847,445,0,0,drop,70,70,0,1,0,1,0
24030,25497,44847,0,0,deny,62,62,0,1,0,1,0
24031,45941,23386,0,0,deny,60,60,0,1,0,1,0
24032,40116,23,0,0,deny,60,60,0,1,0,1,0
24033,5926,25174,0,0,deny,62,62,0,1,0,1,0
24034,45313,64147,0,0,deny,62,62,0,1,0,1,0
24035,61619,445,0,0,drop,66,66,0,1,0,1,0
24036,55496,64097,0,0,deny,62,62,0,1,0,1,0
24037,27773,56205,0,0,deny,62,62,0,1,0,1,0
24038,52988,53567,0,0,deny,66,66,0,1,0,1,0
24039,61190,21247,0,0,deny,66,66,0,1,0,1,0
24040,61392,445,0,0,drop,70,70,0,1,0,1,0
24041,57090,51505,0,0,deny,66,66,0,1,0,1,0
24042,56718,50584,0,0,deny,62,62,0,1,0,1,0
24043,62273,50584,0,0,deny,66,66,0,1,0,1,0
24044,61613,445,0,0,drop,66,66,0,1,0,1,0
24045,50757,64147,0,0,deny,66,66,0,1,0,1,0
24046,56015,56205,0,0,deny,62,62,0,1,0,1,0
24047,61608,445,0,0,drop,66,66,0,1,0,1,0
24048,39460,23117,0,0,deny,62,62,0,1,0,1,0
24049,60112,23,0,0,deny,60,60,0,1,0,1,0
24050,50052,65008,0,0,deny,60,60,0,1,0,1,0
24051,61385,445,0,0,drop,70,70,0,1,0,1,0
24052,21993,25174,0,0,deny,146,146,0,1,0,1,0
24053,61383,445,0,0,drop,70,70,0,1,0,1,0
24054,50516,53,53120,53,allow,168,86,82,2,30,1,1
24055,57622,7000,57622,7000,allow,2343,856,1487,17,16,10,7
24056,50579,80,50579,80,allow,32612,18106,14506,83,24,47,36
24057,40671,443,5840,443,allow,190,70,120,4,15,2,2
24058,49317,443,8477,443,allow,1486172,26246,1459926,1245,40,266,979
24059,43131,53,0,0,allow,82,82,0,1,30,1,0
24060,41101,443,39031,443,allow,7067,2430,4637,18,17,8,10
24061,55765,53,10201,53,allow,770,101,669,2,30,1,1
24062,58842,443,44558,443,allow,16260,10863,5397,39,19,21,18
24063,55842,80,22065,80,allow,1151,711,440,10,15,5,5
24064,56817,53,9899,53,allow,772,103,669,2,30,1,1
24065,54730,443,29479,443,allow,20465,3839,16626,43,229,22,21
24066,44695,443,65027,443,allow,4419,3179,1240,17,17,10,7
24067,55510,53,10819,53,allow,578,286,292,9,15,5,4
24068,28743,53,28743,53,allow,197,76,121,2,30,1,1
24069,64907,53,25739,53,allow,168,86,82,2,30,1,1
24070,42386,443,40078,443,allow,10424,3393,7031,31,274,16,15
24071,57106,33000,6001,33000,allow,223,223,0,1,30,1,0
24072,55704,53,41065,53,allow,752,93,659,2,30,1,1
24073,57044,53,19964,53,allow,194,99,95,2,31,1,1
24074,55176,53,63516,53,allow,190,97,93,2,31,1,1
24075,50046,443,28953,443,allow,12134,6888,5246,27,37,15,12
24076,37568,443,13649,443,allow,1702,861,841,19,110,10,9
24077,13088,80,11600,80,allow,4079,3203,876,12,97,8,4
24078,56078,80,65466,80,allow,2458,531,1927,11,75,6,5
24079,64843,53,27388,53,allow,772,103,669,2,30,1,1
24080,65419,443,11559,443,allow,2494,1643,851,17,24,9,8
24081,63548,443,63548,443,allow,4742,1835,2907,19,29,11,8
24082,58863,443,23250,443,allow,3873,2469,1404,17,16,9,8
24083,49839,443,44506,443,allow,7021,1767,5254,26,224,13,13
24084,49573,53,33204,53,allow,738,86,652,2,30,1,1
24085,38961,443,19720,443,allow,67063,17409,49654,94,274,48,46
24086,38300,443,24962,443,allow,200383,4673,195710,196,30,58,138
24087,50193,53,18428,53,allow,770,101,669,2,30,1,1
24088,65342,53,53223,53,allow,760,97,663,2,30,1,1
24089,49934,53,41301,53,allow,752,93,659,2,30,1,1
24090,27005,27015,61503,27015,allow,868,126,742,3,31,2,1
24091,55382,53,44759,53,allow,738,86,652,2,31,1,1
24092,58868,443,40093,443,allow,3867,2403,1464,17,15,8,9
24093,37874,19000,47411,19000,allow,602,174,428,2,31,1,1
24094,49771,80,10429,80,allow,254,128,126,5,16,3,2
24095,50582,80,50582,80,allow,6647,4891,1756,23,21,13,10
24096,49312,443,38998,443,allow,3171,2293,878,17,40,10,7
24097,58850,443,33361,443,allow,9035,5883,3152,26,17,14,12
24098,55992,80,41926,80,allow,57401,3150,54251,84,109,43,41
24099,56077,80,49245,80,allow,2481,529,1952,11,75,6,5
24100,62074,443,62074,443,allow,151233,12592,138641,190,19,88,102
24101,61295,443,61295,443,allow,5014,1722,3292,17,18,10,7
24102,50912,53,50912,53,allow,213,81,132,2,30,1,1
24103,52968,53,0,0,allow,82,82,0,1,30,1,0
24104,27005,27015,5725,27015,allow,876,126,750,2,30,1,1
24105,49964,53,9082,53,allow,760,97,663,2,30,1,1
24106,65071,53,11229,53,allow,93,93,0,2,60,2,0
24107,46215,443,63410,443,allow,4182,2874,1308,17,361,9,8
24108,49522,443,58242,443,allow,2731084,2639957,91127,2979,151,1945,1034
24109,55123,53,62052,53,allow,762,97,665,2,31,1,1
24110,37965,11102,8568,11102,allow,132,132,0,3,1200,3,0
24111,46211,443,8239,443,allow,9805,1642,8163,24,362,12,12
24112,27005,27015,40148,27015,allow,886,126,760,2,31,1,1
24113,46212,443,60547,443,allow,9753,1572,8181,22,362,11,11
24114,40967,1433,0,0,deny,60,60,0,1,0,1,0
24115,8999,57470,0,0,deny,146,146,0,1,0,1,0
24116,63944,30188,0,0,deny,62,62,0,1,0,1,0
24117,13159,37965,0,0,deny,66,66,0,1,0,1,0
24118,55123,64097,0,0,deny,66,66,0,1,0,1,0
24119,49835,445,0,0,drop,70,70,0,1,0,1,0
24120,49834,445,0,0,drop,70,70,0,1,0,1,0
24121,49832,445,0,0,drop,70,70,0,1,0,1,0
24122,61379,445,0,0,drop,70,70,0,1,0,1,0
24123,61597,445,0,0,drop,66,66,0,1,0,1,0
24124,61596,445,0,0,drop,66,66,0,1,0,1,0
24125,61595,445,0,0,drop,66,66,0,1,0,1,0
24126,61593,445,0,0,drop,66,66,0,1,0,1,0
24127,61594,445,0,0,drop,66,66,0,1,0,1,0
24128,61592,445,0,0,drop,66,66,0,1,0,1,0
24129,61591,445,0,0,drop,66,66,0,1,0,1,0
24130,61589,445,0,0,drop,66,66,0,1,0,1,0
24131,33912,25174,0,0,deny,146,146,0,1,0,1,0
24132,59051,27520,0,0,deny,62,62,0,1,0,1,0
24133,61377,445,0,0,drop,70,70,0,1,0,1,0
24134,43725,57470,0,0,deny,109,109,0,1,0,1,0
24135,16270,56205,0,0,deny,62,62,0,1,0,1,0
24136,1046,25174,0,0,deny,146,146,0,1,0,1,0
24137,61373,445,0,0,drop,70,70,0,1,0,1,0
24138,36688,443,58971,443,allow,178,118,60,2,15,1,1
24139,50298,53,22376,53,allow,172,94,78,2,30,1,1
24140,34209,80,4661,80,allow,1280,586,694,10,14,5,5
24141,10006,40025,40345,40025,allow,284,190,94,2,29,1,1
24142,10552,25174,0,0,deny,62,62,0,1,0,1,0
24143,10627,36829,0,0,deny,146,146,0,1,0,1,0
24144,61372,445,0,0,drop,70,70,0,1,0,1,0
24145,12986,64147,0,0,deny,62,62,0,1,0,1,0
24146,49825,445,0,0,drop,70,70,0,1,0,1,0
24147,49822,445,0,0,drop,70,70,0,1,0,1,0
24148,49817,445,0,0,drop,70,70,0,1,0,1,0
24149,49814,445,0,0,drop,70,70,0,1,0,1,0
24150,40356,9192,0,0,deny,145,145,0,1,0,1,0
24151,61140,27520,0,0,deny,66,66,0,1,0,1,0
24152,48335,25174,0,0,deny,62,62,0,1,0,1,0
24153,61576,445,0,0,drop,66,66,0,1,0,1,0
24154,61575,445,0,0,drop,66,66,0,1,0,1,0
24155,61574,445,0,0,drop,66,66,0,1,0,1,0
24156,2636,7302,0,0,deny,66,66,0,1,0,1,0
24157,13062,52752,0,0,deny,66,66,0,1,0,1,0
24158,61367,445,0,0,drop,70,70,0,1,0,1,0
24159,55012,64147,0,0,deny,66,66,0,1,0,1,0
24160,40204,40031,4239,40031,allow,140,78,62,2,29,1,1
24161,15241,53,62094,53,allow,215,86,129,2,30,1,1
24162,53464,3389,53464,3389,allow,4245,2461,1784,18,31,9,9
24163,49922,443,6981,443,allow,11466,1320,10146,22,135,10,12
24164,50616,443,60964,443,allow,8643,1918,6725,21,26,11,10
24165,10128,443,36900,443,allow,22677,11756,10921,45,315,26,19
24166,65405,53,50341,53,allow,560,104,456,4,43,2,2
24167,38697,443,5230,443,allow,90001,3161,86840,91,15,26,65
24168,39803,443,33160,443,allow,1701571,69958,1631613,1930,170,782,1148
24169,54993,53,49299,53,allow,410,109,301,4,32,2,2
24170,63961,53,2242,53,allow,373,171,202,5,40,3,2
24171,38873,443,28510,443,allow,10209,2574,7635,39,917,18,21
24172,57044,53,35114,53,allow,197,102,95,2,30,1,1
24173,55176,53,23619,53,allow,195,102,93,2,30,1,1
24174,52489,53,54304,53,allow,302,78,224,2,29,1,1
24175,64907,53,65054,53,allow,168,86,82,2,29,1,1
24176,55853,53,20879,53,allow,197,102,95,2,29,1,1
24177,65404,53,11597,53,allow,182,94,88,2,30,1,1
24178,10978,8443,10978,8443,allow,66,66,0,1,5,1,0
24179,50432,5222,28391,5222,allow,28281,9813,18468,196,608,100,96
24180,64926,53,45252,53,allow,257,102,155,2,30,1,1
24181,40290,22,40290,22,allow,66,66,0,1,5,1,0
24182,35869,80,16584,80,allow,2604,1690,914,20,610,11,9
24183,50673,443,61982,443,allow,14723,2606,12117,54,19,22,32
24184,55836,443,63316,443,allow,320,140,180,6,15,3,3
24185,56522,443,50354,443,allow,5212,1037,4175,20,115,10,10
24186,55239,53,38143,53,allow,272,94,178,2,30,1,1
24187,54287,443,13671,443,allow,122,62,60,2,15,1,1
24188,60453,24369,18318,24369,allow,70,70,0,1,5,1,0
24189,65024,53,6765,53,allow,199,102,97,2,30,1,1
24190,42443,443,56747,443,allow,5378,1512,3866,20,16,11,9
24191,58867,443,59291,443,allow,5167,700,4467,16,15,7,9
24192,27005,27111,30399,27111,allow,893,126,767,2,30,1,1
24193,27005,27015,38392,27015,allow,878,126,752,2,30,1,1
24194,63139,12311,7837,12311,allow,70,70,0,2,8,2,0
24195,55834,443,1790,443,allow,190,70,120,4,15,2,2
24196,49742,53,64876,53,allow,223,102,121,2,30,1,1
24197,57326,53,9216,53,allow,180,94,86,2,35,1,1
24198,27005,27015,2437,27015,allow,878,126,752,2,30,1,1
24199,64684,53,7467,53,allow,757,102,655,2,30,1,1
24200,56523,443,42102,443,allow,5212,1037,4175,20,115,10,10
24201,51641,443,16546,443,allow,7419,2682,4737,26,66,13,13
24202,65499,443,30170,443,allow,410116,12150,397966,421,16,148,273
24203,46082,443,8016,443,allow,137024,6442,130582,171,109,61,110
24204,46085,443,28925,443,allow,13018,2021,10997,34,95,14,20
24205,64555,53,23004,53,allow,297,102,195,4,48,2,2
24206,64649,53,32892,53,allow,807,94,713,2,30,1,1
24207,27005,27222,26856,27222,allow,890,126,764,2,30,1,1
24208,52824,443,36459,443,allow,7118,2239,4879,22,15,12,10
24209,46279,443,60019,443,allow,172,172,0,2,5,2,0
24210,50578,80,50578,80,allow,35580,13335,22245,69,23,38,31
24211,50584,80,50584,80,allow,6706,4950,1756,23,20,13,10
24212,61461,443,61461,443,allow,19070,4830,14240,33,18,18,15
24213,56524,443,12291,443,allow,5212,1037,4175,20,115,10,10
24214,54449,443,31656,443,allow,128477,6347,122130,155,276,56,99
24215,27005,27333,40989,27333,allow,890,126,764,2,30,1,1
24216,55865,53,34168,53,allow,807,94,713,2,30,1,1
24217,50516,53,58230,53,allow,168,86,82,2,30,1,1
24218,49614,53,6383,53,allow,183,94,89,2,30,1,1
24219,55821,443,39900,443,allow,128791,11254,117537,141,132,48,93
24220,49894,80,26822,80,allow,1409,735,674,12,17,5,7
24221,48574,443,45361,443,allow,9336,1153,8183,27,34,14,13
24222,58871,443,24134,443,allow,5106,700,4406,15,15,7,8
24223,51967,443,38807,443,allow,10684,3167,7517,43,34,24,19
24224,46315,443,19188,443,allow,5571,2240,3331,28,87,14,14
24225,53425,51689,2819,51689,allow,546,306,240,9,142,5,4
24226,56388,443,41257,443,allow,15485,8351,7134,71,130,40,31
24227,39180,443,51621,443,allow,3221,2218,1003,16,15,8,8
24228,60195,443,54821,443,allow,8894,1633,7261,18,15,9,9
24229,60782,20010,25511,20010,allow,70,70,0,1,5,1,0
24230,49296,443,32357,443,allow,50454,5259,45195,52,105,17,35
24231,10010,40029,17242,40029,allow,148,86,62,2,29,1,1
24232,65460,53,50952,53,allow,215,102,113,2,29,1,1
24233,49921,443,56889,443,allow,11831,1466,10365,24,135,11,13
24234,55012,53,50167,53,allow,275,110,165,2,30,1,1
24235,65440,53,38806,53,allow,240,86,154,2,29,1,1
24236,27005,27019,53599,27019,allow,881,126,755,2,30,1,1
24237,55865,53,22117,53,allow,184,94,90,2,30,1,1
24238,50298,53,38554,53,allow,164,86,78,2,30,1,1
24239,63560,443,29520,443,allow,2773,1570,1203,22,275,11,11
24240,65024,53,19328,53,allow,199,102,97,2,30,1,1
24241,26815,80,16585,80,allow,2894,1095,1799,15,131,8,7
24242,63076,443,41788,443,allow,7975,423,7552,15,119,6,9
24243,65286,53,17051,53,allow,756,94,662,2,30,1,1
24244,49420,53,26234,53,allow,364,102,262,2,30,1,1
24245,20222,53,8890,53,allow,223,78,145,2,30,1,1
24246,59792,443,33674,443,allow,12836,2016,10820,48,361,20,28
24247,35785,80,12900,80,allow,1594,1280,314,10,15,5,5
24248,65500,443,21161,443,allow,91813,4379,87434,101,16,37,64
24249,59044,53,47816,53,allow,78,78,0,1,30,1,0
24250,65404,53,9178,53,allow,198,110,88,2,30,1,1
24251,32927,443,31722,443,allow,867883,29498,838385,922,58,328,594
24252,60036,161,64579,161,allow,2800,2800,0,28,111,28,0
24253,49157,443,64620,443,allow,2529,1230,1299,17,16,9,8
24254,34574,443,39427,443,allow,130,70,60,2,15,1,1
24255,55057,443,7517,443,allow,1364,940,424,12,16,7,5
24256,65101,53,44970,53,allow,749,94,655,2,30,1,1
24257,64649,53,56977,53,allow,184,94,90,2,30,1,1
24258,49867,53,28958,53,allow,232,110,122,2,30,1,1
24259,55176,53,57165,53,allow,195,102,93,2,30,1,1
24260,56724,53,27864,53,allow,182,94,88,2,30,1,1
24261,49534,53,11716,53,allow,193,102,91,2,31,1,1
24262,52092,443,50536,443,allow,4642,3496,1146,18,16,10,8
24263,60461,10138,55813,10138,allow,70,70,0,2,8,2,0
24264,60452,62582,62916,62582,allow,70,70,0,1,5,1,0
24265,56435,80,7640,80,allow,17248,1619,15629,26,25,11,15
24266,65432,53,2736,53,allow,254,94,160,2,30,1,1
24267,57044,53,24810,53,allow,197,102,95,2,30,1,1
24268,44847,43154,42931,43154,allow,150,150,0,1,1200,1,0
24269,15503,52798,43633,52798,allow,28448,16525,11923,253,3696,148,105
24270,30188,27772,64348,27772,allow,502,150,352,2,1200,1,1
24271,37965,1,53190,1,allow,330,330,0,6,1199,6,0
24272,51148,443,35605,443,allow,4332,1907,2425,18,136,8,10
24273,6882,50239,19851,50239,allow,296,150,146,2,1200,1,1
24274,55683,19215,63970,19215,allow,320,140,180,6,7,3,3
24275,63978,63776,45573,63776,allow,66,66,0,2,8,2,0
24276,63981,34250,53768,34250,allow,66,66,0,2,8,2,0
24277,53822,18716,3913,18716,allow,70,70,0,2,8,2,0
24278,64102,53,54377,53,allow,619,102,517,4,43,2,2
24279,50077,53,56181,53,allow,261,97,164,4,44,2,2
24280,47040,443,54181,443,allow,10326,4295,6031,29,62,16,13
24281,50669,443,37355,443,allow,12463,2350,10113,46,20,19,27
24282,49920,443,51438,443,allow,10526,811,9715,20,135,8,12
24283,50077,53,51701,53,allow,261,97,164,4,44,2,2
24284,9059,443,42849,443,allow,19816,13030,6786,80,159,40,40
24285,63980,4804,28040,4804,allow,66,66,0,2,8,2,0
24286,58866,443,35097,443,allow,5166,700,4466,16,15,7,9
24287,55993,53,52586,53,allow,199,102,97,2,30,1,1
24288,50596,53,57766,53,allow,168,86,82,2,30,1,1
24289,57136,53,36933,53,allow,209,110,99,2,31,1,1
24290,56055,53,2822,53,allow,168,86,82,2,31,1,1
24291,54488,443,26044,443,allow,4967,2482,2485,26,271,13,13
24292,60786,40010,58556,40010,allow,316,136,180,6,7,3,3
24293,51462,3027,51462,3027,allow,156,156,0,3,8,3,0
24294,53820,7488,11201,7488,allow,70,70,0,2,8,2,0
24295,52008,49383,19063,49383,allow,70,70,0,1,5,1,0
24296,58856,443,29128,443,allow,2881,1766,1115,17,16,9,8
24297,64769,53,55242,53,allow,418,150,268,2,30,1,1
24298,49812,445,0,0,drop,70,70,0,1,0,1,0
24299,49806,445,0,0,drop,70,70,0,1,0,1,0
24300,49807,445,0,0,deny,70,70,0,1,0,1,0
24301,49805,445,0,0,drop,70,70,0,1,0,1,0
24302,60558,51221,0,0,deny,62,62,0,1,0,1,0
24303,62991,51221,0,0,deny,66,66,0,1,0,1,0
24304,52578,34021,0,0,reset-both,62,62,0,1,0,1,0
24305,12794,25174,0,0,deny,146,146,0,1,0,1,0
24306,6889,8497,0,0,deny,143,143,0,1,0,1,0
24307,57825,13014,0,0,deny,74,74,0,1,0,1,0
24308,40840,21247,0,0,deny,62,62,0,1,0,1,0
24309,62079,30188,0,0,deny,62,62,0,1,0,1,0
24310,50160,57470,0,0,deny,146,146,0,1,0,1,0
24311,13518,25174,0,0,deny,62,62,0,1,0,1,0
24312,64306,64147,0,0,deny,66,66,0,1,0,1,0
24313,58276,43890,0,0,deny,62,62,0,1,0,1,0
24314,61354,445,0,0,drop,70,70,0,1,0,1,0
24315,37014,23,0,0,deny,60,60,0,1,0,1,0
24316,2890,443,2890,443,allow,6915,882,6033,16,134,9,7
24317,12164,22114,0,0,deny,62,62,0,1,0,1,0
24318,49795,445,0,0,drop,70,70,0,1,0,1,0
24319,49792,445,0,0,drop,70,70,0,1,0,1,0
24320,49789,445,0,0,drop,70,70,0,1,0,1,0
24321,3478,61463,0,0,deny,233,233,0,1,0,1,0
24322,3478,61463,0,0,deny,1262,1262,0,1,0,1,0
24323,61351,445,0,0,drop,70,70,0,1,0,1,0
24324,48706,23393,0,0,deny,60,60,0,1,0,1,0
24325,61563,445,0,0,drop,66,66,0,1,0,1,0
24326,60311,56205,0,0,deny,62,62,0,1,0,1,0
24327,55766,36237,0,0,deny,62,62,0,1,0,1,0
24328,3478,61463,0,0,deny,301,301,0,1,0,1,0
24329,3478,61463,0,0,deny,1248,1248,0,1,0,1,0
24330,61346,445,0,0,drop,70,70,0,1,0,1,0
24331,27539,25174,0,0,deny,146,146,0,1,0,1,0
24332,61345,445,0,0,drop,70,70,0,1,0,1,0
24333,6355,25174,0,0,deny,62,62,0,1,0,1,0
24334,49787,445,0,0,drop,70,70,0,1,0,1,0
24335,49779,445,0,0,drop,70,70,0,1,0,1,0
24336,13120,25174,0,0,deny,146,146,0,1,0,1,0
24337,61343,445,0,0,drop,70,70,0,1,0,1,0
24338,14103,35440,0,0,deny,62,62,0,1,0,1,0
24339,14175,10387,0,0,deny,159,159,0,1,0,1,0
24340,52973,57470,0,0,deny,74,74,0,1,0,1,0
24341,50371,443,40015,443,allow,456,390,66,4,0,3,1
24342,50372,443,12434,443,allow,456,390,66,4,0,3,1
24343,29895,23,0,0,deny,60,60,0,1,0,1,0
24344,51769,51505,0,0,deny,66,66,0,1,0,1,0
24345,53546,46824,0,0,deny,66,66,0,1,0,1,0
24346,56816,11392,0,0,deny,66,66,0,1,0,1,0
24347,3478,61463,0,0,deny,921,921,0,1,0,1,0
24348,61549,445,0,0,drop,66,66,0,1,0,1,0
24349,61546,445,0,0,drop,66,66,0,1,0,1,0
24350,48125,7548,0,0,deny,60,60,0,1,0,1,0
24351,443,61686,0,0,deny,1484,1484,0,1,0,1,0
24352,58195,38303,0,0,deny,66,66,0,1,0,1,0
24353,5223,14446,0,0,deny,220,220,0,1,0,1,0
24354,52459,5555,0,0,deny,60,60,0,1,0,1,0
24355,58357,62413,0,0,deny,62,62,0,1,0,1,0
24356,51094,35440,0,0,deny,66,66,0,1,0,1,0
24357,59934,35440,0,0,deny,62,62,0,1,0,1,0
24358,14350,56205,0,0,deny,62,62,0,1,0,1,0
24359,49773,445,0,0,drop,70,70,0,1,0,1,0
24360,49769,445,0,0,drop,70,70,0,1,0,1,0
24361,49767,445,0,0,drop,70,70,0,1,0,1,0
24362,49766,445,0,0,drop,70,70,0,1,0,1,0
24363,61336,445,0,0,drop,70,70,0,1,0,1,0
24364,3478,61463,0,0,deny,164,164,0,1,0,1,0
24365,3478,61463,0,0,deny,1262,1262,0,1,0,1,0
24366,45964,2225,0,0,deny,60,60,0,1,0,1,0
24367,48327,57470,0,0,deny,145,145,0,1,0,1,0
24368,61334,445,0,0,drop,70,70,0,1,0,1,0
24369,61544,445,0,0,drop,66,66,0,1,0,1,0
24370,1025,25174,0,0,deny,62,62,0,1,0,1,0
24371,55524,46232,0,0,deny,62,62,0,1,0,1,0
24372,24127,56205,0,0,deny,66,66,0,1,0,1,0
24373,61333,445,0,0,drop,70,70,0,1,0,1,0
24374,61536,445,0,0,drop,66,66,0,1,0,1,0
24375,61532,445,0,0,drop,66,66,0,1,0,1,0
24376,61537,445,0,0,drop,66,66,0,1,0,1,0
24377,61530,445,0,0,drop,66,66,0,1,0,1,0
24378,61538,445,0,0,drop,66,66,0,1,0,1,0
24379,61535,445,0,0,drop,66,66,0,1,0,1,0
24380,61528,445,0,0,drop,66,66,0,1,0,1,0
24381,40797,25174,0,0,deny,62,62,0,1,0,1,0
24382,61332,445,0,0,drop,70,70,0,1,0,1,0
24383,45941,23386,0,0,deny,60,60,0,1,0,1,0
24384,3478,61463,0,0,deny,1188,1188,0,1,0,1,0
24385,61331,445,0,0,drop,70,70,0,1,0,1,0
24386,14693,64147,0,0,deny,62,62,0,1,0,1,0
24387,61329,445,0,0,drop,70,70,0,1,0,1,0
24388,61326,445,0,0,deny,70,70,0,1,0,1,0
24389,3478,61463,0,0,deny,455,455,0,1,0,1,0
24390,3478,61463,0,0,deny,1275,1275,0,1,0,1,0
24391,49761,445,0,0,drop,70,70,0,1,0,1,0
24392,50063,35776,0,0,deny,148,148,0,1,0,1,0
24393,49757,445,0,0,drop,70,70,0,1,0,1,0
24394,49756,445,0,0,drop,70,70,0,1,0,1,0
24395,49753,445,0,0,drop,70,70,0,1,0,1,0
24396,54868,1433,0,0,deny,60,60,0,1,0,1,0
24397,61313,445,0,0,drop,70,70,0,1,0,1,0
24398,61312,445,0,0,drop,70,70,0,1,0,1,0
24399,61306,445,0,0,drop,70,70,0,1,0,1,0
24400,51453,64147,0,0,deny,62,62,0,1,0,1,0
24401,61302,445,0,0,drop,70,70,0,1,0,1,0
24402,61303,445,0,0,drop,70,70,0,1,0,1,0
24403,3478,61463,0,0,deny,928,928,0,1,0,1,0
24404,57762,25174,0,0,deny,62,62,0,1,0,1,0
24405,63569,62413,0,0,deny,66,66,0,1,0,1,0
24406,50160,57470,0,0,deny,146,146,0,1,0,1,0
24407,23936,41615,0,0,deny,146,146,0,1,0,1,0
24408,23936,41615,0,0,deny,146,146,0,1,0,1,0
24409,58022,1471,0,0,deny,60,60,0,1,0,1,0
24410,50160,57470,0,0,deny,146,146,0,1,0,1,0
24411,53539,44847,0,0,deny,66,66,0,1,0,1,0
24412,59745,25174,0,0,deny,62,62,0,1,0,1,0
24413,49750,445,0,0,drop,70,70,0,1,0,1,0
24414,49749,445,0,0,drop,70,70,0,1,0,1,0
24415,49747,445,0,0,drop,70,70,0,1,0,1,0
24416,3478,61463,0,0,deny,665,665,0,1,0,1,0
24417,61522,445,0,0,drop,66,66,0,1,0,1,0
24418,63467,37807,0,0,deny,62,62,0,1,0,1,0
24419,49744,445,0,0,drop,70,70,0,1,0,1,0
24420,62043,25174,0,0,deny,146,146,0,1,0,1,0
24421,0,0,0,0,allow,156,156,0,2,0,2,0
24422,0,0,0,0,allow,2000,1020,980,20,0,10,10
24423,0,0,0,0,allow,244,244,0,2,0,2,0
24424,61518,445,0,0,drop,66,66,0,1,0,1,0
24425,1024,41055,0,0,deny,157,157,0,1,0,1,0
24426,3478,61463,0,0,deny,1097,1097,0,1,0,1,0
24427,61516,445,0,0,drop,66,66,0,1,0,1,0
24428,61515,445,0,0,drop,66,66,0,1,0,1,0
24429,61291,445,0,0,drop,70,70,0,1,0,1,0
24430,61513,445,0,0,drop,66,66,0,1,0,1,0
24431,31950,22114,0,0,deny,62,62,0,1,0,1,0
24432,54206,25174,0,0,deny,62,62,0,1,0,1,0
24433,46856,25174,0,0,deny,62,62,0,1,0,1,0
24434,46330,56205,0,0,deny,146,146,0,1,0,1,0
24435,45767,50584,0,0,deny,146,146,0,1,0,1,0
24436,49736,445,0,0,drop,70,70,0,1,0,1,0
24437,25187,31573,0,0,deny,62,62,0,1,0,1,0
24438,25233,23,0,0,deny,60,60,0,1,0,1,0
24439,49730,445,0,0,drop,70,70,0,1,0,1,0
24440,49726,445,0,0,drop,70,70,0,1,0,1,0
24441,63242,50584,0,0,deny,66,66,0,1,0,1,0
24442,61287,445,0,0,drop,70,70,0,1,0,1,0
24443,3478,61463,0,0,deny,1049,1049,0,1,0,1,0
24444,61461,50584,0,0,deny,62,62,0,1,0,1,0
24445,61502,445,0,0,drop,66,66,0,1,0,1,0
24446,19790,35440,0,0,deny,146,146,0,1,0,1,0
24447,61278,445,0,0,drop,70,70,0,1,0,1,0
24448,61275,445,0,0,drop,70,70,0,1,0,1,0
24449,61277,445,0,0,drop,70,70,0,1,0,1,0
24450,63855,25174,0,0,deny,146,146,0,1,0,1,0
24451,12143,56205,0,0,deny,66,66,0,1,0,1,0
24452,61273,445,0,0,drop,70,70,0,1,0,1,0
24453,52318,22114,0,0,deny,62,62,0,1,0,1,0
24454,3375,35253,0,0,deny,62,62,0,1,0,1,0
24455,61270,445,0,0,drop,70,70,0,1,0,1,0
24456,31017,50584,0,0,deny,62,62,0,1,0,1,0
24457,61494,445,0,0,drop,66,66,0,1,0,1,0
24458,3478,61463,0,0,deny,822,822,0,1,0,1,0
24459,49719,445,0,0,drop,70,70,0,1,0,1,0
24460,26717,25174,0,0,deny,146,146,0,1,0,1,0
24461,33886,65504,0,0,deny,162,162,0,1,0,1,0
24462,29363,36237,0,0,deny,146,146,0,1,0,1,0
24463,1882,43890,0,0,deny,62,62,0,1,0,1,0
24464,25901,50265,0,0,deny,62,62,0,1,0,1,0
24465,62067,80,14393,80,allow,1862,616,1246,11,15,6,5
24466,58854,443,18047,443,allow,5202,3361,1841,19,16,10,9
24467,38380,80,38380,80,allow,5397,713,4684,14,16,8,6
24468,56715,443,19932,443,allow,1207531,28695,1178836,1184,46,400,784
24469,54870,443,54870,443,allow,313399,38167,275232,411,23,205,206
24470,57331,53,13149,53,allow,1420,95,1325,4,32,2,2
24471,65184,53,54868,53,allow,164,84,80,2,31,1,1
24472,54587,53,0,0,allow,82,82,0,1,30,1,0
24473,56500,53,18802,53,allow,775,103,672,2,31,1,1
24474,57136,53,51914,53,allow,202,103,99,2,31,1,1
24475,56055,53,24959,53,allow,168,86,82,2,30,1,1
24476,55830,53,60660,53,allow,182,93,89,2,31,1,1
24477,58020,80,7358,80,allow,2482,516,1966,11,75,6,5
24478,50042,80,50042,80,allow,2986,1514,1472,10,15,6,4
24479,53821,7788,19069,7788,allow,70,70,0,2,8,2,0
24480,48983,15000,51295,15000,allow,130,70,60,2,6,1,1
24481,52030,43068,39879,43068,allow,70,70,0,2,8,2,0
24482,53060,1433,53060,1433,allow,60,60,0,1,5,1,0
24483,56505,443,54192,443,allow,78426,3219,75207,98,96,37,61
24484,58846,443,58496,443,allow,7680,4905,2775,24,17,12,12
24485,60587,443,60587,443,allow,4572,1665,2907,19,27,11,8
24486,56590,53,27360,53,allow,760,97,663,2,30,1,1
24487,56360,53,50871,53,allow,814,110,704,2,30,1,1
24488,50542,53,19780,53,allow,762,98,664,2,30,1,1
24489,61018,443,61018,443,allow,4400,1493,2907,19,29,11,8
24490,51230,80,14122,80,allow,579418,15579,563839,599,76,219,380
24491,63977,54486,31444,54486,allow,66,66,0,2,8,2,0
24492,54833,443,54833,443,allow,306802,26705,280097,395,21,190,205
24493,36858,443,39662,443,allow,3789,2373,1416,24,26,14,10
24494,63976,25725,46114,25725,allow,66,66,0,2,8,2,0
24495,62068,80,36797,80,allow,2806,626,2180,12,15,6,6
24496,33661,53,33661,53,allow,643,88,555,2,30,1,1
24497,53781,36366,2063,36366,allow,70,70,0,1,5,1,0
24498,55076,53,44619,53,allow,760,97,663,2,30,1,1
24499,27005,27017,29678,27017,allow,917,126,791,2,30,1,1
24500,58113,3389,58113,3389,allow,4245,2461,1784,18,33,9,9
24501,27005,27015,49152,27015,allow,919,126,793,2,30,1,1
24502,54291,443,41478,443,allow,8056,3762,4294,55,517,28,27
24503,44482,443,20797,443,allow,7464,1869,5595,29,409,11,18
24504,50467,53,38713,53,allow,758,93,665,2,31,1,1
24505,49898,53,38099,53,allow,184,94,90,2,31,1,1
24506,53687,19010,53687,19010,allow,64,64,0,1,31,1,0
24507,59003,443,53579,443,allow,10196,6897,3299,39,121,20,19
24508,50584,53,23534,53,allow,744,89,655,2,31,1,1
24509,55261,53,40486,53,allow,716,95,621,2,31,1,1
24510,49534,53,33345,53,allow,186,95,91,2,31,1,1
24511,55200,53,19804,53,allow,202,103,99,2,31,1,1
24512,56697,53,31729,53,allow,196,100,96,2,31,1,1
24513,55362,53,13886,53,allow,190,97,93,2,31,1,1
24514,27005,27017,53289,27017,allow,900,126,774,2,31,1,1
24515,50265,42805,33244,42805,allow,480,149,331,2,1200,1,1
24516,55831,53,12169,53,allow,182,93,89,2,31,1,1
24517,50219,53,44100,53,allow,751,95,656,2,31,1,1
24518,57470,17984,29715,17984,allow,870,330,540,12,1496,6,6
24519,64614,443,5122,443,allow,5505,3166,2339,22,136,11,11
24520,52811,44847,0,0,deny,66,66,0,1,0,1,0
24521,61491,445,0,0,drop,66,66,0,1,0,1,0
24522,61265,445,0,0,drop,70,70,0,1,0,1,0
24523,3478,61463,0,0,deny,1063,1063,0,1,0,1,0
24524,3478,61463,0,0,deny,1012,1012,0,1,0,1,0
24525,16376,35440,0,0,deny,62,62,0,1,0,1,0
24526,61485,445,0,0,drop,66,66,0,1,0,1,0
24527,61475,445,0,0,drop,66,66,0,1,0,1,0
24528,3478,61463,0,0,deny,164,164,0,1,0,1,0
24529,61257,445,0,0,drop,70,70,0,1,0,1,0
24530,3478,61463,0,0,deny,942,942,0,1,0,1,0
24531,51298,57470,0,0,deny,66,66,0,1,0,1,0
24532,49296,80,39063,80,allow,1515,481,1034,11,15,6,5
24533,54826,443,54826,443,allow,158092,23051,135041,216,21,110,106
24534,52025,42442,23036,42442,allow,70,70,0,2,7,2,0
24535,52011,10722,14551,10722,allow,70,70,0,1,4,1,0
24536,56724,53,33113,53,allow,182,94,88,2,29,1,1
24537,49677,53,61420,53,allow,373,126,247,2,29,1,1
24538,8998,53,50504,53,allow,225,78,147,2,29,1,1
24539,50378,53,9266,53,allow,199,102,97,2,29,1,1
24540,55993,53,8187,53,allow,199,102,97,2,29,1,1
24541,58862,443,26650,443,allow,5167,700,4467,16,15,7,9
24542,63975,24874,26677,24874,allow,66,66,0,2,7,2,0
24543,52026,12523,2339,12523,allow,70,70,0,2,7,2,0
24544,63139,53,8265,53,allow,78,78,0,2,31,2,0
24545,52007,37732,20807,37732,allow,70,70,0,1,4,1,0
24546,49197,2710,30685,2710,allow,70,70,0,1,4,1,0
24547,49537,80,13843,80,allow,5514,3156,2358,21,66,15,6
24548,50596,53,52895,53,allow,168,86,82,2,29,1,1
24549,58860,443,58775,443,allow,5594,3484,2110,16,15,8,8
24550,45852,53,16051,53,allow,774,76,698,4,29,2,2
24551,37093,53,37093,53,allow,645,90,555,2,29,1,1
24552,25463,53,62402,53,allow,827,91,736,4,29,2,2
24553,26079,53,52153,53,allow,226,78,148,2,29,1,1
24554,50378,53,11083,53,allow,199,102,97,2,29,1,1
24555,50378,53,26291,53,allow,199,102,97,2,29,1,1
24556,65504,53,13937,53,allow,216,94,122,2,30,1,1
24557,55176,53,60647,53,allow,195,102,93,2,30,1,1
24558,56961,53,64914,53,allow,757,102,655,2,30,1,1
24559,51453,80,39611,80,allow,214,140,74,4,15,3,1
24560,49749,443,9817,443,allow,438048,86860,351188,491,420,213,278
24561,49895,443,62049,443,allow,493316,12157,481159,470,94,122,348
24562,50100,53,44319,53,allow,216,110,106,2,30,1,1
24563,50386,53,42277,53,allow,782,110,672,2,30,1,1
24564,64548,53,58347,53,allow,209,110,99,2,30,1,1
24565,49317,53,61782,53,allow,194,102,92,2,30,1,1
24566,54998,53,51168,53,allow,195,102,93,2,30,1,1
24567,64827,53,50756,53,allow,291,86,205,2,30,1,1
24568,49842,443,3993,443,allow,6212,1823,4389,16,75,9,7
24569,38799,53,0,0,allow,86,86,0,1,30,1,0
24570,38101,443,38674,443,allow,190,70,120,4,15,2,2
24571,55107,53,60503,53,allow,816,102,714,2,30,1,1
24572,53638,443,51723,443,allow,24895,2856,22039,46,270,22,24
24573,55223,443,2473,443,allow,1118883,33814,1085069,1206,48,451,755
24574,62480,443,56428,443,allow,1326,876,450,11,26,6,5
24575,64126,53,37940,53,allow,216,102,114,2,30,1,1
24576,53770,58120,33681,58120,allow,684,432,252,10,19,6,4
24577,56456,53,45669,53,allow,199,102,97,2,30,1,1
24578,55380,53,60904,53,allow,289,97,192,4,45,2,2
24579,56456,53,39368,53,allow,199,102,97,2,30,1,1
24580,39839,443,5588,443,allow,5829,1408,4421,21,188,11,10
24581,63138,51452,48571,51452,allow,70,70,0,2,8,2,0
24582,55830,53,64690,53,allow,183,94,89,2,30,1,1
24583,55715,53,57381,53,allow,168,86,82,2,30,1,1
24584,7318,443,16542,443,allow,6458,2658,3800,34,255,16,18
24585,50028,53,64249,53,allow,256,102,154,2,30,1,1
24586,57435,53,43686,53,allow,184,102,82,2,30,1,1
24587,56799,80,63768,80,allow,1514,481,1033,11,15,6,5
24588,49199,53,25125,53,allow,193,102,91,2,30,1,1
24589,49199,53,34176,53,allow,816,102,714,2,30,1,1
24590,54476,443,29193,443,allow,48303,3997,44306,69,271,30,39
24591,49678,80,44529,80,allow,1977,921,1056,9,15,5,4
24592,41714,443,33432,443,allow,4590,3026,1564,28,80,15,13
24593,64387,53,16161,53,allow,359,99,260,4,54,2,2
24594,49503,443,38675,443,allow,1363701,35511,1328190,1382,271,476,906
24595,57340,53,29949,53,allow,216,110,106,2,30,1,1
24596,27005,27015,8670,27015,allow,877,126,751,2,30,1,1
24597,65300,53,36602,53,allow,758,102,656,2,30,1,1
24598,51263,443,3091,443,allow,8247,2116,6131,23,360,11,12
24599,55392,443,3923,443,allow,7347,2127,5220,18,135,8,10
24600,55042,443,48187,443,allow,5409,1471,3938,21,17,12,9
24601,57340,53,7589,53,allow,216,110,106,2,30,1,1
24602,58864,443,14029,443,allow,5167,700,4467,16,15,7,9
24603,33971,443,52032,443,allow,244193,7090,237103,260,136,87,173
24604,52027,49743,54736,49743,allow,70,70,0,2,7,2,0
24605,50126,443,34426,443,allow,15032,5689,9343,51,35,27,24
24606,50211,1688,29763,1688,allow,70,70,0,2,7,2,0
24607,57893,80,44001,80,allow,318,192,126,6,26,4,2
24608,49772,80,38817,80,allow,70,70,0,1,5,1,0
24609,59734,443,48585,443,allow,1312,651,661,13,184,7,6
24610,33845,443,64577,443,allow,6495,1547,4948,19,318,10,9
24611,55285,53,16025,53,allow,268,95,173,4,47,2,2
24612,58872,443,3820,443,allow,1178,820,358,9,15,6,3
24613,57034,443,8240,443,allow,30645,2719,27926,60,153,25,35
24614,56660,80,51147,80,allow,234,234,0,4,12,4,0
24615,64794,80,22092,80,allow,22646,1660,20986,29,135,10,19
24616,55285,53,18984,53,allow,268,95,173,4,46,2,2
24617,53819,9472,27834,9472,allow,70,70,0,2,7,2,0
24618,52029,52093,47612,52093,allow,70,70,0,2,7,2,0
24619,64589,53,62557,53,allow,814,110,704,2,29,1,1
24620,27724,53,46943,53,allow,322,84,238,4,29,2,2
24621,64882,53,62094,53,allow,343,134,209,2,30,1,1
24622,56357,53,8894,53,allow,168,86,82,2,30,1,1
24623,39422,80,48610,80,allow,1057,683,374,10,15,6,4
24624,64774,53,37147,53,allow,214,102,112,2,29,1,1
24625,49614,53,48973,53,allow,183,94,89,2,29,1,1
24626,56372,53,7936,53,allow,172,94,78,2,30,1,1
24627,56456,53,58146,53,allow,199,102,97,2,30,1,1
24628,65234,53,55204,53,allow,248,110,138,2,29,1,1
24629,62749,53,25858,53,allow,184,86,98,2,30,1,1
24630,56372,53,63368,53,allow,172,94,78,2,29,1,1
24631,49283,53,8368,53,allow,251,102,149,2,30,1,1
24632,39869,53,19258,53,allow,394,80,314,4,29,2,2
24633,50100,53,47683,53,allow,216,110,106,2,30,1,1
24634,56357,53,62096,53,allow,168,86,82,2,30,1,1
24635,27005,27015,51947,27015,allow,879,126,753,2,30,1,1
24636,55651,53,17505,53,allow,199,102,97,2,30,1,1
24637,27005,27013,41883,27013,allow,879,126,753,2,30,1,1
24638,65431,53,63045,53,allow,210,102,108,2,30,1,1
24639,57044,53,35705,53,allow,197,102,95,2,30,1,1
24640,64991,53,4692,53,allow,779,86,693,2,30,1,1
24641,50450,53,9173,53,allow,209,110,99,2,30,1,1
24642,51795,443,38241,443,allow,4209,2221,1988,25,157,12,13
24643,60582,53,13685,53,allow,180,86,94,2,30,1,1
24644,49572,443,38388,443,allow,11583,4967,6616,31,47,17,14
24645,38086,53,54095,53,allow,199,94,105,2,30,1,1
24646,49568,53,32071,53,allow,168,86,82,2,31,1,1
24647,59964,443,21876,443,allow,1346200,44765,1301435,1428,128,479,949
24648,15503,61284,64885,61284,allow,16553,6930,9623,212,6269,106,106
24649,57340,53,2776,53,allow,216,110,106,2,30,1,1
24650,50450,53,51972,53,allow,209,110,99,2,30,1,1
24651,51867,53,1821,53,allow,179,86,93,2,30,1,1
24652,65184,53,13116,53,allow,166,86,80,2,30,1,1
24653,56738,53,38791,53,allow,821,102,719,2,30,1,1
24654,49543,53,52836,53,allow,200,102,98,2,30,1,1
24655,56738,53,58828,53,allow,198,102,96,2,30,1,1
24656,65152,53,32824,53,allow,167,86,81,2,31,1,1
24657,50308,443,46748,443,allow,44311,4535,39776,55,121,21,34
24658,37965,31483,54456,31483,allow,4530,2856,1674,62,2421,35,27
24659,52845,443,44053,443,allow,2082,1322,760,14,41,8,6
24660,28474,3389,28474,3389,allow,3850,1745,2105,19,18,11,8
24661,48676,53395,48676,53395,allow,124,60,64,3,5,2,1
24662,64957,53,41435,53,allow,506,131,375,4,41,2,2
24663,51110,80,32972,80,allow,23850,1662,22188,36,15,19,17
24664,50672,443,34507,443,allow,6202,1828,4374,25,18,12,13
24665,52148,443,33858,443,allow,375357,11451,363906,356,61,100,256
24666,41398,443,9003,443,allow,3135,1968,1167,22,72,12,10
24667,65309,53,6020,53,allow,227,110,117,2,30,1,1
24668,57435,53,39763,53,allow,184,102,82,2,30,1,1
24669,50011,53,7545,53,allow,766,102,664,2,30,1,1
24670,27005,27018,3011,27018,allow,882,126,756,2,30,1,1
24671,50137,53,54059,53,allow,183,94,89,2,31,1,1
24672,49677,80,37951,80,allow,1977,921,1056,9,16,5,4
24673,57136,53,22982,53,allow,209,110,99,2,30,1,1
24674,56626,53,17271,53,allow,224,102,122,2,30,1,1
24675,57054,53,38199,53,allow,164,78,86,2,30,1,1
24676,27005,27015,34659,27015,allow,899,126,773,2,30,1,1
24677,55107,53,32486,53,allow,193,102,91,2,30,1,1
24678,39888,53,65133,53,allow,168,78,90,2,30,1,1
24679,50630,53,64139,53,allow,209,110,99,2,30,1,1
24680,65515,53,15950,53,allow,652,209,443,6,50,3,3
24681,50100,53,23176,53,allow,216,110,106,2,30,1,1
24682,65193,53,19280,53,allow,436,94,342,2,30,1,1
24683,27005,27444,51395,27444,allow,893,126,767,2,30,1,1
24684,49898,53,31342,53,allow,184,94,90,2,30,1,1
24685,56365,53,8027,53,allow,199,102,97,2,30,1,1
24686,55830,53,46828,53,allow,183,94,89,2,30,1,1
24687,56365,53,14208,53,allow,199,102,97,2,30,1,1
24688,49898,53,13665,53,allow,184,94,90,2,30,1,1
24689,17750,51965,19962,51965,allow,150,150,0,1,1200,1,0
24690,46479,443,13902,443,allow,5241,2026,3215,50,6660,18,32
24691,55849,53,18869,53,allow,195,102,93,2,31,1,1
24692,65112,53,1739,53,allow,209,110,99,2,31,1,1
24693,40040,5223,48273,5223,allow,5386,1100,4286,27,686,10,17
24694,64655,443,35493,443,allow,8903,2857,6046,22,135,10,12
24695,57707,443,36174,443,allow,3150,1709,1441,26,276,13,13
24696,37965,46008,3180,46008,allow,132,132,0,3,1200,3,0
24697,56934,53,48178,53,allow,216,110,106,2,31,1,1
24698,37965,15357,58016,15357,allow,481,150,331,2,1200,1,1
24699,53818,15337,22779,15337,allow,258,70,188,4,8,2,2
24700,37612,443,3287,443,allow,2141,1270,871,18,130,10,8
24701,53133,443,4728,443,allow,5610,1599,4011,24,17,14,10
24702,65219,53,52496,53,allow,197,102,95,2,31,1,1
24703,62478,443,29633,443,allow,10391,7059,3332,27,27,15,12
24704,62479,443,46621,443,allow,14673,3914,10759,31,27,14,17
24705,50609,80,7480,80,allow,12986,6816,6170,26,26,12,14
24706,44086,443,28968,443,allow,8542,4191,4351,84,616,46,38
24707,52006,49849,60139,49849,allow,70,70,0,1,5,1,0
24708,64768,80,26612,80,allow,18045,3544,14501,28,156,12,16
24709,49326,53,56279,53,allow,765,102,663,2,30,1,1
24710,123,123,56817,123,allow,184,94,90,2,30,1,1
24711,53258,53,63456,53,allow,277,78,199,2,30,1,1
24712,59802,53,61597,53,allow,168,78,90,2,30,1,1
24713,50418,53,14403,53,allow,177,94,83,2,30,1,1
24714,61255,445,0,0,drop,70,70,0,1,0,1,0
24715,45964,3111,0,0,deny,60,60,0,1,0,1,0
24716,62424,37965,0,0,deny,66,66,0,1,0,1,0
24717,28221,37965,0,0,deny,62,62,0,1,0,1,0
24718,63888,57470,0,0,deny,62,62,0,1,0,1,0
24719,61250,445,0,0,drop,70,70,0,1,0,1,0
24720,61248,445,0,0,drop,70,70,0,1,0,1,0
24721,3478,61463,0,0,deny,1163,1163,0,1,0,1,0
24722,49708,445,0,0,drop,70,70,0,1,0,1,0
24723,49705,445,0,0,drop,70,70,0,1,0,1,0
24724,14023,37965,0,0,deny,62,62,0,1,0,1,0
24725,50211,51050,0,0,deny,66,66,0,1,0,1,0
24726,61463,445,0,0,drop,66,66,0,1,0,1,0
24727,61469,445,0,0,drop,66,66,0,1,0,1,0
24728,61462,445,0,0,drop,66,66,0,1,0,1,0
24729,61467,445,0,0,drop,66,66,0,1,0,1,0
24730,61464,445,0,0,drop,66,66,0,1,0,1,0
24731,61465,445,0,0,drop,66,66,0,1,0,1,0
24732,61468,445,0,0,drop,66,66,0,1,0,1,0
24733,55008,21247,0,0,deny,66,66,0,1,0,1,0
24734,61244,445,0,0,drop,70,70,0,1,0,1,0
24735,3212,22114,0,0,deny,62,62,0,1,0,1,0
24736,11716,37965,0,0,deny,62,62,0,1,0,1,0
24737,3212,22114,0,0,deny,146,146,0,1,0,1,0
24738,14696,42707,0,0,deny,62,62,0,1,0,1,0
24739,3478,61463,0,0,deny,451,451,0,1,0,1,0
24740,3478,61463,0,0,deny,174,174,0,1,0,1,0
24741,61243,445,0,0,drop,70,70,0,1,0,1,0
24742,63030,25174,0,0,deny,146,146,0,1,0,1,0
24743,3478,61463,0,0,deny,68,68,0,1,0,1,0
24744,39132,44847,0,0,deny,66,66,0,1,0,1,0
24745,49701,445,0,0,drop,70,70,0,1,0,1,0
24746,49700,445,0,0,drop,70,70,0,1,0,1,0
24747,49695,445,0,0,drop,70,70,0,1,0,1,0
24748,49688,445,0,0,drop,70,70,0,1,0,1,0
24749,64543,50265,0,0,deny,66,66,0,1,0,1,0
24750,3478,61463,0,0,deny,944,944,0,1,0,1,0
24751,61448,445,0,0,drop,66,66,0,1,0,1,0
24752,61449,445,0,0,drop,66,66,0,1,0,1,0
24753,61447,445,0,0,drop,66,66,0,1,0,1,0
24754,33405,37965,0,0,deny,62,62,0,1,0,1,0
24755,61238,445,0,0,drop,70,70,0,1,0,1,0
24756,10333,22114,0,0,deny,62,62,0,1,0,1,0
24757,11136,57587,0,0,deny,62,62,0,1,0,1,0
24758,59451,50584,0,0,deny,66,66,0,1,0,1,0
24759,55713,25174,0,0,deny,62,62,0,1,0,1,0
24760,49685,445,0,0,drop,70,70,0,1,0,1,0
24761,55674,5900,0,0,deny,60,60,0,1,0,1,0
24762,3478,61463,0,0,deny,927,927,0,1,0,1,0
24763,49678,445,0,0,drop,70,70,0,1,0,1,0
24764,49677,445,0,0,drop,70,70,0,1,0,1,0
24765,49674,445,0,0,drop,70,70,0,1,0,1,0
24766,2531,30188,0,0,deny,62,62,0,1,0,1,0
24767,15113,25174,0,0,deny,62,62,0,1,0,1,0
24768,49163,22114,0,0,deny,146,146,0,1,0,1,0
24769,15266,55783,0,0,deny,145,145,0,1,0,1,0
24770,50197,64147,0,0,deny,66,66,0,1,0,1,0
24771,50651,25174,0,0,deny,62,62,0,1,0,1,0
24772,63397,26467,0,0,deny,66,66,0,1,0,1,0
24773,3478,61463,0,0,deny,928,928,0,1,0,1,0
24774,14567,37965,0,0,deny,62,62,0,1,0,1,0
24775,61225,445,0,0,drop,70,70,0,1,0,1,0
24776,2886,35440,0,0,deny,66,66,0,1,0,1,0
24777,36717,51505,0,0,deny,146,146,0,1,0,1,0
24778,61222,445,0,0,drop,70,70,0,1,0,1,0
24779,49664,445,0,0,drop,70,70,0,1,0,1,0
24780,53100,443,19603,443,allow,472,406,66,4,0,3,1
24781,49663,445,0,0,drop,70,70,0,1,0,1,0
24782,49661,445,0,0,drop,70,70,0,1,0,1,0
24783,61970,57866,0,0,deny,62,62,0,1,0,1,0
24784,19699,48817,0,0,deny,143,143,0,1,0,1,0
24785,62219,25174,0,0,deny,146,146,0,1,0,1,0
24786,52973,57470,0,0,deny,74,74,0,1,0,1,0
24787,3478,61463,0,0,deny,1188,1188,0,1,0,1,0
24788,3478,61463,0,0,deny,364,364,0,1,0,1,0
24789,3478,61463,0,0,deny,1162,1162,0,1,0,1,0
24790,61435,445,0,0,drop,66,66,0,1,0,1,0
24791,65249,25864,0,0,deny,72,72,0,1,0,1,0
24792,20706,37965,0,0,deny,62,62,0,1,0,1,0
24793,45682,37965,0,0,deny,62,62,0,1,0,1,0
24794,61218,445,0,0,drop,70,70,0,1,0,1,0
24795,1873,37965,0,0,deny,62,62,0,1,0,1,0
24796,61216,445,0,0,drop,70,70,0,1,0,1,0
24797,3478,61463,0,0,deny,164,164,0,1,0,1,0
24798,3478,61463,0,0,deny,214,214,0,1,0,1,0
24799,3478,61463,0,0,deny,1292,1292,0,1,0,1,0
24800,61214,445,0,0,drop,70,70,0,1,0,1,0
24801,49657,445,0,0,drop,70,70,0,1,0,1,0
24802,49651,445,0,0,drop,70,70,0,1,0,1,0
24803,61420,445,0,0,drop,66,66,0,1,0,1,0
24804,61419,445,0,0,drop,66,66,0,1,0,1,0
24805,3478,61463,0,0,deny,933,933,0,1,0,1,0
24806,63460,55160,0,0,deny,66,66,0,1,0,1,0
24807,59043,35440,0,0,deny,62,62,0,1,0,1,0
24808,50339,25174,0,0,deny,146,146,0,1,0,1,0
24809,56943,44847,0,0,deny,62,62,0,1,0,1,0
24810,61207,445,0,0,drop,70,70,0,1,0,1,0
24811,42898,25174,0,0,deny,62,62,0,1,0,1,0
24812,6666,990,0,0,deny,60,60,0,1,0,1,0
24813,10022,55839,0,0,deny,145,145,0,1,0,1,0
24814,49644,445,0,0,drop,70,70,0,1,0,1,0
24815,49646,445,0,0,drop,70,70,0,1,0,1,0
24816,49643,445,0,0,drop,70,70,0,1,0,1,0
24817,49641,445,0,0,drop,70,70,0,1,0,1,0
24818,61205,445,0,0,drop,70,70,0,1,0,1,0
24819,53143,50584,0,0,deny,66,66,0,1,0,1,0
24820,29195,51505,0,0,deny,146,146,0,1,0,1,0
24821,51830,42707,0,0,deny,66,66,0,1,0,1,0
24822,3478,61463,0,0,deny,901,901,0,1,0,1,0
24823,61415,445,0,0,drop,66,66,0,1,0,1,0
24824,61204,445,0,0,drop,70,70,0,1,0,1,0
24825,49540,50584,0,0,deny,66,66,0,1,0,1,0
24826,61203,445,0,0,drop,70,70,0,1,0,1,0
24827,61202,445,0,0,drop,70,70,0,1,0,1,0
24828,61200,445,0,0,drop,70,70,0,1,0,1,0
24829,61197,445,0,0,drop,70,70,0,1,0,1,0
24830,61403,445,0,0,drop,66,66,0,1,0,1,0
24831,61402,445,0,0,drop,66,66,0,1,0,1,0
24832,61410,445,0,0,drop,66,66,0,1,0,1,0
24833,61408,445,0,0,drop,66,66,0,1,0,1,0
24834,61399,445,0,0,drop,66,66,0,1,0,1,0
24835,61405,445,0,0,drop,66,66,0,1,0,1,0
24836,61398,445,0,0,drop,66,66,0,1,0,1,0
24837,52471,22114,0,0,deny,66,66,0,1,0,1,0
24838,49632,445,0,0,drop,70,70,0,1,0,1,0
24839,3478,61463,0,0,deny,1103,1103,0,1,0,1,0
24840,56582,23718,0,0,deny,62,62,0,1,0,1,0
24841,53871,37965,0,0,deny,66,66,0,1,0,1,0
24842,49628,445,0,0,drop,70,70,0,1,0,1,0
24843,49627,445,0,0,drop,70,70,0,1,0,1,0
24844,49625,445,0,0,drop,70,70,0,1,0,1,0
24845,11688,23718,0,0,deny,62,62,0,1,0,1,0
24846,45941,23388,0,0,deny,60,60,0,1,0,1,0
24847,19882,22114,0,0,deny,62,62,0,1,0,1,0
24848,61184,445,0,0,drop,70,70,0,1,0,1,0
24849,61183,445,0,0,drop,70,70,0,1,0,1,0
24850,61181,445,0,0,drop,70,70,0,1,0,1,0
24851,61174,445,0,0,drop,70,70,0,1,0,1,0
24852,61173,445,0,0,drop,70,70,0,1,0,1,0
24853,51155,56205,0,0,deny,66,66,0,1,0,1,0
24854,63840,36829,0,0,deny,66,66,0,1,0,1,0
24855,3478,61463,0,0,deny,491,491,0,1,0,1,0
24856,56005,64147,0,0,deny,62,62,0,1,0,1,0
24857,56131,37807,0,0,deny,66,66,0,1,0,1,0
24858,63984,25174,0,0,deny,62,62,0,1,0,1,0
24859,49624,445,0,0,drop,70,70,0,1,0,1,0
24860,49622,445,0,0,drop,70,70,0,1,0,1,0
24861,49620,445,0,0,drop,70,70,0,1,0,1,0
24862,63984,25174,0,0,deny,146,146,0,1,0,1,0
24863,49686,44847,0,0,deny,66,66,0,1,0,1,0
24864,61394,445,0,0,drop,66,66,0,1,0,1,0
24865,49616,445,0,0,drop,70,70,0,1,0,1,0
24866,53756,50584,0,0,deny,66,66,0,1,0,1,0
24867,5926,25174,0,0,deny,146,146,0,1,0,1,0
24868,61389,445,0,0,drop,66,66,0,1,0,1,0
24869,3478,61463,0,0,deny,1345,1345,0,1,0,1,0
24870,3478,61463,0,0,deny,893,893,0,1,0,1,0
24871,61162,445,0,0,drop,70,70,0,1,0,1,0
24872,61388,445,0,0,drop,66,66,0,1,0,1,0
24873,61386,445,0,0,drop,66,66,0,1,0,1,0
24874,61385,445,0,0,drop,66,66,0,1,0,1,0
24875,64124,25174,0,0,deny,62,62,0,1,0,1,0
24876,64124,25174,0,0,deny,146,146,0,1,0,1,0
24877,19875,30170,0,0,deny,145,145,0,1,0,1,0
24878,7720,44847,0,0,deny,66,66,0,1,0,1,0
24879,3478,61463,0,0,deny,1004,1004,0,1,0,1,0
24880,62408,50584,0,0,deny,66,66,0,1,0,1,0
24881,49333,25174,0,0,deny,146,146,0,1,0,1,0
24882,49608,445,0,0,deny,70,70,0,1,0,1,0
24883,61158,445,0,0,drop,70,70,0,1,0,1,0
24884,32282,8604,0,0,deny,62,62,0,1,0,1,0
24885,64535,37965,0,0,deny,62,62,0,1,0,1,0
24886,49605,445,0,0,drop,70,70,0,1,0,1,0
24887,49604,445,0,0,drop,70,70,0,1,0,1,0
24888,52050,11392,0,0,deny,62,62,0,1,0,1,0
24889,50949,45960,0,0,deny,62,62,0,1,0,1,0
24890,49514,65504,0,0,deny,162,162,0,1,0,1,0
24891,61148,445,0,0,drop,70,70,0,1,0,1,0
24892,61147,445,0,0,drop,70,70,0,1,0,1,0
24893,39268,443,60773,443,allow,7691,1999,5692,35,256,18,17
24894,52803,443,59403,443,allow,4913,751,4162,18,28,8,10
24895,50158,53,45524,53,allow,758,96,662,2,30,1,1
24896,27005,27015,4147,27015,allow,869,126,743,2,30,1,1
24897,50601,53,58017,53,allow,760,97,663,2,30,1,1
24898,26900,27017,32451,27017,allow,422,164,258,6,30,3,3
24899,36148,443,59223,443,allow,2233,1237,996,18,75,9,9
24900,27005,27015,58222,27015,allow,901,126,775,2,30,1,1
24901,49631,80,18406,80,allow,1446,914,532,8,16,5,3
24902,56967,443,1130,443,allow,9222,3148,6074,26,91,14,12
24903,50589,53,50328,53,allow,733,85,648,2,30,1,1
24904,64823,53,49719,53,allow,754,94,660,2,30,1,1
24905,26900,27017,11967,27017,allow,422,164,258,6,30,3,3
24906,56006,53,14148,53,allow,200,102,98,2,30,1,1
24907,56713,443,29098,443,allow,373053,9725,363328,374,45,129,245
24908,50602,53,48380,53,allow,761,100,661,2,30,1,1
24909,50152,53,50662,53,allow,776,102,674,2,30,1,1
24910,39575,53,26625,53,allow,198,93,105,2,30,1,1
24911,52471,443,40608,443,allow,41966,23593,18373,89,154,42,47
24912,56912,443,18350,443,allow,7618,2859,4759,26,17,14,12
24913,35187,443,10629,443,allow,13057,1460,11597,28,255,14,14
24914,56710,80,31559,80,allow,30614,1926,28688,44,45,23,21
24915,33498,443,13950,443,allow,3672,1802,1870,25,129,10,15
24916,56711,443,22373,443,allow,1207531,28695,1178836,1184,45,400,784
24917,53779,24874,46162,24874,allow,70,70,0,1,5,1,0
24918,49654,80,62671,80,allow,1506,914,592,9,16,5,4
24919,36146,443,42647,443,allow,2514,1249,1265,19,76,9,10
24920,55380,53,27233,53,allow,289,97,192,4,45,2,2
24921,49989,53,14607,53,allow,778,103,675,2,30,1,1
24922,58823,443,42336,443,allow,25195,16739,8456,60,20,35,25
24923,39251,53,9429,53,allow,198,93,105,2,30,1,1
24924,45439,443,28530,443,allow,24785,17234,7551,68,421,36,32
24925,56365,53,1142,53,allow,198,101,97,2,30,1,1
24926,56068,53,2215,53,allow,752,93,659,2,30,1,1
24927,50135,53,57045,53,allow,774,101,673,2,30,1,1
24928,56934,53,42274,53,allow,216,110,106,2,31,1,1
24929,33877,443,16562,443,allow,9449,3441,6008,27,41,17,10
24930,52002,34348,46608,34348,allow,66,66,0,1,5,1,0
24931,49429,53,29436,53,allow,188,96,92,2,31,1,1
24932,55849,53,21168,53,allow,190,97,93,2,31,1,1
24933,54563,443,54563,443,allow,109880,24958,84922,154,20,83,71
24934,56709,443,60934,443,allow,1239919,29325,1210594,1214,46,409,805
24935,53817,59216,6687,59216,allow,258,70,188,4,8,2,2
24936,50803,443,40558,443,allow,1590,1038,552,12,48,6,6
24937,53780,47132,52557,47132,allow,70,70,0,1,5,1,0
24938,52001,12514,13607,12514,allow,66,66,0,1,5,1,0
24939,65219,53,39844,53,allow,410,99,311,4,56,2,2
24940,55651,53,31474,53,allow,198,101,97,2,30,1,1
24941,57066,53,53308,53,allow,778,103,675,2,30,1,1
24942,55185,53,27754,53,allow,758,93,665,2,30,1,1
24943,56795,53,37529,53,allow,776,102,674,2,30,1,1
24944,54262,443,59350,443,allow,11356,5509,5847,84,544,44,40
24945,64729,53,52284,53,allow,770,102,668,2,30,1,1
24946,55715,53,53520,53,allow,168,86,82,2,30,1,1
24947,55791,53,26721,53,allow,770,101,669,2,30,1,1
24948,57423,53,20278,53,allow,774,101,673,2,30,1,1
24949,50426,53,23864,53,allow,760,97,663,2,30,1,1
24950,27005,27015,27620,27015,allow,880,126,754,2,30,1,1
24951,56500,53,34519,53,allow,198,101,97,2,31,1,1
24952,57025,53,3380,53,allow,168,86,82,2,31,1,1
24953,65313,53,63714,53,allow,164,84,80,2,31,1,1
24954,57565,443,12958,443,allow,3586,1074,2512,17,137,8,9
24955,64959,53,59416,53,allow,202,103,99,2,31,1,1
24956,26900,27017,61520,27017,allow,422,164,258,6,31,3,3
24957,57157,53,17035,53,allow,755,94,661,2,31,1,1
24958,56290,53,40983,53,allow,716,95,621,2,31,1,1
24959,55439,53,12410,53,allow,738,86,652,2,30,1,1
24960,55390,53,32407,53,allow,778,103,675,2,31,1,1
24961,64687,53,62553,53,allow,182,93,89,2,31,1,1
24962,16387,22226,0,0,allow,60,60,0,1,61,1,0
24963,49593,53,21447,53,allow,762,98,664,2,31,1,1
24964,56804,53,22833,53,allow,760,96,664,2,31,1,1
24965,55443,53,31894,53,allow,751,95,656,2,31,1,1
24966,65112,53,30397,53,allow,202,103,99,2,31,1,1
24967,64054,53,42745,53,allow,182,93,89,2,31,1,1
24968,26900,27017,18355,27017,allow,422,164,258,6,31,3,3
24969,56664,53,62279,53,allow,774,101,673,2,31,1,1
24970,27005,27022,21223,27022,allow,890,126,764,2,31,1,1
24971,27005,27016,17178,27016,allow,914,126,788,2,31,1,1
24972,55262,53,28090,53,allow,762,98,664,2,31,1,1
24973,64330,53,32772,53,allow,186,95,91,2,31,1,1
24974,56544,53,62437,53,allow,760,97,663,2,31,1,1
24975,56245,53,57808,53,allow,200,102,98,2,31,1,1
24976,56624,53,13351,53,allow,198,101,97,2,31,1,1
24977,47756,443,23688,443,allow,8504,4770,3734,46,196,25,21
24978,27005,27015,34776,27015,allow,882,126,756,2,31,1,1
24979,16387,26637,0,0,allow,60,60,0,1,61,1,0
24980,27005,27015,27978,27015,allow,888,126,762,2,31,1,1
24981,55037,443,21745,443,allow,2639,258,2381,9,120,4,5
24982,6881,6881,46331,6881,allow,259,150,109,2,1201,1,1
24983,61146,445,0,0,drop,70,70,0,1,0,1,0
24984,61145,445,0,0,drop,70,70,0,1,0,1,0
24985,61373,445,0,0,drop,66,66,0,1,0,1,0
24986,3478,61463,0,0,deny,918,918,0,1,0,1,0
24987,45766,35440,0,0,deny,62,62,0,1,0,1,0
24988,61142,445,0,0,drop,70,70,0,1,0,1,0
24989,45964,55559,0,0,deny,60,60,0,1,0,1,0
24990,18608,11392,0,0,deny,66,66,0,1,0,1,0
24991,58251,36237,0,0,deny,66,66,0,1,0,1,0
24992,57604,32480,0,0,deny,62,62,0,1,0,1,0
24993,60806,51050,0,0,deny,66,66,0,1,0,1,0
24994,63910,44847,0,0,deny,66,66,0,1,0,1,0
24995,55831,53,65358,53,allow,183,94,89,2,30,1,1
24996,65311,53,5309,53,allow,198,94,104,2,30,1,1
24997,64959,53,9017,53,allow,209,110,99,2,30,1,1
24998,35927,443,23260,443,allow,9102,1205,7897,25,14,14,11
24999,46271,443,30209,443,allow,70,70,0,2,4,2,0
25000,49461,53,38932,53,allow,198,102,96,2,29,1,1
25001,49568,53,53479,53,allow,184,102,82,2,29,1,1
25002,56697,53,16898,53,allow,198,102,96,2,29,1,1
25003,49543,53,5363,53,allow,200,102,98,2,30,1,1
25004,65313,53,62981,53,allow,166,86,80,2,30,1,1
25005,48996,443,35257,443,allow,128299,119001,9298,178,280,103,75
25006,64113,443,11350,443,allow,14057427,329652,13727775,13768,110,4655,9113
25007,51956,443,35785,443,allow,5065,1658,3407,21,16,13,8
25008,60867,443,29499,443,allow,3072,2174,898,14,317,8,6
25009,54439,443,63339,443,allow,44294,9390,34904,167,319,83,84
25010,63901,42053,50757,42053,allow,2980,1647,1333,16,31,10,6
25011,58855,443,45547,443,allow,5168,700,4468,16,14,7,9
25012,53154,44645,45393,44645,allow,320,140,180,6,5,3,3
25013,50667,443,38450,443,allow,8536,2068,6468,36,18,16,20
25014,53823,25291,38093,25291,allow,320,140,180,6,6,3,3
25015,55752,8060,41329,8060,allow,70,70,0,1,4,1,0
25016,55380,53,32660,53,allow,289,97,192,4,44,2,2
25017,55050,443,54563,443,allow,126,60,66,3,5,2,1
25018,55651,53,8251,53,allow,199,102,97,2,29,1,1
25019,65219,53,31087,53,allow,197,102,95,2,29,1,1
25020,56934,53,16279,53,allow,216,110,106,2,29,1,1
25021,49534,53,40703,53,allow,193,102,91,2,29,1,1
25022,49461,53,21062,53,allow,821,102,719,2,29,1,1
25023,56474,53,60230,53,allow,209,110,99,2,29,1,1
25024,55715,53,19164,53,allow,168,86,82,2,29,1,1
25025,49403,53,28281,53,allow,228,102,126,2,29,1,1
25026,57136,53,60175,53,allow,209,110,99,2,29,1,1
25027,50630,53,12018,53,allow,209,110,99,2,29,1,1
25028,49429,53,2752,53,allow,194,102,92,2,30,1,1
25029,55200,53,14143,53,allow,209,110,99,2,30,1,1
25030,37048,53,15129,53,allow,168,78,90,2,29,1,1
25031,50418,53,58072,53,allow,185,102,83,2,30,1,1
25032,60290,53,25533,53,allow,199,94,105,2,29,1,1
25033,42300,53,40798,53,allow,168,78,90,2,29,1,1
25034,54998,53,32757,53,allow,195,102,93,2,29,1,1
25035,58767,53,1096,53,allow,168,78,90,2,29,1,1
25036,65245,53,50630,53,allow,193,102,91,2,30,1,1
25037,55715,53,18469,53,allow,168,86,82,2,30,1,1
25038,65116,53,63151,53,allow,214,110,104,2,30,1,1
25039,56459,53,30479,53,allow,209,110,99,2,30,1,1
25040,56673,53,38951,53,allow,183,94,89,2,30,1,1
25041,49814,53,14666,53,allow,189,102,87,2,30,1,1
25042,55200,53,50421,53,allow,209,110,99,2,30,1,1
25043,26900,27017,38373,27017,allow,422,164,258,6,30,3,3
25044,55712,53,64759,53,allow,164,86,78,2,30,1,1
25045,65323,53,29690,53,allow,816,102,714,2,30,1,1
25046,39054,443,15031,443,allow,7772,4119,3653,31,17,16,15
25047,65116,53,4360,53,allow,214,110,104,2,30,1,1
25048,52003,18150,63580,18150,allow,70,70,0,1,5,1,0
25049,60460,54233,40952,54233,allow,70,70,0,2,8,2,0
25050,55380,53,36013,53,allow,289,97,192,4,45,2,2
25051,50671,443,30836,443,allow,5409,1834,3575,25,17,12,13
25052,49814,53,29277,53,allow,181,94,87,2,30,1,1
25053,42336,443,36600,443,allow,4181,998,3183,14,26,7,7
25054,65152,53,13983,53,allow,167,86,81,2,30,1,1
25055,51999,34619,53326,34619,allow,70,70,0,1,5,1,0
25056,53864,443,51683,443,allow,232,172,60,3,5,2,1
25057,65449,53,42820,53,allow,723,102,621,2,30,1,1
25058,57802,443,19538,443,allow,37181,32491,4690,93,81,54,39
25059,54136,443,48147,443,allow,18716,8002,10714,100,945,51,49
25060,55830,53,32937,53,allow,183,94,89,2,30,1,1
25061,55651,53,20940,53,allow,199,102,97,2,30,1,1
25062,65057,53,5504,53,allow,199,102,97,2,30,1,1
25063,55262,53,4967,53,allow,193,102,91,2,30,1,1
25064,64905,53,62456,53,allow,283,102,181,2,30,1,1
25065,56273,53,10176,53,allow,200,102,98,2,30,1,1
25066,56006,53,56453,53,allow,200,102,98,2,30,1,1
25067,55932,53,42862,53,allow,193,102,91,2,30,1,1
25068,27005,27015,8730,27015,allow,913,126,787,2,30,1,1
25069,56365,53,6321,53,allow,199,102,97,2,30,1,1
25070,62415,53,36183,53,allow,86,86,0,1,30,1,0
25071,27005,27015,31472,27015,allow,888,126,762,2,30,1,1
25072,63951,55255,6079,55255,allow,1277,856,421,9,15,6,3
25073,52426,443,20298,443,allow,8760,1218,7542,25,15,14,11
25074,65245,53,59048,53,allow,193,102,91,2,30,1,1
25075,49429,53,55360,53,allow,194,102,92,2,30,1,1
25076,55169,53,40051,53,allow,199,102,97,2,30,1,1
25077,63084,53,54059,53,allow,86,86,0,1,30,1,0
25078,54966,443,5878,443,allow,4645,2498,2147,14,135,7,7
25079,36109,443,56907,443,allow,26538,7971,18567,70,128,38,32
25080,50614,80,59659,80,allow,318,192,126,6,25,4,2
25081,52005,33191,35955,33191,allow,70,70,0,1,5,1,0
25082,64338,53,13922,53,allow,298,102,196,4,43,2,2
25083,64544,53,63880,53,allow,199,94,105,2,30,1,1
25084,50161,53,38218,53,allow,165,86,79,2,30,1,1
25085,27005,27001,28367,27001,allow,883,126,757,2,30,1,1
25086,64537,53,37078,53,allow,168,86,82,2,30,1,1
25087,64959,53,12491,53,allow,209,110,99,2,30,1,1
25088,53394,53,24735,53,allow,86,86,0,1,30,1,0
25089,57203,53,26707,53,allow,199,102,97,2,30,1,1
25090,58851,443,38942,443,allow,5166,700,4466,16,15,7,9
25091,52024,47600,56931,47600,allow,70,70,0,2,8,2,0
25092,45458,80,54981,80,allow,138,78,60,2,5,1,1
25093,52000,10491,1794,10491,allow,70,70,0,1,5,1,0
25094,62059,443,14919,443,allow,11903,6327,5576,48,15,27,21
25095,55243,443,31338,443,allow,36501,26194,10307,76,71,47,29
25096,53808,56215,39390,56215,allow,70,70,0,2,7,2,0
25097,41925,443,48625,443,allow,8333,2153,6180,31,100,18,13
25098,61552,443,61552,443,allow,38146,3555,34591,57,16,28,29
25099,53814,6725,2877,6725,allow,70,70,0,2,7,2,0
25100,53815,17290,63882,17290,allow,70,70,0,2,7,2,0
25101,51037,80,32981,80,allow,134,60,74,3,4,2,1
25102,52101,443,43263,443,allow,22696,18094,4602,41,315,25,16
25103,65060,53,21160,53,allow,324,97,227,4,52,2,2
25104,39224,53,62138,53,allow,168,78,90,2,29,1,1
25105,60989,443,11071,443,allow,7592,2966,4626,26,15,15,11
25106,56474,53,9698,53,allow,209,110,99,2,29,1,1
25107,58848,443,1963,443,allow,5168,700,4468,16,15,7,9
25108,64943,53,17729,53,allow,341,110,231,2,29,1,1
25109,48458,53,36064,53,allow,289,86,203,2,29,1,1
25110,55362,53,21893,53,allow,195,102,93,2,29,1,1
25111,49317,53,28300,53,allow,194,102,92,2,29,1,1
25112,50137,53,58176,53,allow,183,94,89,2,29,1,1
25113,57838,53,1470,53,allow,70,70,0,1,29,1,0
25114,60548,53,24812,53,allow,199,94,105,2,29,1,1
25115,8283,45858,25688,45858,allow,130,70,60,2,30,1,1
25116,56273,53,30021,53,allow,200,102,98,2,30,1,1
25117,58536,53,15925,53,allow,177,86,91,2,30,1,1
25118,55362,53,39798,53,allow,195,102,93,2,30,1,1
25119,50558,53,44600,53,allow,733,94,639,2,30,1,1
25120,64595,53,8174,53,allow,305,94,211,4,60,2,2
25121,56697,53,1249,53,allow,198,102,96,2,30,1,1
25122,49885,53,38127,53,allow,377,94,283,2,30,1,1
25123,55169,53,58327,53,allow,199,102,97,2,30,1,1
25124,50151,53,17420,53,allow,152,78,74,2,30,1,1
25125,50151,53,44129,53,allow,168,94,74,2,30,1,1
25126,26900,27017,34324,27017,allow,422,164,258,6,30,3,3
25127,27005,27016,31550,27016,allow,884,126,758,2,30,1,1
25128,57867,27019,40046,27019,allow,2338,634,1704,10,30,6,4
25129,56492,53,1811,53,allow,94,94,0,1,30,1,0
25130,57860,443,46825,443,allow,1786,172,1614,7,120,3,4
25131,55831,53,9463,53,allow,183,94,89,2,30,1,1
25132,38288,443,40759,443,allow,8627,2906,5721,10,121,4,6
25133,57025,53,16250,53,allow,168,86,82,2,30,1,1
25134,26900,27017,12136,27017,allow,422,164,258,6,30,3,3
25135,64519,53,39794,53,allow,277,94,183,4,60,2,2
25136,65313,53,7915,53,allow,166,86,80,2,30,1,1
25137,49898,53,22442,53,allow,184,94,90,2,30,1,1
25138,55752,53,44697,53,allow,200,102,98,2,30,1,1
25139,64723,53,38339,53,allow,165,86,79,2,30,1,1
25140,55752,53,6985,53,allow,200,102,98,2,30,1,1
25141,64575,53,5183,53,allow,182,102,80,2,31,1,1
25142,65019,53,29209,53,allow,195,102,93,2,31,1,1
25143,49416,53,31346,53,allow,177,94,83,2,31,1,1
25144,56934,53,21277,53,allow,216,110,106,2,31,1,1
25145,65219,53,20854,53,allow,197,102,95,2,31,1,1
25146,49314,443,60912,443,allow,8599,4862,3737,47,195,26,21
25147,43603,443,42478,443,allow,8420,2986,5434,23,138,13,10
25148,34960,443,6692,443,allow,7029,2223,4806,23,361,12,11
25149,56500,53,23471,53,allow,199,102,97,2,30,1,1
25150,55170,53,27773,53,allow,250,94,156,2,30,1,1
25151,57258,53,22772,53,allow,821,102,719,2,30,1,1
25152,53262,443,5546,443,allow,242149,7606,234543,260,150,92,168
25153,62058,443,34202,443,allow,8666,2933,5733,46,15,27,19
25154,63979,49547,9568,49547,allow,312,132,180,6,6,3,3
25155,42337,443,16716,443,allow,4181,998,3183,14,26,7,7
25156,49402,443,59952,443,allow,7965,4044,3921,63,464,30,33
25157,55200,53,19754,53,allow,209,110,99,2,30,1,1
25158,65057,53,53489,53,allow,199,102,97,2,30,1,1
25159,49689,53,60193,53,allow,812,110,702,2,30,1,1
25160,55262,53,22053,53,allow,193,102,91,2,30,1,1
25161,64261,53,48738,53,allow,295,110,185,2,30,1,1
25162,65101,53,61768,53,allow,402,118,284,2,30,1,1
25163,27005,27015,15666,27015,allow,876,126,750,2,30,1,1
25164,58101,53,38765,53,allow,86,86,0,1,30,1,0
25165,52142,443,7937,443,allow,9911,2041,7870,34,120,17,17
25166,64054,53,33800,53,allow,183,94,89,2,31,1,1
25167,53261,443,39643,443,allow,96485,4565,91920,119,150,45,74
25168,64513,53,5790,53,allow,336,93,243,4,33,2,2
25169,52004,55711,7662,55711,allow,70,70,0,1,5,1,0
25170,3155,23,3155,23,allow,66,66,0,1,5,1,0
25171,42338,443,46950,443,allow,4181,998,3183,14,26,7,7
25172,50633,80,7997,80,allow,1717,1247,470,9,15,5,4
25173,56673,53,13282,53,allow,183,94,89,2,30,1,1
25174,49173,53,27694,53,allow,214,110,104,2,30,1,1
25175,65112,53,26607,53,allow,209,110,99,2,30,1,1
25176,49610,53,38769,53,allow,754,94,660,2,30,1,1
25177,27005,27015,24386,27015,allow,882,126,756,3,31,2,1
25178,49227,53,61588,53,allow,179,94,85,2,30,1,1
25179,26900,27017,45404,27017,allow,422,164,258,6,30,3,3
25180,42341,443,25797,443,allow,276,70,206,5,26,2,3
25181,52425,443,43475,443,allow,8454,978,7476,20,15,10,10
25182,56459,53,20811,53,allow,209,110,99,2,30,1,1
25183,50100,53,17377,53,allow,734,94,640,2,30,1,1
25184,56006,53,30347,53,allow,200,102,98,2,30,1,1
25185,64440,53,9584,53,allow,270,110,160,2,30,1,1
25186,26900,27017,22133,27017,allow,422,164,258,6,30,3,3
25187,50161,53,40110,53,allow,173,94,79,2,30,1,1
25188,49687,53,40743,53,allow,184,102,82,2,30,1,1
25189,65323,53,20486,53,allow,193,102,91,2,30,1,1
25190,64586,53,21236,53,allow,173,94,79,2,30,1,1
25191,57190,53,17320,53,allow,757,102,655,2,30,1,1
25192,48864,123,32657,123,allow,184,94,90,2,30,1,1
25193,56500,53,60506,53,allow,199,102,97,2,30,1,1
25194,49687,53,9331,53,allow,184,102,82,2,30,1,1
25195,55831,53,4843,53,allow,183,94,89,2,30,1,1
25196,56447,53,39784,53,allow,403,110,293,2,30,1,1
25197,26900,27017,18578,27017,allow,422,164,258,6,30,3,3
25198,64959,53,12342,53,allow,209,110,99,2,30,1,1
25199,64330,53,5975,53,allow,193,102,91,2,30,1,1
25200,64054,53,34990,53,allow,183,94,89,2,30,1,1
25201,64586,53,2228,53,allow,173,94,79,2,30,1,1
25202,49365,53,34232,53,allow,199,94,105,2,31,1,1
25203,59191,443,56618,443,allow,4489,2046,2443,23,121,11,12
25204,123,123,23599,123,allow,184,94,90,2,30,1,1
25205,57258,53,32914,53,allow,198,102,96,2,30,1,1
25206,56170,53,19497,53,allow,198,102,96,2,30,1,1
25207,56787,53,40108,53,allow,209,110,99,2,30,1,1
25208,56328,53,20002,53,allow,214,102,112,2,31,1,1
25209,65328,53,29572,53,allow,182,102,80,2,31,1,1
25210,49163,53,27365,53,allow,167,86,81,2,31,1,1
25211,57470,29137,36773,29137,allow,1386,1386,0,22,1610,22,0
25212,15986,8000,55980,8000,allow,274,150,124,4,60,2,2
25213,46531,53,8725,53,allow,209,86,123,2,30,1,1
25214,55849,53,54594,53,allow,195,102,93,2,30,1,1
25215,57647,53,15724,53,allow,265,78,187,2,30,1,1
25216,56697,53,34605,53,allow,198,102,96,2,30,1,1
25217,26900,27017,41768,27017,allow,422,164,258,6,30,3,3
25218,65384,53,4009,53,allow,443,182,261,6,30,3,3
25219,26900,27017,50857,27017,allow,254,82,172,4,30,2,2
25220,64519,53,52190,53,allow,184,94,90,2,30,1,1
25221,49416,53,16616,53,allow,185,102,83,2,30,1,1
25222,49163,53,4379,53,allow,167,86,81,2,30,1,1
25223,56787,53,13426,53,allow,209,110,99,2,30,1,1
25224,65398,53,64225,53,allow,214,110,104,2,30,1,1
25225,49503,53,8833,53,allow,167,86,81,2,30,1,1
25226,55371,53,41494,53,allow,168,86,82,2,30,1,1
25227,64723,53,29424,53,allow,165,86,79,2,31,1,1
25228,49218,53,12399,53,allow,195,102,93,2,31,1,1
25229,49722,53,40518,53,allow,200,102,98,2,31,1,1
25230,49227,53,18246,53,allow,179,94,85,2,31,1,1
25231,64316,53,46275,53,allow,184,94,90,2,31,1,1
25232,65112,53,6227,53,allow,209,110,99,2,31,1,1
25233,52929,443,26411,443,allow,8623,4829,3794,44,195,22,22
25234,50307,443,61889,443,allow,1786,172,1614,7,120,3,4
25235,33912,443,41888,443,allow,6288,3354,2934,9,122,5,4
25236,45558,443,51093,443,allow,6450,1003,5447,21,360,11,10
25237,38169,443,2048,443,allow,7841,2301,5540,18,135,8,10
25238,55070,53,47871,53,allow,195,102,93,2,31,1,1
25239,52233,80,14705,80,allow,1674,708,966,18,392,6,12
25240,49160,52011,11430,52011,allow,800,150,650,4,1200,2,2
25241,63381,443,50807,443,allow,11344,5681,5663,34,3601,20,14
25242,37965,8272,8707,8272,allow,1577,594,983,20,1740,10,10
25243,57470,56098,25356,56098,allow,1359,726,633,6,1199,3,3
25244,54342,80,39601,80,allow,1515,481,1034,11,16,6,5
25245,56006,53,22097,53,allow,200,102,98,2,30,1,1
25246,56695,53,2838,53,allow,183,94,89,2,30,1,1
25247,55362,53,23060,53,allow,374,97,277,4,32,2,2
25248,53807,28630,53835,28630,allow,70,70,0,2,8,2,0
25249,64614,53,5990,53,allow,517,179,338,6,62,3,3
25250,34720,443,52073,443,allow,6453,2318,4135,32,84,16,16
25251,56492,53,62080,53,allow,184,94,90,2,30,1,1
25252,56500,53,41129,53,allow,199,102,97,2,30,1,1
25253,56170,53,52947,53,allow,198,102,96,2,31,1,1
25254,65366,53,44706,53,allow,458,188,270,6,31,3,3
25255,49667,53,30486,53,allow,759,102,657,2,31,1,1
25256,64330,53,52470,53,allow,193,102,91,2,31,1,1
25257,50278,53,13442,53,allow,196,102,94,2,31,1,1
25258,58857,443,13362,443,allow,3439647,103607,3336040,3670,452,1291,2379
25259,45897,443,62629,443,allow,2267946,70852,2197094,2429,316,859,1570
25260,50731,27029,22129,27029,allow,269,78,191,2,31,1,1
25261,50728,27029,42888,27029,allow,269,78,191,2,31,1,1
25262,53806,37267,15309,37267,allow,70,70,0,2,8,2,0
25263,49925,80,18933,80,allow,12290,10150,2140,37,256,19,18
25264,46002,443,21932,443,allow,6299,1424,4875,27,291,10,17
25265,64054,53,41905,53,allow,1299,387,912,10,103,5,5
25266,3478,61463,0,0,deny,1053,1053,0,1,0,1,0
25267,61366,445,0,0,drop,66,66,0,1,0,1,0
25268,37633,44847,0,0,deny,62,62,0,1,0,1,0
25269,49594,445,0,0,drop,70,70,0,1,0,1,0
25270,57339,57470,0,0,deny,66,66,0,1,0,1,0
25271,52114,64147,0,0,deny,62,62,0,1,0,1,0
25272,80,9918,0,0,deny,60,60,0,1,0,1,0
25273,61135,445,0,0,drop,70,70,0,1,0,1,0
25274,63079,64147,0,0,deny,62,62,0,1,0,1,0
25275,61363,445,0,0,drop,66,66,0,1,0,1,0
25276,3478,61463,0,0,deny,164,164,0,1,0,1,0
25277,46491,50584,0,0,deny,66,66,0,1,0,1,0
25278,3478,61463,0,0,deny,743,743,0,1,0,1,0
25279,60297,25604,0,0,deny,62,62,0,1,0,1,0
25280,8889,42210,0,0,deny,60,60,0,1,0,1,0
25281,61355,445,0,0,drop,66,66,0,1,0,1,0
25282,15854,50584,0,0,deny,146,146,0,1,0,1,0
25283,61128,445,0,0,drop,70,70,0,1,0,1,0
25284,61127,445,0,0,drop,70,70,0,1,0,1,0
25285,61349,445,0,0,drop,66,66,0,1,0,1,0
25286,2717,31573,0,0,deny,66,66,0,1,0,1,0
25287,12550,37807,0,0,deny,62,62,0,1,0,1,0
25288,3478,61463,0,0,deny,180,180,0,1,0,1,0
25289,3478,61463,0,0,deny,1267,1267,0,1,0,1,0
25290,15688,56919,0,0,deny,146,146,0,1,0,1,0
25291,61122,445,0,0,drop,70,70,0,1,0,1,0
25292,61120,445,0,0,drop,70,70,0,1,0,1,0
25293,6881,1707,0,0,deny,146,146,0,1,0,1,0
25294,3478,61463,0,0,deny,68,68,0,1,0,1,0
25295,3478,61463,0,0,deny,1188,1188,0,1,0,1,0
25296,57825,13014,0,0,deny,74,74,0,1,0,1,0
25297,3478,61463,0,0,deny,252,252,0,1,0,1,0
25298,3478,61463,0,0,deny,1273,1273,0,1,0,1,0
25299,3478,61463,0,0,deny,156,156,0,1,0,1,0
25300,49576,445,0,0,drop,70,70,0,1,0,1,0
25301,49578,445,0,0,drop,70,70,0,1,0,1,0
25302,49577,445,0,0,drop,70,70,0,1,0,1,0
25303,61334,445,0,0,drop,66,66,0,1,0,1,0
25304,61340,445,0,0,drop,66,66,0,1,0,1,0
25305,61341,445,0,0,drop,66,66,0,1,0,1,0
25306,61337,445,0,0,drop,66,66,0,1,0,1,0
25307,61339,445,0,0,drop,66,66,0,1,0,1,0
25308,61335,445,0,0,drop,66,66,0,1,0,1,0
25309,61336,445,0,0,drop,66,66,0,1,0,1,0
25310,61333,445,0,0,drop,66,66,0,1,0,1,0
25311,18091,32480,0,0,deny,66,66,0,1,0,1,0
25312,61116,445,0,0,drop,70,70,0,1,0,1,0
25313,24606,55783,0,0,deny,72,72,0,1,0,1,0
25314,61115,445,0,0,drop,70,70,0,1,0,1,0
25315,25961,55783,0,0,deny,66,66,0,1,0,1,0
25316,51705,22114,0,0,deny,66,66,0,1,0,1,0
25317,45981,51505,0,0,deny,62,62,0,1,0,1,0
25318,993,54748,0,0,deny,66,66,0,1,0,1,0
25319,23798,23,0,0,deny,60,60,0,1,0,1,0
25320,3478,61463,0,0,deny,935,935,0,1,0,1,0
25321,62709,57470,0,0,deny,62,62,0,1,0,1,0
25322,49575,445,0,0,drop,70,70,0,1,0,1,0
25323,49568,445,0,0,drop,70,70,0,1,0,1,0
25324,49565,445,0,0,drop,70,70,0,1,0,1,0
25325,49566,445,0,0,drop,70,70,0,1,0,1,0
25326,29080,50265,0,0,deny,62,62,0,1,0,1,0
25327,61110,445,0,0,drop,70,70,0,1,0,1,0
25328,34932,38608,0,0,deny,62,62,0,1,0,1,0
25329,61319,445,0,0,drop,66,66,0,1,0,1,0
25330,61321,445,0,0,drop,66,66,0,1,0,1,0
25331,61318,445,0,0,drop,66,66,0,1,0,1,0
25332,3478,61463,0,0,deny,982,982,0,1,0,1,0
25333,49556,445,0,0,drop,70,70,0,1,0,1,0
25334,51999,37965,0,0,deny,62,62,0,1,0,1,0
25335,58914,37965,0,0,deny,66,66,0,1,0,1,0
25336,49555,445,0,0,drop,70,70,0,1,0,1,0
25337,49550,445,0,0,drop,70,70,0,1,0,1,0
25338,49547,445,0,0,drop,70,70,0,1,0,1,0
25339,3478,61463,0,0,deny,902,902,0,1,0,1,0
25340,41648,56205,0,0,deny,66,66,0,1,0,1,0
25341,64626,50584,0,0,deny,62,62,0,1,0,1,0
25342,51064,5529,0,0,deny,146,146,0,1,0,1,0
25343,59618,46824,0,0,deny,66,66,0,1,0,1,0
25344,61097,445,0,0,drop,70,70,0,1,0,1,0
25345,51948,17372,0,0,deny,62,62,0,1,0,1,0
25346,20864,51221,0,0,deny,62,62,0,1,0,1,0
25347,3478,61463,0,0,deny,164,164,0,1,0,1,0
25348,3478,61463,0,0,deny,1118,1118,0,1,0,1,0
25349,61094,445,0,0,drop,70,70,0,1,0,1,0
25350,63345,53,0,0,deny,75,75,0,1,0,1,0
25351,26469,26348,0,0,deny,66,66,0,1,0,1,0
25352,49536,445,0,0,drop,70,70,0,1,0,1,0
25353,49534,445,0,0,drop,70,70,0,1,0,1,0
25354,49533,445,0,0,drop,70,70,0,1,0,1,0
25355,60438,17372,0,0,deny,66,66,0,1,0,1,0
25356,50570,57470,0,0,deny,66,66,0,1,0,1,0
25357,54621,26296,0,0,deny,145,145,0,1,0,1,0
25358,30580,50265,0,0,deny,62,62,0,1,0,1,0
25359,3478,61463,0,0,deny,159,159,0,1,0,1,0
25360,3478,61463,0,0,deny,1306,1306,0,1,0,1,0
25361,61088,445,0,0,drop,70,70,0,1,0,1,0
25362,38592,57209,0,0,deny,62,62,0,1,0,1,0
25363,61087,445,0,0,drop,70,70,0,1,0,1,0
25364,12965,37965,0,0,deny,66,66,0,1,0,1,0
25365,61085,445,0,0,drop,70,70,0,1,0,1,0
25366,49203,51050,0,0,deny,62,62,0,1,0,1,0
25367,3478,61463,0,0,deny,1188,1188,0,1,0,1,0
25368,3478,61463,0,0,deny,967,967,0,1,0,1,0
25369,49529,445,0,0,drop,70,70,0,1,0,1,0
25370,49523,445,0,0,drop,70,70,0,1,0,1,0
25371,24504,37965,0,0,deny,62,62,0,1,0,1,0
25372,60761,51221,0,0,deny,62,62,0,1,0,1,0
25373,58687,11392,0,0,deny,62,62,0,1,0,1,0
25374,9588,37965,0,0,deny,66,66,0,1,0,1,0
25375,61294,445,0,0,drop,66,66,0,1,0,1,0
25376,61293,445,0,0,drop,66,66,0,1,0,1,0
25377,61078,445,0,0,drop,70,70,0,1,0,1,0
25378,3478,61463,0,0,deny,179,179,0,1,0,1,0
25379,3478,61463,0,0,deny,1275,1275,0,1,0,1,0
25380,0,0,0,0,deny,210,210,0,3,0,3,0
25381,61076,445,0,0,drop,70,70,0,1,0,1,0
25382,45304,64147,0,0,deny,72,72,0,1,0,1,0
25383,37455,50584,0,0,deny,66,66,0,1,0,1,0
25384,49520,445,0,0,drop,70,70,0,1,0,1,0
25385,49516,445,0,0,drop,70,70,0,1,0,1,0
25386,49508,445,0,0,drop,70,70,0,1,0,1,0
25387,49511,445,0,0,drop,70,70,0,1,0,1,0
25388,42429,22114,0,0,deny,62,62,0,1,0,1,0
25389,61075,445,0,0,drop,70,70,0,1,0,1,0
25390,61074,445,0,0,drop,70,70,0,1,0,1,0
25391,61073,445,0,0,drop,70,70,0,1,0,1,0
25392,61287,445,0,0,drop,66,66,0,1,0,1,0
25393,61069,445,0,0,drop,70,70,0,1,0,1,0
25394,61068,445,0,0,drop,70,70,0,1,0,1,0
25395,3478,61463,0,0,deny,400,400,0,1,0,1,0
25396,3478,61463,0,0,deny,1290,1290,0,1,0,1,0
25397,25497,44847,0,0,deny,62,62,0,1,0,1,0
25398,61282,445,0,0,drop,66,66,0,1,0,1,0
25399,61280,445,0,0,drop,66,66,0,1,0,1,0
25400,61281,445,0,0,drop,66,66,0,1,0,1,0
25401,61279,445,0,0,drop,66,66,0,1,0,1,0
25402,61271,445,0,0,drop,66,66,0,1,0,1,0
25403,61275,445,0,0,drop,66,66,0,1,0,1,0
25404,61276,445,0,0,drop,66,66,0,1,0,1,0
25405,49505,445,0,0,drop,70,70,0,1,0,1,0
25406,61055,445,0,0,drop,70,70,0,1,0,1,0
25407,61054,445,0,0,drop,70,70,0,1,0,1,0
25408,44117,6881,0,0,deny,62,62,0,1,0,1,0
25409,61051,445,0,0,drop,70,70,0,1,0,1,0
25410,49501,445,0,0,drop,70,70,0,1,0,1,0
25411,49497,445,0,0,drop,70,70,0,1,0,1,0
25412,49499,445,0,0,drop,70,70,0,1,0,1,0
25413,61044,445,0,0,drop,70,70,0,1,0,1,0
25414,61045,445,0,0,drop,70,70,0,1,0,1,0
25415,3478,61463,0,0,deny,217,217,0,1,0,1,0
25416,3478,61463,0,0,deny,1305,1305,0,1,0,1,0
25417,52348,62413,0,0,deny,66,66,0,1,0,1,0
25418,1027,57866,0,0,deny,146,146,0,1,0,1,0
25419,27773,56205,0,0,deny,62,62,0,1,0,1,0
25420,62273,50584,0,0,deny,66,66,0,1,0,1,0
25421,50757,64147,0,0,deny,66,66,0,1,0,1,0
25422,1030,64147,0,0,deny,62,62,0,1,0,1,0
25423,3478,61463,0,0,deny,1188,1188,0,1,0,1,0
25424,57090,51505,0,0,deny,66,66,0,1,0,1,0
25425,56255,44847,0,0,deny,62,62,0,1,0,1,0
25426,49277,51505,0,0,deny,66,66,0,1,0,1,0
25427,3478,61463,0,0,deny,328,328,0,1,0,1,0
25428,3478,61463,0,0,deny,1162,1162,0,1,0,1,0
25429,3478,61463,0,0,deny,1162,1162,0,1,0,1,0
25430,44117,6881,0,0,deny,146,146,0,1,0,1,0
25431,3478,61463,0,0,deny,1302,1302,0,1,0,1,0
25432,5223,59023,0,0,deny,66,66,0,1,0,1,0
25433,49496,445,0,0,drop,70,70,0,1,0,1,0
25434,49494,445,0,0,drop,70,70,0,1,0,1,0
25435,49493,445,0,0,drop,70,70,0,1,0,1,0
25436,61033,445,0,0,drop,70,70,0,1,0,1,0
25437,61264,445,0,0,drop,66,66,0,1,0,1,0
25438,58839,443,29041,443,allow,6270,4231,2039,22,16,11,11
25439,35080,80,13868,80,allow,71843,2833,69010,83,16,36,47
25440,50116,22,50116,22,allow,60,60,0,1,5,1,0
25441,60903,443,60903,443,allow,3672,2294,1378,23,17,13,10
25442,56953,443,23008,443,allow,66324,17448,48876,86,331,39,47
25443,123,123,34455,123,allow,184,94,90,2,30,1,1
25444,54458,443,1235,443,allow,3885,2355,1530,26,270,13,13
25445,56695,53,39577,53,allow,93,93,0,1,30,1,0
25446,60244,80,21449,80,allow,1114,534,580,12,16,7,5
25447,49722,53,48716,53,allow,200,102,98,2,30,1,1
25448,61502,443,14539,443,allow,580643,7944,572699,475,41,86,389
25449,6580,443,39397,443,allow,2227,1018,1209,17,16,8,9
25450,55285,53,1660,53,allow,268,95,173,4,45,2,2
25451,37638,443,24895,443,allow,8134,2717,5417,24,16,15,9
25452,65019,53,42326,53,allow,190,97,93,2,31,1,1
25453,49227,53,39429,53,allow,174,89,85,2,30,1,1
25454,51415,443,38416,443,allow,9284,2172,7112,39,83,19,20
25455,56492,53,6474,53,allow,184,94,90,2,30,1,1
25456,64316,53,59418,53,allow,184,94,90,2,31,1,1
25457,55830,53,59149,53,allow,164,84,80,2,31,1,1
25458,57208,53,63369,53,allow,182,93,89,2,31,1,1
25459,56636,53,8907,53,allow,168,86,82,2,30,1,1
25460,64519,53,20237,53,allow,277,94,183,4,60,2,2
25461,56992,80,9421,80,allow,214,140,74,4,35,3,1
25462,55098,53,22759,53,allow,474,200,274,6,44,3,3
25463,53586,443,61806,443,allow,8510,3207,5303,25,324,13,12
25464,57204,443,59109,443,allow,35981,14676,21305,63,320,31,32
25465,26979,443,43734,443,allow,7343,2586,4757,23,19,11,12
25466,58639,443,58639,443,allow,4380,1473,2907,19,30,11,8
25467,36144,443,59381,443,allow,8859,1662,7197,26,75,14,12
25468,58836,443,51260,443,allow,12230,8144,4086,33,17,18,15
25469,443,10120,443,10120,allow,64,64,0,1,5,1,0
25470,49285,6881,35710,6881,allow,411,225,186,6,16,3,3
25471,26900,27017,37191,27017,allow,422,164,258,6,30,3,3
25472,56320,53,27969,53,allow,761,100,661,2,30,1,1
25473,55616,53,41127,53,allow,776,102,674,2,30,1,1
25474,49582,80,30882,80,allow,454222,9730,444492,425,155,119,306
25475,49390,53,24759,53,allow,204,104,100,2,31,1,1
25476,39914,443,20492,443,allow,26779179,169104,26610075,19911,91,1968,17943
25477,27005,23333,41916,23333,allow,890,126,764,3,32,2,1
25478,63965,11785,23827,11785,allow,66,66,0,2,8,2,0
25479,53803,17637,1467,17637,allow,70,70,0,2,8,2,0
25480,58837,443,12859,443,allow,13120,8597,4523,34,17,18,16
25481,55979,53,36976,53,allow,186,95,91,2,31,1,1
25482,58673,443,29883,443,allow,11116,2910,8206,30,20,16,14
25483,56994,80,47420,80,allow,214,140,74,4,35,3,1
25484,54497,443,36894,443,allow,10017,2436,7581,22,138,10,12
25485,26900,27017,24961,27017,allow,168,82,86,2,30,1,1
25486,56993,80,53078,80,allow,214,140,74,4,35,3,1
25487,49284,6881,63605,6881,allow,411,225,186,6,16,3,3
25488,55932,53,3397,53,allow,186,95,91,2,30,1,1
25489,61501,443,38275,443,allow,633920,7867,626053,505,41,81,424
25490,50154,53,53091,53,allow,756,95,661,2,30,1,1
25491,51449,443,58007,443,allow,9602,3315,6287,25,37,15,10
25492,55539,53,7321,53,allow,814,110,704,2,30,1,1
25493,55083,53,43737,53,allow,751,95,656,2,30,1,1
25494,56170,53,28854,53,allow,196,100,96,2,30,1,1
25495,51452,443,6945,443,allow,7674,2829,4845,23,31,14,9
25496,55154,53,45659,53,allow,184,94,90,2,30,1,1
25497,65398,53,61803,53,allow,212,108,104,2,30,1,1
25498,65384,53,45912,53,allow,735,88,647,2,31,1,1
25499,56658,53,11385,53,allow,186,95,91,2,31,1,1
25500,49205,53,38111,53,allow,188,96,92,2,31,1,1
25501,56226,53,58477,53,allow,780,104,676,2,31,1,1
25502,37316,443,11978,443,allow,19840,6479,13361,57,127,32,25
25503,56603,53,25992,53,allow,1400,97,1303,4,57,2,2
25504,51204,443,55515,443,allow,37173,3712,33461,54,74,24,30
25505,49163,53,24237,53,allow,166,85,81,2,30,1,1
25506,49218,53,62258,53,allow,190,97,93,2,31,1,1
25507,56723,53,2628,53,allow,733,85,648,2,31,1,1
25508,57241,53,11880,53,allow,760,97,663,2,31,1,1
25509,16387,57833,0,0,allow,60,60,0,1,60,1,0
25510,57366,53,63370,53,allow,745,93,652,2,31,1,1
25511,57398,53,10527,53,allow,770,102,668,2,31,1,1
25512,57049,53,52014,53,allow,755,93,662,2,31,1,1
25513,49354,53,30111,53,allow,192,98,94,2,31,1,1
25514,56362,53,49796,53,allow,190,97,93,2,31,1,1
25515,64380,53,29472,53,allow,186,95,91,2,31,1,1
25516,55070,53,2161,53,allow,190,97,93,2,31,1,1
25517,64089,53,25036,53,allow,188,96,92,2,31,1,1
25518,49754,53,54663,53,allow,176,90,86,2,31,1,1
25519,56344,53,27123,53,allow,198,101,97,2,31,1,1
25520,64631,53,41468,53,allow,186,95,91,2,31,1,1
25521,49293,53,58522,53,allow,172,88,84,2,31,1,1
25522,56457,53,47112,53,allow,731,91,640,2,31,1,1
25523,55919,53,57611,53,allow,754,94,660,2,31,1,1
25524,64573,53,7328,53,allow,184,94,90,2,31,1,1
25525,64326,53,28923,53,allow,192,98,94,2,31,1,1
25526,56318,53,8880,53,allow,182,93,89,2,31,1,1
25527,3175,60038,0,0,allow,66,66,0,1,91,1,0
25528,60074,443,12733,443,allow,3465,818,2647,11,122,5,6
25529,55356,53,43051,53,allow,756,95,661,2,31,1,1
25530,58380,80,42000,80,allow,3130,2290,840,15,135,8,7
25531,55976,53,37566,53,allow,758,96,662,2,31,1,1
25532,65096,443,53521,443,allow,2414,639,1775,9,121,5,4
25533,32921,443,5993,443,allow,7578,2270,5308,17,123,8,9
25534,37635,443,51413,443,allow,4883,1327,3556,18,135,9,9
25535,55646,53,39790,53,allow,760,97,663,2,31,1,1
25536,57355,443,34540,443,allow,16483,8545,7938,40,281,21,19
25537,56816,53,44842,53,allow,754,94,660,2,31,1,1
25538,55463,53,53091,53,allow,216,110,106,2,31,1,1
25539,55411,53,60848,53,allow,182,93,89,2,31,1,1
25540,56930,53,53703,53,allow,774,101,673,2,31,1,1
25541,60893,443,56200,443,allow,4252,1594,2658,13,135,6,7
25542,43461,35440,0,0,deny,62,62,0,1,0,1,0
25543,49488,445,0,0,drop,70,70,0,1,0,1,0
25544,61261,445,0,0,drop,66,66,0,1,0,1,0
25545,61258,445,0,0,drop,66,66,0,1,0,1,0
25546,61259,445,0,0,drop,66,66,0,1,0,1,0
25547,3478,61463,0,0,deny,686,686,0,1,0,1,0
25548,53337,1433,0,0,deny,60,60,0,1,0,1,0
25549,22094,23,0,0,deny,60,60,0,1,0,1,0
25550,61256,445,0,0,drop,66,66,0,1,0,1,0
25551,45964,55559,0,0,deny,60,60,0,1,0,1,0
25552,61029,445,0,0,drop,70,70,0,1,0,1,0
25553,49480,445,0,0,drop,70,70,0,1,0,1,0
25554,55979,53,33606,53,allow,193,102,91,2,30,1,1
25555,58994,443,40125,443,allow,4989,1014,3975,16,27,9,7
25556,60981,443,40562,443,allow,22449,19500,2949,53,21,31,22
25557,60976,443,6084,443,allow,5027222,114898,4912324,4763,109,1375,3388
25558,53670,80,8760,80,allow,950,502,448,12,15,7,5
25559,61332,23,0,0,deny,60,60,0,1,0,1,0
25560,3478,61463,0,0,deny,780,780,0,1,0,1,0
25561,49476,445,0,0,drop,70,70,0,1,0,1,0
25562,49474,445,0,0,drop,70,70,0,1,0,1,0
25563,1912,48817,0,0,deny,62,62,0,1,0,1,0
25564,61020,445,0,0,drop,70,70,0,1,0,1,0
25565,61018,445,0,0,drop,70,70,0,1,0,1,0
25566,61017,445,0,0,drop,70,70,0,1,0,1,0
25567,61016,445,0,0,drop,70,70,0,1,0,1,0
25568,24589,10197,0,0,deny,145,145,0,1,0,1,0
25569,59051,27520,0,0,deny,62,62,0,1,0,1,0
25570,61012,445,0,0,drop,70,70,0,1,0,1,0
25571,61140,27520,0,0,deny,66,66,0,1,0,1,0
25572,56250,36237,0,0,deny,66,66,0,1,0,1,0
25573,51244,1,0,0,deny,100,100,0,1,0,1,0
25574,61246,445,0,0,drop,66,66,0,1,0,1,0
25575,45964,3111,0,0,deny,60,60,0,1,0,1,0
25576,3478,61463,0,0,deny,240,240,0,1,0,1,0
25577,7184,15503,0,0,deny,66,66,0,1,0,1,0
25578,61238,445,0,0,drop,66,66,0,1,0,1,0
25579,49390,1433,0,0,deny,60,60,0,1,0,1,0
25580,49464,445,0,0,drop,70,70,0,1,0,1,0
25581,40742,2967,0,0,deny,62,62,0,1,0,1,0
25582,55012,64147,0,0,deny,66,66,0,1,0,1,0
25583,56658,53,53602,53,allow,193,102,91,2,30,1,1
25584,64575,53,7510,53,allow,182,102,80,2,30,1,1
25585,56327,53,30596,53,allow,199,102,97,2,30,1,1
25586,50589,53,14237,53,allow,786,110,676,2,30,1,1
25587,57344,53,11119,53,allow,969,86,883,2,30,1,1
25588,53799,53,39316,53,allow,213,78,135,2,30,1,1
25589,58858,443,56785,443,allow,7413235,214811,7198424,7869,344,2785,5084
25590,58856,443,36240,443,allow,6350667,198580,6152087,6885,451,2497,4388
25591,45896,443,32975,443,allow,1160457,45088,1115369,1320,315,518,802
25592,40408,443,59569,443,allow,6058,1749,4309,22,201,13,9
25593,35654,80,35654,80,allow,7040,5744,1296,16,158,9,7
25594,49214,58485,53751,58485,allow,70,70,0,2,8,2,0
25595,53805,34155,31252,34155,allow,70,70,0,2,7,2,0
25596,59779,443,59854,443,allow,568,568,0,5,10,5,0
25597,57016,53,13360,53,allow,266,110,156,2,30,1,1
25598,53804,24067,52480,24067,allow,70,70,0,2,7,2,0
25599,50458,443,25872,443,allow,523577,34256,489321,1025,208,473,552
25600,50303,443,52524,443,allow,208,60,148,4,11,2,2
25601,55042,443,45406,443,allow,126,60,66,3,5,2,1
25602,55285,53,22135,53,allow,268,95,173,4,45,2,2
25603,55098,53,38857,53,allow,474,200,274,6,43,3,3
25604,63966,42532,21022,42532,allow,66,66,0,2,7,2,0
25605,35941,443,48738,443,allow,190,70,120,4,18,2,2
25606,53798,62166,11396,62166,allow,258,70,188,4,7,2,2
25607,63954,60430,37652,60430,allow,70,70,0,1,4,1,0
25608,64980,53,40885,53,allow,274,88,186,4,35,2,2
25609,65238,53,61898,53,allow,302,104,198,4,46,2,2
25610,50612,80,47441,80,allow,1559,1107,452,9,24,5,4
25611,26900,27017,1081,27017,allow,422,164,258,6,29,3,3
25612,55932,53,10932,53,allow,193,102,91,2,29,1,1
25613,64537,53,60663,53,allow,168,86,82,2,29,1,1
25614,55371,53,15832,53,allow,184,102,82,2,29,1,1
25615,26900,27017,35787,27017,allow,422,164,258,6,29,3,3
25616,56395,53,34668,53,allow,199,102,97,2,29,1,1
25617,26900,27017,23136,27017,allow,422,164,258,6,29,3,3
25618,26900,27017,19370,27017,allow,422,164,258,6,29,3,3
25619,49811,53,10574,53,allow,763,102,661,2,29,1,1
25620,57203,53,8040,53,allow,199,102,97,2,29,1,1
25621,56450,53,8472,53,allow,168,86,82,2,30,1,1
25622,56395,53,54170,53,allow,199,102,97,2,29,1,1
25623,49390,53,36883,53,allow,210,110,100,2,30,1,1
25624,56636,53,49408,53,allow,168,86,82,2,30,1,1
25625,56151,53,10029,53,allow,194,102,92,2,30,1,1
25626,55727,53,33963,53,allow,335,93,242,4,32,2,2
25627,56245,53,35606,53,allow,200,102,98,2,30,1,1
25628,49835,53,19938,53,allow,194,102,92,2,30,1,1
25629,57299,53,60240,53,allow,338,110,228,2,30,1,1
25630,65019,53,36796,53,allow,195,102,93,2,30,1,1
25631,55849,53,49045,53,allow,195,102,93,2,30,1,1
25632,44211,443,12188,443,allow,6263,1804,4459,21,361,11,10
25633,56170,53,63567,53,allow,198,102,96,2,30,1,1
25634,50727,27029,42555,27029,allow,269,78,191,2,30,1,1
25635,55113,53,62631,53,allow,177,94,83,2,30,1,1
25636,49215,52611,46200,52611,allow,70,70,0,2,8,2,0
25637,58993,443,55872,443,allow,416,210,206,7,26,4,3
25638,55098,53,15101,53,allow,474,200,274,6,43,3,3
25639,56998,80,16426,80,allow,214,140,74,4,35,3,1
25640,60971,443,16884,443,allow,4548,2858,1690,42,111,22,20
25641,56327,53,60019,53,allow,199,102,97,2,30,1,1
25642,57467,443,57467,443,allow,4373,1466,2907,19,27,11,8
25643,55154,53,33060,53,allow,184,94,90,2,30,1,1
25644,58774,443,50443,443,allow,7254,838,6416,27,290,9,18
25645,56958,53,59654,53,allow,816,102,714,2,30,1,1
25646,56995,80,29664,80,allow,214,140,74,4,35,3,1
25647,56198,53,28713,53,allow,184,102,82,2,30,1,1
25648,49372,53,16928,53,allow,210,110,100,2,30,1,1
25649,26900,27017,30170,27017,allow,422,164,258,6,30,3,3
25650,60780,28080,48359,28080,allow,70,70,0,1,5,1,0
25651,64980,53,62800,53,allow,180,94,86,2,30,1,1
25652,56001,53,33036,53,allow,196,94,102,2,30,1,1
25653,58844,443,8325,443,allow,5167,700,4467,16,15,7,9
25654,65328,53,18942,53,allow,166,86,80,2,30,1,1
25655,58771,80,60976,80,allow,3312,1569,1743,12,135,7,5
25656,64330,53,10524,53,allow,193,102,91,2,30,1,1
25657,27005,27015,64723,27015,allow,901,126,775,2,30,1,1
25658,48817,25636,48817,25636,allow,481,150,331,2,1200,1,1
25659,27005,27014,60898,27014,allow,879,126,753,2,30,1,1
25660,27005,4444,13134,4444,allow,881,126,755,2,30,1,1
25661,51166,443,54384,443,allow,13072,4708,8364,47,130,24,23
25662,58847,443,48579,443,allow,5167,700,4467,16,15,7,9
25663,50465,80,51689,80,allow,3688274,86827,3601447,3622,32,1228,2394
25664,49354,53,61914,53,allow,196,102,94,2,30,1,1
25665,56624,53,44653,53,allow,199,102,97,2,30,1,1
25666,56988,53,43201,53,allow,216,110,106,2,30,1,1
25667,49205,53,61916,53,allow,194,102,92,2,30,1,1
25668,55098,53,33176,53,allow,474,200,274,6,44,3,3
25669,60965,443,57735,443,allow,1439,718,721,15,111,8,7
25670,35889,443,19640,443,allow,6982,1728,5254,23,27,13,10
25671,50581,80,61624,80,allow,2573,1859,714,9,47,5,4
25672,58776,443,11042,443,allow,7259,842,6417,27,290,9,18
25673,26900,27017,57594,27017,allow,172,86,86,2,30,1,1
25674,55979,53,60691,53,allow,193,102,91,2,30,1,1
25675,49218,53,40400,53,allow,195,102,93,2,30,1,1
25676,56416,53,14432,53,allow,193,102,91,2,30,1,1
25677,55684,53,56434,53,allow,193,102,91,2,30,1,1
25678,55272,53,55902,53,allow,198,110,88,2,30,1,1
25679,64621,53,62273,53,allow,214,102,112,2,30,1,1
25680,50729,27029,59296,27029,allow,269,78,191,2,30,1,1
25681,55877,1049,50494,1049,allow,323,150,173,2,1200,1,1
25682,49212,38306,32120,38306,allow,70,70,0,2,8,2,0
25683,49502,443,21667,443,allow,26402,2904,23498,56,270,29,27
25684,64894,53,1246,53,allow,550,113,437,4,46,2,2
25685,53799,6881,35241,6881,allow,70,70,0,2,7,2,0
25686,64582,443,48743,443,allow,24686,1935,22751,36,19,17,19
25687,49216,63752,46385,63752,allow,70,70,0,2,8,2,0
25688,56492,53,12334,53,allow,184,94,90,2,29,1,1
25689,37175,53,14480,53,allow,231,86,145,2,29,1,1
25690,26900,27017,14698,27017,allow,422,164,258,6,29,3,3
25691,56450,53,45835,53,allow,184,102,82,2,29,1,1
25692,55932,53,12204,53,allow,193,102,91,2,29,1,1
25693,64687,53,10483,53,allow,183,94,89,2,29,1,1
25694,57002,80,6505,80,allow,214,140,74,4,35,3,1
25695,56245,53,14605,53,allow,200,102,98,2,30,1,1
25696,56997,80,45711,80,allow,214,140,74,4,35,3,1
25697,65307,53,36094,53,allow,811,94,717,2,29,1,1
25698,38131,443,7949,443,allow,85590,4656,80934,111,37,47,64
25699,55712,53,52427,53,allow,164,86,78,2,29,1,1
25700,26900,27017,43852,27017,allow,422,164,258,6,29,3,3
25701,56395,53,56804,53,allow,199,102,97,2,29,1,1
25702,52090,443,53299,443,allow,45583818,387905,45195913,35736,272,5246,30490
25703,26900,27017,8503,27017,allow,422,164,258,6,29,3,3
25704,49503,53,43089,53,allow,167,86,81,2,29,1,1
25705,49722,53,64718,53,allow,200,102,98,2,29,1,1
25706,123,123,48945,123,allow,184,94,90,2,29,1,1
25707,64687,53,9775,53,allow,183,94,89,2,29,1,1
25708,64599,53,10160,53,allow,250,94,156,2,29,1,1
25709,26900,27017,44088,27017,allow,250,164,86,4,30,3,1
25710,26900,27017,55434,27017,allow,422,164,258,6,29,3,3
25711,57437,53,35666,53,allow,193,102,91,2,30,1,1
25712,57208,53,39529,53,allow,183,94,89,2,30,1,1
25713,55154,53,5239,53,allow,184,94,90,2,30,1,1
25714,56344,53,2417,53,allow,199,102,97,2,30,1,1
25715,49205,53,36921,53,allow,194,102,92,2,30,1,1
25716,56245,53,47709,53,allow,200,102,98,2,30,1,1
25717,55154,53,39546,53,allow,184,94,90,2,30,1,1
25718,56344,53,47952,53,allow,199,102,97,2,30,1,1
25719,64089,53,37654,53,allow,194,102,92,2,30,1,1
25720,64573,53,39960,53,allow,184,94,90,2,30,1,1
25721,56067,53,59693,53,allow,294,102,192,2,30,1,1
25722,55463,53,9844,53,allow,216,110,106,2,31,1,1
25723,59008,443,16532,443,allow,10214,2669,7545,30,170,14,16
25724,45898,443,17048,443,allow,814431,31637,782794,913,315,346,567
25725,56004,443,20130,443,allow,53826,3670,50156,85,275,41,44
25726,45900,443,8565,443,allow,1277649,37293,1240356,1337,303,459,878
25727,6881,37321,46991,37321,allow,502,150,352,2,1199,1,1
25728,65398,53,27490,53,allow,214,110,104,2,30,1,1
25729,49429,53,47373,53,allow,194,102,92,2,30,1,1
25730,56624,53,64033,53,allow,199,102,97,2,30,1,1
25731,57208,53,19470,53,allow,183,94,89,2,30,1,1
25732,56988,53,29456,53,allow,216,110,106,2,30,1,1
25733,64631,53,8154,53,allow,193,102,91,2,30,1,1
25734,56362,53,16824,53,allow,195,102,93,2,30,1,1
25735,64380,53,47265,53,allow,193,102,91,2,30,1,1
25736,50730,27029,7986,27029,allow,269,78,191,2,30,1,1
25737,55070,53,21493,53,allow,195,102,93,2,30,1,1
25738,55975,53,27530,53,allow,939,678,261,2,30,1,1
25739,55113,53,22722,53,allow,177,94,83,2,30,1,1
25740,56151,53,18710,53,allow,194,102,92,2,30,1,1
25741,56318,53,32737,53,allow,183,94,89,2,30,1,1
25742,49390,53,56282,53,allow,210,110,100,2,30,1,1
25743,64907,53,21503,53,allow,247,86,161,3,31,2,1
25744,55155,53,52768,53,allow,194,102,92,2,31,1,1
25745,40738,443,14631,443,allow,1656,114,1542,5,120,2,3
25746,55830,53,50350,53,allow,166,86,80,2,30,1,1
25747,56198,53,50578,53,allow,184,102,82,2,30,1,1
25748,49211,15576,51582,15576,allow,70,70,0,2,8,2,0
25749,48157,443,51436,443,allow,7209,2331,4878,20,23,11,9
25750,37624,443,54201,443,allow,471102,14016,457086,503,25,191,312
25751,53131,80,64503,80,allow,2957,619,2338,12,15,6,6
25752,53130,80,42031,80,allow,3683,606,3077,12,15,6,6
25753,55078,443,55078,443,allow,4401,1494,2907,19,30,11,8
25754,53671,80,50539,80,allow,956,502,454,12,15,7,5
25755,37641,443,55231,443,allow,8423,2244,6179,32,15,17,15
25756,56655,80,36577,80,allow,234,234,0,4,12,4,0
25757,64266,53,53096,53,allow,1026,383,643,10,84,5,5
25758,55010,443,19028,443,allow,7651,2261,5390,41,255,21,20
25759,56999,80,32577,80,allow,214,140,74,4,35,3,1
25760,56996,80,27965,80,allow,214,140,74,4,35,3,1
25761,57003,80,40780,80,allow,526,304,222,8,35,5,3
25762,51554,443,48017,443,allow,4263,671,3592,14,75,8,6
25763,57076,53,47154,53,allow,184,94,90,2,30,1,1
25764,49878,53,52467,53,allow,262,126,136,2,30,1,1
25765,56958,53,40535,53,allow,193,102,91,2,30,1,1
25766,49835,53,6905,53,allow,817,102,715,2,30,1,1
25767,64573,53,34650,53,allow,184,94,90,2,30,1,1
25768,49372,53,57735,53,allow,210,110,100,2,30,1,1
25769,56988,53,25747,53,allow,216,110,106,2,30,1,1
25770,27005,27015,65078,27015,allow,878,126,752,2,30,1,1
25771,53798,53,26638,53,allow,224,86,138,2,30,1,1
25772,64316,53,5577,53,allow,184,94,90,2,30,1,1
25773,50278,53,34897,53,allow,819,102,717,2,30,1,1
25774,57409,53,6816,53,allow,168,86,82,2,31,1,1
25775,60137,443,42633,443,allow,10407,3966,6441,30,149,18,12
25776,61405,443,43963,443,allow,4810,2361,2449,34,80,16,18
25777,57001,80,47227,80,allow,214,140,74,4,35,3,1
25778,57000,80,51268,80,allow,214,140,74,4,35,3,1
25779,48652,443,38749,443,allow,6388,964,5424,21,255,11,10
25780,37633,443,4674,443,allow,8493,2314,6179,33,16,18,15
25781,57437,53,57480,53,allow,193,102,91,2,30,1,1
25782,64980,53,51851,53,allow,180,94,86,2,30,1,1
25783,56658,53,26187,53,allow,193,102,91,2,30,1,1
25784,57409,53,63027,53,allow,168,86,82,2,30,1,1
25785,56416,53,30154,53,allow,816,102,714,2,30,1,1
25786,49390,53,61910,53,allow,210,110,100,2,30,1,1
25787,55755,53,57482,53,allow,779,86,693,2,30,1,1
25788,50732,27029,64378,27029,allow,269,78,191,2,30,1,1
25789,56636,53,34067,53,allow,168,86,82,2,30,1,1
25790,50025,53,33178,53,allow,761,102,659,2,30,1,1
25791,49354,53,16501,53,allow,196,102,94,2,30,1,1
25792,55085,53,9873,53,allow,301,94,207,2,30,1,1
25793,65398,53,49816,53,allow,214,110,104,2,30,1,1
25794,65356,53,49410,53,allow,199,102,97,2,30,1,1
25795,55979,53,21397,53,allow,193,102,91,2,31,1,1
25796,65019,53,46989,53,allow,195,102,93,2,31,1,1
25797,57243,53,64536,53,allow,165,86,79,2,31,1,1
25798,35577,443,21477,443,allow,15162,8505,6657,55,197,29,26
25799,53427,443,4839,443,allow,9896,2040,7856,34,120,17,17
25800,58859,443,48012,443,allow,39518,2389,37129,54,179,21,33
25801,56880,53,8683,53,allow,209,110,99,2,31,1,1
25802,64326,53,50909,53,allow,196,102,94,2,31,1,1
25803,41321,443,41856,443,allow,9168,1596,7572,22,186,11,11
25804,53797,53,41009,53,allow,260,86,174,2,30,1,1
25805,49813,53,53266,53,allow,775,102,673,2,30,1,1
25806,53686,19010,53686,19010,allow,70,70,0,1,30,1,0
25807,64089,53,3452,53,allow,194,102,92,2,31,1,1
25808,57208,53,46583,53,allow,183,94,89,2,31,1,1
25809,56344,53,6437,53,allow,199,102,97,2,31,1,1
25810,56757,53,30520,53,allow,167,86,81,2,31,1,1
25811,55883,53,56307,53,allow,181,94,87,2,31,1,1
25812,36956,443,8939,443,allow,9273,2731,6542,31,403,10,21
25813,65356,53,36098,53,allow,199,102,97,2,30,1,1
25814,55315,53,5468,53,allow,196,102,94,2,31,1,1
25815,57470,51413,19647,51413,allow,740725,699740,40985,1031,1411,616,415
25816,49218,53,22762,53,allow,195,102,93,2,31,1,1
25817,56637,53,47556,53,allow,214,110,104,2,31,1,1
25818,55684,53,54861,53,allow,193,102,91,2,31,1,1
25819,56318,53,47693,53,allow,183,94,89,2,31,1,1
25820,54527,443,27649,443,allow,13132,7107,6025,45,174,23,22
25821,61626,443,21665,443,allow,5663,3258,2405,19,120,9,10
25822,42076,443,63627,443,allow,22106,5214,16892,23,128,9,14
25823,63964,60705,4477,60705,allow,312,132,180,6,7,3,3
25824,63952,50734,27783,50734,allow,70,70,0,1,5,1,0
25825,49205,53,19317,53,allow,194,102,92,2,31,1,1
25826,55070,53,23784,53,allow,195,102,93,2,31,1,1
25827,64316,53,34882,53,allow,184,94,90,2,31,1,1
25828,64519,53,15868,53,allow,518,185,333,6,60,3,3
25829,52020,28704,45681,28704,allow,70,70,0,2,9,2,0
25830,51995,50031,29706,50031,allow,70,70,0,1,5,1,0
25831,57894,80,58107,80,allow,9800,2228,7572,23,24,12,11
25832,58843,443,44716,443,allow,6033,770,5263,18,16,8,10
25833,20570,53,52597,53,allow,428,78,350,2,31,1,1
25834,57418,53,1554,53,allow,165,86,79,2,31,1,1
25835,61936,443,38328,443,allow,4348,1643,2705,14,138,6,8
25836,56487,53,61282,53,allow,194,102,92,2,31,1,1
25837,52023,41791,61647,41791,allow,70,70,0,2,8,2,0
25838,52018,2425,15478,2425,allow,70,70,0,2,9,2,0
25839,57337,443,40846,443,allow,1169,616,553,12,16,7,5
25840,50584,80,65205,80,allow,1883,995,888,11,47,6,5
25841,25101,50584,0,0,deny,62,62,0,1,0,1,0
25842,61007,445,0,0,drop,70,70,0,1,0,1,0
25843,45313,64147,0,0,deny,62,62,0,1,0,1,0
25844,3478,61463,0,0,deny,804,804,0,1,0,1,0
25845,53816,22114,0,0,deny,62,62,0,1,0,1,0
25846,3478,61463,0,0,deny,164,164,0,1,0,1,0
25847,50772,35440,0,0,deny,62,62,0,1,0,1,0
25848,61235,445,0,0,drop,66,66,0,1,0,1,0
25849,57825,13014,0,0,deny,74,74,0,1,0,1,0
25850,3478,61463,0,0,deny,1292,1292,0,1,0,1,0
25851,45941,23386,0,0,deny,60,60,0,1,0,1,0
25852,60999,445,0,0,drop,70,70,0,1,0,1,0
25853,3478,61463,0,0,deny,877,877,0,1,0,1,0
25854,3478,61463,0,0,deny,68,68,0,1,0,1,0
25855,3478,61463,0,0,deny,409,409,0,1,0,1,0
25856,58829,64147,0,0,deny,62,62,0,1,0,1,0
25857,60997,445,0,0,drop,70,70,0,1,0,1,0
25858,61229,445,0,0,drop,66,66,0,1,0,1,0
25859,61226,445,0,0,drop,66,66,0,1,0,1,0
25860,60993,445,0,0,drop,70,70,0,1,0,1,0
25861,60991,445,0,0,drop,70,70,0,1,0,1,0
25862,5223,14446,0,0,deny,220,220,0,1,0,1,0
25863,60987,445,0,0,drop,70,70,0,1,0,1,0
25864,49450,445,0,0,drop,70,70,0,1,0,1,0
25865,49449,445,0,0,drop,70,70,0,1,0,1,0
25866,49448,445,0,0,drop,70,70,0,1,0,1,0
25867,61211,445,0,0,drop,66,66,0,1,0,1,0
25868,61213,445,0,0,drop,66,66,0,1,0,1,0
25869,61212,445,0,0,drop,66,66,0,1,0,1,0
25870,61209,445,0,0,drop,66,66,0,1,0,1,0
25871,61210,445,0,0,drop,66,66,0,1,0,1,0
25872,61207,445,0,0,drop,66,66,0,1,0,1,0
25873,61208,445,0,0,drop,66,66,0,1,0,1,0
25874,61205,445,0,0,drop,66,66,0,1,0,1,0
25875,3478,61463,0,0,deny,252,252,0,1,0,1,0
25876,57011,49813,0,0,deny,62,62,0,1,0,1,0
25877,60986,445,0,0,drop,70,70,0,1,0,1,0
25878,59366,35440,0,0,deny,66,66,0,1,0,1,0
25879,11005,30188,0,0,deny,146,146,0,1,0,1,0
25880,55766,36237,0,0,deny,62,62,0,1,0,1,0
25881,54464,56205,0,0,deny,62,62,0,1,0,1,0
25882,51769,51505,0,0,deny,66,66,0,1,0,1,0
25883,3478,61463,0,0,deny,1044,1044,0,1,0,1,0
25884,3478,61463,0,0,deny,1288,1288,0,1,0,1,0
25885,38885,21247,0,0,deny,62,62,0,1,0,1,0
25886,60981,445,0,0,drop,70,70,0,1,0,1,0
25887,49447,445,0,0,drop,70,70,0,1,0,1,0
25888,49446,445,0,0,drop,70,70,0,1,0,1,0
25889,49444,445,0,0,drop,70,70,0,1,0,1,0
25890,49443,445,0,0,drop,70,70,0,1,0,1,0
25891,443,62732,0,0,deny,332,332,0,1,0,1,0
25892,61191,445,0,0,drop,66,66,0,1,0,1,0
25893,61193,445,0,0,drop,66,66,0,1,0,1,0
25894,61190,445,0,0,drop,66,66,0,1,0,1,0
25895,14350,56205,0,0,deny,62,62,0,1,0,1,0
25896,48186,51050,0,0,deny,62,62,0,1,0,1,0
25897,3478,61463,0,0,deny,342,342,0,1,0,1,0
25898,28378,56205,0,0,deny,146,146,0,1,0,1,0
25899,49428,445,0,0,drop,70,70,0,1,0,1,0
25900,48176,50584,0,0,deny,146,146,0,1,0,1,0
25901,49423,445,0,0,drop,70,70,0,1,0,1,0
25902,49420,445,0,0,drop,70,70,0,1,0,1,0
25903,49421,445,0,0,drop,70,70,0,1,0,1,0
25904,45908,33330,0,0,deny,60,60,0,1,0,1,0
25905,45908,33330,0,0,deny,60,60,0,1,0,1,0
25906,60968,445,0,0,drop,70,70,0,1,0,1,0
25907,3478,61463,0,0,deny,164,164,0,1,0,1,0
25908,3478,61463,0,0,deny,1094,1094,0,1,0,1,0
25909,54752,31573,0,0,deny,66,66,0,1,0,1,0
25910,58488,37965,0,0,deny,62,62,0,1,0,1,0
25911,62153,35440,0,0,deny,62,62,0,1,0,1,0
25912,60965,445,0,0,drop,70,70,0,1,0,1,0
25913,59400,22114,0,0,deny,62,62,0,1,0,1,0
25914,38664,37965,0,0,deny,62,62,0,1,0,1,0
25915,63569,62413,0,0,deny,66,66,0,1,0,1,0
25916,3478,61463,0,0,deny,857,857,0,1,0,1,0
25917,3478,61463,0,0,deny,437,437,0,1,0,1,0
25918,11136,19910,0,0,deny,62,62,0,1,0,1,0
25919,49411,445,0,0,drop,70,70,0,1,0,1,0
25920,49408,445,0,0,drop,70,70,0,1,0,1,0
25921,49406,445,0,0,drop,70,70,0,1,0,1,0
25922,60960,445,0,0,drop,70,70,0,1,0,1,0
25923,61180,445,0,0,drop,66,66,0,1,0,1,0
25924,60959,445,0,0,drop,70,70,0,1,0,1,0
25925,63467,37807,0,0,deny,62,62,0,1,0,1,0
25926,63331,51221,0,0,deny,62,62,0,1,0,1,0
25927,443,18411,0,0,deny,74,74,0,1,0,1,0
25928,443,60082,0,0,deny,74,74,0,1,0,1,0
25929,443,39711,0,0,deny,74,74,0,1,0,1,0
25930,3478,61463,0,0,deny,814,814,0,1,0,1,0
25931,0,0,0,0,deny,140,140,0,2,0,2,0
25932,0,0,0,0,allow,320,320,0,5,0,5,0
25933,60957,445,0,0,drop,70,70,0,1,0,1,0
25934,13285,29892,0,0,deny,145,145,0,1,0,1,0
25935,443,39999,0,0,deny,74,74,0,1,0,1,0
25936,36374,30228,0,0,deny,145,145,0,1,0,1,0
25937,443,9313,0,0,deny,74,74,0,1,0,1,0
25938,443,49031,0,0,deny,74,74,0,1,0,1,0
25939,443,11817,0,0,deny,74,74,0,1,0,1,0
25940,62493,50584,0,0,deny,62,62,0,1,0,1,0
25941,443,23622,0,0,deny,74,74,0,1,0,1,0
25942,30794,37965,0,0,deny,62,62,0,1,0,1,0
25943,3478,61463,0,0,deny,441,441,0,1,0,1,0
25944,40977,21247,0,0,deny,66,66,0,1,0,1,0
25945,49401,445,0,0,drop,70,70,0,1,0,1,0
25946,49395,445,0,0,drop,70,70,0,1,0,1,0
25947,46218,23,0,0,deny,60,60,0,1,0,1,0
25948,57459,51505,0,0,deny,66,66,0,1,0,1,0
25949,52830,22114,0,0,deny,62,62,0,1,0,1,0
25950,26698,57470,0,0,deny,62,62,0,1,0,1,0
25951,60950,445,0,0,drop,70,70,0,1,0,1,0
25952,63242,50584,0,0,deny,66,66,0,1,0,1,0
25953,61164,445,0,0,drop,66,66,0,1,0,1,0
25954,61163,445,0,0,drop,66,66,0,1,0,1,0
25955,60948,445,0,0,drop,70,70,0,1,0,1,0
25956,49511,57470,0,0,deny,66,66,0,1,0,1,0
25957,50052,65010,0,0,deny,60,60,0,1,0,1,0
25958,57131,8055,0,0,deny,145,145,0,1,0,1,0
25959,3478,61463,0,0,deny,315,315,0,1,0,1,0
25960,64697,37965,0,0,deny,66,66,0,1,0,1,0
25961,59376,5900,0,0,deny,60,60,0,1,0,1,0
25962,60947,445,0,0,drop,70,70,0,1,0,1,0
25963,35291,44847,0,0,deny,66,66,0,1,0,1,0
25964,60946,445,0,0,drop,70,70,0,1,0,1,0
25965,60945,445,0,0,drop,70,70,0,1,0,1,0
25966,49388,445,0,0,drop,70,70,0,1,0,1,0
25967,12143,56205,0,0,deny,66,66,0,1,0,1,0
25968,60939,445,0,0,drop,70,70,0,1,0,1,0
25969,60942,445,0,0,drop,70,70,0,1,0,1,0
25970,49386,445,0,0,drop,70,70,0,1,0,1,0
25971,49383,445,0,0,drop,70,70,0,1,0,1,0
25972,49380,445,0,0,drop,70,70,0,1,0,1,0
25973,52962,35440,0,0,deny,66,66,0,1,0,1,0
25974,14103,35440,0,0,deny,62,62,0,1,0,1,0
25975,59679,37807,0,0,deny,66,66,0,1,0,1,0
25976,61159,445,0,0,drop,66,66,0,1,0,1,0
25977,58836,44847,0,0,deny,70,70,0,1,0,1,0
25978,3478,61463,0,0,deny,627,627,0,1,0,1,0
25979,61154,445,0,0,drop,66,66,0,1,0,1,0
25980,61153,445,0,0,drop,66,66,0,1,0,1,0
25981,61152,445,0,0,drop,66,66,0,1,0,1,0
25982,61150,445,0,0,drop,66,66,0,1,0,1,0
25983,61142,445,0,0,drop,66,66,0,1,0,1,0
25984,61143,445,0,0,drop,66,66,0,1,0,1,0
25985,61148,445,0,0,drop,66,66,0,1,0,1,0
25986,64677,57470,0,0,deny,66,66,0,1,0,1,0
25987,60927,445,0,0,drop,70,70,0,1,0,1,0
25988,60925,445,0,0,drop,70,70,0,1,0,1,0
25989,60923,445,0,0,drop,70,70,0,1,0,1,0
25990,60917,445,0,0,drop,70,70,0,1,0,1,0
25991,60916,445,0,0,drop,70,70,0,1,0,1,0
25992,6881,61980,0,0,deny,150,150,0,1,0,1,0
25993,49377,445,0,0,drop,70,70,0,1,0,1,0
25994,61791,80,61791,80,allow,16848,822,16026,23,16,9,14
25995,62324,443,62324,443,allow,2882,1622,1260,20,86,10,10
25996,62231,443,62231,443,allow,180730,19869,160861,239,171,103,136
25997,36881,443,36881,443,allow,4652,1745,2907,19,28,11,8
25998,49208,6881,3930,6881,allow,70,70,0,2,8,2,0
25999,39198,443,37054,443,allow,6328,850,5478,26,289,9,17
26000,50621,443,42155,443,allow,3171,1473,1698,15,93,9,6
26001,49158,443,3923,443,allow,23613,13099,10514,79,1341,36,43
26002,52021,32202,58767,32202,allow,70,70,0,2,8,2,0
26003,54280,3396,54280,3396,allow,146,60,86,2,10,1,1
26004,51990,42127,1528,42127,allow,66,66,0,1,5,1,0
26005,51202,443,46664,443,allow,7702,2410,5292,26,34,13,13
26006,56487,53,12533,53,allow,188,96,92,2,30,1,1
26007,56779,53,7300,53,allow,757,98,659,2,30,1,1
26008,52017,26175,18735,26175,allow,70,70,0,2,9,2,0
26009,58834,443,42035,443,allow,7880,5105,2775,25,17,13,12
26010,50076,80,29026,80,allow,26128,9214,16914,81,512,40,41
26011,51613,7000,51613,7000,allow,2163,676,1487,14,15,7,7
26012,56169,53,42323,53,allow,204,104,100,2,30,1,1
26013,50279,443,22072,443,allow,21204,10998,10206,51,392,27,24
26014,60856,443,12085,443,allow,8201,2795,5406,43,18,26,17
26015,50625,443,24719,443,allow,9588,1204,8384,29,93,15,14
26016,43632,80,17222,80,allow,2000,710,1290,8,15,5,3
26017,58805,443,25945,443,allow,32148,21507,10641,72,21,42,30
26018,45319,443,29767,443,allow,9284,2430,6854,25,82,14,11
26019,46991,443,46408,443,allow,2809,1884,925,19,26,11,8
26020,52513,80,64881,80,allow,39793,2026,37767,55,16,27,28
26021,55684,53,10799,53,allow,186,95,91,2,30,1,1
26022,27005,30010,26771,30010,allow,887,126,761,2,31,1,1
26023,57092,53,22566,53,allow,756,95,661,2,31,1,1
26024,55155,53,65476,53,allow,188,96,92,2,31,1,1
26025,50584,443,50316,443,allow,36457,2308,34149,52,98,23,29
26026,60540,443,60540,443,allow,4455,1548,2907,19,27,11,8
26027,60870,443,18926,443,allow,8219,2676,5543,40,15,24,16
26028,50517,80,63449,80,allow,5997,1327,4670,18,157,10,8
26029,53912,3478,54737,3478,allow,3532,1792,1740,58,88,29,29
26030,49201,17852,9879,17852,allow,70,70,0,2,8,2,0
26031,50660,443,1887,443,allow,3845,1814,2031,19,38,11,8
26032,47516,80,2518,80,allow,956,541,415,11,316,6,5
26033,49157,443,32525,443,allow,5115,977,4138,18,18,10,8
26034,49209,52030,40486,52030,allow,70,70,0,2,8,2,0
26035,50637,80,48925,80,allow,1742,589,1153,10,87,6,4
26036,52022,53657,34064,53657,allow,70,70,0,2,8,2,0
26037,57721,443,65259,443,allow,1019,644,375,10,37,6,4
26038,51994,25509,12796,25509,allow,66,66,0,1,5,1,0
26039,54912,443,54912,443,allow,4401,1494,2907,19,27,11,8
26040,50092,80,20230,80,allow,11297,8141,3156,52,508,34,18
26041,53687,19010,53687,19010,allow,64,64,0,1,30,1,0
26042,54371,443,51699,443,allow,6120,1305,4815,20,983,10,10
26043,50306,80,39882,80,allow,182517,10761,171756,265,352,130,135
26044,53713,443,33766,443,allow,9555,4200,5355,25,86,15,10
26045,55351,53,4702,53,allow,1497,108,1389,4,53,2,2
26046,50580,443,63411,443,allow,2604,1413,1191,15,98,9,6
26047,55986,53,53201,53,allow,744,89,655,2,30,1,1
26048,55546,53,22275,53,allow,1417,96,1321,4,30,2,2
26049,55315,53,41500,53,allow,192,98,94,2,31,1,1
26050,52385,53,0,0,allow,138,69,69,2,30,1,1
26051,56540,53,53541,53,allow,735,88,647,2,30,1,1
26052,57409,53,7230,53,allow,168,86,82,2,30,1,1
26053,42186,443,1253,443,allow,3562,2096,1466,18,336,9,9
26054,56880,53,23570,53,allow,202,103,99,2,31,1,1
26055,27005,27015,56171,27015,allow,858,126,732,2,31,1,1
26056,55907,53,18391,53,allow,184,94,90,2,31,1,1
26057,55068,53,58274,53,allow,192,98,94,2,31,1,1
26058,56112,53,3199,53,allow,198,101,97,2,31,1,1
26059,56875,53,47885,53,allow,166,85,81,2,31,1,1
26060,46779,5228,25730,5228,allow,3775,2029,1746,30,3637,13,17
26061,50620,443,5914,443,allow,1277,851,426,12,92,7,5
26062,50600,443,20473,443,allow,5035,3194,1841,23,96,12,11
26063,50629,443,47938,443,allow,6553,1034,5519,23,87,12,11
26064,59994,53,59994,53,allow,462,158,304,4,31,2,2
26065,56503,53,8942,53,allow,916,86,830,2,31,1,1
26066,51968,443,14636,443,allow,122815,48545,74270,164,95,76,88
26067,55525,53,23543,53,allow,212,108,104,2,31,1,1
26068,50439,443,55602,443,allow,73712,18850,54862,135,717,61,74
26069,42185,443,3806,443,allow,15233,9395,5838,33,338,16,17
26070,56427,53,59297,53,allow,164,84,80,2,31,1,1
26071,56676,53,4759,53,allow,172,88,84,2,31,1,1
26072,57343,53,26142,53,allow,178,91,87,2,31,1,1
26073,56382,53,19333,53,allow,190,97,93,2,31,1,1
26074,60795,443,29587,443,allow,3282,1018,2264,10,121,5,5
26075,2598,23718,0,0,deny,66,66,0,1,0,1,0
26076,52811,44847,0,0,deny,66,66,0,1,0,1,0
26077,49373,445,0,0,drop,70,70,0,1,0,1,0
26078,49371,445,0,0,drop,70,70,0,1,0,1,0
26079,49369,445,0,0,drop,70,70,0,1,0,1,0
26080,55689,37965,0,0,deny,66,66,0,1,0,1,0
26081,3478,61463,0,0,deny,503,503,0,1,0,1,0
26082,65379,22114,0,0,deny,62,62,0,1,0,1,0
26083,41348,5555,0,0,deny,60,60,0,1,0,1,0
26084,56494,50432,0,0,deny,146,146,0,1,0,1,0
26085,52828,51221,0,0,deny,66,66,0,1,0,1,0
26086,60905,445,0,0,drop,70,70,0,1,0,1,0
26087,56704,53,35730,53,allow,210,94,116,2,30,1,1
26088,64823,53,30935,53,allow,508,102,406,2,30,1,1
26089,55155,53,23280,53,allow,194,102,92,2,30,1,1
26090,50535,80,27169,80,allow,36985,3992,32993,56,151,25,31
26091,1737,80,1737,80,allow,424934,9929,415005,411,95,129,282
26092,58057,80,12753,80,allow,254,128,126,5,15,3,2
26093,51992,22670,31187,22670,allow,70,70,0,1,4,1,0
26094,56105,53,14961,53,allow,372,142,230,2,29,1,1
26095,64999,53,5804,53,allow,178,94,84,2,29,1,1
26096,56560,53,15895,53,allow,164,86,78,2,29,1,1
26097,55777,53,5442,53,allow,733,94,639,2,29,1,1
26098,64999,53,33322,53,allow,178,94,84,2,29,1,1
26099,56632,53,26751,53,allow,200,94,106,2,29,1,1
26100,49373,443,19953,443,allow,1857,1218,639,18,104,11,7
26101,57335,8631,57083,8631,allow,742,298,444,11,16,5,6
26102,49372,443,30393,443,allow,6158,3587,2571,37,104,19,18
26103,44145,443,29432,443,allow,8746,2844,5902,26,315,13,13
26104,50139,443,27090,443,allow,72523,5814,66709,125,255,61,64
26105,51996,41888,46821,41888,allow,70,70,0,1,4,1,0
26106,55803,53,18638,53,allow,261,89,172,4,32,2,2
26107,53796,48019,39849,48019,allow,70,70,0,2,7,2,0
26108,62208,443,62208,443,allow,4497,1590,2907,19,29,11,8
26109,50618,80,9879,80,allow,25890,3442,22448,33,21,13,20
26110,53813,39832,19071,39832,allow,320,140,180,6,5,3,3
26111,50562,443,53886,443,allow,103466,11111,92355,258,140,119,139
26112,45627,443,47069,443,allow,7092,1883,5209,21,21,12,9
26113,1736,80,1736,80,allow,101959,5508,96451,111,95,41,70
26114,43591,443,23363,443,allow,4680,2835,1845,33,80,16,17
26115,55358,53,33999,53,allow,200,94,106,2,29,1,1
26116,56624,53,40354,53,allow,199,102,97,2,29,1,1
26117,64380,53,22158,53,allow,193,102,91,2,29,1,1
26118,55272,53,54690,53,allow,198,110,88,2,29,1,1
26119,64326,53,30580,53,allow,196,102,94,2,29,1,1
26120,50311,443,2014,443,allow,133674,20935,112739,206,350,105,101
26121,56639,53,47791,53,allow,168,86,82,2,32,1,1
26122,1735,80,1735,80,allow,78576,5218,73358,91,95,36,55
26123,54506,80,60844,80,allow,254,128,126,5,15,3,2
26124,56655,53,1875,53,allow,210,110,100,2,30,1,1
26125,57211,53,8547,53,allow,258,110,148,2,30,1,1
26126,57419,53,26611,53,allow,196,102,94,2,30,1,1
26127,55582,53,15587,53,allow,168,86,82,2,30,1,1
26128,39205,53,46384,53,allow,489,94,395,2,30,1,1
26129,55068,53,54785,53,allow,196,102,94,2,30,1,1
26130,15680,53,61838,53,allow,464,287,177,3,30,2,1
26131,65108,53,40239,53,allow,215,94,121,2,30,1,1
26132,55427,53,22421,53,allow,200,102,98,2,33,1,1
26133,34170,53,0,0,allow,82,82,0,2,40,2,0
26134,64424,53,30245,53,allow,211,102,109,2,30,1,1
26135,57593,28678,11489,28678,allow,1806,1806,0,22,225,22,0
26136,49198,64509,42217,64509,allow,70,70,0,2,8,2,0
26137,64721,443,45723,443,allow,5552,927,4625,16,15,10,6
26138,49200,38001,36048,38001,allow,70,70,0,2,8,2,0
26139,55260,53,35785,53,allow,183,94,89,2,30,1,1
26140,58841,443,62984,443,allow,5168,700,4468,16,15,7,9
26141,50057,53,32757,53,allow,718,94,624,2,30,1,1
26142,64104,53,19823,53,allow,288,101,187,4,57,2,2
26143,55411,53,33954,53,allow,183,94,89,2,30,1,1
26144,56107,53,50537,53,allow,817,102,715,2,30,1,1
26145,49924,53,19826,53,allow,718,94,624,2,30,1,1
26146,50574,443,9752,443,allow,9191,2003,7188,25,100,13,12
26147,49293,53,24281,53,allow,178,94,84,2,30,1,1
26148,56487,53,32287,53,allow,194,102,92,2,30,1,1
26149,56995,443,35339,443,allow,8721,2518,6203,29,159,13,16
26150,49935,53,50105,53,allow,177,94,83,2,30,1,1
26151,56757,53,39521,53,allow,167,86,81,2,30,1,1
26152,56107,53,24230,53,allow,194,102,92,2,30,1,1
26153,55411,53,25352,53,allow,183,94,89,2,30,1,1
26154,49754,53,60786,53,allow,180,94,86,2,30,1,1
26155,65391,53,47962,53,allow,720,94,626,2,30,1,1
26156,55427,53,31506,53,allow,200,102,98,2,30,1,1
26157,55411,53,47570,53,allow,183,94,89,2,30,1,1
26158,56111,53,56414,53,allow,152,78,74,2,30,1,1
26159,55791,53,4698,53,allow,811,94,717,2,30,1,1
26160,57243,53,20159,53,allow,173,94,79,2,30,1,1
26161,56667,53,19814,53,allow,244,94,150,2,30,1,1
26162,55261,53,19627,53,allow,173,94,79,2,30,1,1
26163,64326,53,26486,53,allow,196,102,94,2,30,1,1
26164,56941,53,32595,53,allow,212,102,110,2,30,1,1
26165,49625,53,64446,53,allow,251,102,149,2,30,1,1
26166,56362,53,49455,53,allow,195,102,93,2,30,1,1
26167,56860,53,63586,53,allow,184,102,82,2,30,1,1
26168,56888,443,59232,443,allow,10384,2236,8148,28,186,15,13
26169,54953,53,51225,53,allow,289,134,155,2,30,1,1
26170,55250,53,30475,53,allow,416,102,314,2,30,1,1
26171,50567,443,13850,443,allow,1202,720,482,12,139,7,5
26172,50588,443,8589,443,allow,2460,1267,1193,16,98,9,7
26173,49206,12242,32509,12242,allow,70,70,0,2,8,2,0
26174,49210,33757,53103,33757,allow,70,70,0,2,8,2,0
26175,48024,443,44709,443,allow,9194,1066,8128,21,27,12,9
26176,50526,80,52180,80,allow,259593,12828,246765,308,156,118,190
26177,52207,443,22846,443,allow,74711,8646,66065,150,89,70,80
26178,62226,443,62226,443,allow,130836,22940,107896,161,170,72,89
26179,55676,28694,59367,28694,allow,316,190,126,5,15,3,2
26180,52415,443,3677,443,allow,14050,4805,9245,30,158,17,13
26181,57000,53,37935,53,allow,193,94,99,2,30,1,1
26182,63941,53,42926,53,allow,253,102,151,2,30,1,1
26183,55883,53,20281,53,allow,189,102,87,2,30,1,1
26184,56880,53,27129,53,allow,209,110,99,2,30,1,1
26185,56319,53,40959,53,allow,455,94,361,2,30,1,1
26186,49890,443,37248,443,allow,9545,2433,7112,24,142,10,14
26187,1738,80,1738,80,allow,87958,5378,82580,100,95,39,61
26188,50587,443,51277,443,allow,1198,716,482,12,98,7,5
26189,55671,53,24025,53,allow,196,102,94,2,33,1,1
26190,64089,53,43918,53,allow,340,96,244,4,35,2,2
26191,55729,53,3835,53,allow,256,96,160,4,42,2,2
26192,43096,443,6267,443,allow,7098,2628,4470,20,16,12,8
26193,50625,443,48490,443,allow,3090,1707,1383,15,19,9,6
26194,58838,443,31088,443,allow,5167,700,4467,16,15,7,9
26195,40992,443,49820,443,allow,8705,3570,5135,35,100,20,15
26196,55907,53,49379,53,allow,184,94,90,2,30,1,1
26197,57679,443,35639,443,allow,13034,3324,9710,35,120,15,20
26198,60081,443,25599,443,allow,10893,4674,6219,43,121,19,24
26199,27005,27080,21162,27080,allow,926,126,800,2,31,1,1
26200,49293,53,18352,53,allow,294,88,206,4,57,2,2
26201,50528,80,29237,80,allow,66430,7013,59417,93,156,40,53
26202,14438,443,5069,443,allow,2556,1470,1086,17,15,8,9
26203,56787,443,11653,443,allow,5639,846,4793,18,27,10,8
26204,50525,80,36119,80,allow,152171,9332,142839,189,156,78,111
26205,51797,80,10283,80,allow,9897,4338,5559,27,58,16,11
26206,54196,80,31560,80,allow,2640,540,2100,12,45,6,6
26207,27005,29999,55945,29999,allow,887,126,761,2,31,1,1
26208,50595,443,49114,443,allow,2862,1587,1275,15,95,9,6
26209,35549,443,45483,443,allow,9032,2244,6788,36,255,17,19
26210,33643,443,12343,443,allow,163835,28514,135321,310,153,162,148
26211,57340,443,31175,443,allow,1169,616,553,12,16,7,5
26212,53810,8999,16528,8999,allow,320,140,180,6,5,3,3
26213,35196,8635,35196,8635,allow,138,78,60,2,5,1,1
26214,38695,443,12020,443,allow,1185199,19993,1165206,1088,16,289,799
26215,50266,443,54511,443,allow,21634,11226,10408,54,402,35,19
26216,49227,53,40527,53,allow,340,89,251,4,44,2,2
26217,58001,443,15727,443,allow,300,180,120,6,28,4,2
26218,55414,443,59075,443,allow,6053,4104,1949,31,84,17,14
26219,50573,443,20479,443,allow,6575,1995,4580,26,100,13,13
26220,50354,443,37764,443,allow,71226,18632,52594,137,318,63,74
26221,56991,80,27805,80,allow,1638,1324,314,10,15,5,5
26222,56362,53,31120,53,allow,195,102,93,2,29,1,1
26223,55463,53,33769,53,allow,216,110,106,2,29,1,1
26224,50649,443,16928,443,allow,15295,1755,13540,31,77,15,16
26225,56560,53,37508,53,allow,172,94,78,2,29,1,1
26226,50463,80,10843,80,allow,287874,13215,274659,346,204,136,210
26227,55329,53,39839,53,allow,210,102,108,2,29,1,1
26228,56636,53,35098,53,allow,372,86,286,4,54,2,2
26229,55684,53,19288,53,allow,193,102,91,2,29,1,1
26230,56111,53,50559,53,allow,168,94,74,2,30,1,1
26231,49163,53,13314,53,allow,167,86,81,2,29,1,1
26232,64631,53,29007,53,allow,193,102,91,2,29,1,1
26233,55260,53,54111,53,allow,183,94,89,2,30,1,1
26234,51766,443,63491,443,allow,5462,1305,4157,22,121,10,12
26235,34428,443,49184,443,allow,21512,4620,16892,22,127,8,14
26236,64104,53,54315,53,allow,288,101,187,4,58,2,2
26237,27260,443,46156,443,allow,4329,2374,1955,23,520,8,15
26238,60994,443,7195,443,allow,13145,6129,7016,37,34,19,18
26239,65503,53,13139,53,allow,177,94,83,2,30,1,1
26240,56427,53,59591,53,allow,166,86,80,2,30,1,1
26241,56860,53,58794,53,allow,168,86,82,2,30,1,1
26242,56658,53,32323,53,allow,193,102,91,2,30,1,1
26243,56700,53,42094,53,allow,443,182,261,6,30,3,3
26244,56169,53,21391,53,allow,210,110,100,2,30,1,1
26245,56110,53,15545,53,allow,508,102,406,2,30,1,1
26246,56050,53,62054,53,allow,178,94,84,2,30,1,1
26247,55803,53,62058,53,allow,179,94,85,2,30,1,1
26248,65160,53,39178,53,allow,198,94,104,2,30,1,1
26249,57092,53,56689,53,allow,445,86,359,2,30,1,1
26250,55525,53,56574,53,allow,214,110,104,2,30,1,1
26251,56382,53,27838,53,allow,195,102,93,2,30,1,1
26252,65106,53,60145,53,allow,438,180,258,6,30,3,3
26253,56487,53,4784,53,allow,194,102,92,2,30,1,1
26254,27005,27015,3826,27015,allow,876,126,750,2,31,1,1
26255,56917,53,28057,53,allow,194,102,92,2,31,1,1
26256,64631,53,5606,53,allow,193,102,91,2,30,1,1
26257,57419,53,1217,53,allow,819,102,717,2,30,1,1
26258,56847,53,58381,53,allow,252,102,150,2,30,1,1
26259,33836,443,3806,443,allow,18875,13913,4962,116,788,60,56
26260,49387,53,43855,53,allow,323,102,221,2,30,1,1
26261,55030,53,38017,53,allow,185,102,83,2,30,1,1
26262,27005,29999,22693,29999,allow,876,126,750,2,31,1,1
26263,56261,53,47864,53,allow,184,94,90,2,31,1,1
26264,59582,443,37348,443,allow,22106,5214,16892,23,127,9,14
26265,54977,443,65082,443,allow,263411,11905,251506,318,144,118,200
26266,55315,53,24638,53,allow,196,102,94,2,31,1,1
26267,40204,40021,21562,40021,allow,148,86,62,2,31,1,1
26268,1739,80,1739,80,allow,198357,5070,193287,197,95,63,134
26269,57022,443,20898,443,allow,4228,1470,2758,19,131,9,10
26270,1734,80,1734,80,allow,318813,10418,308395,314,95,102,212
26271,50524,80,58944,80,allow,102242,12176,90066,149,156,68,81
26272,57602,443,23488,443,allow,2614,1689,925,18,20,10,8
26273,49202,31719,45347,31719,allow,70,70,0,2,8,2,0
26274,52019,40689,48482,40689,allow,70,70,0,2,8,2,0
26275,64266,53,26877,53,allow,180,94,86,2,35,1,1
26276,50467,80,31924,80,allow,197269,14917,182352,254,204,107,147
26277,50566,443,4143,443,allow,2064,1287,777,16,139,9,7
26278,56571,53,42202,53,allow,325,102,223,2,30,1,1
26279,56655,53,35529,53,allow,210,110,100,2,30,1,1
26280,57428,53,16884,53,allow,198,94,104,2,30,1,1
26281,56637,53,51918,53,allow,214,110,104,2,30,1,1
26282,57396,53,17014,53,allow,212,102,110,2,30,1,1
26283,56637,53,18660,53,allow,214,110,104,2,30,1,1
26284,56169,53,53942,53,allow,210,110,100,2,30,1,1
26285,49935,53,46528,53,allow,177,94,83,2,30,1,1
26286,64573,53,51074,53,allow,184,94,90,2,30,1,1
26287,64992,53,64992,53,allow,180,82,98,2,30,1,1
26288,63948,80,9193,80,allow,314,192,122,6,15,4,2
26289,57021,443,9946,443,allow,4697,1470,3227,20,131,9,11
26290,50527,80,17326,80,allow,261781,16421,245360,330,156,137,193
26291,62227,443,62227,443,allow,197342,62255,135087,232,170,110,122
26292,60866,443,47757,443,allow,14519,9445,5074,35,15,20,15
26293,50592,443,18630,443,allow,1304,878,426,12,96,7,5
26294,64292,53,10616,53,allow,387,94,293,4,51,2,2
26295,55582,53,34252,53,allow,168,86,82,2,30,1,1
26296,65503,53,29061,53,allow,177,94,83,2,30,1,1
26297,55315,53,15960,53,allow,196,102,94,2,30,1,1
26298,49354,53,25819,53,allow,196,102,94,2,30,1,1
26299,64380,53,5955,53,allow,193,102,91,2,30,1,1
26300,55030,53,46316,53,allow,177,94,83,2,30,1,1
26301,39945,80,32105,80,allow,1948,728,1220,11,150,6,5
26302,53267,443,33925,443,allow,6156,2009,4147,26,18,14,12
26303,56786,443,13825,443,allow,5698,906,4792,19,27,11,8
26304,49207,58751,6797,58751,allow,70,70,0,2,8,2,0
26305,58840,443,27383,443,allow,5108,700,4408,15,15,7,8
26306,60865,443,14969,443,allow,9934,4897,5037,43,15,25,18
26307,50462,80,37104,80,allow,113965,10014,103951,154,204,65,89
26308,50222,443,25494,443,allow,178347,31093,147254,290,446,140,150
26309,53431,80,15544,80,allow,1638,1324,314,10,15,5,5
26310,55973,53,5208,53,allow,939,678,261,2,30,1,1
26311,10097,53,3471,53,allow,259,86,173,2,30,1,1
26312,56160,53,10248,53,allow,94,94,0,1,30,1,0
26313,55525,53,5634,53,allow,214,110,104,2,30,1,1
26314,56875,53,43240,53,allow,167,86,81,2,30,1,1
26315,57253,53,58310,53,allow,199,102,97,2,30,1,1
26316,56050,53,60245,53,allow,178,94,84,2,30,1,1
26317,49884,53,8513,53,allow,252,102,150,2,30,1,1
26318,55421,53,47278,53,allow,200,102,98,2,30,1,1
26319,57343,53,25885,53,allow,181,94,87,2,30,1,1
26320,27065,53,10980,53,allow,822,466,356,3,30,2,1
26321,58695,53,54969,53,allow,392,86,306,2,30,1,1
26322,57418,53,45442,53,allow,165,86,79,2,30,1,1
26323,56427,53,42294,53,allow,166,86,80,2,30,1,1
26324,57082,53,9901,53,allow,239,94,145,2,30,1,1
26325,27005,37569,6063,37569,allow,880,126,754,2,31,1,1
26326,56382,53,5952,53,allow,195,102,93,2,31,1,1
26327,27005,27001,35440,27001,allow,887,126,761,2,31,1,1
26328,15503,51508,42580,51508,allow,481,150,331,2,1200,1,1
26329,6881,6881,37919,6881,allow,238,118,120,2,1200,1,1
26330,50230,80,65071,80,allow,12572,8562,4010,48,442,26,22
26331,14437,443,4301,443,allow,2589,1443,1146,18,16,8,10
26332,55276,53,37772,53,allow,215,94,121,2,30,1,1
26333,56167,53,20756,53,allow,461,94,367,2,30,1,1
26334,55463,53,21645,53,allow,216,110,106,2,30,1,1
26335,55666,53,45375,53,allow,211,102,109,2,30,1,1
26336,56112,53,63106,53,allow,199,102,97,2,30,1,1
26337,55934,53,0,0,allow,86,86,0,1,30,1,0
26338,56676,53,9987,53,allow,178,94,84,2,30,1,1
26339,56875,53,55228,53,allow,167,86,81,2,30,1,1
26340,56676,53,39365,53,allow,178,94,84,2,31,1,1
26341,27005,27015,4428,27015,allow,884,126,758,2,31,1,1
26342,57343,53,32639,53,allow,181,94,87,2,31,1,1
26343,56556,53,18816,53,allow,184,94,90,2,31,1,1
26344,55155,53,35899,53,allow,194,102,92,2,31,1,1
26345,55321,53,4307,53,allow,193,102,91,2,31,1,1
26346,43514,443,45895,443,allow,9643,2462,7181,26,146,11,15
26347,55727,53,2697,53,allow,195,102,93,2,31,1,1
26348,57470,12383,34199,12383,allow,5728,4818,910,87,4485,74,13
26349,58453,443,9103,443,allow,9972,2138,7834,39,130,19,20
26350,65238,443,5223,443,allow,26538,8416,18122,54,121,25,29
26351,43130,443,2379,443,allow,207714,9731,197983,267,193,120,147
26352,55002,53,42728,53,allow,196,102,94,2,31,1,1
26353,60822,443,31127,443,allow,4435,2482,1953,10,121,6,4
26354,56297,53,38652,53,allow,228,75,153,4,31,2,2
26355,57032,53,17045,53,allow,166,86,80,2,31,1,1
26356,57409,53,32069,53,allow,168,86,82,2,31,1,1
26357,55645,443,7018,443,allow,9213,3751,5462,17,121,8,9
26358,64824,443,53612,443,allow,2442,356,2086,12,120,5,7
26359,52152,443,39969,443,allow,433460,26631,406829,595,147,224,371
26360,55834,53,32935,53,allow,184,94,90,2,31,1,1
26361,38694,443,56498,443,allow,90289,3481,86808,96,16,31,65
26362,50593,443,18063,443,allow,1745,1068,677,18,95,10,8
26363,50544,443,24381,443,allow,8592,1152,7440,25,150,13,12
26364,59955,80,59955,80,allow,16324,808,15516,25,59,11,14
26365,58761,443,45887,443,allow,318,192,126,6,26,4,2
26366,39342,80,30469,80,allow,1638,1324,314,10,16,5,5
26367,33705,80,63150,80,allow,1288,496,792,8,43,5,3
26368,50547,443,55787,443,allow,5895,1068,4827,22,149,12,10
26369,50657,443,9730,443,allow,3339,2205,1134,21,38,13,8
26370,53801,47933,40487,47933,allow,320,140,180,6,6,3,3
26371,59936,80,54096,80,allow,1281,399,882,10,16,6,4
26372,53129,80,16654,80,allow,5318,685,4633,14,15,7,7
26373,50626,443,22681,443,allow,1604,987,617,16,93,9,7
26374,53802,59932,27956,59932,allow,320,140,180,6,6,3,3
26375,53790,21011,61681,21011,allow,70,70,0,2,8,2,0
26376,3478,61463,0,0,deny,585,585,0,1,0,1,0
26377,46844,34567,0,0,deny,60,60,0,1,0,1,0
26378,49367,445,0,0,drop,70,70,0,1,0,1,0
26379,49366,445,0,0,drop,70,70,0,1,0,1,0
26380,49365,445,0,0,drop,70,70,0,1,0,1,0
26381,50514,52752,0,0,deny,146,146,0,1,0,1,0
26382,61138,445,0,0,drop,66,66,0,1,0,1,0
26383,49360,445,0,0,drop,70,70,0,1,0,1,0
26384,61133,445,0,0,drop,66,66,0,1,0,1,0
26385,6666,16010,0,0,deny,60,60,0,1,0,1,0
26386,61132,445,0,0,drop,66,66,0,1,0,1,0
26387,61130,445,0,0,drop,66,66,0,1,0,1,0
26388,61128,445,0,0,drop,66,66,0,1,0,1,0
26389,3478,61463,0,0,deny,1148,1148,0,1,0,1,0
26390,3478,61463,0,0,deny,431,431,0,1,0,1,0
26391,60899,445,0,0,drop,70,70,0,1,0,1,0
26392,54737,50584,0,0,deny,66,66,0,1,0,1,0
26393,45964,3111,0,0,deny,60,60,0,1,0,1,0
26394,54280,3398,0,0,deny,60,60,0,1,0,1,0
26395,61550,5529,0,0,deny,145,145,0,1,0,1,0
26396,60888,445,0,0,drop,70,70,0,1,0,1,0
26397,60889,445,0,0,drop,70,70,0,1,0,1,0
26398,60887,445,0,0,drop,70,70,0,1,0,1,0
26399,49352,445,0,0,drop,70,70,0,1,0,1,0
26400,36369,51505,0,0,deny,62,62,0,1,0,1,0
26401,60886,445,0,0,drop,70,70,0,1,0,1,0
26402,3341,23117,0,0,deny,66,66,0,1,0,1,0
26403,49351,445,0,0,drop,70,70,0,1,0,1,0
26404,49348,445,0,0,drop,70,70,0,1,0,1,0
26405,60883,445,0,0,drop,70,70,0,1,0,1,0
26406,11716,37965,0,0,deny,62,62,0,1,0,1,0
26407,26553,57470,0,0,deny,66,66,0,1,0,1,0
26408,3478,61463,0,0,deny,252,252,0,1,0,1,0
26409,61589,21247,0,0,deny,66,66,0,1,0,1,0
26410,25448,36827,0,0,deny,62,62,0,1,0,1,0
26411,12285,61248,0,0,reset-both,139,139,0,1,0,1,0
26412,59592,37965,0,0,deny,62,62,0,1,0,1,0
26413,61117,445,0,0,drop,66,66,0,1,0,1,0
26414,3478,61463,0,0,deny,164,164,0,1,0,1,0
26415,3478,61463,0,0,deny,343,343,0,1,0,1,0
26416,3478,61463,0,0,deny,68,68,0,1,0,1,0
26417,11136,17500,0,0,deny,62,62,0,1,0,1,0
26418,60877,445,0,0,drop,70,70,0,1,0,1,0
26419,54614,37807,0,0,deny,66,66,0,1,0,1,0
26420,61110,445,0,0,drop,66,66,0,1,0,1,0
26421,49335,445,0,0,drop,70,70,0,1,0,1,0
26422,3478,61463,0,0,deny,1109,1109,0,1,0,1,0
26423,3478,61463,0,0,deny,64,64,0,1,0,1,0
26424,14618,6881,0,0,deny,66,66,0,1,0,1,0
26425,7246,59858,0,0,deny,66,66,0,1,0,1,0
26426,12709,51505,0,0,deny,62,62,0,1,0,1,0
26427,61108,445,0,0,drop,66,66,0,1,0,1,0
26428,60869,445,0,0,drop,70,70,0,1,0,1,0
26429,60868,445,0,0,drop,70,70,0,1,0,1,0
26430,11859,64147,0,0,deny,62,62,0,1,0,1,0
26431,59736,51505,0,0,deny,62,62,0,1,0,1,0
26432,61100,445,0,0,drop,66,66,0,1,0,1,0
26433,50478,51505,0,0,deny,66,66,0,1,0,1,0
26434,61096,445,0,0,drop,66,66,0,1,0,1,0
26435,60863,445,0,0,drop,70,70,0,1,0,1,0
26436,2886,35440,0,0,deny,66,66,0,1,0,1,0
26437,60861,445,0,0,drop,70,70,0,1,0,1,0
26438,57131,7774,0,0,deny,145,145,0,1,0,1,0
26439,18029,50584,0,0,deny,66,66,0,1,0,1,0
26440,14183,26467,0,0,deny,62,62,0,1,0,1,0
26441,12651,62413,0,0,deny,62,62,0,1,0,1,0
26442,60857,445,0,0,drop,70,70,0,1,0,1,0
26443,62415,57470,0,0,deny,66,66,0,1,0,1,0
26444,49322,445,0,0,drop,70,70,0,1,0,1,0
26445,49320,445,0,0,drop,70,70,0,1,0,1,0
26446,49321,445,0,0,drop,70,70,0,1,0,1,0
26447,13166,57470,0,0,deny,62,62,0,1,0,1,0
26448,60856,445,0,0,drop,70,70,0,1,0,1,0
26449,61082,445,0,0,drop,66,66,0,1,0,1,0
26450,61077,445,0,0,drop,66,66,0,1,0,1,0
26451,61085,445,0,0,drop,66,66,0,1,0,1,0
26452,61083,445,0,0,drop,66,66,0,1,0,1,0
26453,61078,445,0,0,drop,66,66,0,1,0,1,0
26454,61079,445,0,0,drop,66,66,0,1,0,1,0
26455,61080,445,0,0,drop,66,66,0,1,0,1,0
26456,61081,445,0,0,drop,66,66,0,1,0,1,0
26457,3792,52700,0,0,deny,62,62,0,1,0,1,0
26458,24219,1900,0,0,deny,60,60,0,1,0,1,0
26459,34775,5900,0,0,deny,60,60,0,1,0,1,0
26460,62973,51505,0,0,deny,62,62,0,1,0,1,0
26461,55488,57470,0,0,deny,145,145,0,1,0,1,0
26462,60851,445,0,0,drop,70,70,0,1,0,1,0
26463,41744,37965,0,0,deny,62,62,0,1,0,1,0
26464,60155,23718,0,0,deny,66,66,0,1,0,1,0
26465,61430,37965,0,0,deny,66,66,0,1,0,1,0
26466,49316,445,0,0,drop,70,70,0,1,0,1,0
26467,49310,445,0,0,drop,70,70,0,1,0,1,0
26468,49311,445,0,0,drop,70,70,0,1,0,1,0
26469,49305,445,0,0,drop,70,70,0,1,0,1,0
26470,33062,17,0,0,deny,60,60,0,1,0,1,0
26471,61065,445,0,0,drop,66,66,0,1,0,1,0
26472,61064,445,0,0,drop,66,66,0,1,0,1,0
26473,61063,445,0,0,drop,66,66,0,1,0,1,0
26474,59210,50584,0,0,deny,62,62,0,1,0,1,0
26475,57917,44847,0,0,deny,66,66,0,1,0,1,0
26476,62824,37807,0,0,deny,62,62,0,1,0,1,0
26477,3478,61463,0,0,deny,164,164,0,1,0,1,0
26478,50,64147,0,0,deny,62,62,0,1,0,1,0
26479,11136,57587,0,0,deny,62,62,0,1,0,1,0
26480,49300,445,0,0,drop,70,70,0,1,0,1,0
26481,59422,51221,0,0,deny,66,66,0,1,0,1,0
26482,60838,445,0,0,drop,70,70,0,1,0,1,0
26483,49298,445,0,0,drop,70,70,0,1,0,1,0
26484,49290,445,0,0,drop,70,70,0,1,0,1,0
26485,49289,445,0,0,drop,70,70,0,1,0,1,0
26486,19634,64147,0,0,deny,62,62,0,1,0,1,0
26487,59842,62413,0,0,deny,62,62,0,1,0,1,0
26488,3512,23,0,0,deny,60,60,0,1,0,1,0
26489,50799,37807,0,0,deny,62,62,0,1,0,1,0
26490,60835,445,0,0,drop,70,70,0,1,0,1,0
26491,29697,51221,0,0,deny,62,62,0,1,0,1,0
26492,60818,37965,0,0,deny,66,66,0,1,0,1,0
26493,45682,37965,0,0,deny,62,62,0,1,0,1,0
26494,55862,62413,0,0,deny,62,62,0,1,0,1,0
26495,60070,44847,0,0,deny,66,66,0,1,0,1,0
26496,45682,37965,0,0,deny,145,145,0,1,0,1,0
26497,51903,26467,0,0,deny,62,62,0,1,0,1,0
26498,59663,37965,0,0,deny,66,66,0,1,0,1,0
26499,54365,64147,0,0,deny,62,62,0,1,0,1,0
26500,42252,33303,0,0,deny,60,60,0,1,0,1,0
26501,60830,445,0,0,drop,70,70,0,1,0,1,0
26502,5223,14446,0,0,deny,220,220,0,1,0,1,0
26503,49280,445,0,0,drop,70,70,0,1,0,1,0
26504,49278,445,0,0,drop,70,70,0,1,0,1,0
26505,49277,445,0,0,drop,70,70,0,1,0,1,0
26506,57114,35440,0,0,deny,146,146,0,1,0,1,0
26507,64368,22114,0,0,deny,62,62,0,1,0,1,0
26508,60829,445,0,0,drop,70,70,0,1,0,1,0
26509,6703,21247,0,0,deny,62,62,0,1,0,1,0
26510,44681,31573,0,0,deny,146,146,0,1,0,1,0
26511,60827,445,0,0,drop,70,70,0,1,0,1,0
26512,61050,445,0,0,drop,66,66,0,1,0,1,0
26513,15466,41864,0,0,deny,148,148,0,1,0,1,0
26514,62341,26467,0,0,deny,66,66,0,1,0,1,0
26515,24271,52700,0,0,deny,66,66,0,1,0,1,0
26516,49686,44847,0,0,deny,66,66,0,1,0,1,0
26517,53756,50584,0,0,deny,66,66,0,1,0,1,0
26518,37875,55108,0,0,deny,148,148,0,1,0,1,0
26519,49274,445,0,0,drop,70,70,0,1,0,1,0
26520,49266,445,0,0,drop,70,70,0,1,0,1,0
26521,60820,445,0,0,drop,70,70,0,1,0,1,0
26522,60818,445,0,0,drop,70,70,0,1,0,1,0
26523,30948,50584,0,0,deny,146,146,0,1,0,1,0
26524,61038,445,0,0,drop,66,66,0,1,0,1,0
26525,61037,445,0,0,drop,66,66,0,1,0,1,0
26526,27824,51505,0,0,deny,62,62,0,1,0,1,0
26527,63822,14037,0,0,deny,145,145,0,1,0,1,0
26528,60817,445,0,0,drop,70,70,0,1,0,1,0
26529,18608,11392,0,0,deny,66,66,0,1,0,1,0
26530,47910,7454,0,0,deny,60,60,0,1,0,1,0
26531,55421,53,44471,53,allow,200,102,98,2,30,1,1
26532,55756,53,41764,53,allow,747,90,657,2,30,1,1
26533,50630,443,47610,443,allow,5013,968,4045,20,87,11,9
26534,55834,53,38945,53,allow,184,94,90,2,31,1,1
26535,16384,443,23910,443,allow,2227,1018,1209,17,16,8,9
26536,53794,39607,29958,39607,allow,70,70,0,2,8,2,0
26537,49205,29020,24277,29020,allow,316,136,180,6,7,3,3
26538,49791,443,35792,443,allow,20149,14507,5642,40,355,24,16
26539,56261,53,22541,53,allow,184,94,90,2,31,1,1
26540,56072,80,56072,80,allow,23248,1600,21648,35,31,17,18
26541,53795,22719,37217,22719,allow,258,70,188,4,8,2,2
26542,52016,58318,32216,58318,allow,70,70,0,2,9,2,0
26543,61427,443,64293,443,allow,7288,1763,5525,22,77,12,10
26544,61430,443,43160,443,allow,7288,1763,5525,22,77,12,10
26545,58035,80,60635,80,allow,130,70,60,2,15,1,1
26546,60999,53,14276,53,allow,578,286,292,9,16,5,4
26547,53789,47191,44143,47191,allow,70,70,0,2,8,2,0
26548,53793,20468,60935,20468,allow,70,70,0,2,8,2,0
26549,52013,35185,52958,35185,allow,70,70,0,2,9,2,0
26550,56556,53,58365,53,allow,184,94,90,2,31,1,1
26551,50265,31240,10906,31240,allow,726,726,0,12,1200,12,0
26552,57262,53,44073,53,allow,176,90,86,2,30,1,1
26553,58824,443,46343,443,allow,11863,7694,4169,33,17,17,16
26554,34746,80,56625,80,allow,1299,793,506,12,15,6,6
26555,56639,53,16587,53,allow,168,86,82,2,36,1,1
26556,63962,10115,10126,10115,allow,66,66,0,2,8,2,0
26557,61429,443,58099,443,allow,9504,3379,6125,28,77,15,13
26558,53788,1,8231,1,allow,70,70,0,2,8,2,0
26559,43818,80,62769,80,allow,2005,715,1290,8,15,5,3
26560,41650,443,33832,443,allow,6356,1857,4499,48,229,20,28
26561,51988,32239,13198,32239,allow,66,66,0,1,5,1,0
26562,34942,443,50978,443,allow,4317,2189,2128,29,82,15,14
26563,55803,53,28022,53,allow,174,89,85,3,36,2,1
26564,50576,80,50576,80,allow,24419,8463,15956,49,19,25,24
26565,55321,53,43693,53,allow,186,95,91,2,31,1,1
26566,61428,443,21919,443,allow,7276,1763,5513,22,77,12,10
26567,61426,443,49528,443,allow,7348,1763,5585,23,77,12,11
26568,57193,80,36563,80,allow,2235,1055,1180,12,16,7,5
26569,58821,443,62939,443,allow,16200,10803,5397,42,18,24,18
26570,60929,80,45754,80,allow,2235,1055,1180,12,15,7,5
26571,53791,16881,62073,16881,allow,70,70,0,2,8,2,0
26572,61510,80,61510,80,allow,17105,750,16355,21,15,7,14
26573,42650,3389,42650,3389,allow,4930,2691,2239,24,19,14,10
26574,49990,443,43414,443,allow,622,210,412,10,21,4,6
26575,62620,3389,62620,3389,allow,4410,2321,2089,22,18,12,10
26576,60593,80,43950,80,allow,130,70,60,2,15,1,1
26577,56297,53,44253,53,allow,168,86,82,2,30,1,1
26578,55727,53,51328,53,allow,190,97,93,2,30,1,1
26579,55433,443,16673,443,allow,72759,18547,54212,120,137,49,71
26580,49454,80,13717,80,allow,3920,2138,1782,23,135,12,11
26581,27005,12345,8943,12345,allow,898,126,772,2,31,1,1
26582,44847,31105,50353,31105,allow,324,150,174,2,1200,1,1
26583,53930,443,55523,443,allow,33489,2768,30721,44,121,17,27
26584,56917,53,47484,53,allow,188,96,92,2,31,1,1
26585,57176,53,65163,53,allow,793,101,692,2,31,1,1
26586,55002,53,54595,53,allow,192,98,94,2,31,1,1
26587,54712,443,60548,443,allow,5158,2609,2549,11,121,6,5
26588,48886,443,65287,443,allow,8468,2867,5601,23,144,10,13
26589,60816,445,0,0,drop,70,70,0,1,0,1,0
26590,60815,445,0,0,drop,70,70,0,1,0,1,0
26591,45766,35440,0,0,deny,62,62,0,1,0,1,0
26592,60812,445,0,0,drop,70,70,0,1,0,1,0
26593,60811,445,0,0,drop,70,70,0,1,0,1,0
26594,51756,64147,0,0,deny,66,66,0,1,0,1,0
26595,51655,26467,0,0,deny,62,62,0,1,0,1,0
26596,49259,445,0,0,drop,70,70,0,1,0,1,0
26597,49257,445,0,0,drop,70,70,0,1,0,1,0
26598,49256,445,0,0,drop,70,70,0,1,0,1,0
26599,49252,445,0,0,drop,70,70,0,1,0,1,0
26600,15899,37807,0,0,deny,146,146,0,1,0,1,0
26601,51989,29736,26603,29736,allow,160,70,90,2,5,1,1
26602,60018,443,30525,443,allow,8127,1796,6331,21,79,12,9
26603,52278,443,55005,443,allow,7196,1791,5405,18,31,11,7
26604,56297,53,58728,53,allow,168,86,82,2,30,1,1
26605,56783,53,44308,53,allow,193,102,91,2,30,1,1
26606,39742,80,38417,80,allow,1569,593,976,10,44,6,4
26607,59585,443,47956,443,allow,4815,2461,2354,47,58,26,21
26608,59900,443,59900,443,allow,5980,1122,4858,18,58,9,9
26609,50659,443,57690,443,allow,7128,2589,4539,25,37,15,10
26610,9202,80,37636,80,allow,2949,546,2403,11,25,6,5
26611,51540,443,24638,443,allow,957715,36759,920956,1075,161,378,697
26612,50704,80,48490,80,allow,1082,896,186,18,214,15,3
26613,50498,53,36030,53,allow,751,94,657,2,29,1,1
26614,57032,53,53093,53,allow,166,86,80,2,29,1,1
26615,50598,443,44338,443,allow,1653,1010,643,16,94,9,7
26616,54201,443,42354,443,allow,6500,1064,5436,22,255,12,10
26617,50609,443,29620,443,allow,1738,1061,677,18,94,10,8
26618,50640,443,7427,443,allow,1533,950,583,14,85,8,6
26619,57098,80,38453,80,allow,819,530,289,8,40,5,3
26620,50537,443,21381,443,allow,6250,1595,4655,23,150,12,11
26621,39175,80,7841,80,allow,1712,1324,388,11,16,5,6
26622,60858,443,17492,443,allow,64658,47775,16883,115,16,63,52
26623,53797,14550,19741,14550,allow,320,140,180,6,5,3,3
26624,39724,443,26600,443,allow,6128,1344,4784,19,87,12,7
26625,50645,443,5664,443,allow,1514,852,662,16,86,9,7
26626,50585,443,60446,443,allow,1594,951,643,15,97,8,7
26627,50703,80,64252,80,allow,1082,896,186,18,214,15,3
26628,60785,40010,47744,40010,allow,316,136,180,6,5,3,3
26629,5588,5588,0,0,allow,3354,1792,1562,46,192,23,23
26630,53785,33324,40281,33324,allow,70,70,0,2,7,2,0
26631,59994,53,59994,53,allow,86,86,0,1,29,1,0
26632,43014,443,37896,443,allow,134,60,74,3,5,2,1
26633,22278,53,34234,53,allow,806,458,348,3,29,2,1
26634,56169,53,27417,53,allow,210,110,100,2,29,1,1
26635,56109,53,59181,53,allow,323,102,221,2,29,1,1
26636,55387,53,15050,53,allow,195,94,101,2,29,1,1
26637,55907,53,31154,53,allow,184,94,90,2,29,1,1
26638,49444,443,41469,443,allow,2293735,61874,2231861,2321,87,764,1557
26639,55261,53,55428,53,allow,165,86,79,2,29,1,1
26640,57253,53,25140,53,allow,199,102,97,2,29,1,1
26641,58101,53,12737,53,allow,83,83,0,2,31,2,0
26642,64887,53,53065,53,allow,209,110,99,2,30,1,1
26643,55907,53,18173,53,allow,184,94,90,2,30,1,1
26644,55421,53,56436,53,allow,200,102,98,2,30,1,1
26645,52015,25487,58605,25487,allow,70,70,0,2,8,2,0
26646,64219,53,14756,53,allow,403,94,309,4,38,2,2
26647,41279,443,39948,443,allow,8119,1411,6708,20,200,11,9
26648,65439,53,10579,53,allow,228,110,118,2,30,1,1
26649,55002,53,6216,53,allow,196,102,94,2,30,1,1
26650,49207,443,35081,443,allow,2643240,203689,2439551,3285,576,1237,2048
26651,63084,53,39134,53,allow,86,86,0,2,31,2,0
26652,51984,54606,27351,54606,allow,70,70,0,1,5,1,0
26653,51214,443,63195,443,allow,7924,3247,4677,32,71,19,13
26654,58759,443,21160,443,allow,6012,873,5139,18,25,9,9
26655,57326,53,16719,53,allow,180,94,86,2,35,1,1
26656,58432,443,22620,443,allow,26845,11746,15099,187,161,104,83
26657,61422,443,38584,443,allow,8360,1781,6579,23,77,12,11
26658,51997,14398,36359,14398,allow,130,70,60,2,5,1,1
26659,57131,443,18384,443,allow,6489,1065,5424,22,255,12,10
26660,55679,1024,59914,1024,allow,70,70,0,2,8,2,0
26661,56968,443,61875,443,allow,5649,2005,3644,21,186,11,10
26662,15760,53,32222,53,allow,497,83,414,4,30,2,2
26663,49879,53,57267,53,allow,517,95,422,4,44,2,2
26664,49662,53,37093,53,allow,268,93,175,4,59,2,2
26665,56676,53,50057,53,allow,178,94,84,2,30,1,1
26666,63239,443,35910,443,allow,5725,3290,2435,34,125,19,15
26667,55656,53,30150,53,allow,413,102,311,2,30,1,1
26668,57262,53,58338,53,allow,180,94,86,2,30,1,1
26669,52010,443,6265,443,allow,7722,2568,5154,26,63,15,11
26670,58322,53,48798,53,allow,320,94,226,2,30,1,1
26671,45977,53,27186,53,allow,164,78,86,2,30,1,1
26672,48308,443,61860,443,allow,4654,2499,2155,17,31,9,8
26673,56556,53,50468,53,allow,184,94,90,2,30,1,1
26674,57053,53,14001,53,allow,211,102,109,2,30,1,1
26675,59923,53,29358,53,allow,197,78,119,2,30,1,1
26676,56940,80,57845,80,allow,606,70,536,10,278,2,8
26677,56112,53,18781,53,allow,199,102,97,2,30,1,1
26678,55321,53,63193,53,allow,193,102,91,2,30,1,1
26679,51986,41982,32620,41982,allow,70,70,0,1,5,1,0
26680,49991,443,60218,443,allow,622,210,412,10,21,4,6
26681,41052,80,7228,80,allow,1056,682,374,10,15,6,4
26682,49568,80,26293,80,allow,1515,481,1034,11,15,6,5
26683,56297,53,12569,53,allow,168,86,82,2,30,1,1
26684,56561,443,57452,443,allow,341343,9074,332269,353,121,122,231
26685,50811,443,33324,443,allow,2719275,48822,2670453,2459,127,689,1770
26686,61409,443,48164,443,allow,7839,1726,6113,21,77,11,10
26687,55803,53,42450,53,allow,261,89,172,4,38,2,2
26688,50575,80,50575,80,allow,44569,12221,32348,81,19,42,39
26689,56438,53,21882,53,allow,312,94,218,2,30,1,1
26690,56810,53,20653,53,allow,438,180,258,6,30,3,3
26691,53686,19010,53686,19010,allow,70,70,0,1,30,1,0
26692,56653,53,34935,53,allow,78,78,0,1,30,1,0
26693,56740,443,11618,443,allow,456259,379546,76713,1179,364,656,523
26694,63925,53,36572,53,allow,682,199,483,6,46,3,3
26695,49502,80,22198,80,allow,2300864,53111,2247753,2242,18,755,1487
26696,58835,443,42835,443,allow,5166,700,4466,16,15,7,9
26697,64999,53,20323,53,allow,515,86,429,4,45,2,2
26698,37395,443,29125,443,allow,16590,1630,14960,33,199,15,18
26699,50618,443,39503,443,allow,11054,1724,9330,28,91,15,13
26700,50613,443,53382,443,allow,1512,850,662,16,93,9,7
26701,50644,443,24533,443,allow,1514,852,662,16,86,9,7
26702,58760,443,37477,443,allow,5927,794,5133,17,25,8,9
26703,57342,443,57537,443,allow,10761,5724,5037,43,15,25,18
26704,50606,443,59722,443,allow,1511,849,662,16,94,9,7
26705,50611,443,62610,443,allow,11152,2086,9066,33,93,17,16
26706,55681,31948,3131,31948,allow,70,70,0,2,8,2,0
26707,47052,80,21524,80,allow,1217,486,731,8,43,5,3
26708,55677,16588,6838,16588,allow,70,70,0,1,5,1,0
26709,55399,53,4452,53,allow,405,99,306,4,41,2,2
26710,55729,53,41477,53,allow,256,96,160,4,41,2,2
26711,65466,53,9762,53,allow,298,102,196,4,39,2,2
26712,50610,443,21425,443,allow,9469,1273,8196,29,93,15,14
26713,53792,1,12742,1,allow,70,70,0,2,7,2,0
26714,53784,16671,49140,16671,allow,70,70,0,2,7,2,0
26715,51987,23136,41339,23136,allow,70,70,0,1,5,1,0
26716,54828,443,63990,443,allow,70,70,0,1,5,1,0
26717,58885,443,6031,443,allow,152,86,66,2,5,1,1
26718,63240,443,14470,443,allow,1433,734,699,18,125,10,8
26719,59723,443,10674,443,allow,70,70,0,2,5,2,0
26720,49385,53,59773,53,allow,241,102,139,2,29,1,1
26721,64017,53,10978,53,allow,461,94,367,2,29,1,1
26722,55675,49271,26954,49271,allow,504,318,186,8,16,5,3
26723,49500,53,31434,53,allow,248,118,130,2,29,1,1
26724,45344,53,14086,53,allow,538,328,210,3,29,2,1
26725,64775,53,35140,53,allow,445,86,359,2,29,1,1
26726,55727,53,2459,53,allow,195,102,93,2,29,1,1
26727,55068,53,59463,53,allow,196,102,94,2,29,1,1
26728,56112,53,63692,53,allow,199,102,97,2,29,1,1
26729,40204,40034,20615,40034,allow,164,102,62,2,30,1,1
26730,56318,53,21992,53,allow,183,94,89,2,29,1,1
26731,55421,53,33025,53,allow,200,102,98,2,29,1,1
26732,56880,53,13587,53,allow,209,110,99,2,30,1,1
26733,65071,53,37727,53,allow,93,93,0,2,60,2,0
26734,55868,53,39236,53,allow,458,188,270,6,29,3,3
26735,56261,53,2901,53,allow,184,94,90,2,30,1,1
26736,55525,53,3773,53,allow,214,110,104,2,30,1,1
26737,59923,53,7241,53,allow,197,78,119,2,30,1,1
26738,56556,53,6278,53,allow,184,94,90,2,31,1,1
26739,49450,443,1753,443,allow,2319947,69322,2250625,2464,70,870,1594
26740,45753,80,11896,80,allow,48495,10969,37526,83,477,39,44
26741,61418,443,63876,443,allow,7741,1614,6127,21,77,11,10
26742,58096,443,10840,443,allow,7252,1150,6102,22,199,11,11
26743,55678,52879,22607,52879,allow,70,70,0,1,5,1,0
26744,50580,80,50580,80,allow,18727,8262,10465,44,18,23,21
26745,50258,5228,5532,5228,allow,6764,1575,5189,25,157,14,11
26746,59381,53,5162,53,allow,189,78,111,2,30,1,1
26747,55834,53,17845,53,allow,184,94,90,2,30,1,1
26748,56875,53,33833,53,allow,167,86,81,2,30,1,1
26749,59699,443,10810,443,allow,9015,2221,6794,27,421,13,14
26750,50306,443,42473,443,allow,2474,735,1739,11,120,6,5
26751,51221,6889,53258,6889,allow,481,150,331,2,1200,1,1
26752,50265,32988,60132,32988,allow,1488,930,558,21,1200,12,9
26753,36617,443,29137,443,allow,16276,14463,1813,33,95,20,13
26754,56819,443,59951,443,allow,79878,10479,69399,138,120,68,70
26755,49447,443,42024,443,allow,790501,27378,763123,858,86,322,536
26756,46209,443,22477,443,allow,4900,2781,2119,25,95,13,12
26757,45754,80,23823,80,allow,47137,10210,36927,80,477,38,42
26758,9195,80,8495,80,allow,2819,541,2278,12,31,6,6
26759,58758,443,49380,443,allow,4889,1079,3810,15,25,8,7
26760,51982,56306,51670,56306,allow,70,70,0,1,5,1,0
26761,52837,443,26069,443,allow,843201,50940,792261,1191,159,451,740
26762,57130,443,40605,443,allow,6489,1065,5424,22,255,12,10
26763,56917,53,28541,53,allow,194,102,92,2,30,1,1
26764,56427,53,19551,53,allow,166,86,80,2,30,1,1
26765,57262,53,33477,53,allow,180,94,86,2,30,1,1
26766,57683,53,53315,53,allow,243,94,149,2,30,1,1
26767,57343,53,33500,53,allow,181,94,87,2,30,1,1
26768,57262,53,12912,53,allow,180,94,86,2,30,1,1
26769,62415,53,11045,53,allow,86,86,0,2,31,2,0
26770,49451,443,37319,443,allow,1855625,57182,1798443,1981,70,703,1278
26771,57132,443,41283,443,allow,6489,1065,5424,22,255,12,10
26772,65497,443,27033,443,allow,392197,11800,380397,406,16,143,263
26773,58762,443,39294,443,allow,318,192,126,6,25,4,2
26774,52014,20524,1318,20524,allow,70,70,0,2,8,2,0
26775,55680,23711,23434,23711,allow,70,70,0,2,8,2,0
26776,56864,15646,51512,15646,allow,70,70,0,2,8,2,0
26777,51985,38904,1159,38904,allow,70,70,0,1,5,1,0
26778,51983,30472,5988,30472,allow,70,70,0,1,5,1,0
26779,65498,443,2400,443,allow,92290,4799,87491,107,16,43,64
26780,57206,123,21797,123,allow,184,94,90,2,30,1,1
26781,59381,53,57847,53,allow,189,78,111,2,30,1,1
26782,56639,53,41760,53,allow,168,86,82,2,30,1,1
26783,46000,53,44521,53,allow,164,78,86,2,31,1,1
26784,55068,53,43226,53,allow,196,102,94,2,31,1,1
26785,27005,26259,41193,26259,allow,889,126,763,2,31,1,1
26786,51304,443,39350,443,allow,5839,3609,2230,25,361,13,12
26787,30188,23453,55935,23453,allow,502,150,352,2,1200,1,1
26788,50265,14107,11611,14107,allow,132,132,0,3,1200,3,0
26789,55817,53,30944,53,allow,392,102,290,2,30,1,1
26790,64709,53,47288,53,allow,353,118,235,2,30,1,1
26791,48444,53,53992,53,allow,164,78,86,2,30,1,1
26792,53796,53,64571,53,allow,213,78,135,2,30,1,1
26793,37965,58609,35622,58609,allow,15544,7978,7566,132,3153,72,60
26794,55321,53,21988,53,allow,193,102,91,2,31,1,1
26795,55002,53,11641,53,allow,196,102,94,2,31,1,1
26796,27005,33056,50628,33056,allow,885,126,759,2,31,1,1
26797,64500,53,31734,53,allow,212,102,110,2,30,1,1
26798,56419,53,45684,53,allow,199,102,97,2,30,1,1
26799,56279,53,33232,53,allow,228,110,118,2,30,1,1
26800,27005,27015,32670,27015,allow,912,126,786,2,31,1,1
26801,53746,53,62050,53,allow,164,78,86,2,31,1,1
26802,56544,53,44845,53,allow,183,86,97,2,31,1,1
26803,27005,33058,40872,33058,allow,884,126,758,2,31,1,1
26804,65239,443,50519,443,allow,5780,2572,3208,23,120,11,12
26805,55719,443,5079,443,allow,2936,343,2593,12,120,5,7
26806,25,55987,25,55987,allow,118,118,0,1,120,1,0
26807,36685,443,19672,443,allow,10753,1585,9168,24,120,10,14
26808,10151,27715,29644,27715,allow,460,150,310,2,1200,1,1
26809,57346,443,28545,443,allow,72170,4208,67962,102,186,48,54
26810,50584,20824,62214,20824,allow,324,150,174,2,1200,1,1
26811,27005,27015,23860,27015,allow,871,126,745,2,31,1,1
26812,55582,53,48223,53,allow,344,107,237,4,54,2,2
26813,53771,64351,48425,64351,allow,70,70,0,1,5,1,0
26814,5588,5588,0,0,allow,3354,1792,1562,46,193,23,23
26815,62800,80,25172,80,allow,1437,659,778,11,45,6,5
26816,57945,443,56695,443,allow,3522,1763,1759,31,32,16,15
26817,49662,53,31424,53,allow,268,93,175,4,58,2,2
26818,53782,42855,41001,42855,allow,70,70,0,2,8,2,0
26819,49550,80,26667,80,allow,3531,1965,1566,14,29,8,6
26820,60987,443,57213,443,allow,9029,2323,6706,31,16,17,14
26821,55834,53,8445,53,allow,429,94,335,4,52,2,2
26822,56783,53,44833,53,allow,193,102,91,2,30,1,1
26823,59759,53,58276,53,allow,211,78,133,2,30,1,1
26824,55142,53,43974,53,allow,889,404,485,10,30,5,5
26825,55680,53,53324,53,allow,198,94,104,2,30,1,1
26826,44133,53,62526,53,allow,164,78,86,2,30,1,1
26827,61030,445,0,0,drop,66,66,0,1,0,1,0
26828,58251,36237,0,0,deny,66,66,0,1,0,1,0
26829,1330,53567,0,0,deny,146,146,0,1,0,1,0
26830,60797,445,0,0,drop,70,70,0,1,0,1,0
26831,60795,445,0,0,drop,70,70,0,1,0,1,0
26832,60792,445,0,0,drop,70,70,0,1,0,1,0
26833,63910,44847,0,0,deny,66,66,0,1,0,1,0
26834,1903,43890,0,0,deny,62,62,0,1,0,1,0
26835,60787,445,0,0,drop,70,70,0,1,0,1,0
26836,60786,445,0,0,drop,70,70,0,1,0,1,0
26837,61026,445,0,0,drop,66,66,0,1,0,1,0
26838,61024,445,0,0,drop,66,66,0,1,0,1,0
26839,61019,445,0,0,drop,66,66,0,1,0,1,0
26840,61017,445,0,0,drop,66,66,0,1,0,1,0
26841,61020,445,0,0,drop,66,66,0,1,0,1,0
26842,61022,445,0,0,drop,66,66,0,1,0,1,0
26843,61015,445,0,0,drop,66,66,0,1,0,1,0
26844,37633,44847,0,0,deny,62,62,0,1,0,1,0
26845,49245,445,0,0,drop,70,70,0,1,0,1,0
26846,45964,55559,0,0,deny,60,60,0,1,0,1,0
26847,49242,445,0,0,drop,70,70,0,1,0,1,0
26848,49240,445,0,0,drop,70,70,0,1,0,1,0
26849,49238,445,0,0,drop,70,70,0,1,0,1,0
26850,35232,36602,0,0,deny,74,74,0,1,0,1,0
26851,2990,64147,0,0,deny,66,66,0,1,0,1,0
26852,56462,37965,0,0,deny,62,62,0,1,0,1,0
26853,51732,50934,0,0,deny,146,146,0,1,0,1,0
26854,60775,445,0,0,drop,70,70,0,1,0,1,0
26855,7664,2149,0,0,deny,62,62,0,1,0,1,0
26856,2717,31573,0,0,deny,66,66,0,1,0,1,0
26857,58962,23,0,0,deny,60,60,0,1,0,1,0
26858,49234,445,0,0,drop,70,70,0,1,0,1,0
26859,49232,445,0,0,drop,70,70,0,1,0,1,0
26860,49230,445,0,0,drop,70,70,0,1,0,1,0
26861,61009,445,0,0,drop,66,66,0,1,0,1,0
26862,49227,445,0,0,drop,70,70,0,1,0,1,0
26863,38281,37807,0,0,deny,62,62,0,1,0,1,0
26864,61006,445,0,0,drop,66,66,0,1,0,1,0
26865,61004,445,0,0,drop,66,66,0,1,0,1,0
26866,61002,445,0,0,drop,66,66,0,1,0,1,0
26867,60771,445,0,0,drop,70,70,0,1,0,1,0
26868,61001,445,0,0,drop,66,66,0,1,0,1,0
26869,60761,445,0,0,drop,70,70,0,1,0,1,0
26870,60760,445,0,0,drop,70,70,0,1,0,1,0
26871,60762,445,0,0,drop,70,70,0,1,0,1,0
26872,18091,32480,0,0,deny,66,66,0,1,0,1,0
26873,60756,445,0,0,drop,70,70,0,1,0,1,0
26874,57604,32480,0,0,deny,62,62,0,1,0,1,0
26875,60754,445,0,0,drop,70,70,0,1,0,1,0
26876,26092,23,0,0,deny,60,60,0,1,0,1,0
26877,49218,445,0,0,drop,70,70,0,1,0,1,0
26878,25961,55783,0,0,deny,66,66,0,1,0,1,0
26879,24606,55783,0,0,deny,72,72,0,1,0,1,0
26880,31675,23,0,0,deny,60,60,0,1,0,1,0
26881,53469,36237,0,0,deny,66,66,0,1,0,1,0
26882,17489,50584,0,0,deny,146,146,0,1,0,1,0
26883,49214,445,0,0,drop,70,70,0,1,0,1,0
26884,49189,445,0,0,drop,70,70,0,1,0,1,0
26885,10738,50584,0,0,deny,62,62,0,1,0,1,0
26886,57894,44847,0,0,deny,66,66,0,1,0,1,0
26887,60989,445,0,0,drop,66,66,0,1,0,1,0
26888,60748,445,0,0,drop,70,70,0,1,0,1,0
26889,49629,26467,0,0,deny,66,66,0,1,0,1,0
26890,60982,445,0,0,drop,66,66,0,1,0,1,0
26891,49182,445,0,0,drop,70,70,0,1,0,1,0
26892,23349,30188,0,0,deny,146,146,0,1,0,1,0
26893,64346,51505,0,0,deny,66,66,0,1,0,1,0
26894,60740,445,0,0,drop,70,70,0,1,0,1,0
26895,53012,51050,0,0,deny,66,66,0,1,0,1,0
26896,52050,11392,0,0,deny,62,62,0,1,0,1,0
26897,60738,445,0,0,drop,70,70,0,1,0,1,0
26898,60979,445,0,0,drop,66,66,0,1,0,1,0
26899,51414,22,0,0,deny,60,60,0,1,0,1,0
26900,1059,44847,0,0,deny,62,62,0,1,0,1,0
26901,60734,445,0,0,drop,70,70,0,1,0,1,0
26902,5223,14446,0,0,deny,66,66,0,1,0,1,0
26903,60970,445,0,0,drop,66,66,0,1,0,1,0
26904,45682,25604,0,0,deny,62,62,0,1,0,1,0
26905,60732,445,0,0,drop,70,70,0,1,0,1,0
26906,32551,51221,0,0,deny,66,66,0,1,0,1,0
26907,60969,445,0,0,drop,66,66,0,1,0,1,0
26908,51948,17372,0,0,deny,62,62,0,1,0,1,0
26909,43063,57470,0,0,deny,62,62,0,1,0,1,0
26910,58338,3369,0,0,deny,60,60,0,1,0,1,0
26911,60728,445,0,0,drop,70,70,0,1,0,1,0
26912,60438,17372,0,0,deny,66,66,0,1,0,1,0
26913,58475,11392,0,0,deny,66,66,0,1,0,1,0
26914,62709,57470,0,0,deny,62,62,0,1,0,1,0
26915,60727,445,0,0,drop,70,70,0,1,0,1,0
26916,49169,445,0,0,drop,70,70,0,1,0,1,0
26917,49168,445,0,0,drop,70,70,0,1,0,1,0
26918,49170,445,0,0,drop,70,70,0,1,0,1,0
26919,60949,445,0,0,drop,66,66,0,1,0,1,0
26920,60956,445,0,0,drop,66,66,0,1,0,1,0
26921,60951,445,0,0,drop,66,66,0,1,0,1,0
26922,60953,445,0,0,drop,66,66,0,1,0,1,0
26923,60955,445,0,0,drop,66,66,0,1,0,1,0
26924,60954,445,0,0,drop,66,66,0,1,0,1,0
26925,60952,445,0,0,drop,66,66,0,1,0,1,0
26926,60948,445,0,0,drop,66,66,0,1,0,1,0
26927,56386,50584,0,0,deny,62,62,0,1,0,1,0
26928,49203,51050,0,0,deny,62,62,0,1,0,1,0
26929,59763,25604,0,0,deny,62,62,0,1,0,1,0
26930,3478,61463,0,0,deny,164,164,0,1,0,1,0
26931,60722,445,0,0,drop,70,70,0,1,0,1,0
26932,48706,23393,0,0,deny,60,60,0,1,0,1,0
26933,48706,23393,0,0,deny,60,60,0,1,0,1,0
26934,61230,22114,0,0,deny,66,66,0,1,0,1,0
26935,24504,37965,0,0,deny,62,62,0,1,0,1,0
26936,9588,37965,0,0,deny,66,66,0,1,0,1,0
26937,49166,445,0,0,drop,70,70,0,1,0,1,0
26938,49163,445,0,0,drop,70,70,0,1,0,1,0
26939,65528,445,0,0,drop,70,70,0,1,0,1,0
26940,65526,445,0,0,drop,70,70,0,1,0,1,0
26941,0,0,0,0,allow,480,244,236,4,0,2,2
26942,33582,44847,0,0,deny,66,66,0,1,0,1,0
26943,37455,50584,0,0,deny,66,66,0,1,0,1,0
26944,60933,445,0,0,drop,66,66,0,1,0,1,0
26945,60936,445,0,0,drop,66,66,0,1,0,1,0
26946,60934,445,0,0,drop,66,66,0,1,0,1,0
26947,12965,37965,0,0,deny,66,66,0,1,0,1,0
26948,1045,36237,0,0,deny,62,62,0,1,0,1,0
26949,60709,445,0,0,drop,70,70,0,1,0,1,0
26950,56278,52752,0,0,deny,62,62,0,1,0,1,0
26951,65522,445,0,0,drop,70,70,0,1,0,1,0
26952,65515,445,0,0,drop,70,70,0,1,0,1,0
26953,65516,445,0,0,drop,70,70,0,1,0,1,0
26954,65511,445,0,0,drop,70,70,0,1,0,1,0
26955,60706,445,0,0,drop,70,70,0,1,0,1,0
26956,63461,51505,0,0,deny,66,66,0,1,0,1,0
26957,55496,64097,0,0,deny,66,66,0,1,0,1,0
26958,34400,39004,0,0,deny,74,74,0,1,0,1,0
26959,19875,30170,0,0,deny,145,145,0,1,0,1,0
26960,443,62732,0,0,deny,332,332,0,1,0,1,0
26961,56718,50584,0,0,deny,66,66,0,1,0,1,0
26962,2636,11392,0,0,deny,62,62,0,1,0,1,0
26963,14659,11392,0,0,deny,146,146,0,1,0,1,0
26964,60701,445,0,0,drop,70,70,0,1,0,1,0
26965,23483,57470,0,0,deny,109,109,0,1,0,1,0
26966,60700,445,0,0,drop,70,70,0,1,0,1,0
26967,56015,56205,0,0,deny,66,66,0,1,0,1,0
26968,2305,35440,0,0,deny,62,62,0,1,0,1,0
26969,39460,23117,0,0,deny,66,66,0,1,0,1,0
26970,3585,64147,0,0,deny,62,62,0,1,0,1,0
26971,65502,445,0,0,drop,70,70,0,1,0,1,0
26972,65501,445,0,0,drop,70,70,0,1,0,1,0
26973,65498,445,0,0,drop,70,70,0,1,0,1,0
26974,24972,27262,0,0,deny,60,60,0,1,0,1,0
26975,60698,445,0,0,drop,70,70,0,1,0,1,0
26976,60922,445,0,0,drop,66,66,0,1,0,1,0
26977,42366,57470,0,0,deny,66,66,0,1,0,1,0
26978,55123,64097,0,0,deny,66,66,0,1,0,1,0
26979,10329,7774,0,0,deny,143,143,0,1,0,1,0
26980,56638,64147,0,0,deny,62,62,0,1,0,1,0
26981,54999,443,63007,443,allow,6430,1513,4917,26,40,14,12
26982,55012,443,43376,443,allow,7249,1797,5452,29,32,17,12
26983,41170,443,30807,443,allow,8837,1938,6899,21,17,12,9
26984,41169,443,56459,443,allow,8805,1938,6867,21,17,12,9
26985,41730,443,24945,443,allow,760,422,338,12,28,7,5
26986,27005,37579,44292,37579,allow,886,126,760,2,30,1,1
26987,41164,443,60993,443,allow,8949,1938,7011,21,17,12,9
26988,58294,443,58294,443,allow,7356,1014,6342,20,76,10,10
26989,40970,80,47105,80,allow,1052,612,440,10,15,5,5
26990,40858,53,40858,53,allow,200,90,110,2,30,1,1
26991,56783,53,3501,53,allow,186,95,91,2,30,1,1
26992,56419,53,8331,53,allow,198,101,97,2,30,1,1
26993,41168,443,17875,443,allow,8949,1938,7011,21,17,12,9
26994,58815,443,6132,443,allow,11773,7687,4086,31,17,16,15
26995,58829,443,11100,443,allow,2576,1549,1027,15,15,7,8
26996,47167,15000,34015,15000,allow,130,70,60,2,6,1,1
26997,56101,53,1484,53,allow,188,96,92,2,40,1,1
26998,38504,443,56099,443,allow,2227,1018,1209,17,15,8,9
26999,44628,80,44628,80,allow,2898,1485,1413,10,15,6,4
27000,38367,15000,50286,15000,allow,130,70,60,2,5,1,1
27001,53778,6881,15801,6881,allow,70,70,0,1,5,1,0
27002,56014,53,32746,53,allow,711,87,624,2,30,1,1
27003,50710,443,45536,443,allow,1786,172,1614,7,120,3,4
27004,41165,443,56150,443,allow,8949,1938,7011,21,17,12,9
27005,54327,7000,54327,7000,allow,3310,1535,1775,15,15,8,7
27006,53837,15000,29903,15000,allow,130,70,60,2,6,1,1
27007,39058,443,50860,443,allow,70,70,0,1,5,1,0
27008,58832,443,5090,443,allow,3862,2458,1404,16,15,8,8
27009,39057,443,14567,443,allow,70,70,0,1,5,1,0
27010,53772,14132,42222,14132,allow,70,70,0,1,5,1,0
27011,27005,37569,24806,37569,allow,892,126,766,2,30,1,1
27012,26763,443,27928,443,allow,7343,2586,4757,23,20,11,12
27013,58062,443,59135,443,allow,2257,1225,1032,15,18,8,7
27014,54735,443,61550,443,allow,12507,6114,6393,30,90,18,12
27015,50577,80,50577,80,allow,18679,9115,9564,45,18,24,21
27016,48274,15000,32911,15000,allow,130,70,60,2,6,1,1
27017,57748,15000,46693,15000,allow,130,70,60,2,5,1,1
27018,55806,80,22467,80,allow,1248,755,493,7,81,5,2
27019,5588,5588,0,0,allow,3354,1792,1562,46,196,23,23
27020,9104,443,36522,443,allow,6240,1399,4841,24,44,12,12
27021,35173,53,0,0,allow,82,82,0,1,30,1,0
27022,58825,443,1318,443,allow,6357,4318,2039,22,16,11,11
27023,2839,53,2839,53,allow,229,94,135,2,30,1,1
27024,41167,443,51918,443,allow,8869,1938,6931,21,17,12,9
27025,49662,53,40322,53,allow,268,93,175,4,58,2,2
27026,59779,443,18781,443,allow,6055,3602,2453,16,136,8,8
27027,62333,443,30059,443,allow,3170,1556,1614,7,121,3,4
27028,61937,443,25012,443,allow,24420,19966,4454,64,136,35,29
27029,41317,443,52322,443,allow,4555,2276,2279,27,244,9,18
27030,59556,443,25166,443,allow,3888,1169,2719,13,136,6,7
27031,55483,443,25400,443,allow,4496,2369,2127,15,136,7,8
27032,58890,53,0,0,allow,180,82,98,2,31,1,1
27033,61935,443,10080,443,allow,5214,2561,2653,14,136,7,7
27034,41580,443,42075,443,allow,4354,2166,2188,14,136,7,7
27035,63944,30188,0,0,deny,66,66,0,1,0,1,0
27036,7347,56205,0,0,deny,62,62,0,1,0,1,0
27037,57555,35440,0,0,deny,62,62,0,1,0,1,0
27038,16013,35253,0,0,deny,66,66,0,1,0,1,0
27039,60691,445,0,0,drop,70,70,0,1,0,1,0
27040,65493,445,0,0,drop,70,70,0,1,0,1,0
27041,52141,443,17579,443,allow,15637,4217,11420,42,83,19,23
27042,52450,443,7964,443,allow,9648,3653,5995,37,155,19,18
27043,47773,53,42715,53,allow,236,86,150,2,30,1,1
27044,53794,53,8818,53,allow,260,86,174,2,30,1,1
27045,65487,445,0,0,drop,70,70,0,1,0,1,0
27046,60689,445,0,0,drop,70,70,0,1,0,1,0
27047,31780,11392,0,0,deny,146,146,0,1,0,1,0
27048,64957,5555,0,0,deny,60,60,0,1,0,1,0
27049,46640,8880,0,0,deny,60,60,0,1,0,1,0
27050,60688,445,0,0,drop,70,70,0,1,0,1,0
27051,60908,445,0,0,drop,66,66,0,1,0,1,0
27052,60904,445,0,0,drop,66,66,0,1,0,1,0
27053,60687,445,0,0,drop,70,70,0,1,0,1,0
27054,60686,445,0,0,drop,70,70,0,1,0,1,0
27055,60681,445,0,0,drop,70,70,0,1,0,1,0
27056,60680,445,0,0,drop,70,70,0,1,0,1,0
27057,56494,30228,0,0,deny,146,146,0,1,0,1,0
27058,6927,52752,0,0,deny,100,100,0,1,0,1,0
27059,6927,4660,0,0,deny,100,100,0,1,0,1,0
27060,65484,445,0,0,drop,70,70,0,1,0,1,0
27061,14084,43890,0,0,deny,146,146,0,1,0,1,0
27062,60668,445,0,0,drop,70,70,0,1,0,1,0
27063,2572,35440,0,0,deny,62,62,0,1,0,1,0
27064,60666,445,0,0,drop,70,70,0,1,0,1,0
27065,65479,445,0,0,drop,70,70,0,1,0,1,0
27066,65477,445,0,0,drop,70,70,0,1,0,1,0
27067,65472,445,0,0,drop,70,70,0,1,0,1,0
27068,7184,15503,0,0,deny,66,66,0,1,0,1,0
27069,60665,445,0,0,drop,70,70,0,1,0,1,0
27070,7087,23,0,0,deny,60,60,0,1,0,1,0
27071,60900,445,0,0,drop,66,66,0,1,0,1,0
27072,60658,445,0,0,drop,70,70,0,1,0,1,0
27073,60657,445,0,0,drop,70,70,0,1,0,1,0
27074,15320,30188,0,0,deny,146,146,0,1,0,1,0
27075,13062,52752,0,0,deny,66,66,0,1,0,1,0
27076,25101,50584,0,0,deny,62,62,0,1,0,1,0
27077,5223,14446,0,0,deny,66,66,0,1,0,1,0
27078,5223,14446,0,0,deny,119,119,0,1,0,1,0
27079,5223,14446,0,0,deny,167,167,0,1,0,1,0
27080,60897,445,0,0,drop,66,66,0,1,0,1,0
27081,49662,53,17327,53,allow,268,93,175,4,57,2,2
27082,53773,15459,17716,15459,allow,70,70,0,1,4,1,0
27083,58833,443,6455,443,allow,5167,700,4467,16,14,7,9
27084,55010,443,35131,443,allow,9023,4071,4952,30,35,17,13
27085,49204,54530,41547,54530,allow,316,136,180,6,6,3,3
27086,59933,80,46618,80,allow,1756,414,1342,12,15,6,6
27087,51107,80,41417,80,allow,8827,4961,3866,34,47,18,16
27088,65332,53,55664,53,allow,94,94,0,1,30,1,0
27089,51534,443,19846,443,allow,262,70,192,5,21,2,3
27090,49682,53,35686,53,allow,341,110,231,2,29,1,1
27091,56419,53,27801,53,allow,199,102,97,2,30,1,1
27092,37148,53,21111,53,allow,164,78,86,2,30,1,1
27093,63954,53,25119,53,allow,352,102,250,2,29,1,1
27094,56382,53,40376,53,allow,195,102,93,2,29,1,1
27095,37540,443,32914,443,allow,6749,2315,4434,24,46,14,10
27096,56917,53,8537,53,allow,424,104,320,4,30,2,2
27097,27005,30008,37635,30008,allow,881,126,755,2,30,1,1
27098,56419,53,51375,53,allow,199,102,97,2,30,1,1
27099,60475,443,52273,443,allow,585392,18731,566661,623,119,209,414
27100,56261,53,26001,53,allow,184,94,90,2,29,1,1
27101,37965,8999,11644,8999,allow,402,132,270,6,1208,3,3
27102,45755,80,26274,80,allow,52352,11192,41160,90,476,44,46
27103,56119,53,14584,53,allow,199,102,97,2,33,1,1
27104,58831,443,26619,443,allow,5167,700,4467,16,15,7,9
27105,64539,53,38642,53,allow,276,126,150,2,30,1,1
27106,50613,80,37228,80,allow,21942,2323,19619,28,21,11,17
27107,56161,80,10423,80,allow,2670,799,1871,13,46,8,5
27108,55030,443,37524,443,allow,5372,1221,4151,23,18,14,9
27109,4781,443,51838,443,allow,1191,692,499,12,40,7,5
27110,39042,443,16986,443,allow,19733,3606,16127,43,16,22,21
27111,64561,53,25485,53,allow,270,94,176,2,30,1,1
27112,49459,443,10186,443,allow,10166,3392,6774,35,133,18,17
27113,41480,443,25670,443,allow,6004,1688,4316,22,29,13,9
27114,55081,443,63191,443,allow,19866,7188,12678,18,151,7,11
27115,55548,53,39542,53,allow,197,102,95,2,35,1,1
27116,48346,80,10787,80,allow,1878,1444,434,14,15,7,7
27117,49912,53,25675,53,allow,246,102,144,2,30,1,1
27118,63945,28291,25473,28291,allow,504,382,122,8,15,6,2
27119,43286,80,30144,80,allow,1638,1324,314,10,15,5,5
27120,55281,53,62349,53,allow,94,94,0,1,30,1,0
27121,57915,443,51000,443,allow,4103,2950,1153,26,131,16,10
27122,64811,53,63660,53,allow,446,93,353,4,55,2,2
27123,28618,53,13005,53,allow,236,86,150,2,30,1,1
27124,55972,53,37415,53,allow,699,438,261,2,30,1,1
27125,40207,80,3053,80,allow,1364,860,504,13,32,8,5
27126,37155,443,46832,443,allow,7303,2206,5097,23,255,12,11
27127,49219,53,24039,53,allow,264,102,162,2,30,1,1
27128,43659,443,24456,443,allow,17592,11518,6074,51,248,26,25
27129,60093,443,38976,443,allow,292,172,120,4,15,2,2
27130,51547,443,7780,443,allow,202,70,132,3,11,1,2
27131,53764,6881,51389,6881,allow,1463,821,642,15,15,8,7
27132,58830,443,23946,443,allow,5168,700,4468,16,15,7,9
27133,51538,443,33433,443,allow,262,70,192,5,21,2,3
27134,57910,443,61063,443,allow,1853,1214,639,18,156,11,7
27135,57912,443,23938,443,allow,7953,5153,2800,33,142,19,14
27136,45756,80,2776,80,allow,41602,9508,32094,72,476,36,36
27137,64819,53,53319,53,allow,198,94,104,2,30,1,1
27138,48300,443,42844,443,allow,7762,2247,5515,21,31,11,10
27139,51912,45007,7239,45007,allow,1345,679,666,9,30,5,4
27140,56119,53,4548,53,allow,199,102,97,2,30,1,1
27141,64660,53,61374,53,allow,278,94,184,2,30,1,1
27142,64924,53,49056,53,allow,292,126,166,2,30,1,1
27143,65269,53,14472,53,allow,237,94,143,2,30,1,1
27144,39040,443,45031,443,allow,25034,7042,17992,58,21,29,29
27145,39043,443,33177,443,allow,4832,3054,1778,27,16,14,13
27146,64121,443,64564,443,allow,1411,852,559,13,24,7,6
27147,60359,443,21791,443,allow,9607,3847,5760,51,134,26,25
27148,35628,443,42437,443,allow,7840,1829,6011,24,85,14,10
27149,51260,80,52216,80,allow,23175,13071,10104,134,1929,67,67
27150,51106,80,9259,80,allow,9767,6194,3573,40,47,21,19
27151,51108,80,61739,80,allow,6504,3994,2510,26,47,14,12
27152,60782,20010,60186,20010,allow,70,70,0,2,8,2,0
27153,53787,1,62839,1,allow,320,140,180,6,6,3,3
27154,53777,62955,56420,62955,allow,70,70,0,1,4,1,0
27155,53776,37650,38223,37650,allow,70,70,0,1,4,1,0
27156,53266,443,13911,443,allow,12822,4426,8396,42,18,24,18
27157,49261,80,5363,80,allow,3802643,113349,3689294,3463,206,982,2481
27158,42166,443,20816,443,allow,5309,3110,2199,36,81,18,18
27159,55475,53,3330,53,allow,381,102,279,4,44,2,2
27160,50629,80,39121,80,allow,1658,1247,411,8,15,5,3
27161,55002,443,46892,443,allow,6953,2447,4506,26,37,15,11
27162,57913,443,41913,443,allow,1853,1214,639,18,142,11,7
27163,55013,443,19104,443,allow,7531,1773,5758,30,32,17,13
27164,27005,27056,32268,27056,allow,908,126,782,2,30,1,1
27165,45052,443,46441,443,allow,6084,1723,4361,23,201,13,10
27166,53795,53,11623,53,allow,224,86,138,2,30,1,1
27167,64127,53,10956,53,allow,471,182,289,6,57,3,3
27168,49438,443,56354,443,allow,13740,5392,8348,35,134,18,17
27169,54161,443,65319,443,allow,3157,1827,1330,23,15,11,12
27170,59722,443,18746,443,allow,70,70,0,2,5,2,0
27171,51539,443,19176,443,allow,262,70,192,5,21,2,3
27172,58828,443,9559,443,allow,5166,700,4466,16,15,7,9
27173,55673,54815,52506,54815,allow,316,190,126,5,15,3,2
27174,52467,443,14984,443,allow,5343,1102,4241,22,152,11,11
27175,60854,443,16841,443,allow,10447,2417,8030,26,16,15,11
27176,49419,443,41592,443,allow,318,192,126,6,15,4,2
27177,55014,80,6896,80,allow,1573,1145,428,13,32,8,5
27178,54996,443,52291,443,allow,8637,2889,5748,40,41,23,17
27179,27651,53,46551,53,allow,225,78,147,2,30,1,1
27180,64567,443,55637,443,allow,272081,11032,261049,304,139,107,197
27181,51619,443,27223,443,allow,13526,2192,11334,32,141,16,16
27182,40888,8434,40888,8434,allow,156,156,0,3,8,3,0
27183,60453,24369,51749,24369,allow,70,70,0,2,8,2,0
27184,57911,443,43789,443,allow,10141,5997,4144,56,156,28,28
27185,56783,53,7045,53,allow,193,102,91,2,30,1,1
27186,49356,443,28911,443,allow,5946,1254,4692,20,33,10,10
27187,43661,443,21697,443,allow,11255,7612,3643,36,248,19,17
27188,58057,443,19504,443,allow,6821,1076,5745,21,38,12,9
27189,60452,62582,61377,62582,allow,70,70,0,2,8,2,0
27190,9517,23,9517,23,allow,66,66,0,1,5,1,0
27191,34734,5222,46866,5222,allow,7064,2904,4160,68,88,33,35
27192,47166,443,47166,443,allow,4567,1660,2907,19,28,11,8
27193,65444,53,15259,53,allow,86,86,0,1,30,1,0
27194,32299,40015,58130,40015,allow,148,86,62,2,30,1,1
27195,55747,53,24250,53,allow,258,102,156,2,30,1,1
27196,55377,53,7280,53,allow,164,78,86,2,30,1,1
27197,64119,53,14375,53,allow,259,102,157,2,30,1,1
27198,59762,80,15903,80,allow,1278,774,504,12,361,7,5
27199,65511,53,1627,53,allow,212,102,110,2,30,1,1
27200,57470,22468,25297,22468,allow,726,726,0,12,1200,12,0
27201,57240,53,57857,53,allow,215,94,121,2,30,1,1
27202,5497,53,2342,53,allow,208,78,130,2,30,1,1
27203,49222,53,15691,53,allow,199,94,105,2,30,1,1
27204,49296,443,49940,443,allow,20862040,250452,20611588,16880,170,1832,15048
27205,55739,443,29426,443,allow,10875114,348643,10526471,11702,194,3853,7849
27206,42263,443,55947,443,allow,6431,1665,4766,22,275,12,10
27207,19473,53813,59984,53813,allow,481,150,331,2,1200,1,1
27208,57470,43323,55435,43323,allow,2292,332,1960,11,1200,5,6
27209,9122,80,61976,80,allow,98161,5033,93128,125,37,45,80
27210,51980,45478,64521,45478,allow,70,70,0,1,5,1,0
27211,60983,443,50042,443,allow,7458,2832,4626,26,16,15,11
27212,50610,80,53401,80,allow,3726,1504,2222,13,21,7,6
27213,9123,80,23605,80,allow,65336,2808,62528,73,37,28,45
27214,61415,80,27732,80,allow,28257,2893,25364,64,138,30,34
27215,61408,80,60964,80,allow,420720,29056,391664,771,159,325,446
27216,49418,443,14696,443,allow,318,192,126,6,16,4,2
27217,58827,443,27580,443,allow,5167,700,4467,16,15,7,9
27218,55023,443,26981,443,allow,8527,2218,6309,30,26,17,13
27219,58056,443,24409,443,allow,6821,1076,5745,21,38,12,9
27220,50025,53,20225,53,allow,215,94,121,2,30,1,1
27221,64615,53,13915,53,allow,386,134,252,2,30,1,1
27222,64726,53,22205,53,allow,231,94,137,2,30,1,1
27223,49604,53,53151,53,allow,179,94,85,2,30,1,1
27224,33965,443,25810,443,allow,1409634,52704,1356930,1536,173,533,1003
27225,55006,443,44050,443,allow,2900,2007,893,20,36,12,8
27226,61418,80,59402,80,allow,31954,2972,28982,71,138,36,35
27227,50510,443,23339,443,allow,2259313,91208,2168105,2847,1409,1118,1729
27228,9150,443,24673,443,allow,16023,3677,12346,42,37,21,21
27229,55003,443,26179,443,allow,7925,2114,5811,27,37,16,11
27230,32805,80,38439,80,allow,7450,2372,5078,26,24,15,11
27231,49167,443,26021,443,allow,8271,1357,6914,26,17,12,14
27232,49513,443,49513,443,allow,140969,40311,100658,180,68,92,88
27233,49512,53,64595,53,allow,210,102,108,2,30,1,1
27234,27910,53,18233,53,allow,211,94,117,2,30,1,1
27235,49289,53,50733,53,allow,322,118,204,2,30,1,1
27236,62334,443,24621,443,allow,3244,1630,1614,8,120,4,4
27237,60896,445,0,0,drop,66,66,0,1,0,1,0
27238,60895,445,0,0,drop,66,66,0,1,0,1,0
27239,60894,445,0,0,drop,66,66,0,1,0,1,0
27240,60891,445,0,0,drop,66,66,0,1,0,1,0
27241,60887,445,0,0,drop,66,66,0,1,0,1,0
27242,60885,445,0,0,drop,66,66,0,1,0,1,0
27243,52184,22114,0,0,deny,66,66,0,1,0,1,0
27244,53816,22114,0,0,deny,62,62,0,1,0,1,0
27245,65422,26467,0,0,deny,62,62,0,1,0,1,0
27246,65470,445,0,0,drop,70,70,0,1,0,1,0
27247,65465,445,0,0,drop,70,70,0,1,0,1,0
27248,65463,445,0,0,drop,70,70,0,1,0,1,0
27249,65461,445,0,0,drop,70,70,0,1,0,1,0
27250,65012,32468,0,0,deny,62,62,0,1,0,1,0
27251,40598,23,0,0,deny,60,60,0,1,0,1,0
27252,62079,30188,0,0,deny,66,66,0,1,0,1,0
27253,60646,445,0,0,drop,70,70,0,1,0,1,0
27254,28317,35776,0,0,deny,146,146,0,1,0,1,0
27255,58276,43890,0,0,deny,66,66,0,1,0,1,0
27256,39600,5900,0,0,deny,60,60,0,1,0,1,0
27257,11136,19910,0,0,deny,62,62,0,1,0,1,0
27258,3529,25773,0,0,reset-both,143,143,0,1,0,1,0
27259,65259,37965,0,0,deny,62,62,0,1,0,1,0
27260,65460,445,0,0,drop,70,70,0,1,0,1,0
27261,12986,64147,0,0,deny,62,62,0,1,0,1,0
27262,65459,445,0,0,drop,70,70,0,1,0,1,0
27263,65456,445,0,0,drop,70,70,0,1,0,1,0
27264,60311,56205,0,0,deny,66,66,0,1,0,1,0
27265,60879,445,0,0,drop,66,66,0,1,0,1,0
27266,65452,445,0,0,drop,70,70,0,1,0,1,0
27267,60641,445,0,0,drop,70,70,0,1,0,1,0
27268,40742,2967,0,0,deny,62,62,0,1,0,1,0
27269,60876,445,0,0,drop,66,66,0,1,0,1,0
27270,17786,44847,0,0,deny,62,62,0,1,0,1,0
27271,60873,445,0,0,drop,66,66,0,1,0,1,0
27272,60874,445,0,0,drop,66,66,0,1,0,1,0
27273,60872,445,0,0,drop,66,66,0,1,0,1,0
27274,60632,445,0,0,drop,70,70,0,1,0,1,0
27275,60633,445,0,0,drop,70,70,0,1,0,1,0
27276,60631,445,0,0,drop,70,70,0,1,0,1,0
27277,60628,445,0,0,drop,70,70,0,1,0,1,0
27278,60625,445,0,0,drop,70,70,0,1,0,1,0
27279,59366,35440,0,0,deny,66,66,0,1,0,1,0
27280,65444,445,0,0,drop,70,70,0,1,0,1,0
27281,65441,445,0,0,drop,70,70,0,1,0,1,0
27282,65437,445,0,0,drop,70,70,0,1,0,1,0
27283,38885,21247,0,0,deny,62,62,0,1,0,1,0
27284,60861,445,0,0,drop,66,66,0,1,0,1,0
27285,64104,53,45169,53,allow,288,101,187,4,28,2,2
27286,58195,38303,0,0,deny,66,66,0,1,0,1,0
27287,60619,445,0,0,drop,70,70,0,1,0,1,0
27288,22194,31573,0,0,deny,146,146,0,1,0,1,0
27289,59934,35440,0,0,deny,66,66,0,1,0,1,0
27290,48186,51050,0,0,deny,62,62,0,1,0,1,0
27291,54973,1433,0,0,deny,60,60,0,1,0,1,0
27292,57393,48983,0,0,deny,146,146,0,1,0,1,0
27293,29577,64147,0,0,deny,62,62,0,1,0,1,0
27294,33651,36237,0,0,deny,62,62,0,1,0,1,0
27295,60853,445,0,0,drop,66,66,0,1,0,1,0
27296,55524,46232,0,0,deny,66,66,0,1,0,1,0
27297,60612,445,0,0,drop,70,70,0,1,0,1,0
27298,65424,445,0,0,drop,70,70,0,1,0,1,0
27299,60609,445,0,0,drop,70,70,0,1,0,1,0
27300,24127,56205,0,0,deny,66,66,0,1,0,1,0
27301,14693,64147,0,0,deny,66,66,0,1,0,1,0
27302,7364,50584,0,0,deny,66,66,0,1,0,1,0
27303,44344,23,0,0,deny,60,60,0,1,0,1,0
27304,54752,31573,0,0,deny,66,66,0,1,0,1,0
27305,60851,445,0,0,drop,66,66,0,1,0,1,0
27306,14487,38303,0,0,deny,146,146,0,1,0,1,0
27307,60606,445,0,0,drop,70,70,0,1,0,1,0
27308,60604,445,0,0,drop,70,70,0,1,0,1,0
27309,52459,33890,0,0,deny,60,60,0,1,0,1,0
27310,16985,57866,0,0,deny,66,66,0,1,0,1,0
27311,10736,35440,0,0,deny,62,62,0,1,0,1,0
27312,60842,445,0,0,drop,66,66,0,1,0,1,0
27313,59886,64147,0,0,deny,72,72,0,1,0,1,0
27314,51453,64147,0,0,deny,66,66,0,1,0,1,0
27315,60839,445,0,0,drop,66,66,0,1,0,1,0
27316,10834,50584,0,0,deny,62,62,0,1,0,1,0
27317,3478,61463,0,0,deny,164,164,0,1,0,1,0
27318,60600,445,0,0,drop,70,70,0,1,0,1,0
27319,60599,445,0,0,drop,70,70,0,1,0,1,0
27320,443,60496,0,0,deny,60,60,0,1,0,1,0
27321,3597,11392,0,0,deny,62,62,0,1,0,1,0
27322,65415,445,0,0,drop,70,70,0,1,0,1,0
27323,65412,445,0,0,drop,70,70,0,1,0,1,0
27324,65413,445,0,0,drop,70,70,0,1,0,1,0
27325,60822,445,0,0,drop,66,66,0,1,0,1,0
27326,60828,445,0,0,drop,66,66,0,1,0,1,0
27327,60825,445,0,0,drop,66,66,0,1,0,1,0
27328,60826,445,0,0,drop,66,66,0,1,0,1,0
27329,60823,445,0,0,drop,66,66,0,1,0,1,0
27330,60821,445,0,0,drop,66,66,0,1,0,1,0
27331,60824,445,0,0,drop,66,66,0,1,0,1,0
27332,60820,445,0,0,drop,66,66,0,1,0,1,0
27333,63848,64147,0,0,deny,66,66,0,1,0,1,0
27334,60594,445,0,0,drop,70,70,0,1,0,1,0
27335,40977,21247,0,0,deny,66,66,0,1,0,1,0
27336,57459,51505,0,0,deny,66,66,0,1,0,1,0
27337,51287,26467,0,0,deny,66,66,0,1,0,1,0
27338,52830,22114,0,0,deny,62,62,0,1,0,1,0
27339,7310,44847,0,0,deny,62,62,0,1,0,1,0
27340,65419,26467,0,0,deny,62,62,0,1,0,1,0
27341,1026,8305,0,0,deny,148,148,0,1,0,1,0
27342,65406,445,0,0,drop,70,70,0,1,0,1,0
27343,65404,445,0,0,drop,70,70,0,1,0,1,0
27344,65405,445,0,0,drop,70,70,0,1,0,1,0
27345,65396,445,0,0,drop,70,70,0,1,0,1,0
27346,7372,61248,0,0,reset-both,139,139,0,1,0,1,0
27347,51934,36180,0,0,deny,62,62,0,1,0,1,0
27348,56460,22114,0,0,deny,146,146,0,1,0,1,0
27349,60807,445,0,0,drop,66,66,0,1,0,1,0
27350,60806,445,0,0,drop,66,66,0,1,0,1,0
27351,60805,445,0,0,drop,66,66,0,1,0,1,0
27352,35291,44847,0,0,deny,66,66,0,1,0,1,0
27353,60581,445,0,0,drop,70,70,0,1,0,1,0
27354,3375,35253,0,0,deny,66,66,0,1,0,1,0
27355,44411,37965,0,0,deny,62,62,0,1,0,1,0
27356,61461,50584,0,0,deny,66,66,0,1,0,1,0
27357,60771,58414,0,0,deny,62,62,0,1,0,1,0
27358,60578,445,0,0,drop,70,70,0,1,0,1,0
27359,65390,445,0,0,drop,70,70,0,1,0,1,0
27360,65385,445,0,0,drop,70,70,0,1,0,1,0
27361,65381,445,0,0,drop,70,70,0,1,0,1,0
27362,2598,23718,0,0,deny,66,66,0,1,0,1,0
27363,37168,443,59171,443,allow,17716,5150,12566,48,21,25,23
27364,52288,443,59643,443,allow,38314,11683,26631,76,34,38,38
27365,56964,443,49041,443,allow,8085,2164,5921,22,86,12,10
27366,9185,80,20640,80,allow,17855,1067,16788,26,35,11,15
27367,51617,15000,54264,15000,allow,130,70,60,2,5,1,1
27368,21585,443,21585,443,allow,14344,1146,13198,25,19,11,14
27369,58814,443,65401,443,allow,6508,4230,2278,22,16,12,10
27370,55019,443,55019,443,allow,3773,2325,1448,24,18,13,11
27371,47090,15000,28011,15000,allow,138,78,60,2,5,1,1
27372,58566,443,36573,443,allow,34405,7602,26803,53,35,24,29
27373,56168,53,62337,53,allow,745,93,652,2,30,1,1
27374,43708,53,62627,53,allow,168,78,90,2,30,1,1
27375,46081,443,10510,443,allow,125213,5113,120100,153,96,58,95
27376,51588,80,26710,80,allow,2016,1050,966,21,300,11,10
27377,41163,443,48910,443,allow,9045,1938,7107,21,16,12,9
27378,9142,80,13917,80,allow,54219,1884,52335,61,37,23,38
27379,20147,53,20147,53,allow,219,87,132,2,30,1,1
27380,37651,443,37651,443,allow,4659,1752,2907,19,30,11,8
27381,55022,60100,63915,60100,allow,1550,1130,420,15,25,9,6
27382,55427,53,54288,53,allow,200,102,98,2,30,1,1
27383,52012,63475,43517,63475,allow,316,136,180,6,7,3,3
27384,34100,443,31456,443,allow,2044,1024,1020,17,80,9,8
27385,49826,443,3257,443,allow,102548,19098,83450,140,35,60,80
27386,55807,80,52839,80,allow,73021,1232,71789,66,80,14,52
27387,53781,36366,44419,36366,allow,70,70,0,2,8,2,0
27388,57388,53,36277,53,allow,732,89,643,2,30,1,1
27389,57326,53,28871,53,allow,90,90,0,1,30,1,0
27390,53751,443,64587,443,allow,61501,14276,47225,91,35,39,52
27391,21519,443,21519,443,allow,14483,1152,13331,27,19,12,15
27392,47820,443,39799,443,allow,1132,596,536,17,28,9,8
27393,44722,80,3568,80,allow,3162,1159,2003,14,16,8,6
27394,19052,7000,19052,7000,allow,2205,815,1390,13,16,7,6
27395,58507,80,58507,80,allow,348,132,216,6,26,3,3
27396,49169,443,62824,443,allow,11168,3827,7341,42,16,20,22
27397,50248,443,36330,443,allow,8882,3013,5869,29,137,14,15
27398,40022,443,32042,443,allow,6073,1628,4445,23,15,12,11
27399,9187,443,51654,443,allow,158704,5074,153630,184,34,69,115
27400,21839,443,21839,443,allow,13003,1226,11777,25,19,12,13
27401,9186,80,65016,80,allow,17643,1063,16580,26,35,11,15
27402,21716,443,21716,443,allow,10913,762,10151,17,19,7,10
27403,41166,443,62560,443,allow,8933,1938,6995,21,16,12,9
27404,53769,8999,60336,8999,allow,70,70,0,1,5,1,0
27405,58811,443,3266,443,allow,10704,7055,3649,29,17,15,14
27406,45121,15000,17487,15000,allow,130,70,60,2,5,1,1
27407,50193,3389,50193,3389,allow,3473,1518,1955,17,19,9,8
27408,55840,53,9224,53,allow,170,87,83,2,30,1,1
27409,32486,443,32486,443,allow,5497,2520,2977,20,16,11,9
27410,50288,53,0,0,allow,82,82,0,1,30,1,0
27411,58813,443,14180,443,allow,6475,4197,2278,22,16,12,10
27412,56501,53,62547,53,allow,711,87,624,2,31,1,1
27413,64116,53,59357,53,allow,87,87,0,1,31,1,0
27414,53568,443,10135,443,allow,12646,7169,5477,53,198,25,28
27415,54472,443,49806,443,allow,6732,2308,4424,21,141,9,12
27416,56629,53,58033,53,allow,182,93,89,2,30,1,1
27417,64980,53,39962,53,allow,90,90,0,1,31,1,0
27418,53713,443,10339,443,allow,33323,3349,29974,45,123,18,27
27419,41937,53,0,0,allow,82,82,0,1,31,1,0
27420,50017,3389,50017,3389,allow,3428,1714,1714,16,34,8,8
27421,57293,443,21825,443,allow,5161,2421,2740,14,122,7,7
27422,6881,43642,35387,43642,allow,150,150,0,1,1201,1,0
27423,62417,443,4381,443,allow,79513,7480,72033,106,122,39,67
27424,49288,443,26857,443,allow,7332,2907,4425,50,122,22,28
27425,32996,443,27619,443,allow,160,69,91,2,120,1,1
27426,54678,443,37690,443,allow,84066,79714,4352,98,125,66,32
27427,30960,45746,57659,45746,allow,330,330,0,6,3609,6,0
27428,21133,51413,31456,51413,allow,459,149,310,2,1200,1,1
27429,26713,64147,0,0,deny,62,62,0,1,0,1,0
27430,33886,39127,0,0,deny,162,162,0,1,0,1,0
27431,55689,37965,0,0,deny,66,66,0,1,0,1,0
27432,60574,445,0,0,drop,70,70,0,1,0,1,0
27433,58488,37965,0,0,deny,62,62,0,1,0,1,0
27434,60572,445,0,0,drop,70,70,0,1,0,1,0
27435,4581,23,0,0,deny,60,60,0,1,0,1,0
27436,60570,445,0,0,drop,70,70,0,1,0,1,0
27437,25901,50265,0,0,deny,62,62,0,1,0,1,0
27438,26330,26348,0,0,deny,62,62,0,1,0,1,0
27439,65374,445,0,0,drop,70,70,0,1,0,1,0
27440,65372,445,0,0,drop,70,70,0,1,0,1,0
27441,49236,53,51973,53,allow,377,94,283,2,30,1,1
27442,65368,445,0,0,drop,70,70,0,1,0,1,0
27443,60794,445,0,0,drop,66,66,0,1,0,1,0
27444,443,62732,0,0,deny,332,332,0,1,0,1,0
27445,62493,50584,0,0,deny,62,62,0,1,0,1,0
27446,60180,31573,0,0,deny,146,146,0,1,0,1,0
27447,4581,23,0,0,deny,60,60,0,1,0,1,0
27448,35232,36602,0,0,deny,74,74,0,1,0,1,0
27449,60563,445,0,0,drop,70,70,0,1,0,1,0
27450,53519,64147,0,0,deny,66,66,0,1,0,1,0
27451,60560,445,0,0,drop,70,70,0,1,0,1,0
27452,65365,445,0,0,drop,70,70,0,1,0,1,0
27453,65359,445,0,0,drop,70,70,0,1,0,1,0
27454,6666,16010,0,0,deny,60,60,0,1,0,1,0
27455,60559,445,0,0,drop,70,70,0,1,0,1,0
27456,60558,445,0,0,drop,70,70,0,1,0,1,0
27457,60557,445,0,0,drop,70,70,0,1,0,1,0
27458,60555,445,0,0,drop,70,70,0,1,0,1,0
27459,60554,445,0,0,drop,70,70,0,1,0,1,0
27460,60777,445,0,0,drop,66,66,0,1,0,1,0
27461,60778,445,0,0,drop,66,66,0,1,0,1,0
27462,26553,57470,0,0,deny,66,66,0,1,0,1,0
27463,61589,21247,0,0,deny,66,66,0,1,0,1,0
27464,26698,57470,0,0,deny,62,62,0,1,0,1,0
27465,63672,22114,0,0,deny,62,62,0,1,0,1,0
27466,63963,50584,0,0,deny,66,66,0,1,0,1,0
27467,3341,23117,0,0,deny,66,66,0,1,0,1,0
27468,48080,22,0,0,deny,60,60,0,1,0,1,0
27469,52938,64097,0,0,deny,66,66,0,1,0,1,0
27470,50135,50584,0,0,deny,62,62,0,1,0,1,0
27471,60539,445,0,0,drop,70,70,0,1,0,1,0
27472,60537,445,0,0,drop,70,70,0,1,0,1,0
27473,60536,445,0,0,drop,70,70,0,1,0,1,0
27474,28580,64147,0,0,deny,62,62,0,1,0,1,0
27475,65357,445,0,0,drop,70,70,0,1,0,1,0
27476,60528,445,0,0,drop,70,70,0,1,0,1,0
27477,60529,445,0,0,drop,70,70,0,1,0,1,0
27478,13334,41615,0,0,deny,145,145,0,1,0,1,0
27479,64543,50265,0,0,deny,66,66,0,1,0,1,0
27480,65344,445,0,0,drop,70,70,0,1,0,1,0
27481,65347,445,0,0,drop,70,70,0,1,0,1,0
27482,65343,445,0,0,drop,70,70,0,1,0,1,0
27483,60774,445,0,0,drop,66,66,0,1,0,1,0
27484,14696,42707,0,0,deny,62,62,0,1,0,1,0
27485,54614,37807,0,0,deny,66,66,0,1,0,1,0
27486,55616,56205,0,0,deny,62,62,0,1,0,1,0
27487,33405,37965,0,0,deny,62,62,0,1,0,1,0
27488,61639,37965,0,0,deny,66,66,0,1,0,1,0
27489,60757,445,0,0,drop,66,66,0,1,0,1,0
27490,65404,53,13922,53,allow,256,94,162,2,30,1,1
27491,57983,443,8445,443,allow,315701,12378,303323,358,137,129,229
27492,61409,80,63776,80,allow,201243,14555,186688,357,158,145,212
27493,9119,80,62063,80,allow,8732,2438,6294,23,36,11,12
27494,49197,2710,8644,2710,allow,70,70,0,2,7,2,0
27495,62071,443,12103,443,allow,134,60,74,3,4,2,1
27496,55548,53,2209,53,allow,197,102,95,2,29,1,1
27497,55027,53,44978,53,allow,177,94,83,2,29,1,1
27498,56056,53,42855,53,allow,164,86,78,2,29,1,1
27499,50480,443,52040,443,allow,14848,6716,8132,32,30,17,15
27500,50611,80,6797,80,allow,2933,1237,1696,12,20,7,5
27501,36562,443,34526,443,allow,3452,1535,1917,18,82,10,8
27502,58554,80,58554,80,allow,348,132,216,6,26,3,3
27503,55027,443,20215,443,allow,19367,11346,8021,47,19,26,21
27504,56727,443,57540,443,allow,7889,1900,5989,20,14,11,9
27505,65514,53,61722,53,allow,291,98,193,4,33,2,2
27506,9120,80,19755,80,allow,326320,11951,314369,346,36,122,224
27507,52011,10722,20939,10722,allow,70,70,0,2,7,2,0
27508,55001,443,43698,443,allow,8182,3793,4389,27,37,16,11
27509,56726,443,29318,443,allow,7941,1952,5989,20,15,11,9
27510,51589,80,62521,80,allow,2091,1098,993,21,300,11,10
27511,9146,443,17435,443,allow,10056,2310,7746,27,36,14,13
27512,9184,80,49214,80,allow,2066,651,1415,11,35,6,5
27513,62050,443,56297,443,allow,7955,2503,5452,33,16,19,14
27514,35180,443,55162,443,allow,13838,1370,12468,26,34,13,13
27515,56629,53,53878,53,allow,183,94,89,2,30,1,1
27516,65438,53,17432,53,allow,332,94,238,2,29,1,1
27517,56056,53,12861,53,allow,172,94,78,2,29,1,1
27518,55840,53,55617,53,allow,177,94,83,2,30,1,1
27519,64730,53,52714,53,allow,1152,86,1066,2,29,1,1
27520,54496,53,1798,53,allow,164,86,78,2,29,1,1
27521,49698,443,62719,443,allow,14762,1871,12891,30,34,16,14
27522,64703,53,47599,53,allow,306,142,164,2,30,1,1
27523,36394,443,29956,443,allow,8714,1606,7108,24,34,12,12
27524,56724,443,37476,443,allow,7941,1952,5989,20,15,11,9
27525,49432,53,61997,53,allow,312,94,218,2,30,1,1
27526,42894,443,60082,443,allow,448,78,370,6,25,1,5
27527,60730,443,25640,443,allow,5518,1221,4297,16,90,10,6
27528,56541,53,2371,53,allow,294,142,152,2,30,1,1
27529,52601,443,40695,443,allow,2046,1026,1020,17,80,9,8
27530,52599,443,49618,443,allow,2044,1024,1020,17,80,9,8
27531,40386,443,23622,443,allow,600,156,444,8,25,2,6
27532,123,123,35980,123,allow,184,94,90,2,30,1,1
27533,56629,53,25209,53,allow,183,94,89,2,30,1,1
27534,57773,443,16393,443,allow,11544,6888,4656,32,125,17,15
27535,48575,123,43562,123,allow,184,94,90,2,30,1,1
27536,51978,57496,57419,57496,allow,70,70,0,1,5,1,0
27537,51976,11816,28383,11816,allow,70,70,0,1,5,1,0
27538,5588,5588,0,0,allow,3354,1792,1562,46,194,23,23
27539,55840,53,28820,53,allow,177,94,83,2,30,1,1
27540,60848,53,46740,53,allow,168,78,90,2,30,1,1
27541,53158,443,62480,443,allow,4940,2342,2598,21,135,10,11
27542,56429,443,13104,443,allow,227145,7409,219736,252,146,86,166
27543,49160,6886,47580,6886,allow,854,150,704,4,1200,2,2
27544,54269,53,35881,53,allow,86,86,0,1,30,1,0
27545,55527,80,13344,80,allow,20513,1960,18553,39,21,18,21
27546,38274,443,9313,443,allow,600,156,444,8,25,2,6
27547,64638,53,19660,53,allow,397,102,295,2,30,1,1
27548,54460,443,28221,443,allow,7372,1764,5608,27,547,15,12
27549,55024,443,7164,443,allow,6986,1578,5408,26,25,15,11
27550,55000,443,57257,443,allow,16063,2691,13372,38,38,18,20
27551,45546,80,52456,80,allow,1213,471,742,10,255,6,4
27552,55004,443,44724,443,allow,7960,2219,5741,27,35,16,11
27553,58826,443,32981,443,allow,5168,700,4468,16,15,7,9
27554,49193,443,41261,443,allow,11773,2390,9383,29,19,15,14
27555,61411,80,31645,80,allow,145440,11034,134406,292,158,135,157
27556,61413,80,4426,80,allow,283970,23419,260551,574,158,255,319
27557,9103,443,27886,443,allow,7876,1511,6365,29,42,14,15
27558,52008,49383,8718,49383,allow,70,70,0,2,8,2,0
27559,51981,38274,61701,38274,allow,206,136,70,4,13,3,1
27560,49170,443,23155,443,allow,7743,1601,6142,18,16,10,8
27561,45549,80,33456,80,allow,1117,762,355,10,255,6,4
27562,55029,443,11495,443,allow,7682,3198,4484,27,17,16,11
27563,61416,80,26249,80,allow,2366,764,1602,10,137,5,5
27564,44519,443,58426,443,allow,716,428,288,11,26,7,4
27565,54998,443,38889,443,allow,10151,2256,7895,32,39,17,15
27566,50628,80,46976,80,allow,1658,1247,411,8,14,5,3
27567,49168,443,13015,443,allow,17765,1565,16200,29,16,12,17
27568,61414,80,32431,80,allow,22368,2947,19421,53,137,24,29
27569,61410,80,27494,80,allow,297783,19995,277788,543,158,229,314
27570,55021,443,61578,443,allow,8042,2104,5938,27,26,15,12
27571,9140,80,58869,80,allow,49165,1785,47380,56,36,21,35
27572,53150,43918,23563,43918,allow,320,140,180,6,6,3,3
27573,56652,80,38597,80,allow,234,234,0,4,12,4,0
27574,33201,443,28063,443,allow,21805,2081,19724,38,34,19,19
27575,51979,55803,3042,55803,allow,70,70,0,1,4,1,0
27576,64665,53,55262,53,allow,181,94,87,2,31,1,1
27577,42895,443,18411,443,allow,600,156,444,8,25,2,6
27578,55027,53,14460,53,allow,177,94,83,2,29,1,1
27579,52007,37732,15176,37732,allow,70,70,0,2,8,2,0
27580,56379,53,17881,53,allow,94,94,0,1,29,1,0
27581,50380,53,4521,53,allow,737,94,643,2,29,1,1
27582,49604,53,54196,53,allow,179,94,85,2,29,1,1
27583,32804,80,61447,80,allow,7454,2436,5018,26,23,16,10
27584,51977,18504,5519,18504,allow,70,70,0,1,5,1,0
27585,42892,443,39711,443,allow,448,78,370,6,25,1,5
27586,50560,443,29461,443,allow,408090,25873,382217,748,137,354,394
27587,39844,443,3106,443,allow,2042,1022,1020,17,80,9,8
27588,55323,53,29422,53,allow,279,94,185,2,30,1,1
27589,56058,53,33400,53,allow,200,94,106,2,30,1,1
27590,62856,443,62856,443,allow,3743,1654,2089,10,120,5,5
27591,56219,53,57925,53,allow,177,94,83,2,30,1,1
27592,64642,53,2609,53,allow,307,94,213,2,30,1,1
27593,64116,53,59887,53,allow,177,94,83,2,31,1,1
27594,57470,64430,53438,64430,allow,1386,1386,0,22,1526,22,0
27595,53147,26330,24592,26330,allow,70,70,0,1,5,1,0
27596,55672,45682,1314,45682,allow,70,70,0,1,5,1,0
27597,47758,443,3505,443,allow,299614,32024,267590,587,115,304,283
27598,9205,443,26795,443,allow,318,192,126,6,18,4,2
27599,30188,63236,11932,63236,allow,11247,4773,6474,66,1454,32,34
27600,56725,443,10503,443,allow,7889,1900,5989,20,15,11,9
27601,49195,8108,53972,8108,allow,70,70,0,1,5,1,0
27602,38278,443,39999,443,allow,448,78,370,6,25,1,5
27603,52396,443,30033,443,allow,1253628,61672,1191956,1875,220,939,936
27604,58820,443,32869,443,allow,5167,700,4467,16,15,7,9
27605,34165,443,24288,443,allow,14923,1978,12945,32,49,17,15
27606,55840,53,8081,53,allow,177,94,83,2,30,1,1
27607,52667,80,1897,80,allow,1272,633,639,9,150,5,4
27608,43715,443,63901,443,allow,81803,3159,78644,93,20,33,60
27609,54270,443,64669,443,allow,29945,19086,10859,98,736,50,48
27610,58822,443,37574,443,allow,5166,700,4466,16,15,7,9
27611,61295,443,30551,443,allow,134322,10347,123975,220,304,77,143
27612,49772,80,38136,80,allow,70,70,0,2,8,2,0
27613,55674,48870,28202,48870,allow,70,70,0,1,5,1,0
27614,38276,443,11817,443,allow,600,156,444,8,25,2,6
27615,38275,443,49031,443,allow,448,78,370,6,25,1,5
27616,38774,80,38774,80,allow,369073,4523,364550,316,142,59,257
27617,53751,22266,31272,22266,allow,754,502,252,11,20,7,4
27618,65216,53,41251,53,allow,292,94,198,2,30,1,1
27619,60399,123,27117,123,allow,184,94,90,2,30,1,1
27620,64310,53,12682,53,allow,404,102,302,2,30,1,1
27621,53216,443,19039,443,allow,26702,3270,23432,40,136,16,24
27622,56586,53,33852,53,allow,177,94,83,2,31,1,1
27623,50943,443,64250,443,allow,29452,1988,27464,37,3619,10,27
27624,56219,53,60572,53,allow,177,94,83,2,30,1,1
27625,6881,35156,27681,35156,allow,509,150,359,2,1199,1,1
27626,57470,31114,57905,31114,allow,528,528,0,9,1199,9,0
27627,53765,16178,2985,16178,allow,70,70,0,1,5,1,0
27628,62049,443,56388,443,allow,7856,2410,5446,30,17,16,14
27629,60783,40010,46411,40010,allow,316,136,180,6,6,3,3
27630,55490,80,37170,80,allow,186387,10616,175771,243,33,116,127
27631,63944,8999,41992,8999,allow,70,70,0,1,5,1,0
27632,33793,80,7506,80,allow,1286,782,504,12,361,7,5
27633,55752,8060,62936,8060,allow,70,70,0,2,8,2,0
27634,60762,445,0,0,drop,66,66,0,1,0,1,0
27635,60763,445,0,0,drop,66,66,0,1,0,1,0
27636,60768,445,0,0,drop,66,66,0,1,0,1,0
27637,60764,445,0,0,drop,66,66,0,1,0,1,0
27638,60765,445,0,0,drop,66,66,0,1,0,1,0
27639,60756,445,0,0,drop,66,66,0,1,0,1,0
27640,48706,23393,0,0,deny,60,60,0,1,0,1,0
27641,48706,23393,0,0,deny,60,60,0,1,0,1,0
27642,56275,65348,0,0,deny,142,142,0,1,0,1,0
27643,28040,64147,0,0,deny,62,62,0,1,0,1,0
27644,65339,445,0,0,drop,70,70,0,1,0,1,0
27645,37168,5900,0,0,deny,60,60,0,1,0,1,0
27646,2531,30188,0,0,deny,66,66,0,1,0,1,0
27647,59736,51505,0,0,deny,62,62,0,1,0,1,0
27648,14618,6881,0,0,deny,66,66,0,1,0,1,0
27649,65337,445,0,0,drop,70,70,0,1,0,1,0
27650,65336,445,0,0,drop,70,70,0,1,0,1,0
27651,65335,445,0,0,drop,70,70,0,1,0,1,0
27652,60517,445,0,0,drop,70,70,0,1,0,1,0
27653,63397,26467,0,0,deny,66,66,0,1,0,1,0
27654,55255,37965,0,0,deny,146,146,0,1,0,1,0
27655,50478,51505,0,0,deny,66,66,0,1,0,1,0
27656,56442,11392,0,0,deny,62,62,0,1,0,1,0
27657,33503,5529,0,0,deny,146,146,0,1,0,1,0
27658,18029,50584,0,0,deny,66,66,0,1,0,1,0
27659,16327,55442,0,0,deny,66,66,0,1,0,1,0
27660,61537,57866,0,0,deny,66,66,0,1,0,1,0
27661,60513,445,0,0,drop,70,70,0,1,0,1,0
27662,65330,445,0,0,drop,70,70,0,1,0,1,0
27663,65329,445,0,0,drop,70,70,0,1,0,1,0
27664,65327,445,0,0,drop,70,70,0,1,0,1,0
27665,47827,67,0,0,deny,60,60,0,1,0,1,0
27666,60752,445,0,0,drop,66,66,0,1,0,1,0
27667,65324,445,0,0,drop,70,70,0,1,0,1,0
27668,5222,48709,0,0,deny,66,66,0,1,0,1,0
27669,60748,445,0,0,drop,66,66,0,1,0,1,0
27670,25565,52284,0,0,deny,60,60,0,1,0,1,0
27671,59592,37965,0,0,deny,62,62,0,1,0,1,0
27672,60502,445,0,0,drop,70,70,0,1,0,1,0
27673,60501,445,0,0,drop,70,70,0,1,0,1,0
27674,60504,445,0,0,drop,70,70,0,1,0,1,0
27675,60746,445,0,0,drop,66,66,0,1,0,1,0
27676,60745,445,0,0,drop,66,66,0,1,0,1,0
27677,60499,445,0,0,drop,70,70,0,1,0,1,0
27678,60743,445,0,0,drop,66,66,0,1,0,1,0
27679,60496,445,0,0,drop,70,70,0,1,0,1,0
27680,55421,57470,0,0,deny,74,74,0,1,0,1,0
27681,65316,445,0,0,drop,70,70,0,1,0,1,0
27682,65312,445,0,0,drop,70,70,0,1,0,1,0
27683,65307,445,0,0,drop,70,70,0,1,0,1,0
27684,60155,23718,0,0,deny,66,66,0,1,0,1,0
27685,24285,26467,0,0,deny,62,62,0,1,0,1,0
27686,11859,64147,0,0,deny,62,62,0,1,0,1,0
27687,60491,445,0,0,drop,70,70,0,1,0,1,0
27688,60731,445,0,0,drop,66,66,0,1,0,1,0
27689,59043,35440,0,0,deny,66,66,0,1,0,1,0
27690,29697,51221,0,0,deny,62,62,0,1,0,1,0
27691,59422,51221,0,0,deny,66,66,0,1,0,1,0
27692,53143,50584,0,0,deny,66,66,0,1,0,1,0
27693,57917,44847,0,0,deny,66,66,0,1,0,1,0
27694,60483,445,0,0,drop,70,70,0,1,0,1,0
27695,1873,37965,0,0,deny,62,62,0,1,0,1,0
27696,60481,445,0,0,drop,70,70,0,1,0,1,0
27697,61030,21247,0,0,deny,62,62,0,1,0,1,0
27698,51830,42707,0,0,deny,66,66,0,1,0,1,0
27699,60724,445,0,0,drop,66,66,0,1,0,1,0
27700,65299,445,0,0,drop,70,70,0,1,0,1,0
27701,11136,17500,0,0,deny,62,62,0,1,0,1,0
27702,443,43990,0,0,deny,74,74,0,1,0,1,0
27703,49734,23,0,0,deny,60,60,0,1,0,1,0
27704,443,62732,0,0,deny,332,332,0,1,0,1,0
27705,8999,15503,0,0,deny,146,146,0,1,0,1,0
27706,60477,445,0,0,drop,70,70,0,1,0,1,0
27707,13285,29892,0,0,deny,145,145,0,1,0,1,0
27708,14567,37965,0,0,deny,62,62,0,1,0,1,0
27709,60722,445,0,0,drop,66,66,0,1,0,1,0
27710,56582,23718,0,0,deny,66,66,0,1,0,1,0
27711,60475,445,0,0,drop,70,70,0,1,0,1,0
27712,60818,37965,0,0,deny,66,66,0,1,0,1,0
27713,53871,37965,0,0,deny,66,66,0,1,0,1,0
27714,11688,23718,0,0,deny,146,146,0,1,0,1,0
27715,45964,2225,0,0,deny,60,60,0,1,0,1,0
27716,60714,445,0,0,drop,66,66,0,1,0,1,0
27717,60471,445,0,0,drop,70,70,0,1,0,1,0
27718,60710,445,0,0,drop,66,66,0,1,0,1,0
27719,60470,445,0,0,drop,70,70,0,1,0,1,0
27720,6703,21247,0,0,deny,62,62,0,1,0,1,0
27721,62341,26467,0,0,deny,66,66,0,1,0,1,0
27722,65286,445,0,0,drop,70,70,0,1,0,1,0
27723,65284,445,0,0,drop,70,70,0,1,0,1,0
27724,65285,445,0,0,drop,70,70,0,1,0,1,0
27725,61550,5529,0,0,deny,145,145,0,1,0,1,0
27726,60465,445,0,0,drop,70,70,0,1,0,1,0
27727,60696,445,0,0,drop,66,66,0,1,0,1,0
27728,60699,445,0,0,drop,66,66,0,1,0,1,0
27729,60695,445,0,0,drop,66,66,0,1,0,1,0
27730,60692,445,0,0,drop,66,66,0,1,0,1,0
27731,60697,445,0,0,drop,66,66,0,1,0,1,0
27732,60698,445,0,0,drop,66,66,0,1,0,1,0
27733,60693,445,0,0,drop,66,66,0,1,0,1,0
27734,60691,445,0,0,drop,66,66,0,1,0,1,0
27735,51903,26467,0,0,deny,62,62,0,1,0,1,0
27736,56005,64147,0,0,deny,62,62,0,1,0,1,0
27737,50052,65008,0,0,deny,60,60,0,1,0,1,0
27738,64535,37965,0,0,deny,66,66,0,1,0,1,0
27739,59663,37965,0,0,deny,66,66,0,1,0,1,0
27740,50626,80,27963,80,allow,1366,865,501,8,15,5,3
27741,58806,443,62353,443,allow,10442,6793,3649,30,17,16,14
27742,52180,443,15332,443,allow,11127,1324,9803,24,75,12,12
27743,28025,443,15107,443,allow,5578,1390,4188,19,15,9,10
27744,55098,53,8835,53,allow,176,90,86,2,30,1,1
27745,58734,443,48413,443,allow,1413,876,537,12,26,6,6
27746,58809,443,34899,443,allow,4054,2590,1464,18,16,9,9
27747,51975,11998,29831,11998,allow,66,66,0,1,5,1,0
27748,53780,47132,22525,47132,allow,70,70,0,2,8,2,0
27749,28024,443,28708,443,allow,5516,1388,4128,18,15,9,9
27750,58795,443,29024,443,allow,19700,12992,6708,44,18,23,21
27751,53763,50144,49298,50144,allow,492,306,186,8,16,5,3
27752,55835,53,7338,53,allow,176,90,86,2,31,1,1
27753,52182,443,53611,443,allow,10422,1313,9109,23,75,12,11
27754,52009,1035,48428,1035,allow,316,136,180,6,7,3,3
27755,55069,443,55069,443,allow,4517,1610,2907,19,27,11,8
27756,49846,53,37794,53,allow,763,101,662,2,31,1,1
27757,21903,443,21903,443,allow,29203,1859,27344,37,18,14,23
27758,63464,443,46979,443,allow,24271,2640,21631,38,123,16,22
27759,52183,443,6084,443,allow,10107,1324,8783,22,75,12,10
27760,42716,443,52714,443,allow,12561,2901,9660,29,17,15,14
27761,44384,80,20153,80,allow,51651,48866,2785,74,19,38,36
27762,64751,443,49226,443,allow,507753,8795,498958,463,195,122,341
27763,40039,80,11580,80,allow,1112,534,578,12,16,7,5
27764,53768,19067,20998,19067,allow,70,70,0,1,5,1,0
27765,5588,5588,0,0,allow,3354,1792,1562,46,195,23,23
27766,51971,20347,9073,20347,allow,66,66,0,1,5,1,0
27767,52927,443,29135,443,allow,5582,1388,4194,19,15,9,10
27768,56586,53,23269,53,allow,170,87,83,2,30,1,1
27769,56024,53,53250,53,allow,711,87,624,2,30,1,1
27770,52807,443,39495,443,allow,67984,17257,50727,121,148,50,71
27771,52928,443,44110,443,allow,5584,1390,4194,19,15,9,10
27772,14829,443,14829,443,allow,214215,11945,202270,260,94,110,150
27773,53977,443,23449,443,allow,3330,1694,1636,15,30,8,7
27774,53779,24874,26263,24874,allow,70,70,0,2,8,2,0
27775,55021,443,46013,443,allow,31237,2116,29121,57,195,24,33
27776,58735,443,63211,443,allow,1413,876,537,12,26,6,6
27777,51422,443,51422,443,allow,4399,1492,2907,19,27,11,8
27778,64749,443,34361,443,allow,10750,1814,8936,37,195,17,20
27779,45912,443,22419,443,allow,4306,1107,3199,17,30,9,8
27780,64743,443,34069,443,allow,31480,1953,29527,54,196,20,34
27781,42955,80,63046,80,allow,72023,4897,67126,97,115,46,51
27782,52512,80,4200,80,allow,10889,1117,9772,22,16,12,10
27783,65500,443,41851,443,allow,8177,3420,4757,23,124,11,12
27784,58673,443,8091,443,allow,3330,737,2593,10,121,5,5
27785,57470,50321,35732,50321,allow,490,149,341,2,1201,1,1
27786,35833,443,20943,443,allow,5524,1857,3667,27,3652,9,18
27787,65283,445,0,0,drop,70,70,0,1,0,1,0
27788,65274,445,0,0,drop,70,70,0,1,0,1,0
27789,65276,445,0,0,drop,70,70,0,1,0,1,0
27790,65269,445,0,0,drop,70,70,0,1,0,1,0
27791,8999,57470,0,0,deny,146,146,0,1,0,1,0
27792,56494,3033,0,0,deny,146,146,0,1,0,1,0
27793,54365,64147,0,0,deny,62,62,0,1,0,1,0
27794,32282,8604,0,0,deny,66,66,0,1,0,1,0
27795,60452,445,0,0,drop,70,70,0,1,0,1,0
27796,60678,445,0,0,drop,66,66,0,1,0,1,0
27797,60677,445,0,0,drop,66,66,0,1,0,1,0
27798,60675,445,0,0,drop,66,66,0,1,0,1,0
27799,50949,45960,0,0,deny,62,62,0,1,0,1,0
27800,49514,39127,0,0,deny,162,162,0,1,0,1,0
27801,443,62732,0,0,deny,332,332,0,1,0,1,0
27802,56494,15503,0,0,deny,146,146,0,1,0,1,0
27803,8999,57470,0,0,deny,146,146,0,1,0,1,0
27804,60449,445,0,0,drop,70,70,0,1,0,1,0
27805,52605,443,40382,443,allow,3523,518,3005,12,15,6,6
27806,59775,443,26264,443,allow,5024,2538,2486,23,15,13,10
27807,44074,443,54425,443,allow,5498,3406,2092,28,95,16,12
27808,58359,64147,0,0,deny,72,72,0,1,0,1,0
27809,57339,57470,0,0,deny,66,66,0,1,0,1,0
27810,56494,15503,0,0,deny,146,146,0,1,0,1,0
27811,65265,445,0,0,drop,70,70,0,1,0,1,0
27812,38477,5900,0,0,deny,60,60,0,1,0,1,0
27813,65253,445,0,0,drop,70,70,0,1,0,1,0
27814,65254,445,0,0,drop,70,70,0,1,0,1,0
27815,65252,445,0,0,drop,70,70,0,1,0,1,0
27816,55450,64147,0,0,deny,66,66,0,1,0,1,0
27817,56494,57587,0,0,deny,146,146,0,1,0,1,0
27818,58131,15503,0,0,deny,146,146,0,1,0,1,0
27819,2990,64147,0,0,deny,66,66,0,1,0,1,0
27820,63079,64147,0,0,deny,66,66,0,1,0,1,0
27821,60444,445,0,0,drop,70,70,0,1,0,1,0
27822,35232,36602,0,0,deny,74,74,0,1,0,1,0
27823,60443,445,0,0,drop,70,70,0,1,0,1,0
27824,60441,445,0,0,drop,70,70,0,1,0,1,0
27825,56494,1,0,0,deny,146,146,0,1,0,1,0
27826,51655,26467,0,0,deny,62,62,0,1,0,1,0
27827,21213,23,0,0,deny,60,60,0,1,0,1,0
27828,443,62732,0,0,deny,199,199,0,1,0,1,0
27829,65247,445,0,0,drop,70,70,0,1,0,1,0
27830,65245,445,0,0,drop,70,70,0,1,0,1,0
27831,65242,445,0,0,drop,70,70,0,1,0,1,0
27832,48706,23393,0,0,deny,60,60,0,1,0,1,0
27833,48706,23393,0,0,deny,60,60,0,1,0,1,0
27834,3074,64147,0,0,deny,62,62,0,1,0,1,0
27835,15333,44847,0,0,deny,146,146,0,1,0,1,0
27836,60665,445,0,0,drop,66,66,0,1,0,1,0
27837,60297,25604,0,0,deny,62,62,0,1,0,1,0
27838,60434,445,0,0,drop,70,70,0,1,0,1,0
27839,14148,1,0,0,deny,62,62,0,1,0,1,0
27840,54593,51505,0,0,deny,62,62,0,1,0,1,0
27841,2049,23,0,0,deny,60,60,0,1,0,1,0
27842,60431,445,0,0,drop,70,70,0,1,0,1,0
27843,60430,445,0,0,drop,70,70,0,1,0,1,0
27844,65237,445,0,0,drop,70,70,0,1,0,1,0
27845,65231,445,0,0,drop,70,70,0,1,0,1,0
27846,60429,445,0,0,drop,70,70,0,1,0,1,0
27847,47788,1879,0,0,deny,146,146,0,1,0,1,0
27848,60423,445,0,0,drop,70,70,0,1,0,1,0
27849,60424,445,0,0,drop,70,70,0,1,0,1,0
27850,55206,53,49621,53,allow,196,94,102,2,30,1,1
27851,64988,53,16723,53,allow,196,94,102,2,30,1,1
27852,53238,80,59852,80,allow,1726,940,786,8,55,5,3
27853,52006,49849,11177,49849,allow,70,70,0,2,7,2,0
27854,50919,443,16242,443,allow,5962,1621,4341,16,75,9,7
27855,51419,443,59979,443,allow,13049,4849,8200,31,31,15,16
27856,52179,443,33825,443,allow,7439,1156,6283,19,75,11,8
27857,53855,443,61273,443,allow,134631,7253,127378,176,171,79,97
27858,49514,443,49514,443,allow,234110,36300,197810,309,66,160,149
27859,53767,10004,19496,10004,allow,70,70,0,1,4,1,0
27860,55494,80,14370,80,allow,188544,9826,178718,241,32,113,128
27861,51974,54759,44353,54759,allow,70,70,0,1,4,1,0
27862,56723,443,2144,443,allow,7889,1900,5989,20,15,11,9
27863,36100,443,53812,443,allow,812,440,372,14,25,8,6
27864,34657,443,29815,443,allow,3521,516,3005,12,15,6,6
27865,63937,53,8865,53,allow,183,94,89,2,30,1,1
27866,53766,3596,6099,3596,allow,70,70,0,1,4,1,0
27867,60786,80,13349,80,allow,1638,1324,314,10,15,5,5
27868,56367,53,12261,53,allow,900,110,790,2,29,1,1
27869,56405,53,42424,53,allow,226,102,124,2,30,1,1
27870,64477,443,32832,443,allow,8965,3771,5194,33,124,14,19
27871,51108,80,16411,80,allow,2794,2075,719,15,30,9,6
27872,56184,53,63317,53,allow,215,94,121,2,30,1,1
27873,55835,53,25257,53,allow,180,94,86,2,30,1,1
27874,49932,53,2052,53,allow,289,94,195,2,30,1,1
27875,34658,443,51529,443,allow,3521,516,3005,12,15,6,6
27876,50522,443,6531,443,allow,1579,988,591,13,45,7,6
27877,58903,80,49363,80,allow,22851,3171,19680,39,147,20,19
27878,60438,53,9919,53,allow,77,77,0,2,31,2,0
27879,35667,80,40101,80,allow,1638,1324,314,10,15,5,5
27880,52004,55711,12562,55711,allow,70,70,0,2,7,2,0
27881,56722,443,4374,443,allow,7941,1952,5989,20,15,11,9
27882,59758,53,7104,53,allow,211,78,133,2,30,1,1
27883,39748,80,44062,80,allow,1638,1324,314,10,15,5,5
27884,64648,53,9787,53,allow,215,94,121,2,30,1,1
27885,52295,53,54282,53,allow,322,102,220,2,30,1,1
27886,57303,53,6094,53,allow,177,94,83,2,30,1,1
27887,61637,53,32273,53,allow,82,82,0,2,31,2,0
27888,57159,53,30985,53,allow,292,94,198,2,30,1,1
27889,57303,53,43423,53,allow,177,94,83,2,30,1,1
27890,56951,443,25621,443,allow,4679,2071,2608,14,135,7,7
27891,55835,53,39257,53,allow,180,94,86,2,30,1,1
27892,55243,53,43461,53,allow,356,118,238,2,30,1,1
27893,17750,55265,61135,55265,allow,481,150,331,2,1200,1,1
27894,46939,443,46939,443,allow,4657,1750,2907,19,28,11,8
27895,50726,443,27589,443,allow,12350,2504,9846,41,137,21,20
27896,62995,53,59527,53,allow,101,101,0,2,31,2,0
27897,52003,18150,42315,18150,allow,70,70,0,2,7,2,0
27898,29972,53,62142,53,allow,300,94,206,2,30,1,1
27899,65355,53,22974,53,allow,321,102,219,2,30,1,1
27900,53791,53,14073,53,allow,102,102,0,2,31,2,0
27901,60449,28260,32141,28260,allow,70,70,0,1,5,1,0
27902,53761,54363,63571,54363,allow,618,432,186,9,16,6,3
27903,50663,443,57930,443,allow,7732,3046,4686,22,26,12,10
27904,59629,80,40534,80,allow,1652,1264,388,10,17,4,6
27905,58736,443,28275,443,allow,7978,1143,6835,19,26,9,10
27906,56721,443,14378,443,allow,7889,1900,5989,20,15,11,9
27907,53848,443,21534,443,allow,7015200,135026,6880174,6063,438,1252,4811
27908,49194,443,5495,443,allow,605037,246018,359019,1735,1300,846,889
27909,59011,443,8442,443,allow,9619,6442,3177,33,122,15,18
27910,55553,443,62763,443,allow,6639,3918,2721,16,135,8,8
27911,59180,443,21871,443,allow,2592,1486,1106,20,275,10,10
27912,50265,38978,6940,38978,allow,481,150,331,2,1200,1,1
27913,54553,53,43102,53,allow,101,101,0,2,31,2,0
27914,50523,443,11789,443,allow,1579,988,591,13,45,7,6
27915,43494,443,46566,443,allow,670,382,288,10,133,6,4
27916,55305,53,15624,53,allow,88,88,0,2,31,2,0
27917,34656,443,55937,443,allow,3521,516,3005,12,15,6,6
27918,58812,443,22392,443,allow,5167,700,4467,16,15,7,9
27919,52005,33191,61687,33191,allow,70,70,0,2,7,2,0
27920,58816,443,57126,443,allow,5168,700,4468,16,15,7,9
27921,53237,80,8152,80,allow,194,128,66,4,55,3,1
27922,34220,80,10366,80,allow,672,300,372,12,30,6,6
27923,58819,443,22154,443,allow,5168,700,4468,16,14,7,9
27924,54744,443,54744,443,allow,4737,2854,1883,25,117,13,12
27925,54259,443,22869,443,allow,7508,2864,4644,18,75,11,7
27926,53799,3478,23545,3478,allow,3736,1944,1792,58,91,29,29
27927,36661,443,26709,443,allow,16244,2265,13979,35,262,19,16
27928,39674,443,32592,443,allow,2828,1800,1028,27,184,15,12
27929,51972,13604,43742,13604,allow,160,70,90,2,5,1,1
27930,56629,53,45116,53,allow,183,94,89,2,29,1,1
27931,55318,53,29370,53,allow,215,102,113,2,30,1,1
27932,49988,443,8213,443,allow,642,582,60,2,5,1,1
27933,55034,443,40095,443,allow,14671,2953,11718,31,31,17,14
27934,49509,443,49509,443,allow,242669,43830,198839,310,67,159,151
27935,55248,443,36636,443,allow,30281,3919,26362,44,62,21,23
27936,52993,53,60182,53,allow,70,70,0,1,29,1,0
27937,57152,53,56256,53,allow,720,94,626,2,30,1,1
27938,55098,53,14805,53,allow,180,94,86,2,30,1,1
27939,49153,53,32682,53,allow,214,102,112,2,29,1,1
27940,59757,53,47514,53,allow,260,86,174,2,30,1,1
27941,64199,53,4669,53,allow,215,102,113,2,30,1,1
27942,56586,53,39065,53,allow,177,94,83,2,30,1,1
27943,51106,80,64772,80,allow,14616,6227,8389,32,31,16,16
27944,38970,443,29135,443,allow,4144,2479,1665,19,361,10,9
27945,56621,53,30051,53,allow,177,94,83,2,31,1,1
27946,53434,53,34860,53,allow,87,87,0,2,31,2,0
27947,54138,443,3905,443,allow,5702,1212,4490,19,139,10,9
27948,49983,53,19113,53,allow,267,110,157,2,30,1,1
27949,5176,53,35292,53,allow,86,86,0,1,30,1,0
27950,63931,443,46072,443,allow,103248,6121,97127,124,144,47,77
27951,40685,80,25851,80,allow,1278,774,504,12,360,7,5
27952,62617,443,37156,443,allow,3931,678,3253,15,140,6,9
27953,64406,53,8536,53,allow,102,102,0,2,31,2,0
27954,60450,56494,22389,56494,allow,70,70,0,1,5,1,0
27955,64714,53,5629,53,allow,250,86,164,4,36,2,2
27956,65183,53,12672,53,allow,381,89,292,4,43,2,2
27957,50326,443,38402,443,allow,552885,34781,518104,733,245,314,419
27958,64201,53,54602,53,allow,434,96,338,4,30,2,2
27959,54267,53,33061,53,allow,86,86,0,1,30,1,0
27960,61566,53,28325,53,allow,86,86,0,1,30,1,0
27961,54983,53,35853,53,allow,728,102,626,2,30,1,1
27962,56654,53,54903,53,allow,102,102,0,2,31,2,0
27963,65466,53,31281,53,allow,200,102,98,2,33,1,1
27964,55492,80,58922,80,allow,164902,9835,155067,227,32,114,113
27965,51970,18752,15573,18752,allow,70,70,0,1,5,1,0
27966,54080,443,47688,443,allow,1173681,52597,1121084,1428,177,642,786
27967,54079,443,33342,443,allow,1050267,44816,1005451,1276,177,580,696
27968,53853,443,32341,443,allow,1966450,57437,1909013,1885,338,544,1341
27969,49771,53,61386,53,allow,86,86,0,1,30,1,0
27970,49165,53,19244,53,allow,379,94,285,2,30,1,1
27971,64505,53,53732,53,allow,388,134,254,2,30,1,1
27972,57189,53,13765,53,allow,78,78,0,1,30,1,0
27973,56621,53,19745,53,allow,177,94,83,2,30,1,1
27974,6881,55980,18375,55980,allow,226,118,108,2,1199,1,1
27975,58311,443,32362,443,allow,6128,1394,4734,24,146,10,14
27976,48320,80,28314,80,allow,12110,3853,8257,35,1075,13,22
27977,55101,443,55990,443,allow,1786,172,1614,7,120,3,4
27978,60423,443,39132,443,allow,11488,7258,4230,47,122,27,20
27979,55445,53,54858,53,allow,96,96,0,2,31,2,0
27980,34357,443,9724,443,allow,33131,26333,6798,49,121,28,21
27981,56950,443,1900,443,allow,4391,2171,2220,14,135,7,7
27982,60403,443,22407,443,allow,3802,1769,2033,15,135,7,8
27983,55489,80,62350,80,allow,180504,12712,167792,229,32,105,124
27984,56720,443,57174,443,allow,7941,1952,5989,20,15,11,9
27985,55199,53,62103,53,allow,196,94,102,2,30,1,1
27986,63954,60430,18529,60430,allow,66,66,0,2,8,2,0
27987,63937,53,33435,53,allow,183,94,89,2,30,1,1
27988,56075,53,1883,53,allow,215,102,113,2,30,1,1
27989,56020,53,51205,53,allow,199,102,97,2,32,1,1
27990,35292,8100,23509,8100,allow,78,78,0,1,5,1,0
27991,55225,53,24302,53,allow,199,102,97,2,30,1,1
27992,55225,53,48958,53,allow,822,102,720,2,30,1,1
27993,34662,443,60147,443,allow,50100,46087,4013,73,121,43,30
27994,57894,44847,0,0,deny,66,66,0,1,0,1,0
27995,28878,51505,0,0,deny,62,62,0,1,0,1,0
27996,443,62732,0,0,deny,199,199,0,1,0,1,0
27997,53469,36237,0,0,deny,66,66,0,1,0,1,0
27998,60649,445,0,0,drop,66,66,0,1,0,1,0
27999,60648,445,0,0,drop,66,66,0,1,0,1,0
28000,6889,48817,0,0,deny,143,143,0,1,0,1,0
28001,10738,50584,0,0,deny,62,62,0,1,0,1,0
28002,63988,50584,0,0,deny,62,62,0,1,0,1,0
28003,60411,445,0,0,drop,70,70,0,1,0,1,0
28004,60410,445,0,0,drop,70,70,0,1,0,1,0
28005,60408,445,0,0,drop,70,70,0,1,0,1,0
28006,29080,50265,0,0,deny,62,62,0,1,0,1,0
28007,51414,22,0,0,deny,60,60,0,1,0,1,0
28008,60401,445,0,0,drop,70,70,0,1,0,1,0
28009,60400,445,0,0,drop,70,70,0,1,0,1,0
28010,65227,445,0,0,drop,70,70,0,1,0,1,0
28011,16630,44847,0,0,deny,62,62,0,1,0,1,0
28012,65219,445,0,0,drop,70,70,0,1,0,1,0
28013,65220,445,0,0,drop,70,70,0,1,0,1,0
28014,65216,445,0,0,drop,70,70,0,1,0,1,0
28015,60644,445,0,0,drop,66,66,0,1,0,1,0
28016,49629,26467,0,0,deny,66,66,0,1,0,1,0
28017,60633,445,0,0,drop,66,66,0,1,0,1,0
28018,60636,445,0,0,drop,66,66,0,1,0,1,0
28019,60635,445,0,0,drop,66,66,0,1,0,1,0
28020,60634,445,0,0,drop,66,66,0,1,0,1,0
28021,60630,445,0,0,drop,66,66,0,1,0,1,0
28022,60632,445,0,0,drop,66,66,0,1,0,1,0
28023,60629,445,0,0,drop,66,66,0,1,0,1,0
28024,14336,64147,0,0,deny,62,62,0,1,0,1,0
28025,53012,51050,0,0,deny,66,66,0,1,0,1,0
28026,65211,445,0,0,drop,70,70,0,1,0,1,0
28027,60389,445,0,0,drop,70,70,0,1,0,1,0
28028,27824,51505,0,0,deny,62,62,0,1,0,1,0
28029,20864,51221,0,0,deny,62,62,0,1,0,1,0
28030,65209,445,0,0,drop,70,70,0,1,0,1,0
28031,65208,445,0,0,drop,70,70,0,1,0,1,0
28032,65205,445,0,0,drop,70,70,0,1,0,1,0
28033,41648,56205,0,0,deny,66,66,0,1,0,1,0
28034,64626,50584,0,0,deny,66,66,0,1,0,1,0
28035,59618,46824,0,0,deny,66,66,0,1,0,1,0
28036,17378,44847,0,0,deny,62,62,0,1,0,1,0
28037,24910,64147,0,0,deny,66,66,0,1,0,1,0
28038,32551,51221,0,0,deny,66,66,0,1,0,1,0
28039,60385,445,0,0,drop,70,70,0,1,0,1,0
28040,59365,42873,0,0,deny,74,74,0,1,0,1,0
28041,65204,445,0,0,drop,70,70,0,1,0,1,0
28042,65202,445,0,0,drop,70,70,0,1,0,1,0
28043,65201,445,0,0,drop,70,70,0,1,0,1,0
28044,60141,62413,0,0,deny,66,66,0,1,0,1,0
28045,443,61686,0,0,deny,1484,1484,0,1,0,1,0
28046,60621,445,0,0,drop,66,66,0,1,0,1,0
28047,60375,445,0,0,drop,70,70,0,1,0,1,0
28048,60376,445,0,0,drop,70,70,0,1,0,1,0
28049,60374,445,0,0,drop,70,70,0,1,0,1,0
28050,65196,445,0,0,drop,70,70,0,1,0,1,0
28051,60372,445,0,0,drop,70,70,0,1,0,1,0
28052,60619,445,0,0,drop,66,66,0,1,0,1,0
28053,60368,445,0,0,drop,70,70,0,1,0,1,0
28054,60617,445,0,0,drop,66,66,0,1,0,1,0
28055,60616,445,0,0,drop,66,66,0,1,0,1,0
28056,60614,445,0,0,drop,66,66,0,1,0,1,0
28057,23478,1433,0,0,deny,60,60,0,1,0,1,0
28058,6881,6881,0,0,deny,146,146,0,1,0,1,0
28059,30580,50265,0,0,deny,66,66,0,1,0,1,0
28060,50806,51505,0,0,deny,66,66,0,1,0,1,0
28061,65188,445,0,0,drop,70,70,0,1,0,1,0
28062,61230,22114,0,0,deny,66,66,0,1,0,1,0
28063,11136,15503,0,0,deny,145,145,0,1,0,1,0
28064,58825,44847,0,0,deny,146,146,0,1,0,1,0
28065,65184,445,0,0,drop,70,70,0,1,0,1,0
28066,65179,445,0,0,drop,70,70,0,1,0,1,0
28067,60362,445,0,0,drop,70,70,0,1,0,1,0
28068,58687,11392,0,0,deny,66,66,0,1,0,1,0
28069,60761,51221,0,0,deny,66,66,0,1,0,1,0
28070,38281,37807,0,0,deny,62,62,0,1,0,1,0
28071,52252,46314,0,0,deny,62,62,0,1,0,1,0
28072,60603,445,0,0,drop,66,66,0,1,0,1,0
28073,5087,22114,0,0,deny,62,62,0,1,0,1,0
28074,60355,445,0,0,drop,70,70,0,1,0,1,0
28075,60354,445,0,0,drop,70,70,0,1,0,1,0
28076,42094,35440,0,0,deny,146,146,0,1,0,1,0
28077,48706,23393,0,0,deny,60,60,0,1,0,1,0
28078,60595,445,0,0,drop,66,66,0,1,0,1,0
28079,65171,445,0,0,drop,70,70,0,1,0,1,0
28080,60349,445,0,0,drop,70,70,0,1,0,1,0
28081,60347,445,0,0,drop,70,70,0,1,0,1,0
28082,60593,445,0,0,drop,66,66,0,1,0,1,0
28083,19698,502,0,0,deny,60,60,0,1,0,1,0
28084,55496,64097,0,0,deny,66,66,0,1,0,1,0
28085,58114,11119,0,0,deny,148,148,0,1,0,1,0
28086,60343,445,0,0,drop,70,70,0,1,0,1,0
28087,52348,62413,0,0,deny,66,66,0,1,0,1,0
28088,33582,44847,0,0,deny,66,66,0,1,0,1,0
28089,60584,445,0,0,drop,66,66,0,1,0,1,0
28090,56718,50584,0,0,deny,66,66,0,1,0,1,0
28091,57131,7774,0,0,deny,145,145,0,1,0,1,0
28092,60342,445,0,0,drop,70,70,0,1,0,1,0
28093,60575,445,0,0,drop,66,66,0,1,0,1,0
28094,49276,51505,0,0,deny,66,66,0,1,0,1,0
28095,56255,44847,0,0,deny,66,66,0,1,0,1,0
28096,56015,56205,0,0,deny,66,66,0,1,0,1,0
28097,2305,35440,0,0,deny,62,62,0,1,0,1,0
28098,39460,23117,0,0,deny,66,66,0,1,0,1,0
28099,3585,64147,0,0,deny,62,62,0,1,0,1,0
28100,6666,5000,0,0,deny,60,60,0,1,0,1,0
28101,13062,52752,0,0,deny,66,66,0,1,0,1,0
28102,56281,53,50630,53,allow,170,87,83,2,31,1,1
28103,51970,443,63530,443,allow,17072,6138,10934,33,85,18,15
28104,58801,443,36000,443,allow,8937,5785,3152,26,16,14,12
28105,52002,34348,16658,34348,allow,70,70,0,2,7,2,0
28106,54816,3389,54816,3389,allow,3413,1458,1955,16,17,8,8
28107,55624,53,27462,53,allow,701,88,613,2,30,1,1
28108,58045,80,55044,80,allow,62067,24127,37940,79,34,33,46
28109,58055,80,48571,80,allow,3791,2804,987,14,31,8,6
28110,38661,15000,5688,15000,allow,138,78,60,2,5,1,1
28111,51966,18716,18361,18716,allow,66,66,0,1,5,1,0
28112,49503,443,13223,443,allow,9678,4552,5126,22,76,12,10
28113,49270,53,43465,53,allow,216,110,106,2,30,1,1
28114,58034,443,53963,443,allow,10192,3621,6571,24,36,12,12
28115,2885,443,2885,443,allow,28717,3437,25280,45,23,23,22
28116,2359,443,2359,443,allow,8209,1695,6514,21,23,13,8
28117,37554,443,12881,443,allow,13220,4632,8588,32,37,19,13
28118,41628,15000,25474,15000,allow,130,70,60,2,6,1,1
28119,56982,80,33665,80,allow,3817,829,2988,11,16,7,4
28120,58672,443,27008,443,allow,4649,2114,2535,11,120,6,5
28121,2434,443,2434,443,allow,8209,1695,6514,21,23,13,8
28122,52013,443,52013,443,allow,43964,6675,37289,60,49,25,35
28123,57157,443,64238,443,allow,1647,1375,272,9,48,5,4
28124,49270,53,27956,53,allow,216,110,106,2,31,1,1
28125,53974,443,28676,443,allow,3330,1694,1636,15,30,8,7
28126,47207,443,60906,443,allow,11085,2554,8531,48,19,24,24
28127,55576,443,55576,443,allow,4665,1758,2907,19,28,11,8
28128,44687,443,14376,443,allow,3054,1741,1313,20,27,8,12
28129,65418,443,32664,443,allow,2494,1643,851,17,26,9,8
28130,52016,443,52016,443,allow,219803,9390,210413,222,49,72,150
28131,58053,80,60672,80,allow,3751,3009,742,14,31,8,6
28132,51216,22,51216,22,allow,5806,2153,3653,33,24,18,15
28133,5908,3389,5908,3389,allow,3850,1745,2105,19,18,11,8
28134,63937,53,56505,53,allow,182,93,89,2,30,1,1
28135,50583,53,30118,53,allow,783,96,687,2,30,1,1
28136,55071,53,28115,53,allow,711,87,624,2,30,1,1
28137,65442,443,8292,443,allow,3783,1087,2696,11,120,5,6
28138,55307,53,50101,53,allow,1415,101,1314,4,51,2,2
28139,55810,80,19012,80,allow,11093,1415,9678,18,18,8,10
28140,60165,80,45319,80,allow,1982,692,1290,8,15,5,3
28141,39644,80,29707,80,allow,2631,1207,1424,14,16,9,5
28142,52001,12514,64945,12514,allow,70,70,0,2,7,2,0
28143,58799,443,29874,443,allow,7899,5184,2715,24,16,13,11
28144,58054,80,39200,80,allow,3561,3028,533,14,31,8,6
28145,58796,443,44743,443,allow,14463,9503,4960,34,17,17,17
28146,47120,443,47120,443,allow,4380,1473,2907,19,29,11,8
28147,56621,53,42291,53,allow,170,87,83,2,30,1,1
28148,51307,80,27411,80,allow,5912,5182,730,15,23,9,6
28149,63936,14832,6153,14832,allow,312,190,122,5,16,3,2
28150,2252,443,2252,443,allow,11489,1827,9662,25,23,15,10
28151,2226,443,2226,443,allow,46743,4890,41853,69,23,35,34
28152,2506,443,2506,443,allow,35555,4646,30909,59,23,33,26
28153,56119,53,42460,53,allow,198,101,97,2,30,1,1
28154,59115,443,45739,443,allow,30048,2775,27273,41,137,16,25
28155,62623,443,47203,443,allow,5311,1546,3765,15,122,7,8
28156,36099,443,40194,443,allow,48494,10293,38201,71,129,26,45
28157,55199,443,36951,443,allow,4086,1248,2838,24,140,11,13
28158,50319,53,41804,53,allow,188,96,92,2,31,1,1
28159,56138,53,1894,53,allow,783,96,687,2,31,1,1
28160,52426,53,52426,53,allow,310,94,216,2,31,1,1
28161,55563,53,56094,53,allow,188,96,92,2,31,1,1
28162,59715,443,21725,443,allow,3420,983,2437,15,121,7,8
28163,35776,443,4893,443,allow,7500,2339,5161,18,136,8,10
28164,54667,443,17668,443,allow,3989,1104,2885,12,122,5,7
28165,58386,443,54159,443,allow,17470103,920642,16549461,18410,181,6438,11972
28166,55021,53,4080,53,allow,174,89,85,2,31,1,1
28167,49845,443,54304,443,allow,8518,2260,6258,32,806,12,20
28168,54944,443,7511,443,allow,4891,2237,2654,12,121,6,6
28169,49937,443,1883,443,allow,240,240,0,5,338,5,0
28170,54344,443,13534,443,allow,10015,6047,3968,22,122,12,10
28171,46554,5228,16651,5228,allow,4520,2520,2000,40,3961,20,20
28172,34997,22,0,0,deny,60,60,0,1,0,1,0
28173,60337,445,0,0,drop,70,70,0,1,0,1,0
28174,1059,44847,0,0,deny,62,62,0,1,0,1,0
28175,56278,52752,0,0,deny,62,62,0,1,0,1,0
28176,65157,445,0,0,drop,70,70,0,1,0,1,0
28177,65158,445,0,0,drop,70,70,0,1,0,1,0
28178,65156,445,0,0,drop,70,70,0,1,0,1,0
28179,38891,64147,0,0,deny,145,145,0,1,0,1,0
28180,55123,64097,0,0,deny,66,66,0,1,0,1,0
28181,60568,445,0,0,drop,66,66,0,1,0,1,0
28182,60561,445,0,0,drop,66,66,0,1,0,1,0
28183,60569,445,0,0,drop,66,66,0,1,0,1,0
28184,60566,445,0,0,drop,66,66,0,1,0,1,0
28185,60563,445,0,0,drop,66,66,0,1,0,1,0
28186,60565,445,0,0,drop,66,66,0,1,0,1,0
28187,60564,445,0,0,drop,66,66,0,1,0,1,0
28188,23415,11392,0,0,deny,62,62,0,1,0,1,0
28189,8592,35993,0,0,deny,62,62,0,1,0,1,0
28190,63944,30188,0,0,deny,66,66,0,1,0,1,0
28191,50052,65008,0,0,deny,60,60,0,1,0,1,0
28192,60324,445,0,0,drop,70,70,0,1,0,1,0
28193,2695,48817,0,0,deny,62,62,0,1,0,1,0
28194,65155,445,0,0,drop,70,70,0,1,0,1,0
28195,65153,445,0,0,drop,70,70,0,1,0,1,0
28196,49270,53,46560,53,allow,322,110,212,4,30,2,2
28197,65146,445,0,0,drop,70,70,0,1,0,1,0
28198,65143,445,0,0,drop,70,70,0,1,0,1,0
28199,56250,36237,0,0,deny,66,66,0,1,0,1,0
28200,1912,48817,0,0,deny,62,62,0,1,0,1,0
28201,56098,55442,0,0,deny,66,66,0,1,0,1,0
28202,60549,445,0,0,drop,66,66,0,1,0,1,0
28203,60548,445,0,0,drop,66,66,0,1,0,1,0
28204,60546,445,0,0,drop,66,66,0,1,0,1,0
28205,56218,43890,0,0,deny,62,62,0,1,0,1,0
28206,53902,67,0,0,deny,60,60,0,1,0,1,0
28207,60319,445,0,0,drop,70,70,0,1,0,1,0
28208,26601,22114,0,0,deny,62,62,0,1,0,1,0
28209,45304,64147,0,0,deny,72,72,0,1,0,1,0
28210,9445,56205,0,0,deny,62,62,0,1,0,1,0
28211,3052,7302,0,0,deny,66,66,0,1,0,1,0
28212,65136,445,0,0,drop,70,70,0,1,0,1,0
28213,51779,31652,0,0,reset-both,62,62,0,1,0,1,0
28214,65134,445,0,0,drop,70,70,0,1,0,1,0
28215,53759,40826,3442,40826,allow,492,306,186,8,15,5,3
28216,56718,443,49535,443,allow,7940,1951,5989,20,15,11,9
28217,56281,53,4042,53,allow,177,94,83,2,30,1,1
28218,39945,443,42447,443,allow,5446,805,4641,17,26,9,8
28219,37542,443,40273,443,allow,13299,2872,10427,34,41,19,15
28220,37559,443,47158,443,allow,9845,2815,7030,26,37,15,11
28221,52010,23685,49442,23685,allow,316,136,180,6,5,3,3
28222,51968,43622,30970,43622,allow,70,70,0,1,4,1,0
28223,53721,443,6188,443,allow,70,70,0,1,4,1,0
28224,55835,53,15423,53,allow,180,94,86,2,29,1,1
28225,56020,53,34140,53,allow,199,102,97,2,29,1,1
28226,57350,53,53074,53,allow,257,94,163,2,30,1,1
28227,49344,443,51198,443,allow,272627,89686,182941,461,149,220,241
28228,64191,443,64191,443,allow,18608,1844,16764,31,16,16,15
28229,49365,443,7020,443,allow,442336,371266,71070,1143,762,651,492
28230,37546,80,60597,80,allow,10438,979,9459,21,38,11,10
28231,55493,80,50792,80,allow,133558,8265,125293,186,31,93,93
28232,47495,443,53611,443,allow,490,210,280,8,28,4,4
28233,60572,80,35245,80,allow,556,280,276,9,28,5,4
28234,37552,443,42195,443,allow,9959,2495,7464,27,37,15,12
28235,63937,53,1528,53,allow,183,94,89,2,29,1,1
28236,64919,53,28952,53,allow,199,102,97,2,29,1,1
28237,64919,53,63713,53,allow,822,102,720,2,29,1,1
28238,5588,5588,0,0,allow,3354,1792,1562,46,193,23,23
28239,56586,53,17774,53,allow,177,94,83,2,29,1,1
28240,57438,53,26523,53,allow,340,110,230,2,29,1,1
28241,65514,53,51532,53,allow,177,94,83,2,30,1,1
28242,50288,80,24804,80,allow,2032,600,1432,10,45,6,4
28243,52014,443,52014,443,allow,16507,6060,10447,32,49,16,16
28244,54069,443,6998,443,allow,887350,41179,846171,1082,210,487,595
28245,38692,443,1550,443,allow,1188751,17817,1170934,1053,16,255,798
28246,60742,443,40207,443,allow,2258,559,1699,22,120,6,16
28247,49270,53,44798,53,allow,216,110,106,2,30,1,1
28248,44732,80,44732,80,allow,369759,9557,360202,388,22,137,251
28249,9199,80,13955,80,allow,60838,1648,59190,68,27,25,43
28250,53146,50393,43018,50393,allow,70,70,0,1,5,1,0
28251,58810,443,59123,443,allow,5167,700,4467,16,15,7,9
28252,60448,8106,52879,8106,allow,3105,1298,1807,20,16,10,10
28253,49264,80,49264,80,allow,698,366,332,12,44,7,5
28254,55862,53,15902,53,allow,177,94,83,2,30,1,1
28255,27242,443,3447,443,allow,19477,14323,5154,45,309,22,23
28256,58139,443,5557,443,allow,9521,5450,4071,30,120,15,15
28257,64170,53,8544,53,allow,355,118,237,2,30,1,1
28258,56119,53,10048,53,allow,199,102,97,2,33,1,1
28259,57852,7635,57852,7635,allow,216,156,60,4,8,3,1
28260,52009,443,52009,443,allow,588633,17490,571143,578,51,186,392
28261,52011,443,52011,443,allow,110812,7779,103033,122,49,44,78
28262,54078,443,47563,443,allow,1060654,45683,1014971,1265,176,560,705
28263,49194,65100,3468,65100,allow,624,318,306,10,15,5,5
28264,53858,53,53858,53,allow,832,106,726,2,30,1,1
28265,63313,443,9713,443,allow,1786,172,1614,7,120,3,4
28266,47657,443,24927,443,allow,502,140,362,8,140,3,5
28267,50287,80,60290,80,allow,3325,607,2718,11,45,6,5
28268,36754,443,35340,443,allow,1320,822,498,16,41,9,7
28269,45350,443,10693,443,allow,918,358,560,14,40,6,8
28270,56650,80,32144,80,allow,234,234,0,4,12,4,0
28271,64984,53,22465,53,allow,177,94,83,2,30,1,1
28272,57837,443,45626,443,allow,9767,2606,7161,23,120,11,12
28273,10037,443,24188,443,allow,6061,1884,4177,27,16,15,12
28274,51824,80,16784,80,allow,15487,8701,6786,29,44,17,12
28275,55289,53,47764,53,allow,446,94,352,4,44,2,2
28276,55491,80,9905,80,allow,204936,10932,194004,277,31,140,137
28277,55172,443,53179,443,allow,25605,3359,22246,47,82,26,21
28278,42889,443,3091,443,allow,3961,1595,2366,21,15,12,9
28279,60899,443,59717,443,allow,847673,42767,804906,1045,89,441,604
28280,37544,443,15194,443,allow,23647,9422,14225,52,40,28,24
28281,56719,443,65516,443,allow,7888,1899,5989,20,15,11,9
28282,37551,443,6245,443,allow,9381,2351,7030,26,37,15,11
28283,37557,443,30973,443,allow,9824,2477,7347,27,37,16,11
28284,51967,12110,53548,12110,allow,70,70,0,1,4,1,0
28285,60780,28080,29726,28080,allow,70,70,0,2,8,2,0
28286,58718,443,59357,443,allow,1129,599,530,12,25,6,6
28287,49863,8100,2379,8100,allow,78,78,0,1,4,1,0
28288,51969,37558,33450,37558,allow,70,70,0,1,4,1,0
28289,58807,443,28426,443,allow,6033,770,5263,18,15,8,10
28290,65321,53,63779,53,allow,283,103,180,4,54,2,2
28291,59433,53,26803,53,allow,218,78,140,2,29,1,1
28292,49886,53,25717,53,allow,275,94,181,2,30,1,1
28293,48082,443,55722,443,allow,5619,885,4734,17,26,9,8
28294,55862,53,22118,53,allow,177,94,83,2,30,1,1
28295,57113,53,7922,53,allow,215,102,113,2,30,1,1
28296,49256,53,15315,53,allow,212,102,110,2,30,1,1
28297,56621,53,63745,53,allow,177,94,83,2,29,1,1
28298,45099,123,62953,123,allow,184,94,90,2,30,1,1
28299,50319,53,7471,53,allow,194,102,92,2,30,1,1
28300,49741,53,12587,53,allow,211,102,109,2,30,1,1
28301,48941,443,53829,443,allow,10085,3487,6598,21,120,9,12
28302,55641,443,52887,443,allow,6133,1655,4478,12,119,5,7
28303,6881,6881,48136,6881,allow,238,118,120,2,1200,1,1
28304,54081,443,47129,443,allow,444890,27602,417288,580,176,265,315
28305,51459,443,30706,443,allow,6779,2365,4414,19,15,10,9
28306,54070,443,51450,443,allow,828875,45659,783216,1020,210,456,564
28307,50722,80,43079,80,allow,7550,5292,2258,13,29,7,6
28308,52000,10491,3122,10491,allow,70,70,0,2,8,2,0
28309,58808,443,58470,443,allow,5167,700,4467,16,15,7,9
28310,46845,443,36578,443,allow,5506,878,4628,16,26,9,7
28311,55958,53,14478,53,allow,212,102,110,2,30,1,1
28312,50319,53,65506,53,allow,194,102,92,2,30,1,1
28313,51764,443,27947,443,allow,5660,3864,1796,27,95,14,13
28314,60969,443,65231,443,allow,1373,712,661,14,105,8,6
28315,43841,443,59699,443,allow,6516,3085,3431,33,80,17,16
28316,64917,53,19019,53,allow,718,94,624,2,30,1,1
28317,64984,53,54223,53,allow,177,94,83,2,30,1,1
28318,50287,53,47633,53,allow,177,94,83,2,30,1,1
28319,56281,53,7565,53,allow,177,94,83,2,30,1,1
28320,57513,443,18231,443,allow,4346,1212,3134,13,120,6,7
28321,63941,80,15778,80,allow,314,192,122,6,15,4,2
28322,60966,443,26414,443,allow,60331,12765,47566,119,105,57,62
28323,52015,443,52015,443,allow,32358,7474,24884,49,49,23,26
28324,47130,80,63322,80,allow,613,539,74,7,15,6,1
28325,43865,443,4892,443,allow,560,280,280,9,26,5,4
28326,64642,53,25504,53,allow,718,94,624,2,30,1,1
28327,50287,53,45385,53,allow,177,94,83,2,30,1,1
28328,49173,53,47440,53,allow,234,94,140,2,30,1,1
28329,55871,443,13590,443,allow,21179,8150,13029,46,153,25,21
28330,123,123,44210,123,allow,184,94,90,2,30,1,1
28331,55563,53,47239,53,allow,194,102,92,2,31,1,1
28332,55221,443,37010,443,allow,12954,2333,10621,20,120,9,11
28333,62624,443,17860,443,allow,6990,2057,4933,19,121,9,10
28334,59976,80,48173,80,allow,890,469,421,10,360,5,5
28335,37965,35771,32766,35771,allow,481,150,331,2,1199,1,1
28336,54538,443,10842,443,allow,2936,1546,1390,17,70,10,7
28337,63952,50734,54501,50734,allow,66,66,0,2,8,2,0
28338,51963,21638,43079,21638,allow,70,70,0,1,5,1,0
28339,58804,443,5956,443,allow,5167,700,4467,16,15,7,9
28340,60934,80,21512,80,allow,1212,774,438,11,81,7,4
28341,56281,53,38618,53,allow,177,94,83,2,31,1,1
28342,56388,443,34459,443,allow,70,70,0,1,5,1,0
28343,59928,53,64195,53,allow,168,78,90,2,30,1,1
28344,58744,53,27095,53,allow,368,86,282,2,30,1,1
28345,50140,53,14261,53,allow,177,94,83,2,30,1,1
28346,56578,53,41828,53,allow,219,86,133,2,31,1,1
28347,56717,443,27833,443,allow,8006,1986,6020,20,15,11,9
28348,55028,443,57444,443,allow,7196,2834,4362,28,17,16,12
28349,50735,443,6692,443,allow,22676,8150,14526,33,16,17,16
28350,64113,53,33491,53,allow,294,134,160,2,30,1,1
28351,56056,53,19190,53,allow,184,86,98,2,30,1,1
28352,60442,53,50367,53,allow,184,78,106,2,30,1,1
28353,65133,445,0,0,drop,70,70,0,1,0,1,0
28354,65125,445,0,0,drop,70,70,0,1,0,1,0
28355,46837,57470,0,0,deny,62,62,0,1,0,1,0
28356,60315,445,0,0,drop,70,70,0,1,0,1,0
28357,60313,445,0,0,drop,70,70,0,1,0,1,0
28358,60311,445,0,0,drop,70,70,0,1,0,1,0
28359,50321,23684,0,0,deny,143,143,0,1,0,1,0
28360,50772,35440,0,0,deny,66,66,0,1,0,1,0
28361,62079,30188,0,0,deny,66,66,0,1,0,1,0
28362,58829,64147,0,0,deny,66,66,0,1,0,1,0
28363,11907,57470,0,0,deny,66,66,0,1,0,1,0
28364,58276,43890,0,0,deny,66,66,0,1,0,1,0
28365,65118,445,0,0,drop,70,70,0,1,0,1,0
28366,34417,50265,0,0,deny,145,145,0,1,0,1,0
28367,65112,445,0,0,drop,70,70,0,1,0,1,0
28368,65114,445,0,0,drop,70,70,0,1,0,1,0
28369,33003,28543,0,0,deny,62,62,0,1,0,1,0
28370,60304,445,0,0,drop,70,70,0,1,0,1,0
28371,60537,445,0,0,drop,66,66,0,1,0,1,0
28372,20280,30188,0,0,deny,146,146,0,1,0,1,0
28373,60311,56205,0,0,deny,66,66,0,1,0,1,0
28374,60302,445,0,0,drop,70,70,0,1,0,1,0
28375,17786,44847,0,0,deny,62,62,0,1,0,1,0
28376,49522,21247,0,0,deny,62,62,0,1,0,1,0
28377,60301,445,0,0,drop,70,70,0,1,0,1,0
28378,60300,445,0,0,drop,70,70,0,1,0,1,0
28379,60299,445,0,0,drop,70,70,0,1,0,1,0
28380,60297,445,0,0,drop,70,70,0,1,0,1,0
28381,60295,445,0,0,drop,70,70,0,1,0,1,0
28382,57011,49813,0,0,deny,66,66,0,1,0,1,0
28383,65111,445,0,0,drop,70,70,0,1,0,1,0
28384,65110,445,0,0,drop,70,70,0,1,0,1,0
28385,65398,7129,0,0,deny,62,62,0,1,0,1,0
28386,54464,56205,0,0,deny,66,66,0,1,0,1,0
28387,60281,445,0,0,drop,70,70,0,1,0,1,0
28388,60280,445,0,0,drop,70,70,0,1,0,1,0
28389,53856,443,18832,443,allow,495,421,74,4,0,3,1
28390,60521,445,0,0,drop,66,66,0,1,0,1,0
28391,60520,445,0,0,drop,66,66,0,1,0,1,0
28392,60278,445,0,0,drop,70,70,0,1,0,1,0
28393,60271,445,0,0,drop,70,70,0,1,0,1,0
28394,60270,445,0,0,drop,70,70,0,1,0,1,0
28395,10445,46824,0,0,deny,62,62,0,1,0,1,0
28396,59413,51505,0,0,deny,62,62,0,1,0,1,0
28397,18252,18242,0,0,reset-both,62,62,0,1,0,1,0
28398,60557,23117,0,0,deny,62,62,0,1,0,1,0
28399,58195,38303,0,0,deny,66,66,0,1,0,1,0
28400,65099,445,0,0,drop,70,70,0,1,0,1,0
28401,38741,37965,0,0,deny,146,146,0,1,0,1,0
28402,59934,35440,0,0,deny,66,66,0,1,0,1,0
28403,65095,445,0,0,drop,70,70,0,1,0,1,0
28404,65091,445,0,0,drop,70,70,0,1,0,1,0
28405,65092,445,0,0,drop,70,70,0,1,0,1,0
28406,60516,445,0,0,drop,66,66,0,1,0,1,0
28407,24127,56205,0,0,deny,66,66,0,1,0,1,0
28408,55524,46232,0,0,deny,66,66,0,1,0,1,0
28409,60259,445,0,0,drop,70,70,0,1,0,1,0
28410,60508,445,0,0,drop,66,66,0,1,0,1,0
28411,60509,445,0,0,drop,66,66,0,1,0,1,0
28412,60504,445,0,0,drop,66,66,0,1,0,1,0
28413,60506,445,0,0,drop,66,66,0,1,0,1,0
28414,60502,445,0,0,drop,66,66,0,1,0,1,0
28415,60498,445,0,0,drop,66,66,0,1,0,1,0
28416,60500,445,0,0,drop,66,66,0,1,0,1,0
28417,12986,64147,0,0,deny,62,62,0,1,0,1,0
28418,65085,445,0,0,drop,70,70,0,1,0,1,0
28419,14693,64147,0,0,deny,66,66,0,1,0,1,0
28420,62153,35440,0,0,deny,66,66,0,1,0,1,0
28421,65081,445,0,0,drop,70,70,0,1,0,1,0
28422,65079,445,0,0,drop,70,70,0,1,0,1,0
28423,65077,445,0,0,drop,70,70,0,1,0,1,0
28424,59400,22114,0,0,deny,66,66,0,1,0,1,0
28425,60255,445,0,0,drop,70,70,0,1,0,1,0
28426,51453,64147,0,0,deny,66,66,0,1,0,1,0
28427,48706,23393,0,0,deny,60,60,0,1,0,1,0
28428,38664,37965,0,0,deny,62,62,0,1,0,1,0
28429,59886,64147,0,0,deny,72,72,0,1,0,1,0
28430,11136,19910,0,0,deny,62,62,0,1,0,1,0
28431,1114,46824,0,0,deny,62,62,0,1,0,1,0
28432,60243,445,0,0,drop,70,70,0,1,0,1,0
28433,60244,445,0,0,drop,70,70,0,1,0,1,0
28434,60246,445,0,0,drop,70,70,0,1,0,1,0
28435,65075,445,0,0,drop,70,70,0,1,0,1,0
28436,65073,445,0,0,drop,70,70,0,1,0,1,0
28437,65072,445,0,0,drop,70,70,0,1,0,1,0
28438,60241,445,0,0,drop,70,70,0,1,0,1,0
28439,60493,445,0,0,drop,66,66,0,1,0,1,0
28440,60238,445,0,0,drop,70,70,0,1,0,1,0
28441,65068,445,0,0,drop,70,70,0,1,0,1,0
28442,60489,445,0,0,drop,66,66,0,1,0,1,0
28443,54389,28543,0,0,deny,62,62,0,1,0,1,0
28444,0,0,0,0,allow,320,320,0,5,0,5,0
28445,60486,445,0,0,drop,66,66,0,1,0,1,0
28446,60487,445,0,0,drop,66,66,0,1,0,1,0
28447,60485,445,0,0,drop,66,66,0,1,0,1,0
28448,63331,51221,0,0,deny,62,62,0,1,0,1,0
28449,65344,46824,0,0,deny,62,62,0,1,0,1,0
28450,48513,44847,0,0,deny,62,62,0,1,0,1,0
28451,60232,445,0,0,drop,70,70,0,1,0,1,0
28452,65060,445,0,0,drop,70,70,0,1,0,1,0
28453,63344,53,0,0,deny,73,73,0,1,0,1,0
28454,30794,37965,0,0,deny,62,62,0,1,0,1,0
28455,65058,445,0,0,drop,70,70,0,1,0,1,0
28456,65059,445,0,0,drop,70,70,0,1,0,1,0
28457,57365,38303,0,0,deny,62,62,0,1,0,1,0
28458,26085,8305,0,0,deny,148,148,0,1,0,1,0
28459,64697,37965,0,0,deny,66,66,0,1,0,1,0
28460,60474,445,0,0,drop,66,66,0,1,0,1,0
28461,60223,445,0,0,drop,70,70,0,1,0,1,0
28462,59679,37807,0,0,deny,66,66,0,1,0,1,0
28463,3608,25773,0,0,reset-both,146,146,0,1,0,1,0
28464,3375,35253,0,0,deny,66,66,0,1,0,1,0
28465,19875,30170,0,0,deny,145,145,0,1,0,1,0
28466,60219,445,0,0,drop,70,70,0,1,0,1,0
28467,52390,2323,0,0,deny,60,60,0,1,0,1,0
28468,11821,64147,0,0,deny,62,62,0,1,0,1,0
28469,60466,445,0,0,drop,66,66,0,1,0,1,0
28470,58836,44847,0,0,deny,74,74,0,1,0,1,0
28471,60217,445,0,0,drop,70,70,0,1,0,1,0
28472,65041,445,0,0,drop,70,70,0,1,0,1,0
28473,64677,57470,0,0,deny,66,66,0,1,0,1,0
28474,23553,37965,0,0,deny,62,62,0,1,0,1,0
28475,60463,445,0,0,drop,66,66,0,1,0,1,0
28476,61461,50584,0,0,deny,66,66,0,1,0,1,0
28477,13413,44847,0,0,deny,62,62,0,1,0,1,0
28478,49604,53,29103,53,allow,89,89,0,1,30,1,0
28479,54202,53,3615,53,allow,578,286,292,9,16,5,4
28480,40801,443,33203,443,allow,3289,1265,2024,13,32,7,6
28481,51965,48708,36849,48708,allow,66,66,0,1,5,1,0
28482,44799,443,2515,443,allow,3467,2186,1281,16,15,9,7
28483,49322,443,25281,443,allow,3005,2082,923,18,28,9,9
28484,38469,80,38469,80,allow,555104,4582,550522,446,20,60,386
28485,57987,3478,61463,3478,allow,60483,25857,34626,136,47,63,73
28486,55877,14966,41407,14966,allow,480,149,331,2,1200,1,1
28487,33856,443,15583,443,allow,7298,2661,4637,21,21,11,10
28488,53145,44634,36222,44634,allow,70,70,0,1,5,1,0
28489,5588,5588,0,0,allow,3354,1792,1562,46,193,23,23
28490,58800,443,5645,443,allow,3874,2470,1404,17,15,9,8
28491,44794,443,36304,443,allow,11158,3338,7820,27,16,16,11
28492,49307,443,35042,443,allow,245382,6838,238544,214,31,44,170
28493,65514,53,50854,53,allow,170,87,83,2,30,1,1
28494,57470,43611,57055,43611,allow,3960,3960,0,61,3411,61,0
28495,64540,53,58172,53,allow,174,89,85,2,30,1,1
28496,23683,53,23683,53,allow,338,225,113,3,30,2,1
28497,51932,443,23132,443,allow,3207,2430,777,21,26,11,10
28498,26805,443,51812,443,allow,7343,2586,4757,23,20,11,12
28499,44798,443,42874,443,allow,3239,2220,1019,16,15,9,7
28500,35440,443,40080,443,allow,7419,2136,5283,23,255,11,12
28501,55913,53,58939,53,allow,170,87,83,2,31,1,1
28502,49914,53,39261,53,allow,815,95,720,2,30,1,1
28503,53370,443,49689,443,allow,6877,1694,5183,24,306,13,11
28504,58792,443,15545,443,allow,9278,6126,3152,27,16,15,12
28505,55230,443,41463,443,allow,39555,12054,27501,78,66,41,37
28506,63931,16528,26745,16528,allow,376,254,122,6,17,4,2
28507,58888,15000,44683,15000,allow,138,78,60,2,5,1,1
28508,58048,80,12048,80,allow,5171,3018,2153,16,30,8,8
28509,53701,8999,10439,8999,allow,1328,960,368,10,32,5,5
28510,55249,53,63785,53,allow,711,87,624,2,30,1,1
28511,55034,443,55034,443,allow,154907,10748,144159,217,20,101,116
28512,36714,80,19257,80,allow,1792,703,1089,12,16,7,5
28513,59040,24184,0,0,allow,62,62,0,1,60,1,0
28514,56020,53,53467,53,allow,198,101,97,2,31,1,1
28515,54539,443,59530,443,allow,4867,1208,3659,16,23,10,6
28516,55336,443,52055,443,allow,209596,37190,172406,378,79,184,194
28517,53264,443,22628,443,allow,7424,1825,5599,25,18,13,12
28518,51994,25509,30907,25509,allow,70,70,0,2,8,2,0
28519,49321,443,15064,443,allow,3005,2082,923,18,28,9,9
28520,49044,443,55687,443,allow,5150,853,4297,16,27,9,7
28521,51387,443,34318,443,allow,5795,3322,2473,22,93,13,9
28522,39629,53,0,0,allow,82,82,0,1,30,1,0
28523,6882,16276,42707,16276,allow,150,150,0,1,1200,1,0
28524,58789,443,17140,443,allow,14261,9361,4900,35,16,19,16
28525,40802,443,39888,443,allow,3321,1297,2024,13,32,7,6
28526,55504,53,5700,53,allow,711,87,624,2,30,1,1
28527,57275,53,65357,53,allow,170,87,83,2,31,1,1
28528,62873,443,13983,443,allow,3049,988,2061,14,135,7,7
28529,63593,443,12181,443,allow,36819,3967,32852,59,152,30,29
28530,50362,53,31941,53,allow,181,98,83,2,31,1,1
28531,64915,53,25917,53,allow,98,98,0,1,31,1,0
28532,51494,443,60286,443,allow,8140,5384,2756,15,122,8,7
28533,30960,45744,39744,45744,allow,330,330,0,6,3609,6,0
28534,60213,445,0,0,drop,70,70,0,1,0,1,0
28535,46839,51050,0,0,deny,62,62,0,1,0,1,0
28536,26835,47993,0,0,deny,62,62,0,1,0,1,0
28537,65379,22114,0,0,deny,66,66,0,1,0,1,0
28538,60212,445,0,0,drop,70,70,0,1,0,1,0
28539,60455,445,0,0,drop,66,66,0,1,0,1,0
28540,60446,445,0,0,drop,66,66,0,1,0,1,0
28541,22784,9571,0,0,deny,62,62,0,1,0,1,0
28542,33651,36237,0,0,deny,62,62,0,1,0,1,0
28543,26330,26348,0,0,deny,62,62,0,1,0,1,0
28544,58745,30188,0,0,deny,66,66,0,1,0,1,0
28545,52828,51221,0,0,deny,66,66,0,1,0,1,0
28546,57275,53,56267,53,allow,177,94,83,2,30,1,1
28547,65495,443,43238,443,allow,418463,12360,406103,430,16,151,279
28548,49604,53,12616,53,allow,179,94,85,2,30,1,1
28549,56161,53,11132,53,allow,199,94,105,2,30,1,1
28550,60472,443,5896,443,allow,3779,2809,970,23,47,12,11
28551,35743,443,39300,443,allow,560,280,280,9,28,5,4
28552,9197,80,56702,80,allow,1701,883,818,14,26,7,7
28553,52643,6881,27552,6881,allow,719,413,306,10,14,5,5
28554,49840,53,47224,53,allow,463,87,376,4,38,2,2
28555,65061,53,50134,53,allow,297,101,196,4,33,2,2
28556,49339,443,31744,443,allow,208,70,138,4,25,2,2
28557,49604,53,14213,53,allow,86,86,0,1,29,1,0
28558,56876,53,26048,53,allow,283,110,173,2,29,1,1
28559,35628,443,46062,443,allow,8414,4131,4283,36,64,16,20
28560,54148,443,30287,443,allow,272587,11910,260677,336,76,140,196
28561,54151,443,32501,443,allow,1749,966,783,13,75,8,5
28562,35617,443,43217,443,allow,2981,1719,1262,17,79,10,7
28563,56716,443,64304,443,allow,8058,2038,6020,20,15,11,9
28564,36834,443,25361,443,allow,7251,5852,1399,34,75,18,16
28565,48992,443,21581,443,allow,5952,1328,4624,19,76,11,8
28566,57435,443,34425,443,allow,13536,5529,8007,55,18,24,31
28567,42587,443,6188,443,allow,7733,1203,6530,21,15,12,9
28568,55425,5222,24173,5222,allow,9151,4417,4734,84,77,44,40
28569,51996,41888,55881,41888,allow,70,70,0,2,7,2,0
28570,43628,53,19035,53,allow,168,78,90,2,29,1,1
28571,65514,53,17473,53,allow,177,94,83,2,29,1,1
28572,25237,53,25237,53,allow,216,82,134,2,33,1,1
28573,65153,53,31638,53,allow,184,86,98,2,29,1,1
28574,65492,53,51377,53,allow,707,94,613,2,29,1,1
28575,65014,53,11511,53,allow,718,94,624,2,29,1,1
28576,49198,53,16713,53,allow,261,94,167,2,29,1,1
28577,64145,53,4283,53,allow,177,94,83,2,31,1,1
28578,55021,53,44725,53,allow,179,94,85,2,30,1,1
28579,49646,53,41795,53,allow,209,102,107,2,30,1,1
28580,28237,443,25955,443,allow,7876,1540,6336,21,124,10,11
28581,56352,53,18136,53,allow,177,94,83,2,30,1,1
28582,55021,53,50748,53,allow,179,94,85,2,30,1,1
28583,59636,443,44710,443,allow,3197,1047,2150,15,120,8,7
28584,58249,443,38085,443,allow,4192,2267,1925,12,120,6,6
28585,55330,53,64550,53,allow,194,102,92,2,31,1,1
28586,64540,53,24153,53,allow,179,94,85,2,30,1,1
28587,60036,53,52040,53,allow,86,86,0,1,30,1,0
28588,64768,53,30874,53,allow,78,78,0,1,30,1,0
28589,60903,443,18682,443,allow,333062,18123,314939,420,88,182,238
28590,64714,53,29165,53,allow,168,86,82,2,32,1,1
28591,51170,443,40281,443,allow,9894856,232425,9662431,9829,90,3300,6529
28592,52588,443,7205,443,allow,3523,518,3005,12,15,6,6
28593,48282,8080,0,0,allow,184,78,106,3,9,2,1
28594,50233,80,29881,80,allow,2388,1066,1322,16,135,8,8
28595,28236,443,42527,443,allow,9686,2335,7351,28,124,13,15
28596,58803,443,12977,443,allow,5166,700,4466,16,15,7,9
28597,55671,17758,7518,17758,allow,422,140,282,6,15,3,3
28598,36668,443,55888,443,allow,142299,120615,21684,348,336,180,168
28599,54336,443,1774,443,allow,172701,6397,166304,202,246,72,130
28600,9206,443,23255,443,allow,5043,432,4611,12,15,6,6
28601,65124,53,4615,53,allow,353,118,235,2,30,1,1
28602,32927,443,11670,443,allow,5746,1079,4667,17,27,10,7
28603,64889,53,50666,53,allow,215,102,113,2,30,1,1
28604,55872,53,55616,53,allow,177,94,83,2,30,1,1
28605,58798,443,46435,443,allow,5167,700,4467,16,15,7,9
28606,56352,53,39464,53,allow,177,94,83,2,30,1,1
28607,55343,53,44963,53,allow,366,94,272,2,30,1,1
28608,54924,443,20791,443,allow,53816,22991,30825,139,306,71,68
28609,55021,53,26465,53,allow,94,94,0,1,30,1,0
28610,46261,80,62301,80,allow,3578,1673,1905,16,186,9,7
28611,46597,53,0,0,allow,86,86,0,1,30,1,0
28612,55913,53,60589,53,allow,177,94,83,2,30,1,1
28613,47765,443,53985,443,allow,8035,2176,5859,25,331,12,13
28614,60971,443,2878,443,allow,2732,1359,1373,29,193,16,13
28615,33136,443,16239,443,allow,6648,1556,5092,23,29,13,10
28616,37906,443,31579,443,allow,416,210,206,7,26,4,3
28617,57149,53,29225,53,allow,612,114,498,4,52,2,2
28618,65158,53,9153,53,allow,728,102,626,2,30,1,1
28619,52847,53,50629,53,allow,86,86,0,1,30,1,0
28620,64145,53,46343,53,allow,177,94,83,2,30,1,1
28621,64475,53,57543,53,allow,314,99,215,4,39,2,2
28622,59925,80,15613,80,allow,2287,1534,753,11,16,6,5
28623,64108,53,41542,53,allow,296,126,170,2,30,1,1
28624,55667,53,30119,53,allow,305,126,179,2,30,1,1
28625,48817,51413,48817,51413,allow,460,150,310,2,1200,1,1
28626,35967,443,11420,443,allow,3870,1743,2127,13,120,6,7
28627,54535,443,39884,443,allow,9859,3252,6607,24,74,12,12
28628,55033,443,56054,443,allow,13944,2069,11875,28,30,15,13
28629,54150,443,60800,443,allow,230997,10675,220322,291,75,122,169
28630,64694,53,58763,53,allow,361,107,254,4,37,2,2
28631,54534,443,41952,443,allow,7153,2581,4572,28,74,15,13
28632,64956,53,28840,53,allow,322,84,238,4,36,2,2
28633,51995,50031,39289,50031,allow,70,70,0,2,8,2,0
28634,51964,1103,26830,1103,allow,70,70,0,1,4,1,0
28635,51961,40373,22472,40373,allow,70,70,0,1,5,1,0
28636,38693,443,10334,443,allow,90177,3481,86696,96,15,31,65
28637,49777,53,2324,53,allow,485,79,406,4,31,2,2
28638,37965,33149,27231,33149,allow,3957,2324,1633,51,1732,29,22
28639,58802,443,8176,443,allow,5167,700,4467,16,15,7,9
28640,30188,55886,45541,55886,allow,502,150,352,2,1200,1,1
28641,56715,443,60472,443,allow,8005,1985,6020,20,15,11,9
28642,50140,53,8390,53,allow,177,94,83,2,30,1,1
28643,49512,443,49512,443,allow,217225,47956,169269,284,64,149,135
28644,65496,443,16540,443,allow,92799,4939,87860,111,16,45,66
28645,28235,443,3343,443,allow,8830,2388,6442,29,124,14,15
28646,49383,53,63729,53,allow,226,110,116,2,30,1,1
28647,55872,53,18177,53,allow,177,94,83,2,30,1,1
28648,30651,53,22880,53,allow,86,86,0,1,30,1,0
28649,27988,40040,49340,40040,allow,148,86,62,2,30,1,1
28650,55913,53,2700,53,allow,177,94,83,2,30,1,1
28651,50495,53,47068,53,allow,195,102,93,2,30,1,1
28652,36567,53,0,0,allow,86,86,0,1,30,1,0
28653,57275,53,32208,53,allow,177,94,83,2,31,1,1
28654,55565,443,12183,443,allow,21087,4784,16303,25,146,7,18
28655,44780,80,17326,80,allow,120,120,0,3,122,3,0
28656,44847,23628,55980,23628,allow,509,150,359,2,1200,1,1
28657,61806,443,30997,443,allow,7439,1156,6283,19,75,11,8
28658,51960,58601,34616,58601,allow,70,70,0,1,5,1,0
28659,64540,53,45439,53,allow,179,94,85,2,30,1,1
28660,49519,53,62256,53,allow,264,94,170,2,30,1,1
28661,50495,53,56662,53,allow,195,102,93,2,30,1,1
28662,49369,53,17790,53,allow,246,94,152,2,30,1,1
28663,57990,443,7309,443,allow,3182,1568,1614,8,120,4,4
28664,62759,443,5744,443,allow,9928,5183,4745,34,134,17,17
28665,46258,80,9234,80,allow,3711,1806,1905,17,186,10,7
28666,10103,443,54343,443,allow,6334,910,5424,20,360,10,10
28667,46410,443,3591,443,allow,4568,2057,2511,17,62,9,8
28668,62338,443,61578,443,allow,13396186,148566,13247620,10474,59,1498,8976
28669,38663,443,44632,443,allow,16002,4305,11697,60,138,29,31
28670,60904,443,17681,443,allow,2356,1309,1047,16,31,9,7
28671,49285,53,46992,53,allow,94,94,0,1,30,1,0
28672,55563,53,39714,53,allow,194,102,92,2,30,1,1
28673,46260,80,59881,80,allow,3459,1620,1839,16,186,10,6
28674,46259,80,22858,80,allow,3574,1669,1905,17,186,10,7
28675,57985,443,21475,443,allow,140109,5229,134880,159,46,59,100
28676,44220,443,37375,443,allow,2709,1698,1011,20,1143,11,9
28677,53143,24796,50959,24796,allow,698,320,378,10,16,6,4
28678,59859,443,33487,443,allow,10266,7336,2930,49,222,24,25
28679,56434,80,3931,80,allow,17128,1499,15629,24,25,9,15
28680,56714,443,39694,443,allow,8057,2037,6020,20,15,11,9
28681,57736,443,25293,443,allow,3345,823,2522,12,120,6,6
28682,50584,2775,5247,2775,allow,150,150,0,1,1200,1,0
28683,55686,443,35273,443,allow,319563,13365,306198,344,123,119,225
28684,10102,443,2452,443,allow,5415,864,4551,19,360,9,10
28685,50365,443,19679,443,allow,712,374,338,11,28,6,5
28686,53758,63975,2179,63975,allow,2016,1076,940,14,17,8,6
28687,56580,443,55118,443,allow,2343,1296,1047,17,196,10,7
28688,56410,443,52137,443,allow,16167,1392,14775,25,105,12,13
28689,47211,80,37416,80,allow,1638,1324,314,10,16,5,5
28690,56639,53,13077,53,allow,168,86,82,2,31,1,1
28691,63937,43443,65141,43443,allow,160,70,90,2,5,1,1
28692,56409,443,57180,443,allow,25302,1733,23569,35,121,16,19
28693,57275,53,14863,53,allow,177,94,83,2,30,1,1
28694,61016,443,27858,443,allow,56191,3435,52756,81,271,37,44
28695,42283,443,51990,443,allow,16831,14003,2828,31,63,18,13
28696,64204,53,12423,53,allow,211,102,109,2,30,1,1
28697,59950,53,40733,53,allow,168,78,90,2,31,1,1
28698,57470,19853,37734,19853,allow,132,132,0,3,1200,3,0
28699,57455,443,26313,443,allow,9124,5296,3828,54,120,29,25
28700,33633,443,34965,443,allow,5698,1585,4113,23,1108,13,10
28701,55589,53,12456,53,allow,177,94,83,2,30,1,1
28702,59998,53,31845,53,allow,481,110,371,2,31,1,1
28703,60207,445,0,0,drop,70,70,0,1,0,1,0
28704,43323,1,0,0,deny,62,62,0,1,0,1,0
28705,10026,50584,0,0,deny,146,146,0,1,0,1,0
28706,59876,44847,0,0,deny,62,62,0,1,0,1,0
28707,65029,445,0,0,drop,70,70,0,1,0,1,0
28708,65030,445,0,0,drop,70,70,0,1,0,1,0
28709,65028,445,0,0,drop,70,70,0,1,0,1,0
28710,60435,445,0,0,drop,66,66,0,1,0,1,0
28711,60436,445,0,0,drop,66,66,0,1,0,1,0
28712,60438,445,0,0,drop,66,66,0,1,0,1,0
28713,60432,445,0,0,drop,66,66,0,1,0,1,0
28714,60437,445,0,0,drop,66,66,0,1,0,1,0
28715,60439,445,0,0,drop,66,66,0,1,0,1,0
28716,60433,445,0,0,drop,66,66,0,1,0,1,0
28717,60440,445,0,0,drop,66,66,0,1,0,1,0
28718,64104,22114,0,0,deny,62,62,0,1,0,1,0
28719,54737,50584,0,0,deny,66,66,0,1,0,1,0
28720,61550,5529,0,0,deny,145,145,0,1,0,1,0
28721,3170,53567,0,0,deny,66,66,0,1,0,1,0
28722,59483,23,0,0,deny,60,60,0,1,0,1,0
28723,51743,64147,0,0,deny,62,62,0,1,0,1,0
28724,25901,50265,0,0,deny,62,62,0,1,0,1,0
28725,25054,36827,0,0,deny,66,66,0,1,0,1,0
28726,36369,51505,0,0,deny,66,66,0,1,0,1,0
28727,51148,9571,0,0,deny,66,66,0,1,0,1,0
28728,60194,445,0,0,drop,70,70,0,1,0,1,0
28729,53500,1,0,0,deny,66,66,0,1,0,1,0
28730,26301,22114,0,0,deny,62,62,0,1,0,1,0
28731,65027,445,0,0,drop,70,70,0,1,0,1,0
28732,65026,445,0,0,drop,70,70,0,1,0,1,0
28733,65024,445,0,0,drop,70,70,0,1,0,1,0
28734,65012,445,0,0,drop,70,70,0,1,0,1,0
28735,9227,9000,0,0,deny,60,60,0,1,0,1,0
28736,60191,445,0,0,drop,70,70,0,1,0,1,0
28737,50052,65008,0,0,deny,60,60,0,1,0,1,0
28738,60419,445,0,0,drop,66,66,0,1,0,1,0
28739,60417,445,0,0,drop,66,66,0,1,0,1,0
28740,60416,445,0,0,drop,66,66,0,1,0,1,0
28741,39681,37965,0,0,deny,62,62,0,1,0,1,0
28742,64543,50265,0,0,deny,66,66,0,1,0,1,0
28743,13938,64147,0,0,deny,145,145,0,1,0,1,0
28744,31235,22114,0,0,deny,146,146,0,1,0,1,0
28745,65008,445,0,0,drop,70,70,0,1,0,1,0
28746,60186,445,0,0,drop,70,70,0,1,0,1,0
28747,60185,445,0,0,drop,70,70,0,1,0,1,0
28748,65000,445,0,0,drop,70,70,0,1,0,1,0
28749,65002,445,0,0,drop,70,70,0,1,0,1,0
28750,60183,445,0,0,drop,70,70,0,1,0,1,0
28751,2531,30188,0,0,deny,66,66,0,1,0,1,0
28752,12709,51505,0,0,deny,62,62,0,1,0,1,0
28753,45964,3111,0,0,deny,60,60,0,1,0,1,0
28754,7246,59858,0,0,deny,66,66,0,1,0,1,0
28755,45908,3383,0,0,deny,60,60,0,1,0,1,0
28756,63397,26467,0,0,deny,66,66,0,1,0,1,0
28757,63041,50584,0,0,deny,62,62,0,1,0,1,0
28758,40571,26467,0,0,deny,62,62,0,1,0,1,0
28759,17643,50584,0,0,deny,62,62,0,1,0,1,0
28760,27908,23,0,0,deny,60,60,0,1,0,1,0
28761,60176,445,0,0,drop,70,70,0,1,0,1,0
28762,64986,445,0,0,drop,70,70,0,1,0,1,0
28763,64987,445,0,0,drop,70,70,0,1,0,1,0
28764,64988,445,0,0,drop,70,70,0,1,0,1,0
28765,61537,57866,0,0,deny,66,66,0,1,0,1,0
28766,60174,445,0,0,drop,70,70,0,1,0,1,0
28767,32520,47993,0,0,deny,62,62,0,1,0,1,0
28768,60406,445,0,0,drop,66,66,0,1,0,1,0
28769,65081,26467,0,0,deny,66,66,0,1,0,1,0
28770,12663,62413,0,0,deny,66,66,0,1,0,1,0
28771,60173,445,0,0,drop,70,70,0,1,0,1,0
28772,27828,56205,0,0,deny,146,146,0,1,0,1,0
28773,60172,445,0,0,drop,70,70,0,1,0,1,0
28774,60171,445,0,0,drop,70,70,0,1,0,1,0
28775,60169,445,0,0,drop,70,70,0,1,0,1,0
28776,60167,445,0,0,drop,70,70,0,1,0,1,0
28777,14343,6881,0,0,deny,62,62,0,1,0,1,0
28778,3792,52700,0,0,deny,62,62,0,1,0,1,0
28779,64982,445,0,0,drop,70,70,0,1,0,1,0
28780,64975,445,0,0,drop,70,70,0,1,0,1,0
28781,57034,44847,0,0,deny,62,62,0,1,0,1,0
28782,60786,51505,0,0,deny,62,62,0,1,0,1,0
28783,60153,445,0,0,drop,70,70,0,1,0,1,0
28784,60151,445,0,0,drop,70,70,0,1,0,1,0
28785,60150,445,0,0,drop,70,70,0,1,0,1,0
28786,59365,42873,0,0,deny,74,74,0,1,0,1,0
28787,22975,23,0,0,deny,60,60,0,1,0,1,0
28788,60142,445,0,0,drop,70,70,0,1,0,1,0
28789,60143,445,0,0,drop,70,70,0,1,0,1,0
28790,24809,52700,0,0,deny,66,66,0,1,0,1,0
28791,60388,445,0,0,drop,66,66,0,1,0,1,0
28792,60387,445,0,0,drop,66,66,0,1,0,1,0
28793,61430,37965,0,0,deny,66,66,0,1,0,1,0
28794,45908,33330,0,0,deny,60,60,0,1,0,1,0
28795,41744,37965,0,0,deny,62,62,0,1,0,1,0
28796,62973,51505,0,0,deny,62,62,0,1,0,1,0
28797,64969,445,0,0,drop,70,70,0,1,0,1,0
28798,64967,445,0,0,drop,70,70,0,1,0,1,0
28799,64965,445,0,0,drop,70,70,0,1,0,1,0
28800,64964,445,0,0,drop,70,70,0,1,0,1,0
28801,59043,35440,0,0,deny,66,66,0,1,0,1,0
28802,13090,36237,0,0,deny,62,62,0,1,0,1,0
28803,53143,50584,0,0,deny,66,66,0,1,0,1,0
28804,11878,37807,0,0,deny,146,146,0,1,0,1,0
28805,62824,37807,0,0,deny,66,66,0,1,0,1,0
28806,14696,42707,0,0,deny,62,62,0,1,0,1,0
28807,51830,42707,0,0,deny,66,66,0,1,0,1,0
28808,60383,445,0,0,drop,66,66,0,1,0,1,0
28809,60131,445,0,0,drop,70,70,0,1,0,1,0
28810,50,64147,0,0,deny,66,66,0,1,0,1,0
28811,60371,445,0,0,drop,66,66,0,1,0,1,0
28812,60370,445,0,0,drop,66,66,0,1,0,1,0
28813,60380,445,0,0,drop,66,66,0,1,0,1,0
28814,60375,445,0,0,drop,66,66,0,1,0,1,0
28815,60369,445,0,0,drop,66,66,0,1,0,1,0
28816,60373,445,0,0,drop,66,66,0,1,0,1,0
28817,60372,445,0,0,drop,66,66,0,1,0,1,0
28818,58858,15503,0,0,deny,66,66,0,1,0,1,0
28819,33405,37965,0,0,deny,62,62,0,1,0,1,0
28820,53871,37965,0,0,deny,66,66,0,1,0,1,0
28821,59210,50584,0,0,deny,66,66,0,1,0,1,0
28822,64957,445,0,0,drop,70,70,0,1,0,1,0
28823,59842,62413,0,0,deny,66,66,0,1,0,1,0
28824,64953,445,0,0,drop,70,70,0,1,0,1,0
28825,64952,445,0,0,drop,70,70,0,1,0,1,0
28826,64949,445,0,0,drop,70,70,0,1,0,1,0
28827,56582,23718,0,0,deny,66,66,0,1,0,1,0
28828,50799,37807,0,0,deny,66,66,0,1,0,1,0
28829,0,0,0,0,deny,98,98,0,1,0,1,0
28830,0,0,0,0,deny,98,98,0,1,0,1,0
28831,0,0,0,0,deny,98,98,0,1,0,1,0
28832,0,0,0,0,deny,98,98,0,1,0,1,0
28833,0,0,0,0,deny,98,98,0,1,0,1,0
28834,0,0,0,0,deny,98,98,0,1,0,1,0
28835,0,0,0,0,deny,98,98,0,1,0,1,0
28836,0,0,0,0,allow,244,244,0,2,0,2,0
28837,0,0,0,0,deny,98,98,0,1,0,1,0
28838,0,0,0,0,allow,156,156,0,2,0,2,0
28839,50135,50584,0,0,deny,62,62,0,1,0,1,0
28840,8403,46824,0,0,deny,62,62,0,1,0,1,0
28841,60127,445,0,0,drop,70,70,0,1,0,1,0
28842,55862,62413,0,0,deny,66,66,0,1,0,1,0
28843,11562,30188,0,0,deny,62,62,0,1,0,1,0
28844,6289,44847,0,0,deny,66,66,0,1,0,1,0
28845,60118,445,0,0,drop,70,70,0,1,0,1,0
28846,60117,445,0,0,drop,70,70,0,1,0,1,0
28847,60116,445,0,0,drop,70,70,0,1,0,1,0
28848,60114,445,0,0,drop,70,70,0,1,0,1,0
28849,56191,22114,0,0,deny,62,62,0,1,0,1,0
28850,60110,445,0,0,drop,70,70,0,1,0,1,0
28851,38306,51221,0,0,deny,62,62,0,1,0,1,0
28852,64948,445,0,0,drop,70,70,0,1,0,1,0
28853,64947,445,0,0,drop,70,70,0,1,0,1,0
28854,64944,445,0,0,drop,70,70,0,1,0,1,0
28855,58972,57866,0,0,deny,62,62,0,1,0,1,0
28856,64368,22114,0,0,deny,66,66,0,1,0,1,0
28857,60364,445,0,0,drop,66,66,0,1,0,1,0
28858,64940,445,0,0,drop,70,70,0,1,0,1,0
28859,60360,445,0,0,drop,66,66,0,1,0,1,0
28860,24271,52700,0,0,deny,66,66,0,1,0,1,0
28861,14183,26467,0,0,deny,62,62,0,1,0,1,0
28862,60357,445,0,0,drop,66,66,0,1,0,1,0
28863,60356,445,0,0,drop,66,66,0,1,0,1,0
28864,1114,46824,0,0,deny,62,62,0,1,0,1,0
28865,60355,445,0,0,drop,66,66,0,1,0,1,0
28866,43578,15503,0,0,deny,74,74,0,1,0,1,0
28867,46149,23,0,0,deny,60,60,0,1,0,1,0
28868,17781,50265,0,0,deny,62,62,0,1,0,1,0
28869,60105,445,0,0,drop,70,70,0,1,0,1,0
28870,50424,55777,0,0,deny,62,62,0,1,0,1,0
28871,64932,445,0,0,drop,70,70,0,1,0,1,0
28872,14567,37965,0,0,deny,62,62,0,1,0,1,0
28873,64927,445,0,0,drop,70,70,0,1,0,1,0
28874,64926,445,0,0,drop,70,70,0,1,0,1,0
28875,1873,37965,0,0,deny,62,62,0,1,0,1,0
28876,64535,37965,0,0,deny,66,66,0,1,0,1,0
28877,60097,445,0,0,drop,70,70,0,1,0,1,0
28878,60094,445,0,0,drop,70,70,0,1,0,1,0
28879,30315,57470,0,0,deny,145,145,0,1,0,1,0
28880,32282,8604,0,0,deny,66,66,0,1,0,1,0
28881,54886,443,54886,443,allow,136775,6729,130046,181,18,82,99
28882,47111,80,20951,80,allow,162355,7124,155231,207,27,96,111
28883,51988,32239,6773,32239,allow,70,70,0,2,8,2,0
28884,53144,58987,40200,58987,allow,70,70,0,1,5,1,0
28885,51827,443,46992,443,allow,11946,8904,3042,42,42,26,16
28886,56419,80,4193,80,allow,34098,808,33290,34,104,9,25
28887,54849,22448,0,0,allow,66,66,0,1,90,1,0
28888,33569,443,7892,443,allow,7418,1880,5538,28,396,9,19
28889,54644,443,54644,443,allow,103968,5475,98493,141,18,63,78
28890,58765,443,24675,443,allow,26158,17265,8893,57,19,31,26
28891,55670,31056,27603,31056,allow,70,70,0,1,5,1,0
28892,56420,80,57757,80,allow,34636,928,33708,37,104,11,26
28893,56413,80,48301,80,allow,31432,748,30684,32,104,8,24
28894,56412,80,47207,80,allow,34476,818,33658,35,104,9,26
28895,55921,53,30522,53,allow,711,87,624,2,30,1,1
28896,56733,53,13870,53,allow,170,87,83,2,30,1,1
28897,54470,443,54470,443,allow,101021,6173,94848,142,18,65,77
28898,51990,42127,13506,42127,allow,70,70,0,2,8,2,0
28899,47279,443,50478,443,allow,7948,1520,6428,21,16,13,8
28900,44795,443,55624,443,allow,9608,1958,7650,21,15,11,10
28901,56423,80,12556,80,allow,33937,628,33309,31,104,6,25
28902,58790,443,27687,443,allow,3558,2453,1105,17,15,9,8
28903,52479,443,9730,443,allow,11052,4417,6635,19,137,10,9
28904,56561,443,49349,443,allow,26334,2210,24124,49,66,22,27
28905,56025,53,63426,53,allow,761,100,661,2,30,1,1
28906,65449,53,25371,53,allow,170,87,83,2,31,1,1
28907,56417,80,64869,80,allow,38188,688,37500,35,104,7,28
28908,59920,443,3699,443,allow,7359,2050,5309,18,16,10,8
28909,44792,443,44086,443,allow,9700,2137,7563,21,16,12,9
28910,62413,6881,56796,6881,allow,311,311,0,3,1200,3,0
28911,55230,443,46201,443,allow,42376115,1180708,41195407,45399,148,13976,31423
28912,54952,443,11665,443,allow,61842,4466,57376,109,293,46,63
28913,49570,443,15727,443,allow,8058,1806,6252,22,15,12,10
28914,56427,443,19838,443,allow,9901,1298,8603,19,79,10,9
28915,58785,443,24870,443,allow,11873,7787,4086,32,16,17,15
28916,58786,443,62467,443,allow,13240,8717,4523,33,16,17,16
28917,56418,80,22380,80,allow,39249,938,38311,40,104,11,29
28918,51956,36995,10789,36995,allow,66,66,0,1,5,1,0
28919,56414,80,4969,80,allow,33712,928,32784,36,104,11,25
28920,50436,443,10408,443,allow,18959,3307,15652,33,19,16,17
28921,37420,443,37420,443,allow,4624,1717,2907,19,27,11,8
28922,53245,443,26528,443,allow,7705,2005,5700,26,120,13,13
28923,39496,80,39496,80,allow,2898,1485,1413,10,15,6,4
28924,64145,53,55779,53,allow,170,87,83,2,30,1,1
28925,53114,443,28454,443,allow,3796,1523,2273,20,135,10,10
28926,64742,443,6500,443,allow,6372,1582,4790,32,195,15,17
28927,45913,443,64072,443,allow,4046,967,3079,13,27,7,6
28928,56416,80,36682,80,allow,33755,928,32827,36,104,11,25
28929,56421,80,51921,80,allow,34300,868,33432,35,104,10,25
28930,56422,80,3635,80,allow,35833,938,34895,37,104,11,26
28931,56411,80,44029,80,allow,35574,868,34706,36,104,10,26
28932,56415,80,5751,80,allow,38339,808,37531,37,104,9,28
28933,50734,80,62871,80,allow,3498,2696,802,9,26,5,4
28934,55660,42459,61425,42459,allow,1717,1129,588,17,25,10,7
28935,1319,443,12846,443,allow,448,256,192,8,25,5,3
28936,56368,53,19422,53,allow,817,98,719,2,30,1,1
28937,55548,53,25199,53,allow,194,99,95,2,30,1,1
28938,65048,443,9174,443,allow,3283,1019,2264,10,120,5,5
28939,40151,5228,21276,5228,allow,19172,3089,16083,43,3601,20,23
28940,60342,445,0,0,drop,66,66,0,1,0,1,0
28941,6666,80,0,0,deny,60,60,0,1,0,1,0
28942,27368,22114,0,0,deny,146,146,0,1,0,1,0
28943,40308,67,0,0,deny,60,60,0,1,0,1,0
28944,19634,64147,0,0,deny,62,62,0,1,0,1,0
28945,50949,45960,0,0,deny,62,62,0,1,0,1,0
28946,16376,35440,0,0,deny,146,146,0,1,0,1,0
28947,32704,46824,0,0,deny,66,66,0,1,0,1,0
28948,57339,57470,0,0,deny,66,66,0,1,0,1,0
28949,36453,23,0,0,deny,60,60,0,1,0,1,0
28950,60091,445,0,0,drop,70,70,0,1,0,1,0
28951,33886,39127,0,0,deny,162,162,0,1,0,1,0
28952,60089,445,0,0,drop,70,70,0,1,0,1,0
28953,60335,445,0,0,drop,66,66,0,1,0,1,0
28954,64914,445,0,0,drop,70,70,0,1,0,1,0
28955,6666,138,0,0,deny,60,60,0,1,0,1,0
28956,12969,55777,0,0,deny,66,66,0,1,0,1,0
28957,58359,64147,0,0,deny,72,72,0,1,0,1,0
28958,65024,53,8030,53,allow,295,101,194,4,33,2,2
28959,55678,52879,10322,52879,allow,70,70,0,2,8,2,0
28960,57456,443,23040,443,allow,1857,1218,639,18,119,11,7
28961,40182,443,51089,443,allow,6865,1958,4907,21,16,13,8
28962,49262,80,49262,80,allow,515211,10976,504235,506,49,169,337
28963,63938,26204,59342,26204,allow,70,70,0,1,4,1,0
28964,46408,443,13228,443,allow,15452,3787,11665,36,62,19,17
28965,53006,443,3727,443,allow,2651,1504,1147,24,68,13,11
28966,56405,443,6737,443,allow,12470,1570,10900,21,125,10,11
28967,56408,443,36804,443,allow,17704,1456,16248,25,123,11,14
28968,56713,443,15450,443,allow,8006,1986,6020,20,15,11,9
28969,60716,443,33650,443,allow,6898,2843,4055,21,17,11,10
28970,58797,443,17991,443,allow,5167,700,4467,16,15,7,9
28971,50299,443,56417,443,allow,86,86,0,1,4,1,0
28972,63932,63241,5696,63241,allow,436,254,182,7,15,4,3
28973,51959,42269,61621,42269,allow,70,70,0,1,4,1,0
28974,51958,51322,1745,51322,allow,70,70,0,1,4,1,0
28975,55589,53,33223,53,allow,177,94,83,2,29,1,1
28976,33857,123,20930,123,allow,184,94,90,2,30,1,1
28977,64634,53,6012,53,allow,211,102,109,2,29,1,1
28978,51441,443,56551,443,allow,642,582,60,2,15,1,1
28979,53142,47933,51357,47933,allow,698,320,378,10,17,6,4
28980,57226,53,37479,53,allow,178,94,84,2,30,1,1
28981,59823,443,6570,443,allow,27406,15466,11940,123,188,62,61
28982,58788,443,39752,443,allow,5166,700,4466,16,15,7,9
28983,37587,443,9282,443,allow,6912,1841,5071,33,27,17,16
28984,58794,443,62373,443,allow,5166,700,4466,16,15,7,9
28985,60713,443,57689,443,allow,6287,1742,4545,17,19,10,7
28986,35001,53,37388,53,allow,78,78,0,1,30,1,0
28987,56648,80,59981,80,allow,234,234,0,4,12,4,0
28988,55677,16588,61905,16588,allow,70,70,0,2,8,2,0
28989,51955,39871,39902,39871,allow,70,70,0,1,5,1,0
28990,51952,50967,20758,50967,allow,70,70,0,1,5,1,0
28991,52126,443,32440,443,allow,12096,3734,8362,53,102,25,28
28992,37739,443,17741,443,allow,138037,13843,124194,197,206,94,103
28993,64145,53,59140,53,allow,177,94,83,2,30,1,1
28994,59049,53,37929,53,allow,199,94,105,2,30,1,1
28995,61838,443,61838,443,allow,36811,5190,31621,60,150,24,36
28996,56887,53,15011,53,allow,312,94,218,2,30,1,1
28997,60184,443,52371,443,allow,26293,7740,18553,55,121,26,29
28998,65449,53,31955,53,allow,177,94,83,2,30,1,1
28999,33070,80,34842,80,allow,3483,1578,1905,17,186,10,7
29000,56733,53,1965,53,allow,177,94,83,2,30,1,1
29001,15503,19168,41378,19168,allow,481,150,331,2,1200,1,1
29002,64161,53,62669,53,allow,261,102,159,2,30,1,1
29003,52310,53,0,0,allow,247,76,171,2,30,1,1
29004,49987,443,39263,443,allow,426,180,246,8,21,4,4
29005,51985,38904,27850,38904,allow,70,70,0,2,8,2,0
29006,51987,23136,59906,23136,allow,70,70,0,2,8,2,0
29007,33830,443,43990,443,allow,448,78,370,6,25,1,5
29008,52090,443,7071,443,allow,6383,5237,1146,19,16,11,8
29009,58791,443,11218,443,allow,5167,700,4467,16,15,7,9
29010,37736,443,40675,443,allow,498507,26210,472297,544,207,200,344
29011,55545,53,1793,53,allow,821,102,719,2,30,1,1
29012,56712,443,63256,443,allow,8058,2038,6020,20,15,11,9
29013,39426,443,8694,443,allow,903603,21528,882075,858,57,234,624
29014,34454,80,32778,80,allow,1638,1324,314,10,14,5,5
29015,43693,443,24547,443,allow,6389,1439,4950,22,18,11,11
29016,56406,443,10804,443,allow,8328,1391,6937,18,123,10,8
29017,41850,443,17792,443,allow,6714,1515,5199,23,196,13,10
29018,57887,443,20597,443,allow,6938,1531,5407,23,195,13,10
29019,51715,80,53478,80,allow,3309,2152,1157,18,150,10,8
29020,50617,80,45162,80,allow,1658,1247,411,8,14,5,3
29021,51985,80,53937,80,allow,14233438,253696,13979742,12752,54,3515,9237
29022,51998,1877,49263,1877,allow,316,136,180,6,6,3,3
29023,63931,53,21564,53,allow,380,105,275,4,35,2,2
29024,55548,53,43983,53,allow,197,102,95,2,33,1,1
29025,49638,53,28303,53,allow,331,88,243,4,32,2,2
29026,51992,22670,60663,22670,allow,70,70,0,2,7,2,0
29027,53760,45682,20604,45682,allow,70,70,0,1,4,1,0
29028,55545,53,34965,53,allow,196,100,96,3,33,2,1
29029,58793,443,26304,443,allow,5167,700,4467,16,15,7,9
29030,53762,9587,5160,9587,allow,70,70,0,1,4,1,0
29031,37738,443,40273,443,allow,296068,21814,274254,358,206,150,208
29032,64456,53,28818,53,allow,341,110,231,2,29,1,1
29033,55913,53,19739,53,allow,177,94,83,2,30,1,1
29034,65449,53,22193,53,allow,177,94,83,2,30,1,1
29035,64509,53,38948,53,allow,385,134,251,2,30,1,1
29036,56733,53,65238,53,allow,177,94,83,2,30,1,1
29037,41126,53,30186,53,allow,199,94,105,2,30,1,1
29038,64657,53,12172,53,allow,312,94,218,2,30,1,1
29039,50362,53,19652,53,allow,177,94,83,2,30,1,1
29040,33255,53,27087,53,allow,86,86,0,1,30,1,0
29041,55796,53,34450,53,allow,214,94,120,2,30,1,1
29042,56020,53,46192,53,allow,199,102,97,2,30,1,1
29043,46026,443,9317,443,allow,8908,3897,5011,19,135,9,10
29044,49342,53,61829,53,allow,402,118,284,2,30,1,1
29045,33071,443,36886,443,allow,4234,2185,2049,36,1099,16,20
29046,42604,443,37985,443,allow,3243,2026,1217,16,15,8,8
29047,51993,55279,27826,55279,allow,316,136,180,6,7,3,3
29048,51989,29736,40433,29736,allow,258,70,188,4,8,2,2
29049,51954,12380,41427,12380,allow,70,70,0,1,5,1,0
29050,39918,443,58004,443,allow,7542,1235,6307,23,15,12,11
29051,57226,53,25603,53,allow,178,94,84,2,30,1,1
29052,41267,8245,14045,8245,allow,280,214,66,2,30,1,1
29053,49761,53,37619,53,allow,382,94,288,2,30,1,1
29054,22539,53,19206,53,allow,86,86,0,1,30,1,0
29055,49396,80,45610,80,allow,13738839,196158,13542681,11272,248,2231,9041
29056,63928,61494,31292,61494,allow,1691,446,1245,10,15,7,3
29057,65418,53,5528,53,allow,197,94,103,2,30,1,1
29058,37757,53,12221,53,allow,86,86,0,1,30,1,0
29059,38496,5228,27256,5228,allow,3397,1506,1891,26,640,8,18
29060,33684,443,39270,443,allow,6829,1261,5568,21,197,11,10
29061,51986,41982,47346,41982,allow,70,70,0,2,8,2,0
29062,56711,443,47786,443,allow,8005,1985,6020,20,15,11,9
29063,49321,53,65339,53,allow,225,102,123,2,30,1,1
29064,37737,443,61948,443,allow,190013,14784,175229,238,206,101,137
29065,55526,53,8264,53,allow,250,86,164,2,30,1,1
29066,55815,443,3642,443,allow,8602,1050,7552,16,120,7,9
29067,43275,443,50486,443,allow,9093,4719,4374,52,310,24,28
29068,55207,443,50638,443,allow,1803,1029,774,16,185,9,7
29069,54159,443,5303,443,allow,10945,2478,8467,39,18,19,20
29070,65449,53,26123,53,allow,315,87,228,4,40,2,2
29071,52635,443,48519,443,allow,8993,5205,3788,48,167,25,23
29072,42601,443,52311,443,allow,3238,2021,1217,16,16,8,8
29073,43288,443,20649,443,allow,11123,2634,8489,22,121,10,12
29074,53756,61137,24650,61137,allow,672,306,366,11,16,5,6
29075,55025,443,11622,443,allow,7599,3113,4486,30,20,17,13
29076,53771,64351,44787,64351,allow,70,70,0,2,8,2,0
29077,57069,53,3710,53,allow,177,94,83,2,30,1,1
29078,57069,53,52685,53,allow,177,94,83,2,31,1,1
29079,1903,43890,0,0,deny,66,66,0,1,0,1,0
29080,53906,44512,0,0,deny,62,62,0,1,0,1,0
29081,56462,37965,0,0,deny,66,66,0,1,0,1,0
29082,60085,445,0,0,drop,70,70,0,1,0,1,0
29083,8313,51505,0,0,deny,62,62,0,1,0,1,0
29084,51346,51221,0,0,deny,70,70,0,1,0,1,0
29085,60332,445,0,0,drop,66,66,0,1,0,1,0
29086,56005,64147,0,0,deny,62,62,0,1,0,1,0
29087,63079,64147,0,0,deny,66,66,0,1,0,1,0
29088,60297,25604,0,0,deny,62,62,0,1,0,1,0
29089,60083,445,0,0,drop,70,70,0,1,0,1,0
29090,54305,39004,0,0,deny,62,62,0,1,0,1,0
29091,55450,64147,0,0,deny,66,66,0,1,0,1,0
29092,60324,445,0,0,drop,66,66,0,1,0,1,0
29093,27402,37628,0,0,deny,62,62,0,1,0,1,0
29094,60316,445,0,0,drop,66,66,0,1,0,1,0
29095,37911,443,2261,443,allow,466,392,74,4,0,3,1
29096,7664,2149,0,0,deny,66,66,0,1,0,1,0
29097,60079,445,0,0,drop,70,70,0,1,0,1,0
29098,48706,23393,0,0,deny,60,60,0,1,0,1,0
29099,20012,444,0,0,deny,60,60,0,1,0,1,0
29100,6666,6001,0,0,deny,60,60,0,1,0,1,0
29101,24768,22114,0,0,deny,146,146,0,1,0,1,0
29102,64903,445,0,0,drop,70,70,0,1,0,1,0
29103,64901,445,0,0,drop,70,70,0,1,0,1,0
29104,64900,445,0,0,drop,70,70,0,1,0,1,0
29105,60310,445,0,0,drop,66,66,0,1,0,1,0
29106,60308,445,0,0,drop,66,66,0,1,0,1,0
29107,60304,445,0,0,drop,66,66,0,1,0,1,0
29108,60306,445,0,0,drop,66,66,0,1,0,1,0
29109,60309,445,0,0,drop,66,66,0,1,0,1,0
29110,60307,445,0,0,drop,66,66,0,1,0,1,0
29111,60303,445,0,0,drop,66,66,0,1,0,1,0
29112,60302,445,0,0,drop,66,66,0,1,0,1,0
29113,61078,57470,0,0,deny,145,145,0,1,0,1,0
29114,60066,445,0,0,drop,70,70,0,1,0,1,0
29115,28878,51505,0,0,deny,62,62,0,1,0,1,0
29116,54276,37628,0,0,deny,66,66,0,1,0,1,0
29117,40512,57470,0,0,deny,74,74,0,1,0,1,0
29118,60063,445,0,0,drop,70,70,0,1,0,1,0
29119,64891,445,0,0,drop,70,70,0,1,0,1,0
29120,64890,445,0,0,drop,70,70,0,1,0,1,0
29121,64886,445,0,0,drop,70,70,0,1,0,1,0
29122,64883,445,0,0,drop,70,70,0,1,0,1,0
29123,33098,443,16704,443,allow,466,392,74,4,0,3,1
29124,28413,64147,0,0,deny,62,62,0,1,0,1,0
29125,60288,445,0,0,drop,66,66,0,1,0,1,0
29126,60290,445,0,0,drop,66,66,0,1,0,1,0
29127,60287,445,0,0,drop,66,66,0,1,0,1,0
29128,60058,445,0,0,drop,70,70,0,1,0,1,0
29129,60057,445,0,0,drop,70,70,0,1,0,1,0
29130,64880,445,0,0,drop,70,70,0,1,0,1,0
29131,60055,445,0,0,drop,70,70,0,1,0,1,0
29132,50245,44847,0,0,deny,62,62,0,1,0,1,0
29133,64877,445,0,0,drop,70,70,0,1,0,1,0
29134,64872,445,0,0,drop,70,70,0,1,0,1,0
29135,64874,445,0,0,drop,70,70,0,1,0,1,0
29136,64346,51505,0,0,deny,66,66,0,1,0,1,0
29137,55111,39004,0,0,deny,66,66,0,1,0,1,0
29138,57173,44847,0,0,deny,62,62,0,1,0,1,0
29139,13840,37965,0,0,deny,146,146,0,1,0,1,0
29140,41648,56205,0,0,deny,66,66,0,1,0,1,0
29141,59618,46824,0,0,deny,66,66,0,1,0,1,0
29142,1114,46824,0,0,deny,62,62,0,1,0,1,0
29143,64626,50584,0,0,deny,66,66,0,1,0,1,0
29144,443,28215,0,0,deny,60,60,0,1,0,1,0
29145,24110,23,0,0,deny,60,60,0,1,0,1,0
29146,60048,445,0,0,drop,70,70,0,1,0,1,0
29147,60046,445,0,0,drop,70,70,0,1,0,1,0
29148,64862,445,0,0,drop,70,70,0,1,0,1,0
29149,64860,445,0,0,drop,70,70,0,1,0,1,0
29150,64857,445,0,0,drop,70,70,0,1,0,1,0
29151,20830,1433,0,0,deny,60,60,0,1,0,1,0
29152,59365,42873,0,0,deny,74,74,0,1,0,1,0
29153,29080,50265,0,0,deny,62,62,0,1,0,1,0
29154,52094,22114,0,0,deny,146,146,0,1,0,1,0
29155,60045,445,0,0,drop,70,70,0,1,0,1,0
29156,60276,445,0,0,drop,66,66,0,1,0,1,0
29157,60044,445,0,0,drop,70,70,0,1,0,1,0
29158,58475,11392,0,0,deny,66,66,0,1,0,1,0
29159,30580,50265,0,0,deny,66,66,0,1,0,1,0
29160,60043,445,0,0,drop,70,70,0,1,0,1,0
29161,60038,445,0,0,drop,70,70,0,1,0,1,0
29162,60037,445,0,0,drop,70,70,0,1,0,1,0
29163,45682,25604,0,0,deny,62,62,0,1,0,1,0
29164,43063,57470,0,0,deny,62,62,0,1,0,1,0
29165,47910,7454,0,0,deny,60,60,0,1,0,1,0
29166,21750,39004,0,0,deny,62,62,0,1,0,1,0
29167,3068,36237,0,0,deny,62,62,0,1,0,1,0
29168,59763,25604,0,0,deny,66,66,0,1,0,1,0
29169,56386,50584,0,0,deny,66,66,0,1,0,1,0
29170,60025,445,0,0,drop,70,70,0,1,0,1,0
29171,60024,445,0,0,drop,70,70,0,1,0,1,0
29172,60018,445,0,0,drop,70,70,0,1,0,1,0
29173,20864,51221,0,0,deny,62,62,0,1,0,1,0
29174,64853,445,0,0,drop,70,70,0,1,0,1,0
29175,64847,445,0,0,drop,70,70,0,1,0,1,0
29176,58791,30188,0,0,deny,146,146,0,1,0,1,0
29177,60015,445,0,0,drop,70,70,0,1,0,1,0
29178,60014,445,0,0,drop,70,70,0,1,0,1,0
29179,56035,1310,0,0,deny,62,62,0,1,0,1,0
29180,58021,17,0,0,deny,60,60,0,1,0,1,0
29181,60761,51221,0,0,deny,66,66,0,1,0,1,0
29182,60263,445,0,0,drop,66,66,0,1,0,1,0
29183,60260,445,0,0,drop,66,66,0,1,0,1,0
29184,58687,11392,0,0,deny,66,66,0,1,0,1,0
29185,30602,36237,0,0,deny,146,146,0,1,0,1,0
29186,13285,29892,0,0,deny,145,145,0,1,0,1,0
29187,0,0,0,0,deny,185,185,0,1,0,1,0
29188,64844,445,0,0,drop,70,70,0,1,0,1,0
29189,60003,445,0,0,drop,70,70,0,1,0,1,0
29190,64839,445,0,0,drop,70,70,0,1,0,1,0
29191,64838,445,0,0,drop,70,70,0,1,0,1,0
29192,64837,445,0,0,drop,70,70,0,1,0,1,0
29193,36679,443,65477,443,allow,466,392,74,4,0,3,1
29194,1045,36237,0,0,deny,66,66,0,1,0,1,0
29195,60257,445,0,0,drop,66,66,0,1,0,1,0
29196,60249,445,0,0,drop,66,66,0,1,0,1,0
29197,60251,445,0,0,drop,66,66,0,1,0,1,0
29198,60240,445,0,0,drop,66,66,0,1,0,1,0
29199,60245,445,0,0,drop,66,66,0,1,0,1,0
29200,60246,445,0,0,drop,66,66,0,1,0,1,0
29201,60241,445,0,0,drop,66,66,0,1,0,1,0
29202,60239,445,0,0,drop,66,66,0,1,0,1,0
29203,28370,23,0,0,deny,60,60,0,1,0,1,0
29204,65166,62413,0,0,deny,62,62,0,1,0,1,0
29205,80,63761,0,0,deny,66,66,0,1,0,1,0
29206,64827,445,0,0,drop,70,70,0,1,0,1,0
29207,63461,51505,0,0,deny,66,66,0,1,0,1,0
29208,59999,445,0,0,drop,70,70,0,1,0,1,0
29209,64825,445,0,0,drop,70,70,0,1,0,1,0
29210,64823,445,0,0,drop,70,70,0,1,0,1,0
29211,64821,445,0,0,drop,70,70,0,1,0,1,0
29212,45238,44847,0,0,deny,62,62,0,1,0,1,0
29213,16630,44847,0,0,deny,62,62,0,1,0,1,0
29214,34400,39004,0,0,deny,74,74,0,1,0,1,0
29215,16630,44847,0,0,deny,146,146,0,1,0,1,0
29216,59989,445,0,0,drop,70,70,0,1,0,1,0
29217,59987,445,0,0,drop,70,70,0,1,0,1,0
29218,59990,445,0,0,drop,70,70,0,1,0,1,0
29219,59985,445,0,0,drop,70,70,0,1,0,1,0
29220,51731,57470,0,0,deny,78,78,0,1,0,1,0
29221,443,10010,0,0,deny,60,60,0,1,0,1,0
29222,1091,37965,0,0,deny,62,62,0,1,0,1,0
29223,49276,51505,0,0,deny,66,66,0,1,0,1,0
29224,59982,445,0,0,drop,70,70,0,1,0,1,0
29225,56255,44847,0,0,deny,66,66,0,1,0,1,0
29226,64819,445,0,0,drop,70,70,0,1,0,1,0
29227,64818,445,0,0,drop,70,70,0,1,0,1,0
29228,64817,445,0,0,drop,70,70,0,1,0,1,0
29229,2636,11392,0,0,deny,66,66,0,1,0,1,0
29230,60232,445,0,0,drop,66,66,0,1,0,1,0
29231,57302,62413,0,0,deny,66,66,0,1,0,1,0
29232,64812,445,0,0,drop,70,70,0,1,0,1,0
29233,52348,62413,0,0,deny,66,66,0,1,0,1,0
29234,60228,445,0,0,drop,66,66,0,1,0,1,0
29235,60226,445,0,0,drop,66,66,0,1,0,1,0
29236,42366,57470,0,0,deny,66,66,0,1,0,1,0
29237,51148,443,4211,443,allow,4942,2409,2533,11,120,6,5
29238,56450,53,26592,53,allow,170,87,83,2,30,1,1
29239,58907,80,55384,80,allow,694,350,344,11,28,6,5
29240,61129,443,47713,443,allow,3854,1233,2621,19,120,9,10
29241,4651,443,4651,443,allow,14579,1280,13299,25,16,9,16
29242,55101,53,3206,53,allow,711,87,624,2,30,1,1
29243,50820,53,0,0,allow,371,77,294,2,30,1,1
29244,59283,80,59283,80,allow,72354,14398,57956,123,15,40,83
29245,58775,443,62135,443,allow,9017,5865,3152,26,16,14,12
29246,55671,53,32686,53,allow,98,98,0,1,30,1,0
29247,50224,443,62141,443,allow,9530,2104,7426,18,121,9,9
29248,49510,443,40862,443,allow,9571,3757,5814,48,221,26,22
29249,56734,53,17479,53,allow,751,95,656,2,30,1,1
29250,58781,443,48906,443,allow,6673,4335,2338,22,16,11,11
29251,53772,14132,16590,14132,allow,70,70,0,2,8,2,0
29252,54326,7000,54326,7000,allow,2958,1567,1391,15,15,8,7
29253,6881,30279,63096,30279,allow,150,150,0,1,1200,1,0
29254,64477,3478,36622,3478,allow,189,79,110,2,301,1,1
29255,50110,53,49491,53,allow,172,88,84,2,31,1,1
29256,51950,17499,60701,17499,allow,66,66,0,1,5,1,0
29257,59282,80,59282,80,allow,181627,17128,164499,277,15,79,198
29258,55531,53,64298,53,allow,216,110,106,2,30,1,1
29259,58777,443,42281,443,allow,2577,1550,1027,15,16,7,8
29260,53263,443,15903,443,allow,14269,5761,8508,43,18,23,20
29261,58764,443,5482,443,allow,21960,14378,7582,49,18,26,23
29262,53257,443,51156,443,allow,8715,1814,6901,26,29,15,11
29263,48513,443,48513,443,allow,4566,1659,2907,19,27,11,8
29264,59281,80,59281,80,allow,108922,4633,104289,194,16,66,128
29265,58012,53,0,0,allow,82,82,0,1,30,1,0
29266,56997,53,59115,53,allow,711,87,624,2,30,1,1
29267,55711,53,2553,53,allow,728,96,632,2,30,1,1
29268,64763,53,29524,53,allow,728,96,632,2,30,1,1
29269,38634,443,57626,443,allow,9398,4241,5157,22,135,11,11
29270,58782,443,19890,443,allow,5397,3496,1901,20,16,10,10
29271,65024,53,40250,53,allow,198,101,97,2,32,1,1
29272,51991,56980,61136,56980,allow,316,136,180,6,7,3,3
29273,58768,443,60756,443,allow,18568,12357,6211,43,18,24,19
29274,53778,6881,23099,6881,allow,70,70,0,2,8,2,0
29275,51409,443,64493,443,allow,36713,3193,33520,57,623,23,34
29276,54325,7000,54325,7000,allow,755529,16895,738634,785,16,264,521
29277,5416,53,5416,53,allow,213,79,134,2,33,1,1
29278,60342,7000,60342,7000,allow,3114,1659,1455,17,15,9,8
29279,61504,443,15507,443,allow,16708,2331,14377,31,21,14,17
29280,52150,443,44913,443,allow,5481,3086,2395,26,49,13,13
29281,58936,443,47053,443,allow,9081,3368,5713,42,76,24,18
29282,59279,80,59279,80,allow,108786,4563,104223,192,16,65,127
29283,50466,53,25118,53,allow,295,101,194,4,30,2,2
29284,55330,53,46578,53,allow,188,96,92,2,30,1,1
29285,55720,443,32771,443,allow,2494,719,1775,9,120,5,4
29286,55531,53,31789,53,allow,216,110,106,2,30,1,1
29287,58776,443,47713,443,allow,3991,2587,1404,17,16,9,8
29288,57238,53,18077,53,allow,701,88,613,2,31,1,1
29289,55850,53,22849,53,allow,711,87,624,2,31,1,1
29290,55655,53,43785,53,allow,754,94,660,2,31,1,1
29291,58906,80,61612,80,allow,742,350,392,12,28,6,6
29292,64788,53,8538,53,allow,749,94,655,2,31,1,1
29293,57143,53,34750,53,allow,184,94,90,2,31,1,1
29294,49454,53,56383,53,allow,762,97,665,2,31,1,1
29295,36657,443,2188,443,allow,10985,3186,7799,29,204,14,15
29296,61349,443,14011,443,allow,1786,172,1614,7,120,3,4
29297,47966,443,16155,443,allow,10895,2151,8744,26,362,11,15
29298,34357,443,37129,443,allow,17372,10352,7020,91,422,52,39
29299,51221,51413,63036,51413,allow,459,149,310,2,1200,1,1
29300,10151,34592,23117,34592,allow,480,149,331,2,1200,1,1
29301,35051,53,35051,53,allow,194,87,107,2,31,1,1
29302,55705,53,6400,53,allow,281,101,180,4,60,2,2
29303,64792,53,58723,53,allow,768,99,669,2,31,1,1
29304,56612,53,23653,53,allow,172,88,84,2,31,1,1
29305,60435,443,42755,443,allow,38888447,473172,38415275,31568,128,5708,25860
29306,33877,53,33877,53,allow,643,88,555,2,31,1,1
29307,57470,62314,37389,62314,allow,1188,1188,0,19,2338,19,0
29308,49160,16919,59131,16919,allow,868,150,718,4,1200,2,2
29309,51382,56205,0,0,deny,62,62,0,1,0,1,0
29310,59977,445,0,0,drop,70,70,0,1,0,1,0
29311,60224,445,0,0,drop,66,66,0,1,0,1,0
29312,57555,35440,0,0,deny,66,66,0,1,0,1,0
29313,16013,35253,0,0,deny,66,66,0,1,0,1,0
29314,2464,50584,0,0,deny,62,62,0,1,0,1,0
29315,57940,24748,0,0,deny,148,148,0,1,0,1,0
29316,49514,39127,0,0,deny,162,162,0,1,0,1,0
29317,64804,445,0,0,drop,70,70,0,1,0,1,0
29318,59969,445,0,0,drop,70,70,0,1,0,1,0
29319,1912,48817,0,0,deny,62,62,0,1,0,1,0
29320,64797,445,0,0,drop,70,70,0,1,0,1,0
29321,64795,445,0,0,drop,70,70,0,1,0,1,0
29322,59967,445,0,0,drop,70,70,0,1,0,1,0
29323,7347,56205,0,0,deny,66,66,0,1,0,1,0
29324,54866,37965,0,0,deny,62,62,0,1,0,1,0
29325,10480,26467,0,0,deny,62,62,0,1,0,1,0
29326,42717,5900,0,0,deny,60,60,0,1,0,1,0
29327,37607,443,8291,443,allow,499,425,74,4,0,3,1
29328,37609,443,19871,443,allow,499,425,74,4,0,3,1
29329,37610,443,1253,443,allow,499,425,74,4,0,3,1
29330,37612,443,15502,443,allow,499,425,74,4,0,3,1
29331,37611,443,44824,443,allow,499,425,74,4,0,3,1
29332,37608,443,17459,443,allow,499,425,74,4,0,3,1
29333,60214,445,0,0,drop,66,66,0,1,0,1,0
29334,62348,48817,0,0,deny,145,145,0,1,0,1,0
29335,56250,36237,0,0,deny,66,66,0,1,0,1,0
29336,59962,445,0,0,drop,70,70,0,1,0,1,0
29337,59961,445,0,0,drop,70,70,0,1,0,1,0
29338,2572,35440,0,0,deny,66,66,0,1,0,1,0
29339,56638,64147,0,0,deny,62,62,0,1,0,1,0
29340,51429,22114,0,0,deny,62,62,0,1,0,1,0
29341,60206,445,0,0,drop,66,66,0,1,0,1,0
29342,64785,445,0,0,drop,70,70,0,1,0,1,0
29343,15978,50584,0,0,deny,146,146,0,1,0,1,0
29344,59957,445,0,0,drop,70,70,0,1,0,1,0
29345,47201,44847,0,0,deny,66,66,0,1,0,1,0
29346,59956,445,0,0,drop,70,70,0,1,0,1,0
29347,3830,26467,0,0,deny,66,66,0,1,0,1,0
29348,52184,22114,0,0,deny,66,66,0,1,0,1,0
29349,60204,445,0,0,drop,66,66,0,1,0,1,0
29350,65012,32468,0,0,deny,66,66,0,1,0,1,0
29351,28136,443,42266,443,allow,8805,3429,5376,33,475,16,17
29352,50466,53,28614,53,allow,199,102,97,2,30,1,1
29353,62062,443,21250,443,allow,134,60,74,3,5,2,1
29354,55026,443,23738,443,allow,11413,6823,4590,34,18,19,15
29355,49493,53,48045,53,allow,241,118,123,2,30,1,1
29356,62043,80,35524,80,allow,3466,665,2801,14,16,7,7
29357,40244,443,63008,443,allow,21525,15159,6366,43,315,25,18
29358,56199,53,11587,53,allow,79,79,0,2,33,2,0
29359,53777,62955,35330,62955,allow,70,70,0,2,7,2,0
29360,57436,66,1487,66,allow,70,70,0,1,4,1,0
29361,56832,53,34537,53,allow,214,102,112,2,29,1,1
29362,64747,53,39095,53,allow,216,94,122,2,29,1,1
29363,65082,53,4469,53,allow,718,94,624,2,29,1,1
29364,56312,53,57178,53,allow,214,102,112,2,29,1,1
29365,55330,53,28011,53,allow,194,102,92,2,29,1,1
29366,55126,53,7380,53,allow,177,94,83,2,30,1,1
29367,64374,53,21299,53,allow,194,94,100,2,30,1,1
29368,62961,53,49359,53,allow,209,102,107,2,30,1,1
29369,52932,443,50755,443,allow,3032,1082,1950,9,120,5,4
29370,46883,443,30067,443,allow,40443,5300,35143,88,134,38,50
29371,42600,443,64399,443,allow,3137,1986,1151,15,15,8,7
29372,63907,54218,37939,54218,allow,696,452,244,11,21,7,4
29373,56450,53,63813,53,allow,177,94,83,2,30,1,1
29374,55126,53,57162,53,allow,177,94,83,2,30,1,1
29375,48745,443,43215,443,allow,229628,10653,218975,263,49,103,160
29376,38000,443,20816,443,allow,13123,6654,6469,29,135,15,14
29377,51982,56306,48759,56306,allow,70,70,0,2,8,2,0
29378,51179,53,60232,53,allow,86,86,0,1,30,1,0
29379,57646,443,57646,443,allow,4492,1585,2907,19,30,11,8
29380,56361,53,48019,53,allow,816,102,714,2,30,1,1
29381,56707,443,22633,443,allow,8005,1985,6020,20,15,11,9
29382,36498,80,36498,80,allow,161054,3432,157622,140,158,24,116
29383,51983,30472,23592,30472,allow,70,70,0,2,8,2,0
29384,51951,65387,33774,65387,allow,70,70,0,1,5,1,0
29385,58780,443,38511,443,allow,5971,706,5265,17,15,7,10
29386,56101,53,11714,53,allow,194,102,92,2,30,1,1
29387,56708,443,4344,443,allow,8059,2039,6020,20,15,11,9
29388,49183,53,38350,53,allow,177,94,83,2,30,1,1
29389,64937,53,49091,53,allow,94,94,0,1,30,1,0
29390,53496,3389,53496,3389,allow,3624,1910,1714,19,33,11,8
29391,54429,53,0,0,allow,195,70,125,2,30,1,1
29392,56450,53,31149,53,allow,177,94,83,2,30,1,1
29393,45939,5228,13443,5228,allow,7528,1416,6112,29,811,11,18
29394,64172,53,37844,53,allow,197,102,95,2,33,1,1
29395,56969,443,46839,443,allow,6431,1792,4639,22,80,13,9
29396,35568,443,33534,443,allow,5383,3710,1673,27,309,14,13
29397,53753,46790,44362,46790,allow,492,306,186,8,15,5,3
29398,64729,53,36616,53,allow,262,94,168,2,30,1,1
29399,33421,443,28800,443,allow,9917,3184,6733,30,91,12,18
29400,56986,53,20950,53,allow,259,87,172,4,37,2,2
29401,53249,443,22744,443,allow,12082,5745,6337,32,61,16,16
29402,9203,443,1918,443,allow,318,192,126,6,17,4,2
29403,43666,443,10694,443,allow,13212,9431,3781,41,238,21,20
29404,50466,53,34951,53,allow,199,102,97,2,30,1,1
29405,34998,443,4497,443,allow,9114,2208,6906,36,120,19,17
29406,49266,53,11642,53,allow,330,97,233,4,33,2,2
29407,53773,15459,13024,15459,allow,70,70,0,2,7,2,0
29408,56710,443,25252,443,allow,8057,2037,6020,20,15,11,9
29409,54820,443,53134,443,allow,16366,4160,12206,41,55,20,21
29410,52636,443,34549,443,allow,1309,670,639,16,166,9,7
29411,35913,443,5129,443,allow,14329,8250,6079,26,22,16,10
29412,35804,443,35654,443,allow,232,172,60,3,5,2,1
29413,48541,80,51953,80,allow,812,672,140,6,28,4,2
29414,37339,443,37972,443,allow,130,70,60,3,5,2,1
29415,53265,443,57484,443,allow,4995,1414,3581,21,15,12,9
29416,44236,80,40314,80,allow,2982,2565,417,12,15,7,5
29417,55671,53,40091,53,allow,196,102,94,2,33,1,1
29418,53752,35446,60472,35446,allow,492,306,186,8,15,5,3
29419,37907,443,63465,443,allow,9227,2999,6228,64,616,35,29
29420,60781,40010,23139,40010,allow,316,136,180,6,5,3,3
29421,39774,443,8618,443,allow,69542,11991,57551,139,157,60,79
29422,53776,37650,27111,37650,allow,70,70,0,2,7,2,0
29423,58783,443,56867,443,allow,5166,700,4466,16,15,7,9
29424,41246,443,49001,443,allow,78,78,0,1,5,1,0
29425,63823,51558,31200,51558,allow,1518,1396,122,12,45,10,2
29426,32970,443,36092,443,allow,8910,2660,6250,24,18,13,11
29427,64981,53,62988,53,allow,214,102,112,2,29,1,1
29428,56733,53,5825,53,allow,177,94,83,2,29,1,1
29429,50336,53,8935,53,allow,102,102,0,1,30,1,0
29430,58856,443,44646,443,allow,4552,2750,1802,27,95,15,12
29431,51877,53,28972,53,allow,254,78,176,2,29,1,1
29432,48606,443,28779,443,allow,4160,2675,1485,25,95,14,11
29433,49668,53,14674,53,allow,214,102,112,2,29,1,1
29434,55531,53,2010,53,allow,322,110,212,4,30,2,2
29435,64192,53,23253,53,allow,308,110,198,2,29,1,1
29436,56446,443,39205,443,allow,15813,5998,9815,30,120,14,16
29437,49183,53,55748,53,allow,177,94,83,2,30,1,1
29438,57772,443,4338,443,allow,6783,3270,3513,22,120,11,11
29439,65510,53,46580,53,allow,229,102,127,2,30,1,1
29440,37965,61282,39357,61282,allow,402,132,270,6,1208,3,3
29441,55531,53,46307,53,allow,216,110,106,2,30,1,1
29442,60985,443,15568,443,allow,30399,22692,7707,57,144,31,26
29443,54870,443,33932,443,allow,424,210,214,7,131,4,3
29444,39004,443,10788,443,allow,38459,27564,10895,97,189,49,48
29445,58779,443,44782,443,allow,5166,700,4466,16,15,7,9
29446,55067,443,38448,443,allow,3136,2025,1111,19,26,10,9
29447,64000,53,28661,53,allow,241,102,139,2,30,1,1
29448,50252,53,45062,53,allow,173,94,79,2,30,1,1
29449,49981,53,44663,53,allow,360,102,258,2,30,1,1
29450,49688,53,10693,53,allow,782,110,672,2,30,1,1
29451,56273,53,37875,53,allow,330,126,204,2,30,1,1
29452,50010,53,28513,53,allow,330,126,204,2,31,1,1
29453,56177,53,3037,53,allow,807,94,713,2,31,1,1
29454,49812,53,26847,53,allow,193,102,91,2,31,1,1
29455,39009,443,34628,443,allow,12197,2338,9859,34,122,14,20
29456,49948,53,31894,53,allow,755,102,653,2,30,1,1
29457,65049,53,34852,53,allow,199,102,97,2,30,1,1
29458,56709,443,54114,443,allow,8007,1987,6020,20,15,11,9
29459,51984,54606,5412,54606,allow,70,70,0,2,8,2,0
29460,60287,80,59923,80,allow,10135,7433,2702,28,164,19,9
29461,49328,53,46932,53,allow,748,94,654,2,30,1,1
29462,50110,53,63137,53,allow,178,94,84,2,30,1,1
29463,2890,53,28510,53,allow,78,78,0,1,30,1,0
29464,56361,53,14867,53,allow,193,102,91,2,30,1,1
29465,57019,53,54333,53,allow,193,102,91,2,30,1,1
29466,1934,53,51604,53,allow,210,78,132,2,30,1,1
29467,49896,53,58946,53,allow,772,102,670,2,30,1,1
29468,57241,53,26543,53,allow,224,102,122,2,30,1,1
29469,50466,53,18896,53,allow,199,102,97,2,30,1,1
29470,56628,80,40916,80,allow,1359,435,924,13,30,7,6
29471,58784,443,22318,443,allow,5168,700,4468,16,15,7,9
29472,58787,443,18932,443,allow,5107,700,4407,15,15,7,8
29473,49190,443,44351,443,allow,568536,16389,552147,598,19,224,374
29474,51999,34619,15741,34619,allow,70,70,0,1,5,1,0
29475,60286,80,21753,80,allow,5836,2829,3007,19,164,14,5
29476,64226,53,55510,53,allow,211,102,109,2,30,1,1
29477,56101,53,64581,53,allow,194,102,92,2,30,1,1
29478,65206,53,13449,53,allow,330,118,212,2,30,1,1
29479,42819,443,36580,443,allow,10837,3411,7426,34,272,17,17
29480,65212,53,36121,53,allow,230,102,128,2,30,1,1
29481,64097,443,12441,443,allow,6372,1893,4479,15,120,8,7
29482,52933,443,12830,443,allow,3517,993,2524,12,120,6,6
29483,55007,443,13149,443,allow,14030,7043,6987,32,123,18,14
29484,33044,443,19147,443,allow,268582,23654,244928,341,190,128,213
29485,51566,53,46943,53,allow,239,102,137,2,30,1,1
29486,49587,53,25936,53,allow,229,102,127,2,30,1,1
29487,58805,53,42120,53,allow,237,86,151,2,30,1,1
29488,36701,53,35437,53,allow,199,94,105,2,30,1,1
29489,55334,53,17897,53,allow,199,102,97,2,31,1,1
29490,49708,443,3133,443,allow,7772,2563,5209,18,121,9,9
29491,39064,443,7055,443,allow,11356,4341,7015,33,128,16,17
29492,54299,443,30059,443,allow,9986,2440,7546,17,120,8,9
29493,56000,53,26233,53,allow,177,94,83,2,30,1,1
29494,57019,53,50222,53,allow,193,102,91,2,30,1,1
29495,65277,53,2071,53,allow,775,102,673,2,30,1,1
29496,65275,53,62237,53,allow,184,94,90,2,30,1,1
29497,55330,53,61986,53,allow,194,102,92,2,31,1,1
29498,44881,53,62824,53,allow,212,78,134,2,30,1,1
29499,59982,443,10585,443,allow,3640,870,2770,13,120,6,7
29500,50468,443,35607,443,allow,227265,6450,220815,225,124,63,162
29501,63930,44330,31365,44330,allow,70,70,0,1,5,1,0
29502,51949,5484,40071,5484,allow,70,70,0,1,5,1,0
29503,61832,80,61832,80,allow,2221,1482,739,11,149,6,5
29504,65114,443,65114,443,allow,4480,1573,2907,19,30,11,8
29505,65275,53,60428,53,allow,807,94,713,2,30,1,1
29506,46985,53,9920,53,allow,199,94,105,2,30,1,1
29507,49348,53,64482,53,allow,214,94,120,2,31,1,1
29508,56000,53,8849,53,allow,177,94,83,2,31,1,1
29509,64475,443,53340,443,allow,251092,8989,242103,282,123,98,184
29510,61860,10443,7961,10443,allow,10811,2571,8240,27,48,15,12
29511,64665,53,12742,53,allow,181,94,87,2,32,1,1
29512,63929,48477,13540,48477,allow,70,70,0,1,5,1,0
29513,60195,445,0,0,drop,66,66,0,1,0,1,0
29514,59951,445,0,0,drop,70,70,0,1,0,1,0
29515,60193,445,0,0,drop,66,66,0,1,0,1,0
29516,62257,2767,0,0,deny,66,66,0,1,0,1,0
29517,58829,64147,0,0,deny,66,66,0,1,0,1,0
29518,45304,64147,0,0,deny,72,72,0,1,0,1,0
29519,65259,37965,0,0,deny,66,66,0,1,0,1,0
29520,50772,35440,0,0,deny,66,66,0,1,0,1,0
29521,64773,445,0,0,drop,70,70,0,1,0,1,0
29522,64774,445,0,0,drop,70,70,0,1,0,1,0
29523,64772,445,0,0,drop,70,70,0,1,0,1,0
29524,60174,445,0,0,drop,66,66,0,1,0,1,0
29525,60180,445,0,0,drop,66,66,0,1,0,1,0
29526,60175,445,0,0,drop,66,66,0,1,0,1,0
29527,60179,445,0,0,drop,66,66,0,1,0,1,0
29528,60177,445,0,0,drop,66,66,0,1,0,1,0
29529,60181,445,0,0,drop,66,66,0,1,0,1,0
29530,60178,445,0,0,drop,66,66,0,1,0,1,0
29531,60176,445,0,0,drop,66,66,0,1,0,1,0
29532,45908,33330,0,0,deny,60,60,0,1,0,1,0
29533,59938,445,0,0,drop,70,70,0,1,0,1,0
29534,57011,49813,0,0,deny,66,66,0,1,0,1,0
29535,59935,445,0,0,drop,70,70,0,1,0,1,0
29536,16826,22,0,0,deny,60,60,0,1,0,1,0
29537,54464,56205,0,0,deny,66,66,0,1,0,1,0
29538,64765,445,0,0,drop,70,70,0,1,0,1,0
29539,64763,445,0,0,drop,70,70,0,1,0,1,0
29540,64758,445,0,0,drop,70,70,0,1,0,1,0
29541,64755,445,0,0,drop,70,70,0,1,0,1,0
29542,7889,48817,0,0,deny,146,146,0,1,0,1,0
29543,37603,443,61350,443,allow,573,425,148,5,1,3,2
29544,37602,443,57970,443,allow,573,425,148,5,0,3,2
29545,37601,443,50258,443,allow,573,425,148,5,0,3,2
29546,54251,443,43085,443,allow,499,425,74,4,0,3,1
29547,54252,443,11078,443,allow,499,425,74,4,0,3,1
29548,54250,443,54030,443,allow,499,425,74,4,0,3,1
29549,60161,445,0,0,drop,66,66,0,1,0,1,0
29550,60160,445,0,0,drop,66,66,0,1,0,1,0
29551,60159,445,0,0,drop,66,66,0,1,0,1,0
29552,59930,445,0,0,drop,70,70,0,1,0,1,0
29553,59929,445,0,0,drop,70,70,0,1,0,1,0
29554,6817,23,0,0,deny,60,60,0,1,0,1,0
29555,59927,445,0,0,drop,70,70,0,1,0,1,0
29556,65422,26467,0,0,deny,62,62,0,1,0,1,0
29557,64752,445,0,0,drop,70,70,0,1,0,1,0
29558,50920,60182,0,0,deny,62,62,0,1,0,1,0
29559,64747,445,0,0,drop,70,70,0,1,0,1,0
29560,64746,445,0,0,drop,70,70,0,1,0,1,0
29561,54249,443,37595,443,allow,499,425,74,4,0,3,1
29562,37605,443,2336,443,allow,573,425,148,5,0,3,2
29563,37604,443,27839,443,allow,573,425,148,5,0,3,2
29564,54248,443,24435,443,allow,499,425,74,4,0,3,1
29565,37606,443,60055,443,allow,499,425,74,4,0,3,1
29566,54245,443,40246,443,allow,499,425,74,4,0,3,1
29567,64743,445,0,0,drop,70,70,0,1,0,1,0
29568,64824,36829,0,0,deny,62,62,0,1,0,1,0
29569,63956,38211,0,0,deny,62,62,0,1,0,1,0
29570,7364,50584,0,0,deny,66,66,0,1,0,1,0
29571,20217,8333,0,0,deny,60,60,0,1,0,1,0
29572,4110,35440,0,0,deny,62,62,0,1,0,1,0
29573,443,61686,0,0,deny,1484,1484,0,1,0,1,0
29574,59920,445,0,0,drop,70,70,0,1,0,1,0
29575,16905,57866,0,0,deny,66,66,0,1,0,1,0
29576,25565,27960,0,0,deny,60,60,0,1,0,1,0
29577,10736,35440,0,0,deny,66,66,0,1,0,1,0
29578,62153,35440,0,0,deny,66,66,0,1,0,1,0
29579,59400,22114,0,0,deny,66,66,0,1,0,1,0
29580,59918,445,0,0,drop,70,70,0,1,0,1,0
29581,64735,445,0,0,drop,70,70,0,1,0,1,0
29582,64729,445,0,0,drop,70,70,0,1,0,1,0
29583,64730,445,0,0,drop,70,70,0,1,0,1,0
29584,59917,445,0,0,drop,70,70,0,1,0,1,0
29585,48706,23393,0,0,deny,60,60,0,1,0,1,0
29586,11136,19910,0,0,deny,62,62,0,1,0,1,0
29587,59916,445,0,0,drop,70,70,0,1,0,1,0
29588,11136,19910,0,0,deny,145,145,0,1,0,1,0
29589,59915,445,0,0,drop,70,70,0,1,0,1,0
29590,59911,445,0,0,drop,70,70,0,1,0,1,0
29591,59910,445,0,0,drop,70,70,0,1,0,1,0
29592,60149,445,0,0,drop,66,66,0,1,0,1,0
29593,48513,44847,0,0,deny,62,62,0,1,0,1,0
29594,3597,11392,0,0,deny,66,66,0,1,0,1,0
29595,16477,37807,0,0,deny,66,66,0,1,0,1,0
29596,10834,50584,0,0,deny,66,66,0,1,0,1,0
29597,38664,37965,0,0,deny,62,62,0,1,0,1,0
29598,59897,445,0,0,drop,70,70,0,1,0,1,0
29599,59896,445,0,0,drop,70,70,0,1,0,1,0
29600,59891,445,0,0,drop,70,70,0,1,0,1,0
29601,1024,48817,0,0,deny,148,148,0,1,0,1,0
29602,59886,445,0,0,drop,70,70,0,1,0,1,0
29603,59887,445,0,0,drop,70,70,0,1,0,1,0
29604,52022,52752,0,0,deny,74,74,0,1,0,1,0
29605,64725,445,0,0,drop,70,70,0,1,0,1,0
29606,64719,445,0,0,drop,70,70,0,1,0,1,0
29607,50,38211,0,0,deny,66,66,0,1,0,1,0
29608,7310,44847,0,0,deny,66,66,0,1,0,1,0
29609,8889,26330,0,0,deny,60,60,0,1,0,1,0
29610,60134,445,0,0,drop,66,66,0,1,0,1,0
29611,60132,445,0,0,drop,66,66,0,1,0,1,0
29612,25497,44847,0,0,deny,146,146,0,1,0,1,0
29613,52062,443,35040,443,allow,466,392,74,4,0,3,1
29614,23461,34021,0,0,reset-both,62,62,0,1,0,1,0
29615,59875,445,0,0,drop,70,70,0,1,0,1,0
29616,51934,36180,0,0,deny,66,66,0,1,0,1,0
29617,64697,37965,0,0,deny,66,66,0,1,0,1,0
29618,30794,37965,0,0,deny,62,62,0,1,0,1,0
29619,64714,445,0,0,drop,70,70,0,1,0,1,0
29620,64709,445,0,0,drop,70,70,0,1,0,1,0
29621,64708,445,0,0,drop,70,70,0,1,0,1,0
29622,64707,445,0,0,drop,70,70,0,1,0,1,0
29623,60125,445,0,0,drop,66,66,0,1,0,1,0
29624,60771,58414,0,0,deny,66,66,0,1,0,1,0
29625,58836,44847,0,0,deny,74,74,0,1,0,1,0
29626,60120,445,0,0,drop,66,66,0,1,0,1,0
29627,60122,445,0,0,drop,66,66,0,1,0,1,0
29628,60114,445,0,0,drop,66,66,0,1,0,1,0
29629,60118,445,0,0,drop,66,66,0,1,0,1,0
29630,60111,445,0,0,drop,66,66,0,1,0,1,0
29631,60110,445,0,0,drop,66,66,0,1,0,1,0
29632,59871,445,0,0,drop,70,70,0,1,0,1,0
29633,49113,50584,0,0,deny,62,62,0,1,0,1,0
29634,64701,445,0,0,drop,70,70,0,1,0,1,0
29635,55387,53,17527,53,allow,761,100,661,2,31,1,1
29636,57311,53,52829,53,allow,768,99,669,2,31,1,1
29637,45550,80,42274,80,allow,890,420,470,14,27,7,7
29638,49904,80,22359,80,allow,1647,508,1139,8,138,5,3
29639,54990,443,49240,443,allow,20961,10306,10655,49,48,25,24
29640,54617,443,54617,443,allow,3186,1836,1350,16,17,10,6
29641,58769,443,51640,443,allow,3923,2459,1464,17,17,8,9
29642,62905,443,5789,443,allow,8426,2893,5533,27,16,15,12
29643,53774,58433,12540,58433,allow,320,140,180,6,7,3,3
29644,56654,53,59245,53,allow,202,103,99,2,31,1,1
29645,57444,53,22248,53,allow,170,87,83,2,30,1,1
29646,54604,80,54604,80,allow,2244,1549,695,11,18,7,4
29647,35439,443,50661,443,allow,3730,2455,1275,18,256,10,8
29648,50036,80,50018,80,allow,1665,923,742,7,32,4,3
29649,45552,80,5282,80,allow,890,420,470,14,27,7,7
29650,65251,53,54208,53,allow,183,98,85,3,36,2,1
29651,64665,53,63171,53,allow,91,91,0,1,30,1,0
29652,55196,53,52555,53,allow,711,87,624,2,30,1,1
29653,65266,53,41690,53,allow,216,110,106,2,31,1,1
29654,52326,443,52326,443,allow,5433,2251,3182,23,86,12,11
29655,52332,443,52332,443,allow,960,539,421,9,52,5,4
29656,50578,80,53375,80,allow,1114,534,580,12,16,7,5
29657,57259,443,65344,443,allow,6439,1702,4737,21,68,13,8
29658,45551,80,20742,80,allow,694,350,344,11,27,6,5
29659,52616,80,52616,80,allow,3366,2547,819,15,49,8,7
29660,52946,80,25585,80,allow,2043,1331,712,13,17,7,6
29661,52667,80,52667,80,allow,2011,1422,589,12,48,6,6
29662,65061,53,34099,53,allow,297,101,196,4,31,2,2
29663,48867,443,13159,443,allow,6107,2079,4028,19,68,11,8
29664,56440,53,14356,53,allow,742,88,654,2,30,1,1
29665,57106,443,27171,443,allow,38893,31305,7588,107,101,55,52
29666,55949,53,62692,53,allow,774,101,673,2,30,1,1
29667,53769,8999,35608,8999,allow,70,70,0,2,8,2,0
29668,56169,53,29884,53,allow,749,94,655,2,30,1,1
29669,49515,443,49515,443,allow,102168,31819,70349,140,62,75,65
29670,57019,53,12115,53,allow,186,95,91,2,30,1,1
29671,56479,53,28725,53,allow,775,103,672,2,30,1,1
29672,58773,443,53074,443,allow,3854,2390,1464,17,15,8,9
29673,59670,443,52276,443,allow,11549,6152,5397,28,156,16,12
29674,42920,443,33787,443,allow,883886,26396,857490,947,444,340,607
29675,24463,3389,24463,3389,allow,3910,1805,2105,20,18,12,8
29676,54415,443,40112,443,allow,7129,4391,2738,32,196,16,16
29677,55019,53,16040,53,allow,299,110,189,4,32,2,2
29678,48245,443,12754,443,allow,7417,1760,5657,21,256,12,9
29679,56986,53,50579,53,allow,259,87,172,4,37,2,2
29680,40736,443,40736,443,allow,4380,1473,2907,19,26,11,8
29681,5588,5588,0,0,allow,3354,1792,1562,46,195,23,23
29682,62460,443,33310,443,allow,4608,3133,1475,18,35,10,8
29683,52329,443,52329,443,allow,4453,1546,2907,21,86,11,10
29684,19473,20467,44164,20467,allow,480,149,331,2,1200,1,1
29685,56240,53,50619,53,allow,748,95,653,2,30,1,1
29686,65244,53,43768,53,allow,170,87,83,2,30,1,1
29687,64016,53,54219,53,allow,184,94,90,2,31,1,1
29688,45987,443,65054,443,allow,3160640,65300,3095340,2786,144,547,2239
29689,49552,53,40374,53,allow,760,97,663,2,31,1,1
29690,60184,443,18301,443,allow,3915,1934,1981,14,122,7,7
29691,44355,443,45033,443,allow,354,140,214,6,131,3,3
29692,55066,53,26532,53,allow,815,95,720,2,31,1,1
29693,65180,53,32141,53,allow,198,101,97,2,31,1,1
29694,50089,53,38993,53,allow,752,93,659,2,31,1,1
29695,50621,53,54722,53,allow,256,93,163,2,31,1,1
29696,42867,443,28433,443,allow,15769,1619,14150,17,137,4,13
29697,62618,443,27342,443,allow,6939,2970,3969,19,144,9,10
29698,51334,443,42102,443,allow,8407,2034,6373,19,121,8,11
29699,56755,53,37076,53,allow,184,94,90,2,31,1,1
29700,51338,443,48161,443,allow,424,210,214,7,131,4,3
29701,45995,443,45995,443,allow,1494,898,596,12,142,6,6
29702,30960,45721,23609,45721,allow,66,66,0,1,3600,1,0
29703,43300,18242,0,0,allow,62,62,0,1,60,1,0
29704,64697,445,0,0,drop,70,70,0,1,0,1,0
29705,64695,445,0,0,drop,70,70,0,1,0,1,0
29706,64693,445,0,0,drop,70,70,0,1,0,1,0
29707,44411,37965,0,0,deny,62,62,0,1,0,1,0
29708,59861,445,0,0,drop,70,70,0,1,0,1,0
29709,59862,445,0,0,drop,70,70,0,1,0,1,0
29710,59860,445,0,0,deny,70,70,0,1,0,1,0
29711,64677,57470,0,0,deny,66,66,0,1,0,1,0
29712,1025,50584,0,0,deny,62,62,0,1,0,1,0
29713,39287,57470,0,0,deny,62,62,0,1,0,1,0
29714,59856,445,0,0,drop,70,70,0,1,0,1,0
29715,46839,51050,0,0,deny,62,62,0,1,0,1,0
29716,65379,22114,0,0,deny,66,66,0,1,0,1,0
29717,59855,445,0,0,drop,70,70,0,1,0,1,0
29718,26713,64147,0,0,deny,62,62,0,1,0,1,0
29719,29577,64147,0,0,deny,62,62,0,1,0,1,0
29720,64689,445,0,0,drop,70,70,0,1,0,1,0
29721,64688,445,0,0,drop,70,70,0,1,0,1,0
29722,57074,53,2955,53,allow,195,102,93,2,30,1,1
29723,64580,443,64391,443,allow,24686,1935,22751,36,20,17,19
29724,56612,53,28216,53,allow,178,94,84,2,30,1,1
29725,56681,53,9758,53,allow,195,102,93,2,30,1,1
29726,64156,53,39777,53,allow,409,92,317,4,30,2,2
29727,56986,53,34763,53,allow,259,87,172,4,36,2,2
29728,51980,45478,12123,45478,allow,70,70,0,2,7,2,0
29729,51997,14398,23393,14398,allow,130,70,60,2,4,1,1
29730,62053,443,33820,443,allow,134,60,74,3,5,2,1
29731,65251,53,36655,53,allow,277,98,179,4,36,2,2
29732,57265,443,12728,443,allow,9633,4368,5265,32,71,18,14
29733,55334,53,36263,53,allow,199,102,97,2,30,1,1
29734,56706,443,32876,443,allow,8057,2037,6020,20,15,11,9
29735,55665,44235,23820,44235,allow,504,318,186,8,15,5,3
29736,51100,443,10929,443,allow,9429,1978,7451,27,46,14,13
29737,49945,53,62137,53,allow,198,102,96,2,30,1,1
29738,49942,443,49942,443,allow,29781,5947,23834,63,47,32,31
29739,65049,53,13947,53,allow,199,102,97,2,29,1,1
29740,40349,443,1831,443,allow,7128,1336,5792,22,83,11,11
29741,51979,55803,35511,55803,allow,70,70,0,2,7,2,0
29742,56450,53,17647,53,allow,177,94,83,2,29,1,1
29743,64345,53,39290,53,allow,499,94,405,2,29,1,1
29744,65435,53,59924,53,allow,196,94,102,2,29,1,1
29745,64561,53,50313,53,allow,209,110,99,2,30,1,1
29746,56654,53,7307,53,allow,209,110,99,2,30,1,1
29747,64578,443,29592,443,allow,9156,2109,7047,27,32,15,12
29748,37384,443,22279,443,allow,416,210,206,7,29,4,3
29749,59014,443,31435,443,allow,27298,11122,16176,59,31,30,29
29750,49918,80,19931,80,allow,751,455,296,8,125,5,3
29751,64561,53,6022,53,allow,209,110,99,2,30,1,1
29752,53940,53,37682,53,allow,70,70,0,1,30,1,0
29753,65244,53,54645,53,allow,177,94,83,2,30,1,1
29754,49945,53,22837,53,allow,821,102,719,2,30,1,1
29755,55019,53,27465,53,allow,299,110,189,4,31,2,2
29756,37995,49152,51662,49152,allow,156,156,0,3,8,3,0
29757,51947,16935,4514,16935,allow,70,70,0,1,5,1,0
29758,65224,53,18679,53,allow,197,102,95,2,30,1,1
29759,52572,80,52572,80,allow,1899,1310,589,12,48,6,6
29760,52328,443,52328,443,allow,5438,2255,3183,23,86,12,11
29761,56717,53,2347,53,allow,178,94,84,2,30,1,1
29762,52325,443,52325,443,allow,17806,3169,14637,41,86,18,23
29763,48768,443,48768,443,allow,4398,1491,2907,19,27,11,8
29764,38693,443,23499,443,allow,16959,8920,8039,46,33,24,22
29765,52333,443,52333,443,allow,960,539,421,9,52,5,4
29766,65127,443,50841,443,allow,48029,4540,43489,91,120,40,51
29767,49919,80,15298,80,allow,992,524,468,10,125,6,4
29768,64266,53,18916,53,allow,180,94,86,2,31,1,1
29769,53437,6057,55735,6057,allow,245,245,0,2,30,2,0
29770,50169,53,12431,53,allow,211,78,133,2,30,1,1
29771,51977,18504,24364,18504,allow,70,70,0,2,8,2,0
29772,56177,53,33735,53,allow,184,94,90,2,30,1,1
29773,57143,53,42791,53,allow,184,94,90,2,30,1,1
29774,37581,443,19620,443,allow,13435,2441,10994,30,26,16,14
29775,55938,53,31705,53,allow,209,110,99,2,30,1,1
29776,65224,53,46834,53,allow,197,102,95,2,30,1,1
29777,55770,53,22601,53,allow,177,94,83,2,30,1,1
29778,57444,53,32931,53,allow,177,94,83,2,30,1,1
29779,49812,53,34841,53,allow,193,102,91,2,30,1,1
29780,57444,53,54223,53,allow,177,94,83,2,30,1,1
29781,39060,443,26337,443,allow,8554,2353,6201,29,138,14,15
29782,64125,53,55658,53,allow,370,94,276,2,30,1,1
29783,50920,443,1716,443,allow,24070,16123,7947,82,6308,42,40
29784,56717,53,46335,53,allow,178,94,84,2,31,1,1
29785,53301,11000,8510,11000,allow,1642,822,820,5,30,1,4
29786,52330,443,52330,443,allow,11451,5432,6019,34,86,17,17
29787,55705,53,9254,53,allow,281,101,180,4,58,2,2
29788,56035,53,45102,53,allow,173,94,79,2,30,1,1
29789,38832,443,4622,443,allow,23292,17154,6138,141,522,79,62
29790,58774,443,43846,443,allow,5167,700,4467,16,15,7,9
29791,57601,443,61546,443,allow,2614,1689,925,18,20,10,8
29792,55672,45682,48139,45682,allow,70,70,0,2,8,2,0
29793,51976,11816,61215,11816,allow,70,70,0,2,8,2,0
29794,49195,8108,11315,8108,allow,70,70,0,2,8,2,0
29795,51666,443,12470,443,allow,30210,2106,28104,46,201,17,29
29796,52251,80,52251,80,allow,1838,1319,519,11,48,6,5
29797,56704,443,41939,443,allow,8125,2039,6086,21,15,11,10
29798,62337,443,30628,443,allow,3908576,93181,3815395,3743,56,1160,2583
29799,63939,53,40762,53,allow,226,110,116,2,30,1,1
29800,49258,53,9142,53,allow,228,102,126,2,30,1,1
29801,56938,9600,62767,9600,allow,86,86,0,1,30,1,0
29802,55019,53,59602,53,allow,299,110,189,4,31,2,2
29803,60130,443,10266,443,allow,16291,9102,7189,94,508,42,52
29804,55063,80,20796,80,allow,2776,1333,1443,12,37,7,5
29805,52986,443,58135,443,allow,280,140,140,5,130,3,2
29806,48738,443,11931,443,allow,131514,7190,124324,183,53,72,111
29807,63912,18318,13803,18318,allow,1295,926,369,13,17,9,4
29808,65244,53,26357,53,allow,177,94,83,2,31,1,1
29809,43220,5222,35739,5222,allow,5415,2041,3374,53,467,23,30
29810,65061,53,31774,53,allow,299,103,196,4,33,2,2
29811,61027,80,42775,80,allow,9483,767,8716,18,14,10,8
29812,55065,80,56775,80,allow,306,180,126,6,28,4,2
29813,64174,53,47378,53,allow,438,130,308,4,35,2,2
29814,55674,48870,19113,48870,allow,70,70,0,2,8,2,0
29815,49749,443,51214,443,allow,54416,3219,51197,76,240,30,46
29816,56647,80,55289,80,allow,234,234,0,4,12,4,0
29817,62461,443,18805,443,allow,14832,3978,10854,32,34,15,17
29818,62463,443,34613,443,allow,4203,2748,1455,18,33,10,8
29819,53123,443,38611,443,allow,1630,1089,541,14,15,8,6
29820,58772,443,9884,443,allow,5106,700,4406,15,15,7,8
29821,1933,53,18812,53,allow,210,78,132,2,29,1,1
29822,50252,53,7370,53,allow,165,86,79,2,30,1,1
29823,57143,53,50787,53,allow,184,94,90,2,30,1,1
29824,56789,443,21644,443,allow,257154,11550,245604,303,54,121,182
29825,56654,53,36546,53,allow,209,110,99,2,30,1,1
29826,49786,53,64235,53,allow,209,110,99,2,30,1,1
29827,49927,53,25486,53,allow,763,102,661,2,30,1,1
29828,56929,53,14776,53,allow,177,94,83,2,30,1,1
29829,57074,53,22735,53,allow,195,102,93,2,30,1,1
29830,56357,53,35688,53,allow,270,110,160,2,30,1,1
29831,65256,53,14067,53,allow,213,102,111,2,30,1,1
29832,64016,53,18748,53,allow,184,94,90,2,31,1,1
29833,56855,443,28597,443,allow,8114,2511,5603,19,135,9,10
29834,57019,53,31067,53,allow,193,102,91,2,31,1,1
29835,57377,443,4552,443,allow,5553,927,4626,16,15,10,6
29836,59658,443,21276,443,allow,6695,1617,5078,23,200,13,10
29837,62464,443,10700,443,allow,4595,3120,1475,18,33,10,8
29838,52327,443,52327,443,allow,5444,2263,3181,23,86,12,11
29839,51234,80,58624,80,allow,6798,4486,2312,42,107,22,20
29840,39931,443,19532,443,allow,4464,2847,1617,29,80,15,14
29841,55705,53,13969,53,allow,281,101,180,4,58,2,2
29842,64064,53,52675,53,allow,257,94,163,2,30,1,1
29843,64114,53,8208,53,allow,251,102,149,2,30,1,1
29844,56705,443,63668,443,allow,8007,1987,6020,20,15,11,9
29845,58778,443,47598,443,allow,5168,700,4468,16,15,7,9
29846,51978,57496,25018,57496,allow,70,70,0,2,8,2,0
29847,55668,80,57634,80,allow,70,70,0,1,5,1,0
29848,52712,80,52712,80,allow,2012,1423,589,12,48,6,6
29849,52341,80,52341,80,allow,1928,1339,589,12,48,6,6
29850,14432,443,31078,443,allow,7420,1078,6342,21,75,11,10
29851,50393,443,41486,443,allow,7356,1014,6342,20,75,10,10
29852,56035,53,24305,53,allow,173,94,79,2,30,1,1
29853,64524,53,53824,53,allow,235,102,133,2,30,1,1
29854,52647,443,40426,443,allow,46502,33690,12812,93,234,55,38
29855,56796,443,3501,443,allow,5475,1610,3865,19,255,11,8
29856,53147,26330,14316,26330,allow,70,70,0,2,8,2,0
29857,37996,49152,50684,49152,allow,156,156,0,3,8,3,0
29858,56986,53,7478,53,allow,259,87,172,4,37,2,2
29859,37579,443,40926,443,allow,7982,2392,5590,25,26,14,11
29860,55603,32520,10079,32520,allow,5982,1890,4092,30,75,15,15
29861,54977,443,46620,443,allow,322265,12756,309509,409,270,173,236
29862,55705,53,27815,53,allow,281,101,180,4,59,2,2
29863,56681,53,26694,53,allow,195,102,93,2,30,1,1
29864,55938,53,44450,53,allow,209,110,99,2,30,1,1
29865,50411,53,28874,53,allow,86,86,0,1,30,1,0
29866,55770,53,9659,53,allow,177,94,83,2,30,1,1
29867,65266,53,21692,53,allow,216,110,106,2,30,1,1
29868,64313,53,9214,53,allow,226,110,116,2,30,1,1
29869,62711,443,43946,443,allow,266781,12334,254447,323,161,119,204
29870,45996,443,45996,443,allow,1494,898,596,12,142,6,6
29871,64556,53,40982,53,allow,195,102,93,2,30,1,1
29872,51784,8245,58196,8245,allow,280,214,66,2,31,1,1
29873,35832,443,44222,443,allow,17110,4513,12597,42,121,19,23
29874,57275,443,62988,443,allow,45483074,398771,45084303,36307,333,3386,32921
29875,6881,6881,1541,6881,allow,237,118,119,2,1200,1,1
29876,59701,443,37154,443,allow,6155,1819,4336,18,181,8,10
29877,56766,443,14480,443,allow,10137,4019,6118,42,8169,24,18
29878,55019,53,16750,53,allow,299,110,189,4,31,2,2
29879,6881,52563,53881,52563,allow,228,118,110,2,1199,1,1
29880,45992,443,45992,443,allow,1494,898,596,12,142,6,6
29881,49557,53,61895,53,allow,1298,100,1198,4,32,2,2
29882,60204,80,20326,80,allow,70,70,0,2,8,2,0
29883,63944,8999,33141,8999,allow,66,66,0,2,8,2,0
29884,55846,53,27827,53,allow,198,102,96,2,30,1,1
29885,49774,53,49900,53,allow,225,110,115,2,30,1,1
29886,56755,53,26920,53,allow,184,94,90,2,31,1,1
29887,57201,53,17693,53,allow,195,102,93,2,31,1,1
29888,45997,443,45997,443,allow,1494,898,596,12,142,6,6
29889,45994,443,45994,443,allow,1494,898,596,12,142,6,6
29890,45993,443,45993,443,allow,1494,898,596,12,142,6,6
29891,53766,3596,64680,3596,allow,70,70,0,2,8,2,0
29892,53757,1,5970,1,allow,70,70,0,1,5,1,0
29893,53749,53572,44841,53572,allow,492,306,186,8,15,5,3
29894,55475,80,10225,80,allow,350,210,140,6,27,4,2
29895,62904,80,35309,80,allow,1515,481,1034,11,16,6,5
29896,43095,443,34288,443,allow,6513,2043,4470,20,17,12,8
29897,49518,53,34385,53,allow,299,90,209,4,49,2,2
29898,65180,53,7905,53,allow,199,102,97,2,30,1,1
29899,55968,53,21608,53,allow,243,94,149,2,30,1,1
29900,57143,53,17926,53,allow,184,94,90,2,30,1,1
29901,56929,53,47625,53,allow,177,94,83,2,30,1,1
29902,56654,53,22372,53,allow,209,110,99,2,30,1,1
29903,64191,53,5419,53,allow,197,94,103,2,30,1,1
29904,49536,53,5228,53,allow,239,94,145,2,30,1,1
29905,64690,445,0,0,drop,70,70,0,1,0,1,0
29906,63331,51221,0,0,deny,62,62,0,1,0,1,0
29907,52828,51221,0,0,deny,66,66,0,1,0,1,0
29908,60104,445,0,0,drop,66,66,0,1,0,1,0
29909,64684,445,0,0,drop,70,70,0,1,0,1,0
29910,60100,445,0,0,drop,66,66,0,1,0,1,0
29911,59848,445,0,0,drop,70,70,0,1,0,1,0
29912,60097,445,0,0,drop,66,66,0,1,0,1,0
29913,60098,445,0,0,drop,66,66,0,1,0,1,0
29914,60095,445,0,0,drop,66,66,0,1,0,1,0
29915,64449,30188,0,0,deny,62,62,0,1,0,1,0
29916,59679,37807,0,0,deny,66,66,0,1,0,1,0
29917,54737,50584,0,0,deny,66,66,0,1,0,1,0
29918,59841,445,0,0,drop,70,70,0,1,0,1,0
29919,65419,26467,0,0,deny,62,62,0,1,0,1,0
29920,59840,445,0,0,drop,70,70,0,1,0,1,0
29921,33416,23,0,0,deny,60,60,0,1,0,1,0
29922,64676,445,0,0,drop,70,70,0,1,0,1,0
29923,24662,26467,0,0,deny,66,66,0,1,0,1,0
29924,63963,50584,0,0,deny,66,66,0,1,0,1,0
29925,64669,445,0,0,drop,70,70,0,1,0,1,0
29926,64671,445,0,0,drop,70,70,0,1,0,1,0
29927,36369,51505,0,0,deny,66,66,0,1,0,1,0
29928,59834,445,0,0,drop,70,70,0,1,0,1,0
29929,59191,35440,0,0,deny,62,62,0,1,0,1,0
29930,63672,22114,0,0,deny,66,66,0,1,0,1,0
29931,59833,445,0,0,drop,70,70,0,1,0,1,0
29932,25054,36827,0,0,deny,66,66,0,1,0,1,0
29933,60085,445,0,0,drop,66,66,0,1,0,1,0
29934,52938,64097,0,0,deny,66,66,0,1,0,1,0
29935,59829,445,0,0,drop,70,70,0,1,0,1,0
29936,60077,445,0,0,drop,66,66,0,1,0,1,0
29937,41996,5900,0,0,deny,60,60,0,1,0,1,0
29938,64659,445,0,0,drop,70,70,0,1,0,1,0
29939,59828,445,0,0,drop,70,70,0,1,0,1,0
29940,55616,56205,0,0,deny,66,66,0,1,0,1,0
29941,443,39947,0,0,deny,74,74,0,1,0,1,0
29942,61639,37965,0,0,deny,66,66,0,1,0,1,0
29943,60075,445,0,0,drop,66,66,0,1,0,1,0
29944,12709,51505,0,0,deny,62,62,0,1,0,1,0
29945,7246,59858,0,0,deny,66,66,0,1,0,1,0
29946,28040,64147,0,0,deny,66,66,0,1,0,1,0
29947,59823,445,0,0,drop,70,70,0,1,0,1,0
29948,11821,64147,0,0,deny,62,62,0,1,0,1,0
29949,60066,445,0,0,drop,66,66,0,1,0,1,0
29950,60059,445,0,0,drop,66,66,0,1,0,1,0
29951,25237,57470,0,0,deny,62,62,0,1,0,1,0
29952,32770,51505,0,0,deny,62,62,0,1,0,1,0
29953,57468,57470,0,0,deny,66,66,0,1,0,1,0
29954,8889,34659,0,0,deny,60,60,0,1,0,1,0
29955,50927,44847,0,0,deny,62,62,0,1,0,1,0
29956,56442,11392,0,0,deny,66,66,0,1,0,1,0
29957,31500,34729,0,0,deny,146,146,0,1,0,1,0
29958,54280,3398,0,0,deny,60,60,0,1,0,1,0
29959,26810,5033,0,0,deny,145,145,0,1,0,1,0
29960,60357,5900,0,0,deny,60,60,0,1,0,1,0
29961,62757,44847,0,0,deny,146,146,0,1,0,1,0
29962,16693,36237,0,0,deny,62,62,0,1,0,1,0
29963,12663,62413,0,0,deny,66,66,0,1,0,1,0
29964,64646,445,0,0,drop,70,70,0,1,0,1,0
29965,64645,445,0,0,drop,70,70,0,1,0,1,0
29966,64644,445,0,0,drop,70,70,0,1,0,1,0
29967,61005,50584,0,0,deny,146,146,0,1,0,1,0
29968,60052,445,0,0,drop,66,66,0,1,0,1,0
29969,60049,445,0,0,drop,66,66,0,1,0,1,0
29970,60051,445,0,0,drop,66,66,0,1,0,1,0
29971,60048,445,0,0,drop,66,66,0,1,0,1,0
29972,60046,445,0,0,drop,66,66,0,1,0,1,0
29973,60045,445,0,0,drop,66,66,0,1,0,1,0
29974,60050,445,0,0,drop,66,66,0,1,0,1,0
29975,60044,445,0,0,drop,66,66,0,1,0,1,0
29976,59810,445,0,0,drop,70,70,0,1,0,1,0
29977,7524,23,0,0,deny,60,60,0,1,0,1,0
29978,49168,57470,0,0,deny,66,66,0,1,0,1,0
29979,59807,445,0,0,drop,70,70,0,1,0,1,0
29980,55421,57470,0,0,deny,74,74,0,1,0,1,0
29981,54578,64147,0,0,deny,66,66,0,1,0,1,0
29982,27209,25198,0,0,deny,145,145,0,1,0,1,0
29983,64640,445,0,0,drop,70,70,0,1,0,1,0
29984,64641,445,0,0,drop,70,70,0,1,0,1,0
29985,64634,445,0,0,drop,70,70,0,1,0,1,0
29986,64629,445,0,0,drop,70,70,0,1,0,1,0
29987,59802,445,0,0,drop,70,70,0,1,0,1,0
29988,61430,37965,0,0,deny,66,66,0,1,0,1,0
29989,59801,445,0,0,drop,70,70,0,1,0,1,0
29990,60030,445,0,0,drop,66,66,0,1,0,1,0
29991,60032,445,0,0,drop,66,66,0,1,0,1,0
29992,60029,445,0,0,drop,66,66,0,1,0,1,0
29993,13285,29892,0,0,deny,145,145,0,1,0,1,0
29994,61477,57470,0,0,deny,62,62,0,1,0,1,0
29995,59799,445,0,0,drop,70,70,0,1,0,1,0
29996,61030,21247,0,0,deny,66,66,0,1,0,1,0
29997,50,64147,0,0,deny,66,66,0,1,0,1,0
29998,64624,445,0,0,drop,70,70,0,1,0,1,0
29999,62824,37807,0,0,deny,66,66,0,1,0,1,0
30000,26301,22114,0,0,deny,62,62,0,1,0,1,0
30001,64616,445,0,0,drop,70,70,0,1,0,1,0
30002,64617,445,0,0,drop,70,70,0,1,0,1,0
30003,64612,445,0,0,drop,70,70,0,1,0,1,0
30004,59842,62413,0,0,deny,66,66,0,1,0,1,0
30005,28580,64147,0,0,deny,62,62,0,1,0,1,0
30006,59792,445,0,0,drop,70,70,0,1,0,1,0
30007,0,0,0,0,deny,102,102,0,1,0,1,0
30008,50799,37807,0,0,deny,66,66,0,1,0,1,0
30009,59790,445,0,0,drop,70,70,0,1,0,1,0
30010,55862,62413,0,0,deny,66,66,0,1,0,1,0
30011,47453,6881,0,0,deny,146,146,0,1,0,1,0
30012,11562,30188,0,0,deny,62,62,0,1,0,1,0
30013,61059,32480,0,0,deny,146,146,0,1,0,1,0
30014,62973,51505,0,0,deny,62,62,0,1,0,1,0
30015,54280,3398,0,0,deny,60,60,0,1,0,1,0
30016,52022,52752,0,0,deny,74,74,0,1,0,1,0
30017,59210,50584,0,0,deny,66,66,0,1,0,1,0
30018,59789,445,0,0,drop,70,70,0,1,0,1,0
30019,60070,44847,0,0,deny,66,66,0,1,0,1,0
30020,5538,23,0,0,deny,60,60,0,1,0,1,0
30021,59788,445,0,0,drop,70,70,0,1,0,1,0
30022,59787,445,0,0,drop,70,70,0,1,0,1,0
30023,59785,445,0,0,drop,70,70,0,1,0,1,0
30024,59783,445,0,0,drop,70,70,0,1,0,1,0
30025,64606,445,0,0,drop,70,70,0,1,0,1,0
30026,64605,445,0,0,drop,70,70,0,1,0,1,0
30027,64600,445,0,0,drop,70,70,0,1,0,1,0
30028,3792,52700,0,0,deny,62,62,0,1,0,1,0
30029,24271,52700,0,0,deny,66,66,0,1,0,1,0
30030,64368,22114,0,0,deny,66,66,0,1,0,1,0
30031,60020,445,0,0,drop,66,66,0,1,0,1,0
30032,26048,21,0,0,deny,60,60,0,1,0,1,0
30033,59769,445,0,0,drop,70,70,0,1,0,1,0
30034,59767,445,0,0,drop,70,70,0,1,0,1,0
30035,59763,445,0,0,drop,70,70,0,1,0,1,0
30036,59758,445,0,0,drop,70,70,0,1,0,1,0
30037,59759,445,0,0,drop,70,70,0,1,0,1,0
30038,16327,55442,0,0,deny,66,66,0,1,0,1,0
30039,19875,30170,0,0,deny,145,145,0,1,0,1,0
30040,63041,50584,0,0,deny,62,62,0,1,0,1,0
30041,64598,445,0,0,drop,70,70,0,1,0,1,0
30042,64591,445,0,0,drop,70,70,0,1,0,1,0
30043,48676,53393,0,0,deny,60,60,0,1,0,1,0
30044,48676,53399,0,0,deny,60,60,0,1,0,1,0
30045,29136,31652,0,0,reset-both,145,145,0,1,0,1,0
30046,21492,51505,0,0,deny,146,146,0,1,0,1,0
30047,62819,56205,0,0,deny,62,62,0,1,0,1,0
30048,60002,445,0,0,drop,66,66,0,1,0,1,0
30049,60001,445,0,0,drop,66,66,0,1,0,1,0
30050,29922,2750,0,0,deny,145,145,0,1,0,1,0
30051,59747,445,0,0,drop,70,70,0,1,0,1,0
30052,9128,80,3849,80,allow,318,192,126,6,30,4,2
30053,64647,3389,64647,3389,allow,3327,1438,1889,15,17,8,7
30054,26778,443,2994,443,allow,7407,2650,4757,24,20,12,12
30055,51971,20347,9863,20347,allow,70,70,0,2,8,2,0
30056,56203,53,21719,53,allow,751,95,656,2,30,1,1
30057,51081,443,34616,443,allow,8192,2781,5411,22,374,12,10
30058,49297,443,47840,443,allow,5341,3636,1705,30,76,16,14
30059,9132,80,49560,80,allow,318,192,126,6,30,4,2
30060,39724,443,28049,443,allow,45852,4123,41729,61,17,25,36
30061,58755,443,8030,443,allow,11839,7753,4086,30,17,15,15
30062,53768,19067,41942,19067,allow,70,70,0,2,8,2,0
30063,51945,1587,2517,1587,allow,66,66,0,1,5,1,0
30064,57330,443,48576,443,allow,36551,3569,32982,57,46,28,29
30065,9130,80,10198,80,allow,318,192,126,6,30,4,2
30066,38428,443,25567,443,allow,9483,2964,6519,23,17,13,10
30067,48551,443,15020,443,allow,7433,2086,5347,26,316,12,14
30068,64892,53,1067,53,allow,751,95,656,2,30,1,1
30069,61488,53,0,0,allow,314,93,221,2,30,1,1
30070,64154,53,29072,53,allow,188,96,92,2,30,1,1
30071,2088,7010,2088,7010,allow,10300,8829,1471,24,15,13,11
30072,9133,80,26542,80,allow,318,192,126,6,30,4,2
30073,56563,53,31162,53,allow,751,95,656,2,30,1,1
30074,55962,53,39113,53,allow,186,95,91,2,31,1,1
30075,7871,3389,7871,3389,allow,4166,2141,2025,18,18,9,9
30076,49966,80,31375,80,allow,1210,788,422,9,33,5,4
30077,52474,443,15526,443,allow,14908,4027,10881,28,136,11,17
30078,51975,11998,3978,11998,allow,70,70,0,2,8,2,0
30079,58060,80,29313,80,allow,1854,735,1119,8,16,5,3
30080,9126,80,52469,80,allow,318,192,126,6,30,4,2
30081,36361,80,36361,80,allow,514,246,268,9,76,5,4
30082,55081,80,13620,80,allow,1680,697,983,10,52,6,4
30083,9144,80,51086,80,allow,378,192,186,7,30,4,3
30084,36548,80,36548,80,allow,514,246,268,9,76,5,4
30085,58726,443,45284,443,allow,39202,21598,17604,72,20,39,33
30086,9129,80,33910,80,allow,318,192,126,6,30,4,2
30087,36132,80,36132,80,allow,514,246,268,9,76,5,4
30088,9145,80,20559,80,allow,318,192,126,6,30,4,2
30089,5588,5588,0,0,allow,3354,1792,1562,46,194,23,23
30090,5588,5588,0,0,allow,3354,1792,1562,46,195,23,23
30091,5588,5588,0,0,allow,3354,1792,1562,46,195,23,23
30092,56579,53,34186,53,allow,711,87,624,2,30,1,1
30093,56929,53,5055,53,allow,170,87,83,2,30,1,1
30094,56717,53,51715,53,allow,172,88,84,2,31,1,1
30095,53587,3389,53587,3389,allow,3504,1790,1714,17,31,9,8
30096,51838,443,42521,443,allow,9329,3898,5431,21,39,12,9
30097,42665,443,42665,443,allow,4620,1713,2907,19,26,11,8
30098,27005,27021,28946,27021,allow,879,126,753,2,31,1,1
30099,57424,2258,57424,2258,allow,156,156,0,3,8,3,0
30100,36084,80,36084,80,allow,514,246,268,9,76,5,4
30101,5588,5588,0,0,allow,3354,1792,1562,46,193,23,23
30102,61942,3389,61942,3389,allow,3347,1458,1889,15,18,8,7
30103,56811,53,1928,53,allow,762,97,665,2,30,1,1
30104,49009,53,49009,53,allow,172,76,96,2,30,1,1
30105,57074,53,56571,53,allow,190,97,93,2,30,1,1
30106,56417,53,44124,53,allow,752,93,659,2,30,1,1
30107,65491,53,39082,53,allow,186,95,91,2,30,1,1
30108,61732,3389,61732,3389,allow,3380,1730,1650,15,33,8,7
30109,55840,53,25093,53,allow,711,87,624,2,30,1,1
30110,36866,443,19337,443,allow,6798,2901,3897,22,151,13,9
30111,52475,443,47203,443,allow,14713,3210,11503,24,135,9,15
30112,57385,53,40272,53,allow,194,99,95,2,31,1,1
30113,21133,26205,8150,26205,allow,480,149,331,2,1200,1,1
30114,56422,53,35593,53,allow,716,95,621,2,30,1,1
30115,55343,53,13186,53,allow,770,101,669,2,31,1,1
30116,55752,53,35033,53,allow,170,87,83,2,31,1,1
30117,54084,443,63980,443,allow,37440,7952,29488,67,128,28,39
30118,55192,53,1273,53,allow,760,97,663,2,31,1,1
30119,50209,53,45881,53,allow,780,104,676,2,31,1,1
30120,27005,30007,42736,30007,allow,890,126,764,2,31,1,1
30121,57365,53,10039,53,allow,780,104,676,2,31,1,1
30122,55890,53,50894,53,allow,186,95,91,2,31,1,1
30123,65485,53,57081,53,allow,184,94,90,2,31,1,1
30124,49949,53,60223,53,allow,186,95,91,2,31,1,1
30125,65220,53,55552,53,allow,172,88,84,2,31,1,1
30126,50584,53743,42258,53743,allow,1356,300,1056,6,1201,3,3
30127,57122,53,5518,53,allow,295,101,194,4,31,2,2
30128,57128,53,45410,53,allow,755,93,662,2,31,1,1
30129,27005,30006,22484,30006,allow,890,126,764,2,31,1,1
30130,55197,53,53428,53,allow,701,88,613,2,31,1,1
30131,55808,53,19839,53,allow,182,93,89,2,31,1,1
30132,64786,53,39238,53,allow,810,108,702,2,31,1,1
30133,43514,5223,35160,5223,allow,3651,1103,2548,17,1802,10,7
30134,64792,443,39397,443,allow,16199,7657,8542,58,127,28,30
30135,56529,53,60444,53,allow,711,87,624,2,31,1,1
30136,65303,53,22620,53,allow,760,96,664,2,31,1,1
30137,64793,53,59763,53,allow,168,86,82,2,31,1,1
30138,55064,53,40731,53,allow,774,101,673,2,31,1,1
30139,55934,53,55732,53,allow,192,98,94,2,31,1,1
30140,55878,53,54979,53,allow,760,97,663,2,31,1,1
30141,49421,53,15245,53,allow,744,89,655,2,31,1,1
30142,33013,443,50966,443,allow,88895,4807,84088,104,136,37,67
30143,57043,53,5828,53,allow,735,88,647,2,31,1,1
30144,30960,45743,2927,45743,allow,330,330,0,6,3609,6,0
30145,37965,46994,50866,46994,allow,4089,2456,1633,53,1773,31,22
30146,23030,30170,0,0,deny,159,159,0,1,0,1,0
30147,43461,35440,0,0,deny,146,146,0,1,0,1,0
30148,13996,56205,0,0,deny,62,62,0,1,0,1,0
30149,64589,445,0,0,drop,70,70,0,1,0,1,0
30150,24285,26467,0,0,deny,62,62,0,1,0,1,0
30151,64582,445,0,0,drop,70,70,0,1,0,1,0
30152,64583,445,0,0,drop,70,70,0,1,0,1,0
30153,64580,445,0,0,drop,70,70,0,1,0,1,0
30154,53746,36237,0,0,deny,66,66,0,1,0,1,0
30155,59997,445,0,0,drop,66,66,0,1,0,1,0
30156,59743,445,0,0,drop,70,70,0,1,0,1,0
30157,59991,445,0,0,drop,66,66,0,1,0,1,0
30158,65047,53,39231,53,allow,645,185,460,6,40,3,3
30159,50552,53,61704,53,allow,757,102,655,2,30,1,1
30160,65206,53,7490,53,allow,816,102,714,2,30,1,1
30161,56929,53,59011,53,allow,177,94,83,2,30,1,1
30162,64950,53,10318,53,allow,765,102,663,2,30,1,1
30163,64977,53,18612,53,allow,334,94,240,2,30,1,1
30164,65443,53,21010,53,allow,164,86,78,2,30,1,1
30165,55727,53,48303,53,allow,177,94,83,2,30,1,1
30166,64227,53,63621,53,allow,302,92,210,4,30,2,2
30167,53775,8999,38559,8999,allow,320,140,180,6,5,3,3
30168,55666,36653,34073,36653,allow,70,70,0,1,5,1,0
30169,51946,9407,60623,9407,allow,70,70,0,1,4,1,0
30170,65123,53,59199,53,allow,816,102,714,2,29,1,1
30171,65474,53,42125,53,allow,197,94,103,2,29,1,1
30172,57424,53,63565,53,allow,197,102,95,2,30,1,1
30173,43136,443,64659,443,allow,9329,2900,6429,27,135,15,12
30174,55476,80,7666,80,allow,498,280,218,8,26,5,3
30175,57051,53,10858,53,allow,354,90,264,4,50,2,2
30176,51823,80,56758,80,allow,4456,1889,2567,11,39,6,5
30177,37578,443,36969,443,allow,7534,2392,5142,25,25,14,11
30178,53750,27352,15975,27352,allow,70,70,0,1,4,1,0
30179,53765,16178,52610,16178,allow,70,70,0,2,7,2,0
30180,50607,80,15942,80,allow,1657,1247,410,8,14,5,3
30181,53767,10004,34912,10004,allow,70,70,0,2,7,2,0
30182,55477,80,28863,80,allow,498,280,218,8,26,5,3
30183,51942,22272,28402,22272,allow,140,70,70,2,5,1,1
30184,64556,53,11651,53,allow,195,102,93,2,29,1,1
30185,55337,53,41001,53,allow,198,102,96,2,29,1,1
30186,57424,53,59355,53,allow,197,102,95,2,29,1,1
30187,55846,53,44796,53,allow,821,102,719,2,29,1,1
30188,50001,53,34185,53,allow,239,94,145,2,29,1,1
30189,56755,53,13799,53,allow,184,94,90,2,29,1,1
30190,64741,53,21274,53,allow,198,86,112,2,29,1,1
30191,57444,53,35555,53,allow,177,94,83,2,29,1,1
30192,64255,53,12895,53,allow,200,94,106,2,29,1,1
30193,55593,53,62454,53,allow,193,102,91,2,30,1,1
30194,49607,53,13201,53,allow,259,102,157,2,29,1,1
30195,65266,53,57275,53,allow,216,110,106,2,29,1,1
30196,56496,53,21788,53,allow,164,86,78,2,30,1,1
30197,56702,443,53688,443,allow,8058,2038,6020,20,15,11,9
30198,36731,80,36731,80,allow,514,246,268,9,75,5,4
30199,51079,80,14506,80,allow,19699,2094,17605,32,229,14,18
30200,9170,80,30007,80,allow,318,192,126,6,29,4,2
30201,64639,3389,64639,3389,allow,3409,1454,1955,16,16,8,8
30202,65180,53,35991,53,allow,199,102,97,2,30,1,1
30203,49393,53,14583,53,allow,183,86,97,2,30,1,1
30204,65213,53,57292,53,allow,198,94,104,2,30,1,1
30205,64257,53,4953,53,allow,261,94,167,2,30,1,1
30206,49675,53,53697,53,allow,199,102,97,2,30,1,1
30207,55444,53,60851,53,allow,193,102,91,2,30,1,1
30208,50265,443,41315,443,allow,10788,6022,4766,36,144,20,16
30209,48436,53,48436,53,allow,216,82,134,2,32,1,1
30210,51972,13604,16172,13604,allow,258,70,188,4,8,2,2
30211,35615,443,10957,443,allow,6179,1242,4937,22,42,11,11
30212,38690,443,51124,443,allow,1107678,21465,1086213,1058,16,312,746
30213,9154,443,7257,443,allow,6258,843,5415,19,29,10,9
30214,9149,443,28137,443,allow,6128,763,5365,17,29,9,8
30215,9151,443,63028,443,allow,6128,763,5365,17,29,9,8
30216,9148,443,13581,443,allow,6334,840,5494,19,29,10,9
30217,27005,50019,16642,50019,allow,877,126,751,2,30,1,1
30218,65206,53,37251,53,allow,193,102,91,2,30,1,1
30219,64714,53,3550,53,allow,168,86,82,2,31,1,1
30220,64433,53,29795,53,allow,214,102,112,2,30,1,1
30221,59788,443,42215,443,allow,162,102,60,2,5,1,1
30222,56814,53,9627,53,allow,193,102,91,2,30,1,1
30223,50599,80,5247,80,allow,8601,6265,2336,18,26,10,8
30224,55962,53,37019,53,allow,193,102,91,2,30,1,1
30225,42597,443,16661,443,allow,8533,2023,6510,23,15,12,11
30226,9175,443,52821,443,allow,6331,837,5494,19,28,10,9
30227,65330,53,53724,53,allow,723,102,621,2,30,1,1
30228,9177,443,23456,443,allow,6331,837,5494,19,28,10,9
30229,64385,53,21883,53,allow,307,105,202,4,47,2,2
30230,49228,53,7287,53,allow,193,102,91,2,30,1,1
30231,65443,53,23920,53,allow,172,94,78,2,30,1,1
30232,49876,53,41654,53,allow,199,102,97,2,30,1,1
30233,65280,53,36660,53,allow,213,102,111,2,30,1,1
30234,49228,53,30182,53,allow,193,102,91,2,30,1,1
30235,55727,53,61818,53,allow,177,94,83,2,30,1,1
30236,27005,28002,21197,28002,allow,918,126,792,2,30,1,1
30237,56138,53,42749,53,allow,259,86,173,2,30,1,1
30238,61128,80,61128,80,allow,1382,855,527,11,20,6,5
30239,9169,80,55933,80,allow,318,192,126,6,29,4,2
30240,9117,80,20757,80,allow,318,192,126,6,29,4,2
30241,9138,80,8999,80,allow,318,192,126,6,29,4,2
30242,50086,53,16389,53,allow,193,102,91,2,30,1,1
30243,49876,53,54830,53,allow,199,102,97,2,30,1,1
30244,55043,53,56264,53,allow,274,110,164,2,30,1,1
30245,51943,55464,52953,55464,allow,70,70,0,1,5,1,0
30246,55663,19994,24256,19994,allow,70,70,0,1,5,1,0
30247,45435,443,1325,443,allow,8034,400,7634,14,193,2,12
30248,9134,80,9239,80,allow,318,192,126,6,29,4,2
30249,7100,53,7100,53,allow,644,90,554,2,30,1,1
30250,49555,53,24625,53,allow,193,102,91,2,30,1,1
30251,65024,53,20074,53,allow,199,102,97,2,30,1,1
30252,64569,53,52034,53,allow,258,102,156,2,30,1,1
30253,33084,443,45325,443,allow,15474,4188,11286,14,139,4,10
30254,64154,53,27741,53,allow,194,102,92,2,31,1,1
30255,46299,443,43257,443,allow,648083,28117,619966,751,30,323,428
30256,27005,32036,10706,32036,allow,876,126,750,2,30,1,1
30257,52027,443,40345,443,allow,8698,1393,7305,22,16,12,10
30258,56703,443,53583,443,allow,8006,1986,6020,20,15,11,9
30259,47552,443,59060,443,allow,6268,1904,4364,30,119,16,14
30260,38692,443,23262,443,allow,10335,2523,7812,42,32,20,22
30261,34979,80,8756,80,allow,1150,465,685,14,268,5,9
30262,42598,443,46015,443,allow,3134,1983,1151,15,15,8,7
30263,51941,19333,59185,19333,allow,70,70,0,1,5,1,0
30264,60450,56494,22867,56494,allow,70,70,0,2,8,2,0
30265,51974,54759,44030,54759,allow,70,70,0,2,7,2,0
30266,41980,443,47669,443,allow,11377,7703,3674,26,162,19,7
30267,41741,443,53387,443,allow,5379,1424,3955,19,507,11,8
30268,9171,80,16073,80,allow,318,192,126,6,29,4,2
30269,40125,443,1221,443,allow,7000,1799,5201,20,256,12,8
30270,55080,80,25795,80,allow,2305712,80795,2224917,2771,52,1293,1478
30271,9121,80,6298,80,allow,318,192,126,6,29,4,2
30272,56701,443,57052,443,allow,8007,1987,6020,20,15,11,9
30273,34419,443,53851,443,allow,2713,1386,1327,18,316,10,8
30274,9141,80,1670,80,allow,378,192,186,7,29,4,3
30275,64892,53,50035,53,allow,252,102,150,2,29,1,1
30276,55593,53,42641,53,allow,193,102,91,2,29,1,1
30277,55562,53,27476,53,allow,239,94,145,2,29,1,1
30278,65123,53,3182,53,allow,193,102,91,2,29,1,1
30279,56884,53,31028,53,allow,177,94,83,2,30,1,1
30280,56884,53,27069,53,allow,177,94,83,2,30,1,1
30281,54996,53,30248,53,allow,252,102,150,2,29,1,1
30282,49687,53,63012,53,allow,241,94,147,2,29,1,1
30283,64154,53,35293,53,allow,194,102,92,2,29,1,1
30284,64195,53,9148,53,allow,270,110,160,2,29,1,1
30285,65180,53,28162,53,allow,199,102,97,2,30,1,1
30286,65491,53,7417,53,allow,193,102,91,2,30,1,1
30287,65266,53,39575,53,allow,216,110,106,2,30,1,1
30288,57029,53,63160,53,allow,246,94,152,2,30,1,1
30289,49555,53,29992,53,allow,193,102,91,2,30,1,1
30290,56521,53,59104,53,allow,310,126,184,2,30,1,1
30291,49876,53,33233,53,allow,199,102,97,2,30,1,1
30292,27005,32056,3703,32056,allow,886,126,760,2,30,1,1
30293,56212,53,11758,53,allow,168,86,82,2,31,1,1
30294,55742,53,55832,53,allow,193,102,91,2,30,1,1
30295,64491,53,54856,53,allow,244,94,150,2,30,1,1
30296,55752,53,39716,53,allow,177,94,83,2,30,1,1
30297,49355,53,45330,53,allow,184,102,82,2,30,1,1
30298,27005,27055,18786,27055,allow,915,126,789,2,30,1,1
30299,55580,53,57711,53,allow,195,102,93,2,31,1,1
30300,49920,443,59929,443,allow,6489,2137,4352,28,143,14,14
30301,51970,18752,54925,18752,allow,70,70,0,2,8,2,0
30302,55667,19667,61736,19667,allow,70,70,0,1,5,1,0
30303,65061,53,60210,53,allow,733,204,529,6,40,3,3
30304,62896,993,54480,993,allow,178,118,60,2,15,1,1
30305,9153,443,27123,443,allow,6059,773,5286,17,29,9,8
30306,9147,443,1443,443,allow,6334,840,5494,19,29,10,9
30307,49961,53,12419,53,allow,377,107,270,4,45,2,2
30308,50011,53,8163,53,allow,272,110,162,2,30,1,1
30309,65416,53,1423,53,allow,758,102,656,2,30,1,1
30310,57385,53,34809,53,allow,197,102,95,2,30,1,1
30311,56393,53,59869,53,allow,197,94,103,2,30,1,1
30312,49696,53,15575,53,allow,200,94,106,2,30,1,1
30313,55133,53,36178,53,allow,184,102,82,2,31,1,1
30314,65485,53,34553,53,allow,184,94,90,2,31,1,1
30315,27005,27054,38944,27054,allow,921,126,795,2,30,1,1
30316,27005,27058,35794,27058,allow,908,126,782,2,30,1,1
30317,63919,80,26463,80,allow,314,192,122,6,15,4,2
30318,49359,53,64327,53,allow,412,122,290,4,45,2,2
30319,9176,443,40179,443,allow,6331,837,5494,19,28,10,9
30320,49856,443,13732,443,allow,18685,4528,14157,31,151,13,18
30321,1039,53,1039,53,allow,644,90,554,2,30,1,1
30322,64940,53,17775,53,allow,758,102,656,2,30,1,1
30323,49684,53,44986,53,allow,265,110,155,2,30,1,1
30324,57074,53,64644,53,allow,195,102,93,2,30,1,1
30325,49291,53,21649,53,allow,771,102,669,2,30,1,1
30326,55444,53,54146,53,allow,193,102,91,2,30,1,1
30327,62758,443,37429,443,allow,22187,14208,7979,52,130,25,27
30328,45210,443,36516,443,allow,1699,1038,661,16,276,9,7
30329,55742,53,11069,53,allow,193,102,91,2,31,1,1
30330,55358,53,28706,53,allow,183,94,89,2,31,1,1
30331,60449,28260,44457,28260,allow,70,70,0,2,8,2,0
30332,51854,80,4415,80,allow,5438,1822,3616,17,38,11,6
30333,9166,443,13455,443,allow,5242,902,4340,16,29,8,8
30334,58771,443,23708,443,allow,5167,700,4467,16,15,7,9
30335,64540,53,29410,53,allow,94,94,0,1,30,1,0
30336,50086,53,18970,53,allow,816,102,714,2,30,1,1
30337,56814,53,30689,53,allow,816,102,714,2,30,1,1
30338,57201,53,63092,53,allow,195,102,93,2,30,1,1
30339,55898,53,25351,53,allow,757,102,655,2,30,1,1
30340,51261,53,15838,53,allow,259,86,173,2,30,1,1
30341,55890,53,43973,53,allow,193,102,91,2,30,1,1
30342,63970,53,14367,53,allow,200,94,106,2,30,1,1
30343,49229,53,47924,53,allow,183,94,89,2,30,1,1
30344,65466,53,32995,53,allow,200,102,98,2,30,1,1
30345,55962,53,28186,53,allow,193,102,91,2,30,1,1
30346,56755,53,24589,53,allow,184,94,90,2,30,1,1
30347,55580,53,20402,53,allow,195,102,93,2,30,1,1
30348,57385,53,56308,53,allow,197,102,95,2,30,1,1
30349,56212,53,23655,53,allow,184,102,82,2,30,1,1
30350,57275,53,22195,53,allow,199,102,97,2,31,1,1
30351,49966,53,5626,53,allow,168,78,90,2,30,1,1
30352,55890,53,44710,53,allow,193,102,91,2,31,1,1
30353,57226,53,39140,53,allow,178,94,84,2,31,1,1
30354,64955,53,63777,53,allow,210,110,100,2,30,1,1
30355,55752,53,65323,53,allow,177,94,83,2,30,1,1
30356,64526,53,11461,53,allow,377,94,283,2,30,1,1
30357,55337,53,8844,53,allow,198,102,96,2,31,1,1
30358,55391,53,35560,53,allow,210,110,100,2,31,1,1
30359,56892,53,51389,53,allow,199,102,97,2,31,1,1
30360,56004,53,52519,53,allow,178,94,84,2,31,1,1
30361,6881,6881,2586,6881,allow,237,118,119,2,1200,1,1
30362,65304,53,24960,53,allow,195,102,93,2,31,1,1
30363,53258,443,49616,443,allow,26995,3729,23266,40,137,16,24
30364,64016,53,59779,53,allow,184,94,90,2,31,1,1
30365,57464,443,33460,443,allow,7715,1772,5943,25,275,13,12
30366,57470,22796,55699,22796,allow,2224,1852,372,33,1565,27,6
30367,65491,53,33767,53,allow,193,102,91,2,31,1,1
30368,55441,53,20150,53,allow,216,110,106,2,31,1,1
30369,55776,53,14354,53,allow,271,93,178,4,31,2,2
30370,57470,26247,60262,26247,allow,1320,1320,0,21,1624,21,0
30371,57228,53,47856,53,allow,199,102,97,2,31,1,1
30372,35186,443,1570,443,allow,130,70,60,3,5,2,1
30373,58767,443,20066,443,allow,5167,700,4467,16,15,7,9
30374,52441,53,0,0,allow,86,86,0,1,30,1,0
30375,51968,43622,9817,43622,allow,70,70,0,2,8,2,0
30376,51969,37558,21407,37558,allow,70,70,0,2,8,2,0
30377,43109,80,31634,80,allow,7607,3563,4044,18,20,9,9
30378,56704,53,49275,53,allow,177,94,83,2,31,1,1
30379,57591,53,13897,53,allow,165,78,87,2,31,1,1
30380,55934,53,39869,53,allow,196,102,94,2,31,1,1
30381,6882,27032,16689,27032,allow,1200,1200,0,9,1201,9,0
30382,56700,443,13069,443,allow,8059,2039,6020,20,16,11,9
30383,58770,443,24221,443,allow,6033,770,5263,18,15,8,10
30384,53748,51413,19666,51413,allow,70,70,0,1,5,1,0
30385,46771,80,6345,80,allow,2066,1369,697,13,84,7,6
30386,34418,443,25762,443,allow,6402,1595,4807,23,316,12,11
30387,59982,445,0,0,drop,66,66,0,1,0,1,0
30388,59989,445,0,0,drop,66,66,0,1,0,1,0
30389,59986,445,0,0,drop,66,66,0,1,0,1,0
30390,59985,445,0,0,drop,66,66,0,1,0,1,0
30391,59984,445,0,0,drop,66,66,0,1,0,1,0
30392,59979,445,0,0,drop,66,66,0,1,0,1,0
30393,1903,43890,0,0,deny,66,66,0,1,0,1,0
30394,64573,445,0,0,drop,70,70,0,1,0,1,0
30395,1034,26296,0,0,deny,159,159,0,1,0,1,0
30396,59734,445,0,0,drop,70,70,0,1,0,1,0
30397,59732,445,0,0,drop,70,70,0,1,0,1,0
30398,59733,445,0,0,drop,70,70,0,1,0,1,0
30399,64569,445,0,0,drop,70,70,0,1,0,1,0
30400,64567,445,0,0,drop,70,70,0,1,0,1,0
30401,64565,445,0,0,drop,70,70,0,1,0,1,0
30402,59728,445,0,0,drop,70,70,0,1,0,1,0
30403,22409,55442,0,0,deny,74,74,0,1,0,1,0
30404,59726,445,0,0,drop,70,70,0,1,0,1,0
30405,12458,161,0,0,deny,85,85,0,1,0,1,0
30406,51414,22,0,0,deny,60,60,0,1,0,1,0
30407,41744,37965,0,0,deny,62,62,0,1,0,1,0
30408,45908,33330,0,0,deny,60,60,0,1,0,1,0
30409,12737,35440,0,0,deny,62,62,0,1,0,1,0
30410,56462,37965,0,0,deny,66,66,0,1,0,1,0
30411,14042,22114,0,0,deny,62,62,0,1,0,1,0
30412,16387,8455,0,0,deny,60,60,0,1,0,1,0
30413,16387,49252,0,0,deny,60,60,0,1,0,1,0
30414,16387,35244,0,0,deny,60,60,0,1,0,1,0
30415,7664,2149,0,0,deny,66,66,0,1,0,1,0
30416,64563,445,0,0,drop,70,70,0,1,0,1,0
30417,64561,445,0,0,drop,70,70,0,1,0,1,0
30418,64557,445,0,0,drop,70,70,0,1,0,1,0
30419,36237,23,0,0,deny,60,60,0,1,0,1,0
30420,59718,445,0,0,drop,70,70,0,1,0,1,0
30421,59974,445,0,0,drop,66,66,0,1,0,1,0
30422,64556,445,0,0,drop,70,70,0,1,0,1,0
30423,59970,445,0,0,drop,66,66,0,1,0,1,0
30424,3074,64147,0,0,deny,62,62,0,1,0,1,0
30425,59969,445,0,0,drop,66,66,0,1,0,1,0
30426,59967,445,0,0,drop,66,66,0,1,0,1,0
30427,21759,51505,0,0,deny,62,62,0,1,0,1,0
30428,19617,39004,0,0,deny,62,62,0,1,0,1,0
30429,14148,1,0,0,deny,66,66,0,1,0,1,0
30430,7655,23,0,0,deny,60,60,0,1,0,1,0
30431,59965,445,0,0,drop,66,66,0,1,0,1,0
30432,62731,21247,0,0,deny,62,62,0,1,0,1,0
30433,59711,445,0,0,drop,70,70,0,1,0,1,0
30434,59710,445,0,0,drop,70,70,0,1,0,1,0
30435,54593,51505,0,0,deny,66,66,0,1,0,1,0
30436,57131,26296,0,0,deny,145,145,0,1,0,1,0
30437,14183,26467,0,0,deny,62,62,0,1,0,1,0
30438,62912,26467,0,0,deny,62,62,0,1,0,1,0
30439,31500,1,0,0,deny,146,146,0,1,0,1,0
30440,64548,445,0,0,drop,70,70,0,1,0,1,0
30441,5859,11392,0,0,deny,62,62,0,1,0,1,0
30442,64544,445,0,0,drop,70,70,0,1,0,1,0
30443,64540,445,0,0,drop,70,70,0,1,0,1,0
30444,59705,445,0,0,drop,70,70,0,1,0,1,0
30445,59703,445,0,0,drop,70,70,0,1,0,1,0
30446,59954,445,0,0,drop,66,66,0,1,0,1,0
30447,19634,64147,0,0,deny,62,62,0,1,0,1,0
30448,54351,23,0,0,deny,60,60,0,1,0,1,0
30449,59699,445,0,0,drop,70,70,0,1,0,1,0
30450,12262,22114,0,0,deny,146,146,0,1,0,1,0
30451,59698,445,0,0,drop,70,70,0,1,0,1,0
30452,41249,50584,0,0,deny,62,62,0,1,0,1,0
30453,59947,445,0,0,drop,66,66,0,1,0,1,0
30454,64530,445,0,0,drop,70,70,0,1,0,1,0
30455,64346,51505,0,0,deny,66,66,0,1,0,1,0
30456,53906,44512,0,0,deny,62,62,0,1,0,1,0
30457,59944,445,0,0,drop,66,66,0,1,0,1,0
30458,35015,17,0,0,deny,60,60,0,1,0,1,0
30459,59693,445,0,0,drop,70,70,0,1,0,1,0
30460,55600,22,0,0,deny,60,60,0,1,0,1,0
30461,44466,443,54385,443,allow,466,392,74,4,0,3,1
30462,54779,50584,0,0,deny,62,62,0,1,0,1,0
30463,59936,445,0,0,drop,66,66,0,1,0,1,0
30464,59935,445,0,0,drop,66,66,0,1,0,1,0
30465,24910,64147,0,0,deny,66,66,0,1,0,1,0
30466,60514,39004,0,0,deny,62,62,0,1,0,1,0
30467,46640,4443,0,0,deny,60,60,0,1,0,1,0
30468,17378,44847,0,0,deny,66,66,0,1,0,1,0
30469,60141,62413,0,0,deny,66,66,0,1,0,1,0
30470,58475,11392,0,0,deny,66,66,0,1,0,1,0
30471,59680,445,0,0,drop,70,70,0,1,0,1,0
30472,1024,22114,0,0,deny,146,146,0,1,0,1,0
30473,64518,445,0,0,deny,70,70,0,1,0,1,0
30474,64516,445,0,0,drop,70,70,0,1,0,1,0
30475,64517,445,0,0,drop,70,70,0,1,0,1,0
30476,59919,445,0,0,drop,66,66,0,1,0,1,0
30477,59922,445,0,0,drop,66,66,0,1,0,1,0
30478,59917,445,0,0,drop,66,66,0,1,0,1,0
30479,59920,445,0,0,drop,66,66,0,1,0,1,0
30480,59921,445,0,0,drop,66,66,0,1,0,1,0
30481,59918,445,0,0,drop,66,66,0,1,0,1,0
30482,59916,445,0,0,drop,66,66,0,1,0,1,0
30483,59914,445,0,0,drop,66,66,0,1,0,1,0
30484,443,51550,0,0,deny,100,100,0,1,0,1,0
30485,59677,445,0,0,drop,70,70,0,1,0,1,0
30486,45682,25604,0,0,deny,62,62,0,1,0,1,0
30487,59763,25604,0,0,deny,66,66,0,1,0,1,0
30488,59486,50584,0,0,deny,62,62,0,1,0,1,0
30489,56386,50584,0,0,deny,66,66,0,1,0,1,0
30490,443,61686,0,0,deny,1484,1484,0,1,0,1,0
30491,58371,23,0,0,deny,60,60,0,1,0,1,0
30492,17957,64097,0,0,deny,66,66,0,1,0,1,0
30493,63988,50584,0,0,deny,66,66,0,1,0,1,0
30494,49167,19750,0,0,deny,66,66,0,1,0,1,0
30495,50806,51505,0,0,deny,66,66,0,1,0,1,0
30496,35864,44847,0,0,deny,78,78,0,1,0,1,0
30497,37028,51505,0,0,deny,62,62,0,1,0,1,0
30498,57937,22114,0,0,deny,146,146,0,1,0,1,0
30499,59673,445,0,0,drop,70,70,0,1,0,1,0
30500,59671,445,0,0,drop,70,70,0,1,0,1,0
30501,64511,445,0,0,drop,70,70,0,1,0,1,0
30502,64509,445,0,0,drop,70,70,0,1,0,1,0
30503,57538,23,0,0,deny,60,60,0,1,0,1,0
30504,64499,445,0,0,drop,70,70,0,1,0,1,0
30505,64504,445,0,0,drop,70,70,0,1,0,1,0
30506,14336,64147,0,0,deny,62,62,0,1,0,1,0
30507,0,0,0,0,allow,124,64,60,2,0,1,1
30508,59669,445,0,0,drop,70,70,0,1,0,1,0
30509,59900,445,0,0,drop,66,66,0,1,0,1,0
30510,59902,445,0,0,drop,66,66,0,1,0,1,0
30511,59899,445,0,0,drop,66,66,0,1,0,1,0
30512,27337,51505,0,0,deny,62,62,0,1,0,1,0
30513,50052,65008,0,0,deny,60,60,0,1,0,1,0
30514,54280,3385,0,0,deny,60,60,0,1,0,1,0
30515,723,3389,0,0,deny,74,74,0,1,0,1,0
30516,1045,36237,0,0,deny,66,66,0,1,0,1,0
30517,5087,22114,0,0,deny,66,66,0,1,0,1,0
30518,64497,445,0,0,drop,70,70,0,1,0,1,0
30519,64490,445,0,0,drop,70,70,0,1,0,1,0
30520,64489,445,0,0,drop,70,70,0,1,0,1,0
30521,64485,445,0,0,drop,70,70,0,1,0,1,0
30522,47910,7464,0,0,deny,60,60,0,1,0,1,0
30523,59662,445,0,0,drop,70,70,0,1,0,1,0
30524,63461,51505,0,0,deny,66,66,0,1,0,1,0
30525,12260,51505,0,0,deny,62,62,0,1,0,1,0
30526,59660,445,0,0,drop,70,70,0,1,0,1,0
30527,59659,445,0,0,drop,70,70,0,1,0,1,0
30528,34400,39004,0,0,deny,74,74,0,1,0,1,0
30529,59658,445,0,0,drop,70,70,0,1,0,1,0
30530,59657,445,0,0,drop,70,70,0,1,0,1,0
30531,52695,26467,0,0,deny,66,66,0,1,0,1,0
30532,59654,445,0,0,drop,70,70,0,1,0,1,0
30533,59651,445,0,0,drop,70,70,0,1,0,1,0
30534,64478,445,0,0,drop,70,70,0,1,0,1,0
30535,64477,445,0,0,drop,70,70,0,1,0,1,0
30536,64474,445,0,0,drop,70,70,0,1,0,1,0
30537,7286,44847,0,0,deny,66,66,0,1,0,1,0
30538,61766,44847,0,0,deny,62,62,0,1,0,1,0
30539,59889,445,0,0,drop,66,66,0,1,0,1,0
30540,59639,445,0,0,drop,70,70,0,1,0,1,0
30541,59638,445,0,0,drop,70,70,0,1,0,1,0
30542,59634,445,0,0,drop,70,70,0,1,0,1,0
30543,11450,57470,0,0,deny,62,62,0,1,0,1,0
30544,26872,44847,0,0,deny,62,62,0,1,0,1,0
30545,59628,445,0,0,drop,70,70,0,1,0,1,0
30546,56766,53,34150,53,allow,204,104,100,2,30,1,1
30547,55022,53,30402,53,allow,772,103,669,2,30,1,1
30548,56004,53,42302,53,allow,172,88,84,2,30,1,1
30549,64068,53,64068,53,allow,1184,83,1101,4,59,2,2
30550,55742,53,41755,53,allow,186,95,91,2,31,1,1
30551,57321,53,34343,53,allow,762,98,664,2,30,1,1
30552,49177,53,53466,53,allow,735,88,647,2,30,1,1
30553,65264,53,2001,53,allow,738,86,652,2,30,1,1
30554,64810,53,33589,53,allow,272,93,179,4,33,2,2
30555,27005,30008,3198,30008,allow,890,126,764,2,31,1,1
30556,49759,53,54195,53,allow,164,84,80,2,31,1,1
30557,50930,443,59751,443,allow,9354,2370,6984,24,16,13,11
30558,63154,443,63154,443,allow,4642,1735,2907,19,30,11,8
30559,58751,443,12034,443,allow,10505,6856,3649,29,16,15,14
30560,55025,80,12764,80,allow,1142,626,516,8,180,5,3
30561,50299,53,31351,53,allow,770,102,668,2,30,1,1
30562,49314,443,47530,443,allow,3185,2263,922,18,25,9,9
30563,55580,53,25974,53,allow,190,97,93,2,30,1,1
30564,51940,26399,4423,26399,allow,66,66,0,1,5,1,0
30565,49742,53,64012,53,allow,731,91,640,2,30,1,1
30566,39718,443,11292,443,allow,10186,3128,7058,26,16,13,13
30567,60445,20555,38160,20555,allow,70,70,0,1,5,1,0
30568,64172,53,18592,53,allow,194,99,95,2,30,1,1
30569,60776,4156,29632,4156,allow,66,66,0,1,5,1,0
30570,52607,443,60417,443,allow,18341,14819,3522,59,1044,31,28
30571,57226,53,4215,53,allow,88,88,0,1,30,1,0
30572,55187,53,20282,53,allow,256,93,163,2,30,1,1
30573,55337,53,28465,53,allow,196,100,96,2,30,1,1
30574,65304,53,37771,53,allow,190,97,93,2,30,1,1
30575,56974,53,21612,53,allow,814,110,704,2,30,1,1
30576,27005,27017,35539,27017,allow,873,126,747,2,31,1,1
30577,49313,443,5265,443,allow,3185,2263,922,18,25,9,9
30578,55238,53,7598,53,allow,168,86,82,2,31,1,1
30579,52478,443,48158,443,allow,9844,3089,6755,21,133,10,11
30580,58754,443,12477,443,allow,7674,4959,2715,24,16,13,11
30581,57992,80,4887,80,allow,10247,3696,6551,32,33,16,16
30582,55776,53,13718,53,allow,182,93,89,3,33,2,1
30583,51966,18716,12930,18716,allow,70,70,0,2,8,2,0
30584,58745,443,47699,443,allow,14654,9694,4960,36,17,19,17
30585,58749,443,22893,443,allow,6246,4267,1979,21,16,11,10
30586,56829,53,58561,53,allow,170,87,83,2,30,1,1
30587,64711,53,23065,53,allow,760,97,663,2,30,1,1
30588,55211,53,19820,53,allow,760,97,663,2,30,1,1
30589,64902,53,48255,53,allow,762,98,664,2,30,1,1
30590,56509,53,41875,53,allow,747,90,657,2,31,1,1
30591,57307,53,57558,53,allow,170,87,83,2,31,1,1
30592,61850,34021,0,0,allow,66,66,0,1,91,1,0
30593,49421,5228,11226,5228,allow,8399,1901,6498,39,1562,16,23
30594,27005,30005,45159,30005,allow,890,126,764,2,31,1,1
30595,33525,53,23050,53,allow,168,78,90,2,31,1,1
30596,56128,53,30035,53,allow,744,89,655,2,31,1,1
30597,55820,53,6966,53,allow,168,86,82,2,31,1,1
30598,56470,53,21021,53,allow,196,100,96,2,31,1,1
30599,64421,53,64542,53,allow,172,88,84,2,31,1,1
30600,56204,53,35079,53,allow,190,97,93,2,31,1,1
30601,64081,443,44288,443,allow,7280,2277,5003,19,136,9,10
30602,50265,34311,31562,34311,allow,480,149,331,2,1200,1,1
30603,50324,53,1643,53,allow,754,94,660,2,31,1,1
30604,57907,53,57907,53,allow,228,97,131,2,31,1,1
30605,56180,53,48216,53,allow,757,98,659,2,31,1,1
30606,49918,53,24031,53,allow,196,100,96,2,31,1,1
30607,56892,53,3600,53,allow,198,101,97,2,31,1,1
30608,55067,53,2725,53,allow,164,84,80,2,31,1,1
30609,57302,53,18711,53,allow,770,102,668,2,31,1,1
30610,55413,53,9671,53,allow,216,110,106,2,31,1,1
30611,64976,53,22301,53,allow,186,95,91,2,31,1,1
30612,55912,53,49501,53,allow,198,101,97,2,31,1,1
30613,56310,53,55159,53,allow,760,97,663,2,31,1,1
30614,55283,53,5653,53,allow,754,94,660,2,31,1,1
30615,64628,53,57301,53,allow,198,101,97,2,31,1,1
30616,55970,53,39090,53,allow,810,108,702,2,31,1,1
30617,49410,53,65177,53,allow,172,88,84,2,31,1,1
30618,56152,53,61194,53,allow,190,97,93,2,31,1,1
30619,55808,53,45901,53,allow,738,86,652,2,31,1,1
30620,64692,53,27620,53,allow,760,97,663,2,31,1,1
30621,55399,53,7515,53,allow,176,90,86,2,31,1,1
30622,56330,53,30393,53,allow,198,101,97,2,31,1,1
30623,56461,53,50926,53,allow,760,96,664,2,31,1,1
30624,57363,53,6725,53,allow,172,88,84,2,31,1,1
30625,49451,53,46529,53,allow,757,98,659,2,31,1,1
30626,51234,443,8944,443,allow,31736,1463,30273,43,32,14,29
30627,50010,53,39739,53,allow,756,95,661,2,31,1,1
30628,57418,53,27035,53,allow,758,96,662,2,31,1,1
30629,55969,53,43128,53,allow,731,91,640,2,31,1,1
30630,65515,53,32592,53,allow,204,104,100,2,31,1,1
30631,50518,53,60220,53,allow,802,104,698,2,31,1,1
30632,40940,443,13530,443,allow,12685,7319,5366,36,398,15,21
30633,30960,45742,3769,45742,allow,330,330,0,6,3609,6,0
30634,44847,51413,1303,51413,allow,475,150,325,2,1200,1,1
30635,30960,45741,31412,45741,allow,330,330,0,6,3609,6,0
30636,59629,445,0,0,drop,70,70,0,1,0,1,0
30637,43063,57470,0,0,deny,62,62,0,1,0,1,0
30638,42366,57470,0,0,deny,66,66,0,1,0,1,0
30639,57555,35440,0,0,deny,66,66,0,1,0,1,0
30640,16013,35253,0,0,deny,66,66,0,1,0,1,0
30641,1025,51221,0,0,deny,62,62,0,1,0,1,0
30642,8592,35993,0,0,deny,66,66,0,1,0,1,0
30643,23415,11392,0,0,deny,66,66,0,1,0,1,0
30644,52252,46314,0,0,deny,62,62,0,1,0,1,0
30645,64469,445,0,0,drop,70,70,0,1,0,1,0
30646,64467,445,0,0,drop,70,70,0,1,0,1,0
30647,59617,445,0,0,drop,70,70,0,1,0,1,0
30648,49298,53,53447,53,allow,230,102,128,2,30,1,1
30649,64366,53,57312,53,allow,234,94,140,2,30,1,1
30650,35339,443,19701,443,allow,6677,1006,5671,19,27,11,8
30651,56698,443,46123,443,allow,8058,2038,6020,20,15,11,9
30652,49773,53,59337,53,allow,225,110,115,2,30,1,1
30653,64559,53,24538,53,allow,182,94,88,2,30,1,1
30654,56004,53,58058,53,allow,178,94,84,2,30,1,1
30655,49953,53,45166,53,allow,214,110,104,2,30,1,1
30656,46773,80,41646,80,allow,2075,1376,699,13,83,7,6
30657,38691,443,60473,443,allow,90369,3417,86952,95,15,30,65
30658,60779,40010,64094,40010,allow,316,136,180,6,5,3,3
30659,60863,443,14093,443,allow,134,60,74,3,5,2,1
30660,63925,18912,12626,18912,allow,70,70,0,1,4,1,0
30661,64391,53,9777,53,allow,209,102,107,2,29,1,1
30662,56204,53,35086,53,allow,195,102,93,2,30,1,1
30663,46774,80,26120,80,allow,2074,1375,699,13,83,7,6
30664,43879,443,28850,443,allow,71822,4809,67013,112,241,54,58
30665,34312,80,11906,80,allow,874,500,374,10,14,6,4
30666,64665,53,19631,53,allow,181,94,87,2,31,1,1
30667,38936,443,16870,443,allow,3217,2090,1127,16,255,9,7
30668,56470,53,41515,53,allow,198,102,96,2,30,1,1
30669,40306,443,40306,443,allow,4520,1613,2907,19,26,11,8
30670,57434,443,22130,443,allow,9237,2447,6790,30,16,14,16
30671,56984,53,20901,53,allow,199,102,97,2,29,1,1
30672,49906,53,24653,53,allow,200,94,106,2,29,1,1
30673,50427,443,32859,443,allow,783009,84254,698755,776,706,250,526
30674,57122,53,4958,53,allow,199,102,97,2,29,1,1
30675,45862,443,6882,443,allow,234,234,0,4,11,4,0
30676,49229,53,40938,53,allow,183,94,89,2,29,1,1
30677,55358,53,38932,53,allow,183,94,89,2,29,1,1
30678,65430,53,43606,53,allow,305,94,211,2,29,1,1
30679,57122,53,16456,53,allow,199,102,97,2,29,1,1
30680,56984,53,7040,53,allow,199,102,97,2,29,1,1
30681,56984,53,53152,53,allow,199,102,97,2,29,1,1
30682,49949,53,18474,53,allow,193,102,91,2,30,1,1
30683,34415,443,34473,443,allow,6397,1590,4807,23,315,12,11
30684,58763,443,45079,443,allow,5108,700,4408,15,15,7,8
30685,63913,24806,2171,24806,allow,630,508,122,9,15,7,2
30686,51794,80,29436,80,allow,5480,3236,2244,19,47,12,7
30687,57275,53,57643,53,allow,199,102,97,2,30,1,1
30688,55752,53,32253,53,allow,177,94,83,2,30,1,1
30689,37565,123,4980,123,allow,184,94,90,2,30,1,1
30690,50581,53,22242,53,allow,177,94,83,2,30,1,1
30691,63033,443,16495,443,allow,6869,3059,3810,30,123,15,15
30692,65273,53,64303,53,allow,226,102,124,2,30,1,1
30693,49181,53,18919,53,allow,184,102,82,2,30,1,1
30694,49167,53,55211,53,allow,258,94,164,2,30,1,1
30695,43163,443,21681,443,allow,10100,3072,7028,25,16,14,11
30696,36368,80,54133,80,allow,78,78,0,1,5,1,0
30697,56766,53,19363,53,allow,210,110,100,2,30,1,1
30698,52914,443,10656,443,allow,70,70,0,1,5,1,0
30699,56894,53,27064,53,allow,178,94,84,2,30,1,1
30700,64949,53,27960,53,allow,472,124,348,4,39,2,2
30701,55489,53,44022,53,allow,185,102,83,2,30,1,1
30702,57590,53,59223,53,allow,260,86,174,2,30,1,1
30703,60462,80,40235,80,allow,1588,553,1035,10,75,6,4
30704,56422,53,41175,53,allow,199,102,97,2,30,1,1
30705,55808,53,32888,53,allow,183,94,89,2,30,1,1
30706,64445,53,20808,53,allow,269,94,175,2,30,1,1
30707,46378,443,41415,443,allow,10675,4478,6197,25,16,13,12
30708,43025,443,51895,443,allow,25223,13115,12108,63,116,33,30
30709,27005,33026,58261,33026,allow,879,126,753,3,32,2,1
30710,55808,53,36895,53,allow,183,94,89,2,30,1,1
30711,34416,443,50099,443,allow,6396,1589,4807,23,315,12,11
30712,14421,443,39143,443,allow,15204,8747,6457,83,167,44,39
30713,56646,80,51204,80,allow,234,234,0,4,12,4,0
30714,64559,53,29849,53,allow,198,110,88,2,30,1,1
30715,64172,53,61363,53,allow,361,99,262,4,54,2,2
30716,56766,53,15187,53,allow,210,110,100,2,30,1,1
30717,49812,53,48839,53,allow,392,101,291,4,39,2,2
30718,56236,53,43042,53,allow,241,94,147,2,30,1,1
30719,55934,53,48489,53,allow,196,102,94,2,30,1,1
30720,43162,443,31273,443,allow,10096,3002,7094,25,16,13,12
30721,55934,53,60885,53,allow,196,102,94,2,30,1,1
30722,49181,53,64897,53,allow,168,86,82,2,30,1,1
30723,49364,53,61056,53,allow,779,86,693,2,30,1,1
30724,51814,80,8693,80,allow,11975,2907,9068,24,38,14,10
30725,56766,53,59139,53,allow,210,110,100,2,30,1,1
30726,56892,53,6597,53,allow,199,102,97,2,30,1,1
30727,64068,53,64068,53,allow,1184,83,1101,4,59,2,2
30728,64579,53,56844,53,allow,178,94,84,2,30,1,1
30729,49837,53,44716,53,allow,734,86,648,2,30,1,1
30730,49734,53,20221,53,allow,216,110,106,2,30,1,1
30731,50966,443,50616,443,allow,17161,1619,15542,18,143,4,14
30732,55391,53,33139,53,allow,210,110,100,2,30,1,1
30733,17750,44597,35749,44597,allow,481,150,331,2,1200,1,1
30734,27005,33084,13746,33084,allow,906,126,780,2,30,1,1
30735,55912,53,11122,53,allow,199,102,97,2,30,1,1
30736,57385,53,7964,53,allow,197,102,95,2,30,1,1
30737,65491,53,31323,53,allow,193,102,91,2,33,1,1
30738,9916,53,9916,53,allow,235,90,145,2,33,1,1
30739,53146,50393,21783,50393,allow,70,70,0,2,8,2,0
30740,50700,80,7007,80,allow,142,142,0,1,5,1,0
30741,65493,443,45559,443,allow,438968,12780,426188,449,16,157,292
30742,62525,7080,62525,7080,allow,2960,432,2528,11,15,6,5
30743,64276,53,63257,53,allow,398,105,293,4,46,2,2
30744,50195,53,23918,53,allow,199,102,97,2,30,1,1
30745,64879,53,48255,53,allow,356,118,238,2,30,1,1
30746,50581,53,15550,53,allow,185,102,83,2,30,1,1
30747,64579,53,27350,53,allow,178,94,84,2,30,1,1
30748,50168,53,56159,53,allow,211,78,133,2,30,1,1
30749,64867,53,35181,53,allow,184,86,98,2,30,1,1
30750,36406,5228,24879,5228,allow,17762,4403,13359,92,616,47,45
30751,43676,443,26633,443,allow,5903,1367,4536,18,16,10,8
30752,9192,443,26579,443,allow,318,192,126,6,22,4,2
30753,56829,53,52849,53,allow,185,102,83,2,30,1,1
30754,55133,53,13417,53,allow,168,86,82,2,30,1,1
30755,37027,53,20580,53,allow,168,78,90,2,30,1,1
30756,1931,53,26121,53,allow,210,78,132,2,30,1,1
30757,56152,53,29649,53,allow,195,102,93,2,30,1,1
30758,56704,53,2195,53,allow,177,94,83,2,30,1,1
30759,53221,53,3242,53,allow,165,78,87,2,30,1,1
30760,64421,53,34149,53,allow,178,94,84,2,30,1,1
30761,49174,53,10014,53,allow,323,107,216,4,47,2,2
30762,49192,8106,32598,8106,allow,2050,1277,773,15,15,8,7
30763,46772,80,10171,80,allow,2068,1371,697,13,83,7,6
30764,63915,23225,23322,23225,allow,564,382,182,9,15,6,3
30765,46770,80,34528,80,allow,2068,1371,697,13,83,7,6
30766,56699,443,19537,443,allow,8006,1986,6020,20,15,11,9
30767,48086,443,38296,443,allow,3138,2011,1127,16,255,9,7
30768,35340,443,44611,443,allow,7470,1088,6382,21,27,12,9
30769,65304,53,22589,53,allow,308,97,211,4,33,2,2
30770,51967,12110,50176,12110,allow,70,70,0,2,7,2,0
30771,52477,443,18110,443,allow,8788,2185,6603,15,134,7,8
30772,46769,80,58026,80,allow,3589,2432,1157,17,86,9,8
30773,53721,443,43069,443,allow,70,70,0,2,7,2,0
30774,48135,443,38274,443,allow,6426,1858,4568,22,16,12,10
30775,42438,443,37580,443,allow,7747,1737,6010,27,316,13,14
30776,63924,26328,47247,26328,allow,70,70,0,1,4,1,0
30777,63923,59177,22656,59177,allow,70,70,0,1,4,1,0
30778,51939,34393,16792,34393,allow,70,70,0,1,5,1,0
30779,51938,11218,41228,11218,allow,70,70,0,1,5,1,0
30780,49577,53,58264,53,allow,389,134,255,2,29,1,1
30781,49734,53,21745,53,allow,216,110,106,2,30,1,1
30782,55238,53,10880,53,allow,168,86,82,2,30,1,1
30783,65304,53,31926,53,allow,195,102,93,2,29,1,1
30784,50347,53,2188,53,allow,756,94,662,2,29,1,1
30785,49675,53,62598,53,allow,199,102,97,2,29,1,1
30786,56496,53,36684,53,allow,164,86,78,2,29,1,1
30787,65494,443,61063,443,allow,92044,4379,87665,102,16,37,65
30788,55776,53,26753,53,allow,271,93,178,4,30,2,2
30789,56004,53,60416,53,allow,178,94,84,2,29,1,1
30790,49355,53,6777,53,allow,168,86,82,2,29,1,1
30791,49825,53,24008,53,allow,814,110,704,2,29,1,1
30792,55890,53,15703,53,allow,193,102,91,2,29,1,1
30793,57122,53,57720,53,allow,199,102,97,2,29,1,1
30794,56717,53,63655,53,allow,178,94,84,2,30,1,1
30795,56416,53,40943,53,allow,969,86,883,2,29,1,1
30796,64955,53,3638,53,allow,210,110,100,2,29,1,1
30797,55238,53,60752,53,allow,168,86,82,2,29,1,1
30798,49734,53,34033,53,allow,216,110,106,2,30,1,1
30799,1929,53,20387,53,allow,260,86,174,2,30,1,1
30800,55489,53,35095,53,allow,177,94,83,2,30,1,1
30801,27005,32038,39933,32038,allow,868,126,742,2,30,1,1
30802,56263,53,57632,53,allow,214,110,104,2,31,1,1
30803,55884,53,23694,53,allow,438,180,258,6,30,3,3
30804,57307,53,5441,53,allow,177,94,83,2,30,1,1
30805,57057,53,64992,53,allow,194,102,92,2,31,1,1
30806,55820,53,20613,53,allow,168,86,82,2,30,1,1
30807,58766,443,24380,443,allow,6031,770,5261,18,15,8,10
30808,50081,443,5325,443,allow,11958,2983,8975,28,48,15,13
30809,49650,443,26849,443,allow,92597,47158,45439,747,1187,422,325
30810,35341,443,55051,443,allow,1473,988,485,12,26,7,5
30811,35336,443,36436,443,allow,6821,1076,5745,21,27,12,9
30812,64810,53,44808,53,allow,272,93,179,4,33,2,2
30813,60446,6882,37809,6882,allow,70,70,0,1,5,1,0
30814,51275,10924,1826,10924,allow,70,70,0,1,5,1,0
30815,14429,443,41458,443,allow,4118,2905,1213,27,87,16,11
30816,36314,443,44182,443,allow,6287,1476,4811,25,16,13,12
30817,64632,443,35078,443,allow,8391,5178,3213,41,256,20,21
30818,51667,25826,43054,25826,allow,9415,9415,0,11,30,11,0
30819,49986,53,46060,53,allow,779,110,669,2,30,1,1
30820,55808,53,41787,53,allow,183,94,89,2,30,1,1
30821,49935,53,57757,53,allow,775,102,673,2,30,1,1
30822,49949,53,15582,53,allow,193,102,91,2,30,1,1
30823,55441,53,20729,53,allow,216,110,106,2,30,1,1
30824,55337,53,58173,53,allow,198,102,96,2,30,1,1
30825,27005,33086,33799,33086,allow,877,126,751,2,30,1,1
30826,50605,80,49790,80,allow,1657,1247,410,8,15,5,3
30827,60447,36396,58005,36396,allow,70,70,0,1,5,1,0
30828,51796,80,13753,80,allow,2188,1282,906,13,47,8,5
30829,1932,53,37462,53,allow,210,78,132,2,30,1,1
30830,59899,3389,59899,3389,allow,3504,1790,1714,17,32,9,8
30831,49610,53,48262,53,allow,241,94,147,2,30,1,1
30832,50195,53,43781,53,allow,199,102,97,2,30,1,1
30833,64016,53,52366,53,allow,184,94,90,2,30,1,1
30834,64985,53,37843,53,allow,194,102,92,2,30,1,1
30835,49759,53,54239,53,allow,166,86,80,2,30,1,1
30836,65018,53,21026,53,allow,168,94,74,2,31,1,1
30837,55912,53,4881,53,allow,199,102,97,2,31,1,1
30838,57363,53,22472,53,allow,178,94,84,2,30,1,1
30839,43164,443,24293,443,allow,10030,3002,7028,24,16,13,11
30840,34417,443,59906,443,allow,6378,1571,4807,23,315,12,11
30841,14420,443,3846,443,allow,5103,3164,1939,32,168,17,15
30842,43161,443,23414,443,allow,10102,3072,7030,25,16,14,11
30843,51795,80,9427,80,allow,3955,2325,1630,18,47,11,7
30844,51793,80,57988,80,allow,3960,2330,1630,18,47,11,7
30845,51792,80,21440,80,allow,3840,2265,1575,16,47,10,6
30846,50070,443,16090,443,allow,9148,1570,7578,31,257,13,18
30847,50699,443,40507,443,allow,9382,3057,6325,35,1220,17,18
30848,53631,443,46993,443,allow,31965,26754,5211,63,22,34,29
30849,50187,53,34456,53,allow,168,78,90,2,30,1,1
30850,39115,443,62542,443,allow,335190,17497,317693,449,42,211,238
30851,65220,53,55029,53,allow,178,94,84,2,30,1,1
30852,55441,53,33231,53,allow,216,110,106,2,30,1,1
30853,49953,53,46343,53,allow,214,110,104,2,30,1,1
30854,56422,53,18940,53,allow,199,102,97,2,30,1,1
30855,64956,53,29274,53,allow,196,102,94,2,30,1,1
30856,64814,53,26949,53,allow,165,86,79,2,31,1,1
30857,65485,53,26521,53,allow,184,94,90,2,31,1,1
30858,65238,53,15919,53,allow,168,86,82,2,31,1,1
30859,65275,53,14086,53,allow,168,86,82,2,31,1,1
30860,55413,53,59906,53,allow,216,110,106,2,31,1,1
30861,41886,53,64973,53,allow,168,78,90,2,31,1,1
30862,55186,443,62291,443,allow,7375,1549,5826,31,353,10,21
30863,65249,53,43445,53,allow,733,94,639,2,30,1,1
30864,56330,53,49598,53,allow,199,102,97,2,30,1,1
30865,27005,33111,34326,33111,allow,895,126,769,2,30,1,1
30866,50340,53,17641,53,allow,189,102,87,2,31,1,1
30867,64450,53,63147,53,allow,196,94,102,2,31,1,1
30868,55051,53,44193,53,allow,167,86,81,2,31,1,1
30869,49532,53,18389,53,allow,443,182,261,6,31,3,3
30870,56979,53,43376,53,allow,180,94,86,2,31,1,1
30871,57307,53,15696,53,allow,177,94,83,2,30,1,1
30872,56979,53,3476,53,allow,180,94,86,2,30,1,1
30873,27005,32025,26233,32025,allow,887,126,761,2,30,1,1
30874,64964,53,59512,53,allow,197,102,95,2,31,1,1
30875,56470,53,54674,53,allow,198,102,96,2,31,1,1
30876,45211,443,19368,443,allow,1629,968,661,15,275,8,7
30877,57142,53,22612,53,allow,165,86,79,2,31,1,1
30878,56152,53,5986,53,allow,195,102,93,2,31,1,1
30879,49849,53,33985,53,allow,173,94,79,2,31,1,1
30880,56575,443,16584,443,allow,14284,5729,8555,31,61,19,12
30881,50167,53,41841,53,allow,260,86,174,2,30,1,1
30882,56770,53,31600,53,allow,779,86,693,2,30,1,1
30883,55962,53,7744,53,allow,193,102,91,2,30,1,1
30884,27005,27111,65327,27111,allow,913,126,787,2,30,1,1
30885,49626,53,39799,53,allow,969,86,883,2,30,1,1
30886,64592,53,28124,53,allow,197,94,103,2,30,1,1
30887,64154,53,43771,53,allow,194,102,92,2,30,1,1
30888,55238,53,27709,53,allow,168,86,82,2,31,1,1
30889,64956,53,26166,53,allow,196,102,94,2,30,1,1
30890,56101,53,38415,53,allow,194,102,92,2,31,1,1
30891,64814,53,35715,53,allow,173,94,79,2,30,1,1
30892,57228,53,47428,53,allow,199,102,97,2,30,1,1
30893,55399,53,9206,53,allow,180,94,86,2,31,1,1
30894,65039,53,20269,53,allow,258,94,164,2,31,1,1
30895,64976,53,40742,53,allow,193,102,91,2,31,1,1
30896,56892,53,32986,53,allow,199,102,97,2,31,1,1
30897,49918,53,25518,53,allow,198,102,96,2,31,1,1
30898,64547,53,28372,53,allow,367,102,265,2,31,1,1
30899,56063,53,29074,53,allow,196,102,94,2,31,1,1
30900,55580,53,4575,53,allow,195,102,93,2,31,1,1
30901,32299,40034,44134,40034,allow,253,190,63,2,31,1,1
30902,47473,443,41796,443,allow,11072,3983,7089,27,186,15,12
30903,51388,443,47694,443,allow,4209,1570,2639,14,136,7,7
30904,55850,443,57703,443,allow,4344,2189,2155,15,126,7,8
30905,43674,80,54012,80,allow,3714,1646,2068,18,186,9,9
30906,55392,53,27900,53,allow,195,102,93,2,31,1,1
30907,64624,53,46919,53,allow,228,94,134,2,30,1,1
30908,49918,53,41805,53,allow,198,102,96,2,30,1,1
30909,49410,53,54828,53,allow,178,94,84,2,30,1,1
30910,56330,53,48273,53,allow,199,102,97,2,30,1,1
30911,49671,53,2651,53,allow,166,86,80,2,31,1,1
30912,51964,1103,52197,1103,allow,70,70,0,2,8,2,0
30913,58756,443,10542,443,allow,5168,700,4468,16,15,7,9
30914,51451,443,12053,443,allow,6957,1775,5182,22,17,12,10
30915,57891,80,37829,80,allow,6518,1210,5308,15,24,8,7
30916,56553,443,45538,443,allow,116577,6817,109760,137,62,54,83
30917,64985,53,34087,53,allow,194,102,92,2,30,1,1
30918,51235,80,15389,80,allow,3588,2362,1226,24,87,13,11
30919,53118,443,63279,443,allow,21933,11660,10273,206,188,114,92
30920,51963,21638,62624,21638,allow,70,70,0,2,8,2,0
30921,50321,53,23352,53,allow,438,180,258,6,30,3,3
30922,65018,53,37688,53,allow,152,78,74,2,30,1,1
30923,56204,53,16211,53,allow,195,102,93,2,30,1,1
30924,55399,53,43504,53,allow,180,94,86,2,30,1,1
30925,59874,445,0,0,drop,66,66,0,1,0,1,0
30926,59871,445,0,0,drop,66,66,0,1,0,1,0
30927,7347,56205,0,0,deny,66,66,0,1,0,1,0
30928,34731,22114,0,0,deny,146,146,0,1,0,1,0
30929,64460,445,0,0,drop,70,70,0,1,0,1,0
30930,61000,50432,0,0,deny,146,146,0,1,0,1,0
30931,56098,55442,0,0,deny,66,66,0,1,0,1,0
30932,56218,43890,0,0,deny,66,66,0,1,0,1,0
30933,26601,22114,0,0,deny,66,66,0,1,0,1,0
30934,64455,445,0,0,drop,70,70,0,1,0,1,0
30935,64454,445,0,0,drop,70,70,0,1,0,1,0
30936,64452,445,0,0,drop,70,70,0,1,0,1,0
30937,59613,445,0,0,drop,70,70,0,1,0,1,0
30938,59865,445,0,0,drop,66,66,0,1,0,1,0
30939,2572,35440,0,0,deny,66,66,0,1,0,1,0
30940,9445,56205,0,0,deny,66,66,0,1,0,1,0
30941,57260,51221,0,0,deny,66,66,0,1,0,1,0
30942,59862,445,0,0,drop,66,66,0,1,0,1,0
30943,59857,445,0,0,drop,66,66,0,1,0,1,0
30944,59855,445,0,0,drop,66,66,0,1,0,1,0
30945,59861,445,0,0,drop,66,66,0,1,0,1,0
30946,59853,445,0,0,drop,66,66,0,1,0,1,0
30947,59851,445,0,0,drop,66,66,0,1,0,1,0
30948,59850,445,0,0,drop,66,66,0,1,0,1,0
30949,59604,445,0,0,drop,70,70,0,1,0,1,0
30950,59602,445,0,0,drop,70,70,0,1,0,1,0
30951,59601,445,0,0,drop,70,70,0,1,0,1,0
30952,59598,445,0,0,drop,70,70,0,1,0,1,0
30953,56638,64147,0,0,deny,62,62,0,1,0,1,0
30954,3549,64147,0,0,deny,62,62,0,1,0,1,0
30955,64444,445,0,0,drop,70,70,0,1,0,1,0
30956,59597,445,0,0,drop,70,70,0,1,0,1,0
30957,14036,48817,0,0,deny,62,62,0,1,0,1,0
30958,43129,15503,0,0,deny,62,62,0,1,0,1,0
30959,64441,445,0,0,drop,70,70,0,1,0,1,0
30960,64439,445,0,0,drop,70,70,0,1,0,1,0
30961,64437,445,0,0,drop,70,70,0,1,0,1,0
30962,65012,32468,0,0,deny,66,66,0,1,0,1,0
30963,54313,64147,0,0,deny,66,66,0,1,0,1,0
30964,53044,36237,0,0,deny,62,62,0,1,0,1,0
30965,44459,37807,0,0,deny,62,62,0,1,0,1,0
30966,20563,21247,0,0,deny,66,66,0,1,0,1,0
30967,1560,51505,0,0,deny,62,62,0,1,0,1,0
30968,52184,22114,0,0,deny,66,66,0,1,0,1,0
30969,15465,64147,0,0,deny,62,62,0,1,0,1,0
30970,11136,15503,0,0,deny,145,145,0,1,0,1,0
30971,59591,445,0,0,drop,70,70,0,1,0,1,0
30972,46837,57470,0,0,deny,62,62,0,1,0,1,0
30973,1024,44847,0,0,deny,62,62,0,1,0,1,0
30974,11907,57470,0,0,deny,66,66,0,1,0,1,0
30975,62131,50584,0,0,deny,62,62,0,1,0,1,0
30976,8820,41864,0,0,deny,143,143,0,1,0,1,0
30977,64436,445,0,0,drop,70,70,0,1,0,1,0
30978,64432,445,0,0,drop,70,70,0,1,0,1,0
30979,64429,445,0,0,drop,70,70,0,1,0,1,0
30980,59846,445,0,0,drop,66,66,0,1,0,1,0
30981,64428,445,0,0,drop,70,70,0,1,0,1,0
30982,59841,445,0,0,drop,66,66,0,1,0,1,0
30983,65259,37965,0,0,deny,66,66,0,1,0,1,0
30984,59840,445,0,0,drop,66,66,0,1,0,1,0
30985,59838,445,0,0,drop,66,66,0,1,0,1,0
30986,59583,445,0,0,drop,70,70,0,1,0,1,0
30987,59580,445,0,0,drop,70,70,0,1,0,1,0
30988,59837,445,0,0,drop,66,66,0,1,0,1,0
30989,48903,25773,0,0,reset-both,157,157,0,1,0,1,0
30990,59576,445,0,0,drop,70,70,0,1,0,1,0
30991,64420,445,0,0,drop,70,70,0,1,0,1,0
30992,59575,445,0,0,drop,70,70,0,1,0,1,0
30993,54280,3398,0,0,deny,60,60,0,1,0,1,0
30994,64415,445,0,0,drop,70,70,0,1,0,1,0
30995,64410,445,0,0,drop,70,70,0,1,0,1,0
30996,61392,50584,0,0,deny,62,62,0,1,0,1,0
30997,16721,22114,0,0,deny,146,146,0,1,0,1,0
30998,25565,38308,0,0,deny,60,60,0,1,0,1,0
30999,65398,7129,0,0,deny,66,66,0,1,0,1,0
31000,10445,46824,0,0,deny,62,62,0,1,0,1,0
31001,38411,17372,0,0,deny,62,62,0,1,0,1,0
31002,59571,445,0,0,drop,70,70,0,1,0,1,0
31003,59826,445,0,0,drop,66,66,0,1,0,1,0
31004,60557,23117,0,0,deny,66,66,0,1,0,1,0
31005,59569,445,0,0,drop,70,70,0,1,0,1,0
31006,33003,28543,0,0,deny,62,62,0,1,0,1,0
31007,55027,37965,0,0,deny,145,145,0,1,0,1,0
31008,50106,31573,0,0,deny,62,62,0,1,0,1,0
31009,60272,26467,0,0,deny,66,66,0,1,0,1,0
31010,59818,445,0,0,drop,66,66,0,1,0,1,0
31011,64404,445,0,0,drop,70,70,0,1,0,1,0
31012,7364,50584,0,0,deny,66,66,0,1,0,1,0
31013,59565,445,0,0,drop,70,70,0,1,0,1,0
31014,26131,56205,0,0,deny,62,62,0,1,0,1,0
31015,59815,445,0,0,drop,66,66,0,1,0,1,0
31016,59413,51505,0,0,deny,66,66,0,1,0,1,0
31017,16905,57866,0,0,deny,66,66,0,1,0,1,0
31018,59809,445,0,0,drop,66,66,0,1,0,1,0
31019,10736,35440,0,0,deny,66,66,0,1,0,1,0
31020,59803,445,0,0,drop,66,66,0,1,0,1,0
31021,54324,7000,54324,7000,allow,4007,1690,2317,15,0,8,7
31022,443,61686,0,0,deny,78,78,0,1,0,1,0
31023,443,61686,0,0,deny,642,642,0,1,0,1,0
31024,443,61686,0,0,deny,90,90,0,1,0,1,0
31025,443,61686,0,0,deny,1484,1484,0,1,0,1,0
31026,65422,26467,0,0,deny,62,62,0,1,0,1,0
31027,10834,50584,0,0,deny,66,66,0,1,0,1,0
31028,59552,445,0,0,drop,70,70,0,1,0,1,0
31029,49636,44847,0,0,deny,62,62,0,1,0,1,0
31030,3597,11392,0,0,deny,66,66,0,1,0,1,0
31031,64390,445,0,0,drop,70,70,0,1,0,1,0
31032,64388,445,0,0,drop,70,70,0,1,0,1,0
31033,64389,445,0,0,drop,70,70,0,1,0,1,0
31034,0,0,0,0,allow,480,244,236,4,0,2,2
31035,59549,445,0,0,drop,70,70,0,1,0,1,0
31036,59791,445,0,0,drop,66,66,0,1,0,1,0
31037,59785,445,0,0,drop,66,66,0,1,0,1,0
31038,59789,445,0,0,drop,66,66,0,1,0,1,0
31039,59790,445,0,0,drop,66,66,0,1,0,1,0
31040,59787,445,0,0,drop,66,66,0,1,0,1,0
31041,59792,445,0,0,drop,66,66,0,1,0,1,0
31042,59788,445,0,0,drop,66,66,0,1,0,1,0
31043,59786,445,0,0,drop,66,66,0,1,0,1,0
31044,54389,28543,0,0,deny,66,66,0,1,0,1,0
31045,58686,18375,0,0,deny,66,66,0,1,0,1,0
31046,65344,46824,0,0,deny,66,66,0,1,0,1,0
31047,31727,57470,0,0,deny,62,62,0,1,0,1,0
31048,38253,23117,0,0,deny,146,146,0,1,0,1,0
31049,59544,445,0,0,drop,70,70,0,1,0,1,0
31050,59543,445,0,0,drop,70,70,0,1,0,1,0
31051,7310,44847,0,0,deny,66,66,0,1,0,1,0
31052,35154,42707,0,0,deny,62,62,0,1,0,1,0
31053,57170,38303,0,0,deny,66,66,0,1,0,1,0
31054,59541,445,0,0,drop,70,70,0,1,0,1,0
31055,32648,55108,0,0,deny,145,145,0,1,0,1,0
31056,64381,445,0,0,drop,70,70,0,1,0,1,0
31057,64379,445,0,0,drop,70,70,0,1,0,1,0
31058,64378,445,0,0,drop,70,70,0,1,0,1,0
31059,64375,445,0,0,drop,70,70,0,1,0,1,0
31060,56308,22114,0,0,deny,146,146,0,1,0,1,0
31061,58745,30188,0,0,deny,66,66,0,1,0,1,0
31062,64237,51505,0,0,deny,62,62,0,1,0,1,0
31063,51934,36180,0,0,deny,66,66,0,1,0,1,0
31064,59770,445,0,0,drop,66,66,0,1,0,1,0
31065,59773,445,0,0,drop,66,66,0,1,0,1,0
31066,59771,445,0,0,drop,66,66,0,1,0,1,0
31067,65012,2767,0,0,deny,62,62,0,1,0,1,0
31068,1404,51180,0,0,deny,145,145,0,1,0,1,0
31069,33524,10387,0,0,deny,159,159,0,1,0,1,0
31070,60771,58414,0,0,deny,66,66,0,1,0,1,0
31071,64368,445,0,0,drop,70,70,0,1,0,1,0
31072,13554,44847,0,0,deny,62,62,0,1,0,1,0
31073,59534,445,0,0,drop,70,70,0,1,0,1,0
31074,64361,445,0,0,drop,70,70,0,1,0,1,0
31075,64358,445,0,0,drop,70,70,0,1,0,1,0
31076,64357,445,0,0,drop,70,70,0,1,0,1,0
31077,59532,445,0,0,drop,70,70,0,1,0,1,0
31078,39098,51505,0,0,deny,62,62,0,1,0,1,0
31079,13413,44847,0,0,deny,66,66,0,1,0,1,0
31080,2323,23117,0,0,deny,146,146,0,1,0,1,0
31081,64091,53,52948,53,allow,172,88,84,2,30,1,1
31082,55006,53,7313,53,allow,711,87,624,2,30,1,1
31083,52787,443,54390,443,allow,1550,834,716,19,141,10,9
31084,56330,53,38670,53,allow,760,97,663,2,30,1,1
31085,33898,80,33898,80,allow,14448,2001,12447,26,16,14,12
31086,37619,443,7866,443,allow,6169,4980,1189,28,16,15,13
31087,62387,80,62387,80,allow,548903,4452,544451,440,20,58,382
31088,49566,80,39778,80,allow,10134,1142,8992,24,46,12,12
31089,52729,80,27175,80,allow,2255,997,1258,16,152,8,8
31090,50562,80,50562,80,allow,1696,996,700,11,22,6,5
31091,42999,3389,42999,3389,allow,3910,1805,2105,20,19,12,8
31092,35543,443,52290,443,allow,7298,2601,4697,21,26,10,11
31093,61315,53,20800,53,allow,8616,4944,3672,22,87,11,11
31094,50578,443,12552,443,allow,13595,7140,6455,39,116,24,15
31095,64964,53,20852,53,allow,194,99,95,2,31,1,1
31096,55857,53,27164,53,allow,192,98,94,2,30,1,1
31097,56940,443,15296,443,allow,4184,2787,1397,19,345,10,9
31098,37617,443,6093,443,allow,1654,931,723,20,16,11,9
31099,58034,80,58034,80,allow,21684,903,20781,30,41,12,18
31100,27005,27023,20750,27023,allow,875,126,749,3,32,2,1
31101,42550,5222,16634,5222,allow,2060,981,1079,21,15,11,10
31102,53145,44634,28253,44634,allow,70,70,0,2,8,2,0
31103,51975,443,63500,443,allow,35746,4732,31014,68,67,33,35
31104,65363,53,16393,53,allow,747,93,654,2,30,1,1
31105,60092,443,60092,443,allow,4700,1793,2907,19,28,11,8
31106,58727,443,14813,443,allow,26922,13251,13671,50,18,26,24
31107,46987,443,48389,443,allow,3847,2650,1197,22,32,13,9
31108,52786,443,4838,443,allow,9032,2673,6359,30,142,16,14
31109,43921,443,8788,443,allow,8324,1658,6666,24,83,14,10
31110,37618,443,28939,443,allow,28034,26485,1549,48,16,29,19
31111,57985,80,36501,80,allow,3703,2068,1635,17,33,10,7
31112,64986,53,36194,53,allow,182,93,89,2,31,1,1
31113,58696,443,11326,443,allow,6889,4719,2170,25,330,14,11
31114,58750,443,9806,443,allow,3776,2372,1404,17,15,9,8
31115,55229,443,47978,443,allow,3602,1519,2083,18,60,10,8
31116,58297,443,46075,443,allow,7338,2419,4919,19,17,12,7
31117,46014,443,8499,443,allow,13661,2246,11415,28,256,14,14
31118,58853,443,20470,443,allow,155516,6298,149218,174,107,49,125
31119,50444,443,31610,443,allow,47752,21819,25933,119,704,59,60
31120,55256,443,41393,443,allow,3524,2973,551,15,16,9,6
31121,49208,53,22620,53,allow,578,286,292,9,15,5,4
31122,53742,63344,47218,63344,allow,1294,797,497,13,15,7,6
31123,54489,80,6564,80,allow,2828,1710,1118,10,255,6,4
31124,51937,38056,49622,38056,allow,66,66,0,1,5,1,0
31125,51965,48708,39312,48708,allow,70,70,0,2,8,2,0
31126,62039,443,46235,443,allow,356,60,296,6,18,2,4
31127,52788,443,21903,443,allow,1550,834,716,19,141,10,9
31128,64956,53,25279,53,allow,192,98,94,2,30,1,1
31129,49272,53,25138,53,allow,168,86,82,3,44,2,1
31130,57993,80,1572,80,allow,3822,2132,1690,19,32,11,8
31131,56775,53,1038,53,allow,733,85,648,2,30,1,1
31132,55271,53,11910,53,allow,754,94,660,2,30,1,1
31133,56979,53,36485,53,allow,176,90,86,2,31,1,1
31134,57371,53,32883,53,allow,212,108,104,2,31,1,1
31135,55392,53,38891,53,allow,190,97,93,2,31,1,1
31136,56611,53,54936,53,allow,170,87,83,2,31,1,1
31137,49209,53,10202,53,allow,198,101,97,2,31,1,1
31138,49769,53,37724,53,allow,780,93,687,2,31,1,1
31139,57228,53,5585,53,allow,198,101,97,2,30,1,1
31140,64029,53,31401,53,allow,176,90,86,2,30,1,1
31141,57115,53,15026,53,allow,756,95,661,2,30,1,1
31142,56620,53,43601,53,allow,762,98,664,2,30,1,1
31143,27005,27027,61298,27027,allow,880,126,754,2,31,1,1
31144,49931,53,19319,53,allow,190,97,93,2,31,1,1
31145,32940,443,60631,443,allow,13056,4233,8823,27,121,12,15
31146,49663,53,12596,53,allow,190,97,93,2,31,1,1
31147,50509,53,14571,53,allow,789,110,679,2,31,1,1
31148,65024,53,56492,53,allow,174,89,85,2,31,1,1
31149,56085,53,59161,53,allow,166,85,81,2,31,1,1
31150,55867,53,4524,53,allow,184,94,90,2,31,1,1
31151,8878,80,27996,80,allow,1220,403,817,15,414,4,11
31152,41953,443,3719,443,allow,4129,2865,1264,17,361,9,8
31153,56063,53,65199,53,allow,192,98,94,2,31,1,1
31154,27005,27019,23362,27019,allow,873,126,747,2,31,1,1
31155,55000,53,30925,53,allow,753,93,660,2,31,1,1
31156,64321,53,31319,53,allow,190,97,93,2,31,1,1
31157,57071,53,61611,53,allow,164,84,80,2,31,1,1
31158,50407,53,51161,53,allow,749,89,660,2,31,1,1
31159,33545,443,31253,443,allow,9737,3353,6384,27,32,13,14
31160,59596,3389,59596,3389,allow,3523,1714,1809,17,34,8,9
31161,49372,53,17589,53,allow,216,110,106,2,31,1,1
31162,56626,53,22670,53,allow,710,89,621,2,31,1,1
31163,57177,53,5547,53,allow,174,89,85,2,31,1,1
31164,55728,53,39278,53,allow,190,97,93,2,31,1,1
31165,49783,53,20382,53,allow,174,89,85,2,31,1,1
31166,56009,53,7541,53,allow,172,88,84,2,31,1,1
31167,56927,53,57010,53,allow,749,94,655,2,31,1,1
31168,54663,443,5282,443,allow,18311,11567,6744,43,363,21,22
31169,23553,37965,0,0,deny,62,62,0,1,0,1,0
31170,59531,445,0,0,drop,70,70,0,1,0,1,0
31171,59530,445,0,0,drop,70,70,0,1,0,1,0
31172,1025,50584,0,0,deny,62,62,0,1,0,1,0
31173,59529,445,0,0,drop,70,70,0,1,0,1,0
31174,1026,64147,0,0,deny,62,62,0,1,0,1,0
31175,59526,445,0,0,drop,70,70,0,1,0,1,0
31176,59523,445,0,0,drop,70,70,0,1,0,1,0
31177,9518,30228,0,0,deny,100,100,0,1,0,1,0
31178,9518,57587,0,0,deny,100,100,0,1,0,1,0
31179,9518,3855,0,0,deny,100,100,0,1,0,1,0
31180,6712,44818,0,0,deny,66,66,0,1,0,1,0
31181,55153,53,36786,53,allow,733,94,639,2,30,1,1
31182,64351,445,0,0,drop,70,70,0,1,0,1,0
31183,64349,445,0,0,drop,70,70,0,1,0,1,0
31184,64346,445,0,0,drop,70,70,0,1,0,1,0
31185,37647,29892,0,0,deny,145,145,0,1,0,1,0
31186,26835,47993,0,0,deny,62,62,0,1,0,1,0
31187,59511,445,0,0,drop,70,70,0,1,0,1,0
31188,59510,445,0,0,drop,70,70,0,1,0,1,0
31189,59507,445,0,0,drop,70,70,0,1,0,1,0
31190,61419,57470,0,0,deny,66,66,0,1,0,1,0
31191,59501,445,0,0,drop,70,70,0,1,0,1,0
31192,59500,445,0,0,drop,70,70,0,1,0,1,0
31193,59761,445,0,0,drop,66,66,0,1,0,1,0
31194,27160,64147,0,0,deny,62,62,0,1,0,1,0
31195,59876,44847,0,0,deny,66,66,0,1,0,1,0
31196,64104,22114,0,0,deny,66,66,0,1,0,1,0
31197,63963,50584,0,0,deny,66,66,0,1,0,1,0
31198,22784,9571,0,0,deny,62,62,0,1,0,1,0
31199,44491,50584,0,0,deny,62,62,0,1,0,1,0
31200,56869,17637,0,0,deny,66,66,0,1,0,1,0
31201,64342,445,0,0,drop,70,70,0,1,0,1,0
31202,64338,445,0,0,drop,70,70,0,1,0,1,0
31203,3181,53567,0,0,deny,66,66,0,1,0,1,0
31204,59489,445,0,0,drop,70,70,0,1,0,1,0
31205,43323,1,0,0,deny,62,62,0,1,0,1,0
31206,50577,53,36248,53,allow,196,102,94,2,30,1,1
31207,49498,53,4790,53,allow,245,102,143,2,30,1,1
31208,49467,53,63815,53,allow,811,94,717,2,30,1,1
31209,55051,53,56758,53,allow,167,86,81,2,30,1,1
31210,37555,16386,35583,16386,allow,432,192,240,8,30,4,4
31211,11295,40032,25935,40032,allow,148,86,62,2,30,1,1
31212,11295,40018,13039,40018,allow,156,94,62,2,30,1,1
31213,52765,443,7289,443,allow,10359,1566,8793,27,150,13,14
31214,65485,53,26681,53,allow,184,94,90,2,29,1,1
31215,64793,53,25945,53,allow,168,86,82,2,29,1,1
31216,55868,53,29665,53,allow,198,110,88,2,29,1,1
31217,64991,53,31407,53,allow,196,94,102,2,29,1,1
31218,50576,53,22318,53,allow,765,102,663,2,29,1,1
31219,55868,53,11909,53,allow,198,110,88,2,29,1,1
31220,65275,53,52488,53,allow,184,102,82,2,29,1,1
31221,49191,51253,24345,51253,allow,504,318,186,8,15,5,3
31222,48346,443,9051,443,allow,2272788,106549,2166239,2492,190,850,1642
31223,55776,53,11984,53,allow,271,93,178,4,32,2,2
31224,50994,443,11381,443,allow,6349,1072,5277,18,21,10,8
31225,41876,443,3381,443,allow,55975,2553,53422,72,105,29,43
31226,32877,443,56293,443,allow,5701,1585,4116,23,1102,13,10
31227,51452,443,19936,443,allow,6936,1761,5175,17,16,11,6
31228,5240,36828,56682,36828,allow,166456,128,166328,270,35,3,267
31229,65220,53,8622,53,allow,178,94,84,2,29,1,1
31230,64602,53,17194,53,allow,751,94,657,2,29,1,1
31231,55809,443,31063,443,allow,62,62,0,1,4,1,0
31232,56349,53,33887,53,allow,168,86,82,2,29,1,1
31233,50340,53,41286,53,allow,181,94,87,2,29,1,1
31234,56349,53,14775,53,allow,184,102,82,2,29,1,1
31235,50561,80,50561,80,allow,1695,995,700,11,21,6,5
31236,49410,53,7557,53,allow,178,94,84,2,30,1,1
31237,64898,53,53869,53,allow,167,86,81,2,29,1,1
31238,55413,53,38303,53,allow,216,110,106,2,29,1,1
31239,65515,53,42704,53,allow,210,110,100,2,29,1,1
31240,64029,53,34743,53,allow,180,94,86,2,30,1,1
31241,55392,53,8146,53,allow,195,102,93,2,30,1,1
31242,55244,53,26585,53,allow,184,102,82,2,30,1,1
31243,50241,53,50241,53,allow,260,106,154,2,32,1,1
31244,45275,443,27366,443,allow,130,70,60,3,5,2,1
31245,51935,38639,36468,38639,allow,70,70,0,1,5,1,0
31246,51535,443,45578,443,allow,202,70,132,3,11,1,2
31247,63136,443,35141,443,allow,6781,1289,5492,17,15,9,8
31248,57709,443,55185,443,allow,10392,2789,7603,25,16,13,12
31249,57363,53,32810,53,allow,178,94,84,2,30,1,1
31250,37555,16385,63752,16385,allow,556,256,300,10,30,5,5
31251,64776,53,62229,53,allow,198,94,104,2,30,1,1
31252,49534,53,49440,53,allow,168,86,82,2,30,1,1
31253,55176,53,23799,53,allow,181,94,87,2,30,1,1
31254,10151,22208,55626,22208,allow,323,150,173,2,1203,1,1
31255,27005,27091,18957,27091,allow,883,126,757,2,31,1,1
31256,64091,53,16270,53,allow,178,94,84,2,30,1,1
31257,57402,9992,42519,9992,allow,47040,13931,33109,428,129,207,221
31258,49209,53,59782,53,allow,199,102,97,2,30,1,1
31259,58058,443,59293,443,allow,560,280,280,9,28,5,4
31260,56695,443,5124,443,allow,8006,1986,6020,20,15,11,9
31261,57071,53,59373,53,allow,166,86,80,2,30,1,1
31262,55045,443,7851,443,allow,4660,3048,1612,31,81,15,16
31263,65361,53,5566,53,allow,764,102,662,2,30,1,1
31264,52168,443,14996,443,allow,73105,13398,59707,220,374,108,112
31265,50495,53,24606,53,allow,182,102,80,2,30,1,1
31266,58752,443,52846,443,allow,5167,700,4467,16,15,7,9
31267,64989,53,13455,53,allow,167,86,81,2,30,1,1
31268,38122,443,65050,443,allow,191454,11241,180213,262,42,128,134
31269,57057,53,25166,53,allow,194,102,92,2,30,1,1
31270,50932,443,17054,443,allow,167483,7402,160081,221,23,93,128
31271,49410,53,12703,53,allow,178,94,84,2,30,1,1
31272,37558,16386,20045,16386,allow,432,192,240,8,30,4,4
31273,44849,443,64447,443,allow,13791,7866,5925,35,46,20,15
31274,56330,53,26400,53,allow,199,102,97,2,30,1,1
31275,64091,53,24113,53,allow,178,94,84,2,30,1,1
31276,64419,53,6330,53,allow,210,102,108,2,30,1,1
31277,37558,16385,3655,16385,allow,432,192,240,8,30,4,4
31278,64628,53,28992,53,allow,199,102,97,2,30,1,1
31279,57142,53,15103,53,allow,165,86,79,2,30,1,1
31280,37556,16386,44427,16386,allow,432,192,240,8,30,4,4
31281,55857,53,49437,53,allow,196,102,94,2,30,1,1
31282,57307,53,14179,53,allow,177,94,83,2,30,1,1
31283,56526,53,41730,53,allow,168,94,74,2,30,1,1
31284,64989,53,9165,53,allow,183,102,81,2,30,1,1
31285,64602,53,26542,53,allow,185,102,83,2,30,1,1
31286,56204,53,48094,53,allow,195,102,93,2,30,1,1
31287,57371,53,64674,53,allow,214,110,104,2,30,1,1
31288,52758,80,33293,80,allow,1746,980,766,15,151,8,7
31289,49510,53,7986,53,allow,754,94,660,2,30,1,1
31290,37556,16384,16862,16384,allow,556,256,300,10,30,5,5
31291,49849,53,18692,53,allow,173,94,79,2,30,1,1
31292,64562,53,22327,53,allow,371,94,277,2,30,1,1
31293,54748,53,4076,53,allow,245,110,135,2,30,1,1
31294,56063,53,52462,53,allow,196,102,94,2,30,1,1
31295,50009,80,24998,80,allow,186,64,122,4,29,2,2
31296,36688,443,22490,443,allow,86101,7312,78789,145,128,63,82
31297,57994,443,19602,443,allow,14465,1797,12668,30,170,14,16
31298,56263,53,42126,53,allow,214,110,104,2,30,1,1
31299,55342,53,5897,53,allow,323,110,213,2,30,1,1
31300,49605,53,37521,53,allow,239,110,129,2,30,1,1
31301,55067,53,28702,53,allow,166,86,80,2,30,1,1
31302,37558,16384,22272,16384,allow,556,256,300,10,30,5,5
31303,37555,16384,64075,16384,allow,432,192,240,8,30,4,4
31304,50495,53,55393,53,allow,166,86,80,2,30,1,1
31305,64029,53,26038,53,allow,180,94,86,2,30,1,1
31306,56696,443,57667,443,allow,8059,2039,6020,20,15,11,9
31307,59784,443,16677,443,allow,6698,1606,5092,23,19,13,10
31308,49155,443,35211,443,allow,8941,1776,7165,22,136,12,10
31309,50931,443,19777,443,allow,4178,2310,1868,39,30,23,16
31310,48343,443,59139,443,allow,1985333,91427,1893906,2159,190,721,1438
31311,58391,443,1299,443,allow,347192,61325,285867,643,191,297,346
31312,58396,443,53120,443,allow,138065,109491,28574,429,186,230,199
31313,48345,443,50795,443,allow,940826,59470,881356,1101,190,412,689
31314,62037,80,19447,80,allow,1670,422,1248,13,17,5,8
31315,37075,80,59950,80,allow,1597,783,814,10,15,5,5
31316,55019,443,34089,443,allow,12411,7888,4523,33,17,19,14
31317,48952,443,47489,443,allow,15944,6988,8956,135,324,72,63
31318,49737,443,51096,443,allow,334252,14917,319335,405,73,179,226
31319,64810,53,55417,53,allow,272,93,179,4,33,2,2
31320,49788,53,26549,53,allow,302,97,205,4,43,2,2
31321,48344,443,64214,443,allow,2588313,95154,2493159,2645,190,811,1834
31322,64810,53,65205,53,allow,272,93,179,4,32,2,2
31323,52587,443,5455,443,allow,6170,918,5252,18,15,10,8
31324,58753,443,55994,443,allow,5167,700,4467,16,14,7,9
31325,49953,53,27349,53,allow,214,110,104,2,29,1,1
31326,56697,443,20511,443,allow,8007,1987,6020,20,15,11,9
31327,56894,53,54448,53,allow,178,94,84,2,29,1,1
31328,51961,40373,19759,40373,allow,70,70,0,2,8,2,0
31329,56152,53,35520,53,allow,195,102,93,2,29,1,1
31330,62038,80,20471,80,allow,668,224,444,10,18,4,6
31331,64162,53,51950,53,allow,255,118,137,2,29,1,1
31332,51933,80,57196,80,allow,717,651,66,7,15,6,1
31333,56710,53,63295,53,allow,193,94,99,2,29,1,1
31334,53629,443,28491,443,allow,123122,115571,7551,161,23,93,68
31335,57363,53,20262,53,allow,178,94,84,2,29,1,1
31336,64898,53,30399,53,allow,167,86,81,2,29,1,1
31337,64296,53,31060,53,allow,215,94,121,2,29,1,1
31338,51924,80,58410,80,allow,32222,3146,29076,43,31,18,25
31339,10002,80,8568,80,allow,3759,741,3018,15,45,8,7
31340,58748,443,31963,443,allow,5167,700,4467,16,15,7,9
31341,52757,80,11666,80,allow,2426,1594,832,17,151,9,8
31342,56694,443,1542,443,allow,8058,2038,6020,20,15,11,9
31343,56263,53,62395,53,allow,214,110,104,2,29,1,1
31344,49949,53,12218,53,allow,193,102,91,2,29,1,1
31345,64480,53,30625,53,allow,276,126,150,2,30,1,1
31346,55848,53,34320,53,allow,168,86,82,2,30,1,1
31347,55848,53,45545,53,allow,184,102,82,2,30,1,1
31348,57313,53,1093,53,allow,811,94,717,2,30,1,1
31349,27005,32039,29138,32039,allow,883,126,757,2,31,1,1
31350,65176,53,36351,53,allow,193,102,91,2,31,1,1
31351,49209,53,48140,53,allow,199,102,97,2,31,1,1
31352,55495,53,27718,53,allow,210,110,100,2,31,1,1
31353,64628,53,1942,53,allow,199,102,97,2,30,1,1
31354,55166,53,22324,53,allow,177,94,83,2,30,1,1
31355,64321,53,62198,53,allow,195,102,93,2,30,1,1
31356,64091,53,62313,53,allow,178,94,84,2,30,1,1
31357,46123,443,37747,443,allow,5161,3826,1335,16,137,9,7
31358,49931,53,55078,53,allow,195,102,93,2,30,1,1
31359,65013,53,26292,53,allow,473,105,368,4,30,2,2
31360,49567,53,30320,53,allow,195,94,101,2,30,1,1
31361,55867,53,6696,53,allow,184,94,90,2,30,1,1
31362,64822,53,9057,53,allow,200,94,106,2,30,1,1
31363,49622,53,6128,53,allow,209,102,107,2,30,1,1
31364,55413,53,32368,53,allow,216,110,106,2,31,1,1
31365,55828,53,29834,53,allow,181,94,87,2,31,1,1
31366,49837,443,55049,443,allow,4685,2421,2264,10,119,5,5
31367,30188,58770,26804,58770,allow,14172,5733,8439,79,1531,37,42
31368,37845,443,37845,443,allow,4441,1534,2907,19,25,11,8
31369,52991,53,52991,53,allow,235,90,145,2,32,1,1
31370,55857,53,19177,53,allow,437,98,339,4,41,2,2
31371,10010,80,10501,80,allow,2166,600,1566,10,45,6,4
31372,52695,443,43213,443,allow,34402,2328,32074,55,153,23,32
31373,59422,53,43330,53,allow,168,78,90,2,30,1,1
31374,49534,53,53329,53,allow,168,86,82,2,30,1,1
31375,65437,53,6994,53,allow,173,94,79,2,30,1,1
31376,55176,53,15853,53,allow,181,94,87,2,30,1,1
31377,55771,53,22517,53,allow,819,102,717,2,30,1,1
31378,65437,53,4286,53,allow,165,86,79,2,30,1,1
31379,64602,53,18957,53,allow,185,102,83,2,30,1,1
31380,60578,443,8619,443,allow,27150,3104,24046,55,157,24,31
31381,51936,17650,3656,17650,allow,70,70,0,1,5,1,0
31382,56526,53,17737,53,allow,168,94,74,2,30,1,1
31383,37556,16385,7205,16385,allow,432,192,240,8,30,4,4
31384,65152,53,2972,53,allow,763,102,661,2,30,1,1
31385,64986,53,9099,53,allow,183,94,89,2,30,1,1
31386,56470,53,63709,53,allow,198,102,96,2,30,1,1
31387,56938,8000,45584,8000,allow,110,110,0,1,30,1,0
31388,56085,53,41627,53,allow,167,86,81,2,30,1,1
31389,58123,80,21790,80,allow,3641,1784,1857,19,375,10,9
31390,50272,53,61330,53,allow,210,110,100,2,30,1,1
31391,36710,443,45580,443,allow,6786,1795,4991,18,16,11,7
31392,51960,58601,12629,58601,allow,70,70,0,2,8,2,0
31393,49181,53,15171,53,allow,491,98,393,4,40,2,2
31394,52769,443,2032,443,allow,8083,1790,6293,27,150,14,13
31395,52764,443,33185,443,allow,14001,2908,11093,35,150,18,17
31396,64421,53,53236,53,allow,398,88,310,4,54,2,2
31397,50577,53,42323,53,allow,819,102,717,2,30,1,1
31398,65253,53,8346,53,allow,766,102,664,2,30,1,1
31399,55771,53,25077,53,allow,196,102,94,2,30,1,1
31400,65515,53,3298,53,allow,210,110,100,2,30,1,1
31401,49379,53,52143,53,allow,260,102,158,2,30,1,1
31402,55166,53,19784,53,allow,177,94,83,2,30,1,1
31403,56594,53,5143,53,allow,173,94,79,2,30,1,1
31404,55857,53,31762,53,allow,196,102,94,2,30,1,1
31405,56185,53,13789,53,allow,167,86,81,2,30,1,1
31406,57371,53,5536,53,allow,214,110,104,2,30,1,1
31407,55742,53,18944,53,allow,193,102,91,2,30,1,1
31408,55244,53,24318,53,allow,184,102,82,2,30,1,1
31409,64029,53,40003,53,allow,180,94,86,2,30,1,1
31410,57228,53,13792,53,allow,199,102,97,2,30,1,1
31411,49663,53,65385,53,allow,195,102,93,2,30,1,1
31412,57177,53,13049,53,allow,179,94,85,2,30,1,1
31413,44385,53,19261,53,allow,212,78,134,2,30,1,1
31414,64781,53,27529,53,allow,209,102,107,2,30,1,1
31415,64169,53,50395,53,allow,209,102,107,2,30,1,1
31416,27005,27999,8243,27999,allow,913,126,787,2,31,1,1
31417,57177,53,17706,53,allow,179,94,85,2,31,1,1
31418,64244,53,63345,53,allow,199,102,97,2,31,1,1
31419,64986,53,17110,53,allow,183,94,89,2,31,1,1
31420,55728,53,24572,53,allow,195,102,93,2,31,1,1
31421,49378,53,42308,53,allow,306,94,212,2,30,1,1
31422,64586,53,9543,53,allow,183,94,89,2,30,1,1
31423,57445,53,50878,53,allow,342,142,200,2,30,1,1
31424,64598,53,46493,53,allow,342,142,200,2,30,1,1
31425,65052,53,39393,53,allow,200,94,106,2,30,1,1
31426,56142,53,42662,53,allow,194,102,92,2,31,1,1
31427,57147,53,3974,53,allow,166,86,80,2,31,1,1
31428,64174,53,10238,53,allow,180,94,86,2,31,1,1
31429,27005,32073,35249,32073,allow,884,126,758,2,31,1,1
31430,64965,53,42321,53,allow,200,94,106,2,31,1,1
31431,64964,53,28757,53,allow,197,102,95,2,31,1,1
31432,56643,53,21130,53,allow,195,102,93,2,31,1,1
31433,55641,53,24406,53,allow,184,94,90,2,31,1,1
31434,57127,53,61936,53,allow,193,102,91,2,31,1,1
31435,64627,53,3343,53,allow,199,102,97,2,31,1,1
31436,55392,53,19876,53,allow,195,102,93,2,31,1,1
31437,27005,32065,5075,32065,allow,877,126,751,2,31,1,1
31438,57126,53,6801,53,allow,183,94,89,2,31,1,1
31439,56381,53,14303,53,allow,196,102,94,2,31,1,1
31440,52992,443,3497,443,allow,97763,8230,89533,131,150,49,82
31441,37965,28596,25273,28596,allow,479,150,329,2,1199,1,1
31442,41790,443,64093,443,allow,2350,1392,958,17,275,9,8
31443,50000,53,12799,53,allow,216,110,106,2,31,1,1
31444,64989,53,29167,53,allow,214,94,120,2,31,1,1
31445,64607,53,58592,53,allow,211,110,101,2,31,1,1
31446,37957,443,45183,443,allow,7280,2250,5030,15,120,7,8
31447,33995,443,61498,443,allow,6419,995,5424,21,361,11,10
31448,60461,443,30128,443,allow,18515,2899,15616,32,148,15,17
31449,49214,53,64649,53,allow,227,102,125,2,30,1,1
31450,56005,53,41493,53,allow,403,142,261,2,30,1,1
31451,64922,53,2264,53,allow,209,102,107,2,30,1,1
31452,64803,53,18696,53,allow,403,142,261,2,31,1,1
31453,56085,53,39673,53,allow,167,86,81,2,31,1,1
31454,27005,27057,9296,27057,allow,917,126,791,2,31,1,1
31455,55596,53,25789,53,allow,194,102,92,2,31,1,1
31456,56063,53,23721,53,allow,196,102,94,2,31,1,1
31457,55867,53,63583,53,allow,184,94,90,2,31,1,1
31458,49209,53,27106,53,allow,199,102,97,2,31,1,1
31459,49346,53,44128,53,allow,164,78,86,2,31,1,1
31460,56145,53,42798,53,allow,458,188,270,6,31,3,3
31461,49420,53,64966,53,allow,183,94,89,2,31,1,1
31462,8886,80,28945,80,allow,1748,716,1032,19,395,6,13
31463,43549,443,50179,443,allow,10316,2303,8013,39,120,20,19
31464,64911,53,26816,53,allow,209,110,99,2,31,1,1
31465,36266,443,8453,443,allow,6043,1568,4475,11,119,4,7
31466,54664,443,18558,443,allow,8263,1279,6984,15,136,7,8
31467,45549,443,52830,443,allow,7951,1449,6502,22,125,12,10
31468,57470,54058,20688,54058,allow,150,150,0,1,1199,1,0
31469,57278,443,35481,443,allow,8960,2949,6011,21,122,10,11
31470,56411,53,33416,53,allow,184,94,90,2,31,1,1
31471,63917,57826,39527,57826,allow,70,70,0,1,5,1,0
31472,53745,18569,18242,18569,allow,70,70,0,1,5,1,0
31473,48634,443,39947,443,allow,448,78,370,6,25,1,5
31474,58747,443,20889,443,allow,5167,700,4467,16,15,7,9
31475,44911,80,13176,80,allow,1052,612,440,10,15,5,5
31476,35176,80,37365,80,allow,1987,1329,658,10,136,6,4
31477,50543,443,11342,443,allow,11275,4454,6821,24,36,13,11
31478,63651,443,19234,443,allow,333668,12291,321377,321,170,72,249
31479,49968,53,62146,53,allow,1412,94,1318,4,33,2,2
31480,51959,42269,57888,42269,allow,70,70,0,2,8,2,0
31481,51921,80,46796,80,allow,35092,3319,31773,48,31,21,27
31482,64987,53,36862,53,allow,410,100,310,4,55,2,2
31483,55126,53,10895,53,allow,193,102,91,2,31,1,1
31484,56381,443,16712,443,allow,7236,2290,4946,18,16,11,7
31485,5232,46495,40739,46495,allow,832,832,0,14,96,14,0
31486,38450,443,8906,443,allow,593,473,120,4,15,2,2
31487,56693,443,47203,443,allow,7862,1873,5989,20,16,11,9
31488,51148,9571,0,0,deny,66,66,0,1,0,1,0
31489,39681,37965,0,0,deny,66,66,0,1,0,1,0
31490,59744,445,0,0,drop,66,66,0,1,0,1,0
31491,59743,445,0,0,drop,66,66,0,1,0,1,0
31492,29577,64147,0,0,deny,62,62,0,1,0,1,0
31493,16387,25619,0,0,deny,60,60,0,1,0,1,0
31494,16387,64660,0,0,deny,60,60,0,1,0,1,0
31495,16387,24782,0,0,deny,60,60,0,1,0,1,0
31496,53500,1,0,0,deny,66,66,0,1,0,1,0
31497,18088,23,0,0,deny,60,60,0,1,0,1,0
31498,63672,22114,0,0,deny,66,66,0,1,0,1,0
31499,52938,64097,0,0,deny,66,66,0,1,0,1,0
31500,64332,445,0,0,drop,70,70,0,1,0,1,0
31501,59485,445,0,0,drop,70,70,0,1,0,1,0
31502,64325,445,0,0,drop,70,70,0,1,0,1,0
31503,64324,445,0,0,drop,70,70,0,1,0,1,0
31504,64323,445,0,0,drop,70,70,0,1,0,1,0
31505,59738,445,0,0,drop,66,66,0,1,0,1,0
31506,45964,5333,0,0,deny,60,60,0,1,0,1,0
31507,52418,46314,0,0,deny,66,66,0,1,0,1,0
31508,59476,445,0,0,drop,70,70,0,1,0,1,0
31509,59474,445,0,0,drop,70,70,0,1,0,1,0
31510,59473,445,0,0,drop,70,70,0,1,0,1,0
31511,59472,445,0,0,drop,70,70,0,1,0,1,0
31512,17760,50584,0,0,deny,146,146,0,1,0,1,0
31513,59725,445,0,0,drop,66,66,0,1,0,1,0
31514,59731,445,0,0,drop,66,66,0,1,0,1,0
31515,59733,445,0,0,drop,66,66,0,1,0,1,0
31516,59734,445,0,0,drop,66,66,0,1,0,1,0
31517,59728,445,0,0,drop,66,66,0,1,0,1,0
31518,59724,445,0,0,drop,66,66,0,1,0,1,0
31519,59722,445,0,0,drop,66,66,0,1,0,1,0
31520,59468,445,0,0,drop,70,70,0,1,0,1,0
31521,61639,37965,0,0,deny,66,66,0,1,0,1,0
31522,55616,56205,0,0,deny,66,66,0,1,0,1,0
31523,443,60496,0,0,deny,320,320,0,1,0,1,0
31524,44411,37965,0,0,deny,62,62,0,1,0,1,0
31525,64314,445,0,0,drop,70,70,0,1,0,1,0
31526,54016,42707,0,0,deny,62,62,0,1,0,1,0
31527,64313,445,0,0,drop,70,70,0,1,0,1,0
31528,64312,445,0,0,drop,70,70,0,1,0,1,0
31529,64309,445,0,0,drop,70,70,0,1,0,1,0
31530,28367,23,0,0,deny,60,60,0,1,0,1,0
31531,26713,64147,0,0,deny,62,62,0,1,0,1,0
31532,28040,64147,0,0,deny,66,66,0,1,0,1,0
31533,65419,26467,0,0,deny,62,62,0,1,0,1,0
31534,45941,23386,0,0,deny,60,60,0,1,0,1,0
31535,45941,23386,0,0,deny,60,60,0,1,0,1,0
31536,16387,8455,0,0,deny,60,60,0,1,0,1,0
31537,16387,49252,0,0,deny,60,60,0,1,0,1,0
31538,16387,35244,0,0,deny,60,60,0,1,0,1,0
31539,59462,445,0,0,drop,70,70,0,1,0,1,0
31540,32770,51505,0,0,deny,62,62,0,1,0,1,0
31541,26642,57470,0,0,deny,62,62,0,1,0,1,0
31542,64307,445,0,0,drop,70,70,0,1,0,1,0
31543,64306,445,0,0,drop,70,70,0,1,0,1,0
31544,64305,445,0,0,drop,70,70,0,1,0,1,0
31545,56442,11392,0,0,deny,66,66,0,1,0,1,0
31546,59718,445,0,0,drop,66,66,0,1,0,1,0
31547,32520,47993,0,0,deny,66,66,0,1,0,1,0
31548,6338,23117,0,0,deny,66,66,0,1,0,1,0
31549,64300,445,0,0,drop,70,70,0,1,0,1,0
31550,60786,51505,0,0,deny,66,66,0,1,0,1,0
31551,2432,11392,0,0,deny,62,62,0,1,0,1,0
31552,60374,57470,0,0,deny,62,62,0,1,0,1,0
31553,59455,445,0,0,drop,70,70,0,1,0,1,0
31554,56367,44847,0,0,deny,62,62,0,1,0,1,0
31555,59714,445,0,0,drop,66,66,0,1,0,1,0
31556,40571,26467,0,0,deny,62,62,0,1,0,1,0
31557,59453,445,0,0,drop,70,70,0,1,0,1,0
31558,65081,26467,0,0,deny,66,66,0,1,0,1,0
31559,59712,445,0,0,drop,66,66,0,1,0,1,0
31560,59710,445,0,0,drop,66,66,0,1,0,1,0
31561,59709,445,0,0,drop,66,66,0,1,0,1,0
31562,3978,35440,0,0,deny,62,62,0,1,0,1,0
31563,16387,34137,0,0,deny,60,60,0,1,0,1,0
31564,16387,61049,0,0,deny,60,60,0,1,0,1,0
31565,16387,23177,0,0,deny,60,60,0,1,0,1,0
31566,59449,445,0,0,drop,70,70,0,1,0,1,0
31567,59447,445,0,0,drop,70,70,0,1,0,1,0
31568,57034,44847,0,0,deny,66,66,0,1,0,1,0
31569,64292,445,0,0,drop,70,70,0,1,0,1,0
31570,33886,39127,0,0,deny,162,162,0,1,0,1,0
31571,51743,64147,0,0,deny,62,62,0,1,0,1,0
31572,55421,57470,0,0,deny,74,74,0,1,0,1,0
31573,64284,445,0,0,drop,70,70,0,1,0,1,0
31574,64282,445,0,0,drop,70,70,0,1,0,1,0
31575,59443,445,0,0,drop,70,70,0,1,0,1,0
31576,13423,56205,0,0,deny,62,62,0,1,0,1,0
31577,13408,44847,0,0,deny,62,62,0,1,0,1,0
31578,59697,445,0,0,drop,66,66,0,1,0,1,0
31579,59441,445,0,0,drop,70,70,0,1,0,1,0
31580,13090,36237,0,0,deny,66,66,0,1,0,1,0
31581,59690,445,0,0,drop,66,66,0,1,0,1,0
31582,64274,445,0,0,drop,70,70,0,1,0,1,0
31583,59437,445,0,0,drop,70,70,0,1,0,1,0
31584,58858,15503,0,0,deny,66,66,0,1,0,1,0
31585,61030,21247,0,0,deny,66,66,0,1,0,1,0
31586,59688,445,0,0,drop,66,66,0,1,0,1,0
31587,10416,64147,0,0,deny,62,62,0,1,0,1,0
31588,45042,48817,0,0,deny,109,109,0,1,0,1,0
31589,30129,37965,0,0,deny,72,72,0,1,0,1,0
31590,0,0,0,0,allow,320,320,0,5,0,5,0
31591,0,0,0,0,allow,2000,1020,980,20,0,10,10
31592,35229,32468,0,0,deny,62,62,0,1,0,1,0
31593,59680,445,0,0,drop,66,66,0,1,0,1,0
31594,55835,62413,0,0,deny,62,62,0,1,0,1,0
31595,59673,445,0,0,drop,66,66,0,1,0,1,0
31596,8403,46824,0,0,deny,62,62,0,1,0,1,0
31597,443,42788,0,0,deny,74,74,0,1,0,1,0
31598,18904,57470,0,0,deny,62,62,0,1,0,1,0
31599,59424,445,0,0,drop,70,70,0,1,0,1,0
31600,51581,22114,0,0,deny,66,66,0,1,0,1,0
31601,58972,57866,0,0,deny,66,66,0,1,0,1,0
31602,59421,445,0,0,drop,70,70,0,1,0,1,0
31603,64263,445,0,0,drop,70,70,0,1,0,1,0
31604,64261,445,0,0,drop,70,70,0,1,0,1,0
31605,64260,445,0,0,drop,70,70,0,1,0,1,0
31606,59662,445,0,0,drop,66,66,0,1,0,1,0
31607,59664,445,0,0,drop,66,66,0,1,0,1,0
31608,59665,445,0,0,drop,66,66,0,1,0,1,0
31609,59658,445,0,0,drop,66,66,0,1,0,1,0
31610,59663,445,0,0,drop,66,66,0,1,0,1,0
31611,59660,445,0,0,drop,66,66,0,1,0,1,0
31612,59661,445,0,0,drop,66,66,0,1,0,1,0
31613,59659,445,0,0,drop,66,66,0,1,0,1,0
31614,16327,55442,0,0,deny,66,66,0,1,0,1,0
31615,42223,67,0,0,deny,60,60,0,1,0,1,0
31616,59694,50584,0,0,deny,62,62,0,1,0,1,0
31617,13963,50584,0,0,deny,62,62,0,1,0,1,0
31618,47013,44512,0,0,deny,62,62,0,1,0,1,0
31619,59416,445,0,0,drop,70,70,0,1,0,1,0
31620,1187,64147,0,0,deny,66,66,0,1,0,1,0
31621,27947,26467,0,0,deny,62,62,0,1,0,1,0
31622,59415,445,0,0,drop,70,70,0,1,0,1,0
31623,49915,35440,0,0,deny,146,146,0,1,0,1,0
31624,50927,44847,0,0,deny,62,62,0,1,0,1,0
31625,59413,445,0,0,drop,70,70,0,1,0,1,0
31626,50424,55777,0,0,deny,62,62,0,1,0,1,0
31627,64249,445,0,0,drop,70,70,0,1,0,1,0
31628,64247,445,0,0,drop,70,70,0,1,0,1,0
31629,64245,445,0,0,drop,70,70,0,1,0,1,0
31630,64242,445,0,0,drop,70,70,0,1,0,1,0
31631,27617,51505,0,0,deny,146,146,0,1,0,1,0
31632,49323,53,45688,53,allow,192,98,94,2,30,1,1
31633,53144,58987,43141,58987,allow,70,70,0,2,8,2,0
31634,58115,3389,58115,3389,allow,4166,2141,2025,18,17,9,9
31635,64627,53,17603,53,allow,198,101,97,2,30,1,1
31636,64244,53,29357,53,allow,198,101,97,2,30,1,1
31637,55938,53,49190,53,allow,780,93,687,2,30,1,1
31638,50012,53,54567,53,allow,208,106,102,2,30,1,1
31639,57189,53,57433,53,allow,174,89,85,2,30,1,1
31640,57187,53,15982,53,allow,782,105,677,2,30,1,1
31641,56991,53,36997,53,allow,748,106,642,2,30,1,1
31642,57204,53,58502,53,allow,182,93,89,2,30,1,1
31643,54467,80,25502,80,allow,17572,1518,16054,30,255,16,14
31644,58725,443,21181,443,allow,26960,13206,13754,53,17,28,25
31645,63934,55027,48051,55027,allow,66,66,0,2,8,2,0
31646,53140,64128,33195,64128,allow,698,320,378,10,17,6,4
31647,54472,80,34355,80,allow,13695,1377,12318,26,255,14,12
31648,61518,22,61518,22,allow,7306,2583,4723,36,25,19,17
31649,56381,53,44431,53,allow,192,98,94,2,31,1,1
31650,56341,3389,56341,3389,allow,3424,1710,1714,16,33,8,8
31651,35980,443,35980,443,allow,4398,1491,2907,19,26,11,8
31652,58723,443,11514,443,allow,24079,11282,12797,44,17,22,22
31653,60443,50284,54263,50284,allow,164,70,94,2,5,1,1
31654,36026,443,14720,443,allow,7050,984,6066,18,39,12,6
31655,54473,80,28386,80,allow,14035,1381,12654,26,255,14,12
31656,56411,53,42159,53,allow,184,94,90,2,31,1,1
31657,55641,53,45216,53,allow,184,94,90,2,31,1,1
31658,55593,53,41754,53,allow,749,89,660,2,30,1,1
31659,55596,53,37319,53,allow,188,96,92,2,31,1,1
31660,33878,443,33484,443,allow,2279,1637,642,15,25,9,6
31661,64534,53,43156,53,allow,212,108,104,2,31,1,1
31662,45259,53,45259,53,allow,176,78,98,2,30,1,1
31663,58744,443,27181,443,allow,2576,1549,1027,15,15,7,8
31664,65176,53,2902,53,allow,186,95,91,2,30,1,1
31665,55670,31056,18384,31056,allow,70,70,0,2,8,2,0
31666,55006,53,44866,53,allow,789,110,679,2,30,1,1
31667,5231,30114,20445,30114,allow,832,832,0,14,96,14,0
31668,58724,443,37298,443,allow,21610,9250,12360,40,17,19,21
31669,8971,80,8971,80,allow,326,186,140,6,29,4,2
31670,53738,25760,39657,25760,allow,2031,1019,1012,11,16,6,5
31671,58719,443,6983,443,allow,18880,7831,11049,37,18,19,18
31672,54470,80,58006,80,allow,16896,1514,15382,30,255,16,14
31673,55514,53,31515,53,allow,747,93,654,2,30,1,1
31674,65294,53,15570,53,allow,710,89,621,2,30,1,1
31675,56489,53,16732,53,allow,208,106,102,2,31,1,1
31676,64911,53,61645,53,allow,202,103,99,2,31,1,1
31677,56643,53,22354,53,allow,190,97,93,2,31,1,1
31678,36542,3142,36542,3142,allow,138,78,60,2,6,1,1
31679,50544,443,14371,443,allow,11083,4570,6513,24,35,13,11
31680,56661,53,9185,53,allow,297,102,195,4,34,2,2
31681,64837,53,3342,53,allow,190,97,93,2,31,1,1
31682,51956,36995,25588,36995,allow,70,70,0,2,8,2,0
31683,6722,80,6722,80,allow,326,186,140,6,29,4,2
31684,45641,443,12763,443,allow,99276,88410,10866,143,333,78,65
31685,37616,443,22145,443,allow,6506,1356,5150,24,16,14,10
31686,34697,443,10528,443,allow,15997,3015,12982,31,18,16,15
31687,51898,443,2125,443,allow,7866,1549,6317,21,321,10,11
31688,34698,443,50104,443,allow,16164,3053,13111,31,18,16,15
31689,51753,7000,51753,7000,allow,3638,2087,1551,17,15,10,7
31690,56171,53,61869,53,allow,756,95,661,2,30,1,1
31691,34600,80,41483,80,allow,3089,775,2314,15,16,9,6
31692,48015,443,45822,443,allow,19394,2961,16433,51,196,24,27
31693,64987,53,19027,53,allow,196,100,96,2,30,1,1
31694,50551,80,50551,80,allow,4780,1925,2855,16,22,8,8
31695,56690,53,19054,53,allow,802,104,698,2,30,1,1
31696,56142,53,12873,53,allow,188,96,92,2,30,1,1
31697,55828,53,3503,53,allow,178,91,87,2,30,1,1
31698,56415,53,58262,53,allow,174,89,85,2,31,1,1
31699,56094,53,60857,53,allow,764,99,665,2,31,1,1
31700,64588,53,37209,53,allow,186,95,91,2,31,1,1
31701,6881,41872,4010,41872,allow,509,150,359,2,1200,1,1
31702,65246,53,33087,53,allow,174,89,85,2,31,1,1
31703,63473,443,25564,443,allow,4490,1234,3256,20,122,9,11
31704,45590,53,0,0,allow,82,82,0,1,31,1,0
31705,65042,53,25956,53,allow,182,93,89,2,31,1,1
31706,56627,53,42658,53,allow,186,95,91,2,31,1,1
31707,57181,53,65198,53,allow,733,93,640,2,31,1,1
31708,65512,53,60205,53,allow,744,95,649,2,31,1,1
31709,30960,45738,57653,45738,allow,396,396,0,7,3615,7,0
31710,56649,443,48324,443,allow,3469,1006,2463,15,121,7,8
31711,57127,53,59492,53,allow,186,95,91,2,31,1,1
31712,64174,53,49823,53,allow,176,90,86,2,31,1,1
31713,65042,53,41893,53,allow,182,93,89,2,31,1,1
31714,55344,53,18078,53,allow,208,106,102,2,31,1,1
31715,63960,53,41492,53,allow,172,88,84,2,31,1,1
31716,64555,53,55433,53,allow,166,85,81,2,31,1,1
31717,53980,443,7192,443,allow,4957,1627,3330,17,120,8,9
31718,56673,53,13818,53,allow,186,95,91,2,31,1,1
31719,62102,443,56889,443,allow,3466,821,2645,11,121,5,6
31720,64619,53,54626,53,allow,174,89,85,2,31,1,1
31721,57470,45561,33811,45561,allow,792,792,0,13,1201,13,0
31722,55130,53,9076,53,allow,216,110,106,2,31,1,1
31723,56785,53,64900,53,allow,186,95,91,2,31,1,1
31724,55126,53,24901,53,allow,186,95,91,2,31,1,1
31725,56889,53,27625,53,allow,206,105,101,2,31,1,1
31726,55533,53,56018,53,allow,182,93,89,2,31,1,1
31727,56387,53,9036,53,allow,182,93,89,2,31,1,1
31728,49216,53,25748,53,allow,178,91,87,2,31,1,1
31729,56387,53,7178,53,allow,182,93,89,2,31,1,1
31730,53979,443,21511,443,allow,3566,871,2695,11,120,5,6
31731,49864,53,25609,53,allow,186,95,91,2,31,1,1
31732,48817,8677,48817,8677,allow,490,149,341,2,1200,1,1
31733,49160,51839,39818,51839,allow,868,150,718,4,1200,2,2
31734,31974,51505,0,0,deny,66,66,0,1,0,1,0
31735,59644,445,0,0,drop,66,66,0,1,0,1,0
31736,59642,445,0,0,drop,66,66,0,1,0,1,0
31737,59641,445,0,0,drop,66,66,0,1,0,1,0
31738,57131,31061,0,0,deny,145,145,0,1,0,1,0
31739,61000,15503,0,0,deny,146,146,0,1,0,1,0
31740,32704,46824,0,0,deny,66,66,0,1,0,1,0
31741,59406,445,0,0,drop,70,70,0,1,0,1,0
31742,57538,30188,0,0,deny,66,66,0,1,0,1,0
31743,443,23133,0,0,deny,97,97,0,1,0,1,0
31744,61000,57587,0,0,deny,146,146,0,1,0,1,0
31745,64240,445,0,0,drop,70,70,0,1,0,1,0
31746,35925,443,8324,443,allow,1092248,9101,1083147,860,195,111,749
31747,65410,53,23769,53,allow,216,94,122,2,30,1,1
31748,7166,64147,0,0,deny,62,62,0,1,0,1,0
31749,59404,445,0,0,drop,70,70,0,1,0,1,0
31750,38306,51221,0,0,deny,62,62,0,1,0,1,0
31751,64237,445,0,0,drop,70,70,0,1,0,1,0
31752,64231,445,0,0,drop,70,70,0,1,0,1,0
31753,64230,445,0,0,drop,70,70,0,1,0,1,0
31754,39063,5900,0,0,deny,60,60,0,1,0,1,0
31755,63343,53,0,0,deny,74,74,0,1,0,1,0
31756,12969,55777,0,0,deny,66,66,0,1,0,1,0
31757,7226,50584,0,0,deny,62,62,0,1,0,1,0
31758,59403,445,0,0,drop,70,70,0,1,0,1,0
31759,59402,445,0,0,drop,70,70,0,1,0,1,0
31760,59401,445,0,0,drop,70,70,0,1,0,1,0
31761,8313,51505,0,0,deny,66,66,0,1,0,1,0
31762,59397,445,0,0,drop,70,70,0,1,0,1,0
31763,59395,445,0,0,drop,70,70,0,1,0,1,0
31764,25090,9192,0,0,deny,145,145,0,1,0,1,0
31765,51346,51221,0,0,deny,74,74,0,1,0,1,0
31766,52925,3389,0,0,deny,60,60,0,1,0,1,0
31767,13485,43708,0,0,deny,554,554,0,1,0,1,0
31768,45941,23386,0,0,deny,60,60,0,1,0,1,0
31769,45941,23386,0,0,deny,60,60,0,1,0,1,0
31770,9448,57866,0,0,deny,62,62,0,1,0,1,0
31771,24145,35440,0,0,deny,62,62,0,1,0,1,0
31772,6999,11119,0,0,deny,143,143,0,1,0,1,0
31773,59383,445,0,0,drop,70,70,0,1,0,1,0
31774,59382,445,0,0,drop,70,70,0,1,0,1,0
31775,27402,37628,0,0,deny,62,62,0,1,0,1,0
31776,59378,445,0,0,drop,70,70,0,1,0,1,0
31777,54305,39004,0,0,deny,62,62,0,1,0,1,0
31778,59373,445,0,0,drop,70,70,0,1,0,1,0
31779,64221,445,0,0,drop,70,70,0,1,0,1,0
31780,64222,445,0,0,drop,70,70,0,1,0,1,0
31781,64217,445,0,0,drop,70,70,0,1,0,1,0
31782,34470,57470,0,0,deny,66,66,0,1,0,1,0
31783,8868,50584,0,0,deny,146,146,0,1,0,1,0
31784,59630,445,0,0,drop,66,66,0,1,0,1,0
31785,37203,443,4528,443,allow,466,392,74,4,0,3,1
31786,14148,1,0,0,deny,66,66,0,1,0,1,0
31787,56092,56205,0,0,deny,146,146,0,1,0,1,0
31788,52003,44512,0,0,deny,66,66,0,1,0,1,0
31789,51426,47563,0,0,deny,100,100,0,1,0,1,0
31790,10797,50584,0,0,deny,62,62,0,1,0,1,0
31791,34932,38608,0,0,deny,62,62,0,1,0,1,0
31792,59361,445,0,0,drop,70,70,0,1,0,1,0
31793,54276,37628,0,0,deny,66,66,0,1,0,1,0
31794,64215,445,0,0,drop,70,70,0,1,0,1,0
31795,64213,445,0,0,drop,70,70,0,1,0,1,0
31796,50261,64147,0,0,deny,66,66,0,1,0,1,0
31797,54593,51505,0,0,deny,66,66,0,1,0,1,0
31798,61798,35440,0,0,deny,66,66,0,1,0,1,0
31799,51426,12447,0,0,deny,100,100,0,1,0,1,0
31800,61000,1,0,0,deny,146,146,0,1,0,1,0
31801,18423,51505,0,0,deny,62,62,0,1,0,1,0
31802,65322,53,28599,53,allow,395,102,293,2,30,1,1
31803,64987,53,43588,53,allow,198,102,96,2,30,1,1
31804,50575,53,21343,53,allow,184,94,90,2,30,1,1
31805,49663,53,58279,53,allow,195,102,93,2,30,1,1
31806,56269,53,36395,53,allow,102,102,0,1,30,1,0
31807,50000,53,33265,53,allow,216,110,106,2,30,1,1
31808,49420,53,61159,53,allow,183,94,89,2,30,1,1
31809,51632,443,13714,443,allow,5021,2884,2137,14,135,7,7
31810,50156,53,6756,53,allow,186,102,84,2,30,1,1
31811,55218,443,17111,443,allow,17915,7421,10494,39,61,21,18
31812,63914,32805,13245,32805,allow,70,70,0,1,4,1,0
31813,50208,80,63761,80,allow,1277,460,817,16,77,5,11
31814,49189,443,23027,443,allow,9734,1613,8121,24,17,12,12
31815,51111,80,8917,80,allow,366,240,126,7,21,5,2
31816,64976,53,53844,53,allow,193,102,91,2,29,1,1
31817,64421,53,32983,53,allow,178,94,84,2,29,1,1
31818,49490,443,14327,443,allow,9109,1943,7166,32,270,16,16
31819,51853,443,32598,443,allow,7415,1550,5865,28,37,15,13
31820,53746,7546,50898,7546,allow,70,70,0,1,4,1,0
31821,53760,45682,34507,45682,allow,70,70,0,2,7,2,0
31822,34325,443,18256,443,allow,2450,1451,999,19,315,10,9
31823,56661,53,3079,53,allow,297,102,195,4,34,2,2
31824,55912,53,45004,53,allow,199,102,97,2,29,1,1
31825,57371,53,14687,53,allow,321,108,213,4,33,2,2
31826,55350,53,27984,53,allow,177,94,83,2,29,1,1
31827,51958,51322,52514,51322,allow,70,70,0,2,7,2,0
31828,53762,9587,1266,9587,allow,70,70,0,2,7,2,0
31829,56594,53,50396,53,allow,165,86,79,2,29,1,1
31830,64507,53,28479,53,allow,382,102,280,2,29,1,1
31831,57096,53,49643,53,allow,443,182,261,6,29,3,3
31832,56611,53,17951,53,allow,177,94,83,2,29,1,1
31833,64898,53,46183,53,allow,209,94,115,2,29,1,1
31834,50440,53,52778,53,allow,458,188,270,6,29,3,3
31835,55350,53,12521,53,allow,185,102,83,2,29,1,1
31836,49312,53,33674,53,allow,306,94,212,2,29,1,1
31837,49561,53,39252,53,allow,754,94,660,2,30,1,1
31838,56611,53,12492,53,allow,177,94,83,2,29,1,1
31839,55649,53,24364,53,allow,216,110,106,2,30,1,1
31840,58741,443,39394,443,allow,5168,700,4468,16,15,7,9
31841,50552,80,50552,80,allow,2887,1776,1111,14,22,8,6
31842,56806,443,47180,443,allow,403093,31796,371297,497,151,185,312
31843,54469,80,59842,80,allow,1466,831,635,10,255,6,4
31844,50341,5222,19733,5222,allow,9254,3356,5898,74,444,30,44
31845,58742,443,35475,443,allow,5166,700,4466,16,15,7,9
31846,57189,53,16894,53,allow,179,94,85,2,30,1,1
31847,55495,53,17025,53,allow,210,110,100,2,30,1,1
31848,49746,53,8872,53,allow,290,102,188,2,30,1,1
31849,49786,53,59022,53,allow,752,110,642,2,30,1,1
31850,63943,53,44134,53,allow,196,94,102,2,30,1,1
31851,50012,53,27557,53,allow,212,110,102,2,30,1,1
31852,55641,53,38684,53,allow,184,94,90,2,30,1,1
31853,55911,53,35640,53,allow,211,110,101,2,30,1,1
31854,56489,53,43327,53,allow,212,110,102,2,30,1,1
31855,56009,53,53982,53,allow,178,94,84,2,30,1,1
31856,27005,33051,48719,33051,allow,887,126,761,2,31,1,1
31857,56381,53,54551,53,allow,196,102,94,2,30,1,1
31858,57204,53,58516,53,allow,183,94,89,2,30,1,1
31859,55533,53,40009,53,allow,183,94,89,2,30,1,1
31860,54461,80,46042,80,allow,2544,900,1644,12,255,7,5
31861,38517,53,38517,53,allow,214,82,132,2,32,1,1
31862,6455,80,6455,80,allow,326,186,140,6,29,4,2
31863,51485,443,20455,443,allow,828,390,438,11,40,4,7
31864,42654,443,18143,443,allow,3650,2162,1488,25,80,13,12
31865,5571,80,5571,80,allow,326,186,140,6,29,4,2
31866,49456,443,8615,443,allow,10956,1757,9199,21,37,10,11
31867,56562,443,49879,443,allow,8821,3228,5593,25,60,15,10
31868,58743,443,4487,443,allow,5167,700,4467,16,15,7,9
31869,49404,53,23314,53,allow,200,94,106,2,30,1,1
31870,52324,443,60831,443,allow,295493,16052,279441,394,68,186,208
31871,50287,443,51254,443,allow,14559,2721,11838,31,16,17,14
31872,50209,53,30899,53,allow,749,94,655,2,30,1,1
31873,65024,53,47698,53,allow,179,94,85,2,30,1,1
31874,44938,443,27497,443,allow,46323,1563,44760,49,30,15,34
31875,63929,53,15311,53,allow,195,94,101,2,30,1,1
31876,57204,53,35848,53,allow,183,94,89,2,30,1,1
31877,50575,53,41966,53,allow,184,94,90,2,30,1,1
31878,57126,53,50266,53,allow,183,94,89,2,30,1,1
31879,55621,53,47829,53,allow,453,186,267,6,30,3,3
31880,49372,53,37424,53,allow,216,110,106,2,30,1,1
31881,49254,53,55219,53,allow,265,110,155,2,30,1,1
31882,49797,53,5232,53,allow,787,110,677,2,30,1,1
31883,56269,53,62645,53,allow,816,102,714,2,30,1,1
31884,56643,53,48653,53,allow,195,102,93,2,30,1,1
31885,56415,53,51829,53,allow,179,94,85,2,30,1,1
31886,49323,53,61963,53,allow,196,102,94,2,30,1,1
31887,57127,53,64638,53,allow,193,102,91,2,30,1,1
31888,47662,80,15716,80,allow,1067,697,370,8,63,5,3
31889,6590,80,6590,80,allow,326,186,140,6,29,4,2
31890,5686,80,5686,80,allow,326,186,140,6,29,4,2
31891,50598,80,63854,80,allow,17837,3830,14007,27,24,12,15
31892,35217,443,21700,443,allow,2388,1628,760,18,294,11,7
31893,56692,443,45896,443,allow,7914,1925,5989,20,15,11,9
31894,64896,53,50820,53,allow,195,94,101,2,30,1,1
31895,55495,53,27673,53,allow,210,110,100,2,30,1,1
31896,36851,53,31171,53,allow,86,86,0,1,30,1,0
31897,55828,53,17599,53,allow,181,94,87,2,30,1,1
31898,64707,53,47683,53,allow,258,102,156,2,30,1,1
31899,64607,53,1706,53,allow,211,110,101,2,30,1,1
31900,56415,53,6950,53,allow,179,94,85,2,30,1,1
31901,50604,80,39550,80,allow,1658,1247,411,8,15,5,3
31902,51955,39871,23023,39871,allow,70,70,0,2,8,2,0
31903,55464,53,43920,53,allow,216,94,122,2,30,1,1
31904,64457,53,27221,53,allow,261,102,159,2,30,1,1
31905,65146,53,65321,53,allow,335,102,233,2,30,1,1
31906,56009,53,46044,53,allow,178,94,84,2,30,1,1
31907,49420,53,47944,53,allow,183,94,89,2,30,1,1
31908,64964,53,38711,53,allow,197,102,95,2,30,1,1
31909,57071,53,6792,53,allow,166,86,80,2,30,1,1
31910,56411,53,39978,53,allow,184,94,90,2,30,1,1
31911,27005,32028,16656,32028,allow,900,126,774,2,31,1,1
31912,50079,443,27272,443,allow,20880,7976,12904,41,47,22,19
31913,55017,443,32512,443,allow,7627,2734,4893,26,16,15,11
31914,55020,443,26568,443,allow,7239,2934,4305,26,16,15,11
31915,50603,443,37566,443,allow,2928,1448,1480,17,20,10,7
31916,56645,80,11255,80,allow,234,234,0,4,12,4,0
31917,53743,23915,44968,23915,allow,70,70,0,1,4,1,0
31918,58746,443,54765,443,allow,5107,700,4407,15,15,7,8
31919,53808,443,50826,443,allow,10785,2147,8638,22,30,10,12
31920,55018,443,29845,443,allow,7232,2925,4307,27,16,16,11
31921,56661,53,53473,53,allow,297,102,195,4,34,2,2
31922,54067,443,60829,443,allow,113020,6140,106880,149,202,66,83
31923,49323,53,40976,53,allow,196,102,94,2,31,1,1
31924,34530,80,15851,80,allow,1056,682,374,10,15,6,4
31925,63916,56318,63492,56318,allow,70,70,0,1,4,1,0
31926,56691,443,29213,443,allow,7862,1873,5989,20,15,11,9
31927,5233,22683,23073,22683,allow,832,832,0,14,95,14,0
31928,56142,53,19071,53,allow,194,102,92,2,29,1,1
31929,63937,43443,33286,43443,allow,246,66,180,4,7,2,2
31930,63938,26204,5698,26204,allow,66,66,0,2,7,2,0
31931,57071,53,20542,53,allow,166,86,80,2,29,1,1
31932,55031,443,21855,443,allow,134,60,74,3,5,2,1
31933,52080,443,29531,443,allow,3052,2014,1038,16,15,9,7
31934,56185,53,12663,53,allow,183,102,81,2,29,1,1
31935,54076,443,7008,443,allow,55394,4535,50859,91,170,47,44
31936,64987,53,27930,53,allow,198,102,96,2,29,1,1
31937,49384,53,28867,53,allow,305,93,212,4,48,2,2
31938,64976,53,29065,53,allow,193,102,91,2,29,1,1
31939,56979,53,50155,53,allow,180,94,86,2,29,1,1
31940,64628,53,58574,53,allow,199,102,97,2,29,1,1
31941,49671,53,15823,53,allow,166,86,80,2,29,1,1
31942,64586,53,51199,53,allow,183,94,89,2,29,1,1
31943,49811,53,52504,53,allow,300,118,182,2,29,1,1
31944,50272,53,52496,53,allow,210,110,100,2,29,1,1
31945,55728,53,18036,53,allow,195,102,93,2,29,1,1
31946,50272,53,35628,53,allow,210,110,100,2,29,1,1
31947,57147,53,63811,53,allow,166,86,80,2,29,1,1
31948,57204,53,13761,53,allow,183,94,89,2,30,1,1
31949,57131,53,26066,53,allow,168,78,90,2,30,1,1
31950,55596,53,31644,53,allow,194,102,92,2,30,1,1
31951,49783,53,25868,53,allow,179,94,85,2,30,1,1
31952,64496,53,57419,53,allow,196,94,102,2,30,1,1
31953,56889,53,27210,53,allow,211,110,101,2,30,1,1
31954,56009,53,38515,53,allow,178,94,84,2,30,1,1
31955,64619,53,25912,53,allow,179,94,85,2,31,1,1
31956,57470,64108,16646,64108,allow,330,330,0,6,1199,6,0
31957,55649,53,62328,53,allow,216,110,106,2,30,1,1
31958,55728,53,52425,53,allow,195,102,93,2,30,1,1
31959,64555,53,59391,53,allow,167,86,81,2,30,1,1
31960,50037,53,65320,53,allow,195,102,93,2,31,1,1
31961,32012,500,63361,500,allow,879,462,417,2,600,1,1
31962,64321,53,56788,53,allow,195,102,93,2,31,1,1
31963,27005,33060,38657,33060,allow,928,126,802,2,31,1,1
31964,51931,19416,18686,19416,allow,70,70,0,1,5,1,0
31965,64321,53,14158,53,allow,296,97,199,4,53,2,2
31966,65240,53,20571,53,allow,453,186,267,6,30,3,3
31967,52323,443,4848,443,allow,454059,23387,430672,602,76,275,327
31968,64986,53,34295,53,allow,183,94,89,2,30,1,1
31969,64837,53,36950,53,allow,195,102,93,2,30,1,1
31970,56085,53,34233,53,allow,167,86,81,2,30,1,1
31971,55155,53,1843,53,allow,183,94,89,2,30,1,1
31972,54194,443,38493,443,allow,195229,13204,182025,270,124,102,168
31973,63933,443,50085,443,allow,6822,3370,3452,21,135,10,11
31974,64872,53,21895,53,allow,166,86,80,2,31,1,1
31975,56142,53,56422,53,allow,194,102,92,2,31,1,1
31976,53759,80,20494,80,allow,997,582,415,11,315,6,5
31977,65489,53,57940,53,allow,531,97,434,4,35,2,2
31978,51932,36498,40161,36498,allow,70,70,0,1,5,1,0
31979,54066,443,63244,443,allow,307208,13249,293959,367,202,153,214
31980,54073,443,61123,443,allow,90387,4941,85446,123,170,54,69
31981,57117,80,29144,80,allow,1049,679,370,8,16,5,3
31982,45019,443,10530,443,allow,33865,6559,27306,67,67,34,33
31983,64273,53,19409,53,allow,256,102,154,2,30,1,1
31984,49931,53,2557,53,allow,195,102,93,2,30,1,1
31985,56104,53,55768,53,allow,210,110,100,2,30,1,1
31986,55830,53,41012,53,allow,184,94,90,2,30,1,1
31987,55237,53,14253,53,allow,193,102,91,2,30,1,1
31988,59692,443,65414,443,allow,6129,3123,3006,12,120,7,5
31989,55159,53,57486,53,allow,168,86,82,2,30,1,1
31990,40709,443,57804,443,allow,256802,11839,244963,329,173,136,193
31991,55039,443,37835,443,allow,19775,1890,17885,40,80,17,23
31992,56611,53,45220,53,allow,177,94,83,2,30,1,1
31993,43176,53,34266,53,allow,168,78,90,2,30,1,1
31994,56166,53,15271,53,allow,193,102,91,2,30,1,1
31995,49730,53,58094,53,allow,767,102,665,2,30,1,1
31996,64534,53,37006,53,allow,214,110,104,2,30,1,1
31997,55237,53,28991,53,allow,193,102,91,2,30,1,1
31998,33884,53,0,0,allow,86,86,0,1,30,1,0
31999,57914,443,40977,443,allow,17285,4005,13280,26,120,11,15
32000,55644,53,20547,53,allow,184,94,90,2,30,1,1
32001,55808,53,26919,53,allow,179,94,85,2,30,1,1
32002,55911,53,54432,53,allow,211,110,101,2,30,1,1
32003,49845,53,42421,53,allow,168,86,82,2,30,1,1
32004,56627,53,14624,53,allow,193,102,91,2,30,1,1
32005,55130,53,35650,53,allow,216,110,106,2,30,1,1
32006,49162,53,33354,53,allow,183,94,89,2,30,1,1
32007,49563,53,27987,53,allow,200,102,98,2,31,1,1
32008,55644,53,33807,53,allow,184,94,90,2,31,1,1
32009,27005,32055,20958,32055,allow,878,126,752,2,31,1,1
32010,56104,53,51847,53,allow,210,110,100,2,31,1,1
32011,56627,53,7670,53,allow,193,102,91,2,31,1,1
32012,64174,53,11186,53,allow,180,94,86,2,31,1,1
32013,65176,53,48862,53,allow,193,102,91,2,31,1,1
32014,64244,53,1570,53,allow,199,102,97,2,31,1,1
32015,64627,53,39841,53,allow,199,102,97,2,31,1,1
32016,59693,443,23790,443,allow,1867,250,1617,8,120,4,4
32017,60433,443,40567,443,allow,7113,3977,3136,23,136,12,11
32018,36712,53,0,0,allow,139,70,69,2,30,1,1
32019,27005,26258,3792,26258,allow,886,126,760,2,31,1,1
32020,55344,53,62039,53,allow,212,110,102,2,30,1,1
32021,27005,33070,6671,33070,allow,883,126,757,2,31,1,1
32022,56643,53,25715,53,allow,195,102,93,2,31,1,1
32023,55596,53,30266,53,allow,194,102,92,2,31,1,1
32024,64911,53,46196,53,allow,209,110,99,2,31,1,1
32025,56166,53,32897,53,allow,193,102,91,2,31,1,1
32026,56411,53,48736,53,allow,184,94,90,2,31,1,1
32027,57127,53,17390,53,allow,193,102,91,2,31,1,1
32028,64837,53,35241,53,allow,195,102,93,2,31,1,1
32029,51147,443,61160,443,allow,7124,2457,4667,23,120,10,13
32030,60565,443,42590,443,allow,6483,3687,2796,18,135,9,9
32031,61286,443,11751,443,allow,8970,5359,3611,22,121,11,11
32032,27005,32066,15067,32066,allow,881,126,755,2,31,1,1
32033,27005,33055,20199,33055,allow,888,126,762,2,31,1,1
32034,56426,53,37263,53,allow,184,94,90,2,31,1,1
32035,57038,53,5859,53,allow,186,102,84,2,31,1,1
32036,56041,53,17868,53,allow,179,94,85,2,31,1,1
32037,49235,53,6024,53,allow,164,86,78,2,31,1,1
32038,56381,53,46735,53,allow,196,102,94,2,31,1,1
32039,56648,443,4719,443,allow,7080,2136,4944,18,121,8,10
32040,50262,443,49732,443,allow,7608,2413,5195,19,120,9,10
32041,58848,443,16146,443,allow,2109,420,1689,11,121,6,5
32042,50265,44843,10747,44843,allow,70,70,0,1,1200,1,0
32043,55877,12187,8942,12187,allow,150,150,0,1,1200,1,0
32044,55641,53,35786,53,allow,184,94,90,2,31,1,1
32045,64428,53,26819,53,allow,299,97,202,4,44,2,2
32046,63929,443,53771,443,allow,14647,2365,12282,22,136,10,12
32047,53741,43800,30138,43800,allow,70,70,0,1,5,1,0
32048,59617,445,0,0,drop,66,66,0,1,0,1,0
32049,59616,445,0,0,drop,66,66,0,1,0,1,0
32050,59357,445,0,0,drop,70,70,0,1,0,1,0
32051,64203,445,0,0,drop,70,70,0,1,0,1,0
32052,49855,36180,0,0,deny,62,62,0,1,0,1,0
32053,64198,445,0,0,drop,70,70,0,1,0,1,0
32054,64194,445,0,0,drop,70,70,0,1,0,1,0
32055,64193,445,0,0,drop,70,70,0,1,0,1,0
32056,59347,445,0,0,drop,70,70,0,1,0,1,0
32057,59346,445,0,0,drop,70,70,0,1,0,1,0
32058,59345,445,0,0,drop,70,70,0,1,0,1,0
32059,59609,445,0,0,drop,66,66,0,1,0,1,0
32060,59342,445,0,0,drop,70,70,0,1,0,1,0
32061,59340,445,0,0,drop,70,70,0,1,0,1,0
32062,50086,57470,0,0,deny,66,66,0,1,0,1,0
32063,60610,58414,0,0,deny,62,62,0,1,0,1,0
32064,26606,40108,0,0,deny,145,145,0,1,0,1,0
32065,59594,445,0,0,drop,66,66,0,1,0,1,0
32066,59593,445,0,0,drop,66,66,0,1,0,1,0
32067,59605,445,0,0,drop,66,66,0,1,0,1,0
32068,59599,445,0,0,drop,66,66,0,1,0,1,0
32069,59601,445,0,0,drop,66,66,0,1,0,1,0
32070,59600,445,0,0,drop,66,66,0,1,0,1,0
32071,59597,445,0,0,drop,66,66,0,1,0,1,0
32072,62819,56205,0,0,deny,62,62,0,1,0,1,0
32073,50245,44847,0,0,deny,66,66,0,1,0,1,0
32074,64190,445,0,0,drop,70,70,0,1,0,1,0
32075,24285,26467,0,0,deny,62,62,0,1,0,1,0
32076,55111,39004,0,0,deny,66,66,0,1,0,1,0
32077,28413,64147,0,0,deny,66,66,0,1,0,1,0
32078,64185,445,0,0,drop,70,70,0,1,0,1,0
32079,64183,445,0,0,drop,70,70,0,1,0,1,0
32080,64181,445,0,0,drop,70,70,0,1,0,1,0
32081,57173,44847,0,0,deny,62,62,0,1,0,1,0
32082,1024,57470,0,0,deny,72,72,0,1,0,1,0
32083,51812,1433,0,0,deny,60,60,0,1,0,1,0
32084,59334,445,0,0,drop,70,70,0,1,0,1,0
32085,24949,47563,0,0,deny,145,145,0,1,0,1,0
32086,3074,64147,0,0,deny,62,62,0,1,0,1,0
32087,24910,64147,0,0,deny,66,66,0,1,0,1,0
32088,22125,23,0,0,deny,60,60,0,1,0,1,0
32089,49514,39127,0,0,deny,162,162,0,1,0,1,0
32090,17378,44847,0,0,deny,66,66,0,1,0,1,0
32091,59327,445,0,0,drop,70,70,0,1,0,1,0
32092,64180,445,0,0,drop,70,70,0,1,0,1,0
32093,64177,445,0,0,drop,70,70,0,1,0,1,0
32094,64173,445,0,0,drop,70,70,0,1,0,1,0
32095,59326,445,0,0,drop,70,70,0,1,0,1,0
32096,59587,445,0,0,drop,66,66,0,1,0,1,0
32097,443,43775,0,0,deny,97,97,0,1,0,1,0
32098,64172,445,0,0,drop,70,70,0,1,0,1,0
32099,63988,50584,0,0,deny,66,66,0,1,0,1,0
32100,60141,62413,0,0,deny,66,66,0,1,0,1,0
32101,2180,63710,0,0,deny,62,62,0,1,0,1,0
32102,59585,445,0,0,drop,66,66,0,1,0,1,0
32103,1057,57470,0,0,deny,62,62,0,1,0,1,0
32104,59583,445,0,0,drop,66,66,0,1,0,1,0
32105,59582,445,0,0,drop,66,66,0,1,0,1,0
32106,59579,445,0,0,drop,66,66,0,1,0,1,0
32107,59321,445,0,0,drop,70,70,0,1,0,1,0
32108,60351,50584,0,0,deny,62,62,0,1,0,1,0
32109,59319,445,0,0,drop,70,70,0,1,0,1,0
32110,21750,39004,0,0,deny,66,66,0,1,0,1,0
32111,59486,50584,0,0,deny,62,62,0,1,0,1,0
32112,12737,35440,0,0,deny,62,62,0,1,0,1,0
32113,14042,22114,0,0,deny,62,62,0,1,0,1,0
32114,14042,22114,0,0,deny,146,146,0,1,0,1,0
32115,3023,40108,0,0,deny,148,148,0,1,0,1,0
32116,3068,36237,0,0,deny,62,62,0,1,0,1,0
32117,64164,445,0,0,drop,70,70,0,1,0,1,0
32118,56035,1310,0,0,deny,66,66,0,1,0,1,0
32119,37028,51505,0,0,deny,62,62,0,1,0,1,0
32120,58791,15503,0,0,deny,66,66,0,1,0,1,0
32121,12644,11392,0,0,deny,62,62,0,1,0,1,0
32122,59315,445,0,0,drop,70,70,0,1,0,1,0
32123,64159,445,0,0,drop,70,70,0,1,0,1,0
32124,64156,445,0,0,drop,70,70,0,1,0,1,0
32125,39287,57470,0,0,deny,62,62,0,1,0,1,0
32126,50806,51505,0,0,deny,66,66,0,1,0,1,0
32127,55854,54369,0,0,deny,74,74,0,1,0,1,0
32128,51996,57470,0,0,deny,66,66,0,1,0,1,0
32129,59313,445,0,0,drop,70,70,0,1,0,1,0
32130,1143,25198,0,0,deny,148,148,0,1,0,1,0
32131,59569,445,0,0,drop,66,66,0,1,0,1,0
32132,13285,29892,0,0,deny,145,145,0,1,0,1,0
32133,42964,5900,0,0,deny,60,60,0,1,0,1,0
32134,59309,445,0,0,drop,70,70,0,1,0,1,0
32135,59561,445,0,0,drop,66,66,0,1,0,1,0
32136,5087,22114,0,0,deny,66,66,0,1,0,1,0
32137,64144,445,0,0,drop,70,70,0,1,0,1,0
32138,25267,2323,0,0,deny,60,60,0,1,0,1,0
32139,65166,62413,0,0,deny,66,66,0,1,0,1,0
32140,59915,42707,0,0,deny,145,145,0,1,0,1,0
32141,59559,445,0,0,deny,66,66,0,1,0,1,0
32142,12260,51505,0,0,deny,62,62,0,1,0,1,0
32143,57468,57470,0,0,deny,66,66,0,1,0,1,0
32144,53766,51505,0,0,deny,62,62,0,1,0,1,0
32145,59552,445,0,0,drop,66,66,0,1,0,1,0
32146,45941,23386,0,0,deny,60,60,0,1,0,1,0
32147,45238,44847,0,0,deny,66,66,0,1,0,1,0
32148,19875,30170,0,0,deny,145,145,0,1,0,1,0
32149,59543,445,0,0,drop,66,66,0,1,0,1,0
32150,59296,445,0,0,drop,70,70,0,1,0,1,0
32151,14967,24855,0,0,reset-both,62,62,0,1,0,1,0
32152,59293,445,0,0,drop,70,70,0,1,0,1,0
32153,51413,57470,0,0,deny,72,72,0,1,0,1,0
32154,57302,62413,0,0,deny,66,66,0,1,0,1,0
32155,58076,21247,0,0,deny,62,62,0,1,0,1,0
32156,64134,445,0,0,drop,70,70,0,1,0,1,0
32157,64133,445,0,0,drop,70,70,0,1,0,1,0
32158,64132,445,0,0,drop,70,70,0,1,0,1,0
32159,35408,56205,0,0,deny,62,62,0,1,0,1,0
32160,59530,445,0,0,drop,66,66,0,1,0,1,0
32161,55644,53,49999,53,allow,184,94,90,2,30,1,1
32162,56104,53,14895,53,allow,204,104,100,2,30,1,1
32163,56751,53,17361,53,allow,752,93,659,2,30,1,1
32164,49563,53,8253,53,allow,200,102,98,2,30,1,1
32165,56879,53,15562,53,allow,744,95,649,2,30,1,1
32166,59904,443,14583,443,allow,694,370,324,12,34,7,5
32167,63900,42641,18797,42641,allow,504,382,122,8,16,6,2
32168,53141,8595,16874,8595,allow,70,70,0,1,5,1,0
32169,51950,17499,15514,17499,allow,70,70,0,2,8,2,0
32170,46861,15000,42443,15000,allow,130,70,60,2,5,1,1
32171,50286,443,3120,443,allow,8773,1538,7235,25,15,14,11
32172,65262,53,47231,53,allow,216,110,106,2,30,1,1
32173,36738,80,36738,80,allow,416,198,218,7,121,4,3
32174,63935,51413,5308,51413,allow,312,132,180,6,7,3,3
32175,50392,8080,50392,8080,allow,8962,4731,4231,26,75,14,12
32176,64862,53,32776,53,allow,206,105,101,2,30,1,1
32177,64872,53,35777,53,allow,164,84,80,2,30,1,1
32178,49251,443,56131,443,allow,15567,1944,13623,40,81,17,23
32179,49247,53,6509,53,allow,478,196,282,6,64,3,3
32180,55016,1113,36871,1113,allow,6723,1881,4842,25,16,15,10
32181,57364,53,57364,53,allow,213,79,134,2,32,1,1
32182,51700,7000,51700,7000,allow,2163,676,1487,14,15,7,7
32183,38848,80,21726,80,allow,288702,9850,278852,312,105,123,189
32184,55808,53,62686,53,allow,174,89,85,2,30,1,1
32185,55184,53,64437,53,allow,182,93,89,2,31,1,1
32186,57629,80,39284,80,allow,1115,534,581,12,16,7,5
32187,49245,53,3951,53,allow,190,97,93,2,31,1,1
32188,56943,80,45580,80,allow,2817,2024,793,12,75,7,5
32189,50406,8080,50406,8080,allow,47078,2874,44204,66,51,32,34
32190,60979,443,13590,443,allow,49981,8331,41650,75,48,36,39
32191,64200,53,60467,53,allow,186,95,91,2,30,1,1
32192,51107,80,61498,80,allow,366,240,126,7,21,5,2
32193,41061,5222,19047,5222,allow,107717,16808,90909,301,618,148,153
32194,59000,443,41990,443,allow,9876,5325,4551,25,131,14,11
32195,49692,53,19952,53,allow,208,106,102,2,30,1,1
32196,56998,443,56998,443,allow,4577,1670,2907,19,26,11,8
32197,49845,53,59006,53,allow,168,86,82,2,30,1,1
32198,56166,53,15904,53,allow,186,95,91,2,30,1,1
32199,56730,53,51057,53,allow,733,86,647,2,30,1,1
32200,65451,53,6208,53,allow,188,96,92,2,31,1,1
32201,56426,53,19941,53,allow,184,94,90,2,31,1,1
32202,60792,443,60792,443,allow,16401,8712,7689,53,297,25,28
32203,50972,3544,28007,3544,allow,258,107,151,2,31,1,1
32204,3819,80,3819,80,allow,9399,632,8767,15,15,7,8
32205,64460,53,62568,53,allow,192,98,94,2,31,1,1
32206,56041,53,27459,53,allow,174,89,85,2,31,1,1
32207,49480,53,49480,53,allow,213,79,134,2,32,1,1
32208,55000,443,17337,443,allow,134,60,74,3,10,2,1
32209,48885,53,48885,53,allow,215,80,135,2,32,1,1
32210,36307,80,3965,80,allow,1368,920,448,12,20,7,5
32211,59001,443,42456,443,allow,9860,5309,4551,25,131,14,11
32212,57071,443,54499,443,allow,20873,8800,12073,68,19,37,31
32213,5588,5588,0,0,allow,3354,1792,1562,46,194,23,23
32214,61503,443,25661,443,allow,182448,3931,178517,161,26,36,125
32215,49162,53,42033,53,allow,182,93,89,2,30,1,1
32216,55159,53,17196,53,allow,168,86,82,2,30,1,1
32217,49825,53,42990,53,allow,168,86,82,2,30,1,1
32218,49621,53,22875,53,allow,182,93,89,2,31,1,1
32219,38567,80,39974,80,allow,1571,877,694,11,181,6,5
32220,15503,14130,48221,14130,allow,480,149,331,2,1200,1,1
32221,56216,5228,61293,5228,allow,2495,1477,1018,17,3600,8,9
32222,55630,53,58025,53,allow,194,99,95,2,31,1,1
32223,58972,443,21151,443,allow,5979,3487,2492,21,168,10,11
32224,50049,443,7528,443,allow,27889,1445,26444,37,121,14,23
32225,40098,443,58425,443,allow,4564,3204,1360,19,348,10,9
32226,64473,53,45182,53,allow,184,94,90,2,31,1,1
32227,50037,53,57358,53,allow,190,97,93,2,30,1,1
32228,57416,53,52623,53,allow,186,95,91,2,30,1,1
32229,65107,53,21629,53,allow,186,95,91,2,31,1,1
32230,64036,53,10774,53,allow,182,93,89,2,31,1,1
32231,64475,53,56794,53,allow,184,94,90,2,31,1,1
32232,51957,53,51957,53,allow,825,99,726,2,31,1,1
32233,27005,30009,16373,30009,allow,889,126,763,2,31,1,1
32234,15755,53,15755,53,allow,241,95,146,2,31,1,1
32235,65144,53,52237,53,allow,204,104,100,2,31,1,1
32236,62275,443,20241,443,allow,18482489,568378,17914111,19386,214,6466,12920
32237,49188,53,21489,53,allow,777,87,690,2,31,1,1
32238,57397,53,25863,53,allow,182,93,89,2,31,1,1
32239,56144,53,58343,53,allow,176,90,86,2,31,1,1
32240,65049,53,59454,53,allow,184,94,90,2,31,1,1
32241,51221,10476,15636,10476,allow,528,528,0,9,1201,9,0
32242,62062,443,17723,443,allow,13499,2333,11166,24,137,10,14
32243,59534,445,0,0,drop,66,66,0,1,0,1,0
32244,59532,445,0,0,drop,66,66,0,1,0,1,0
32245,59527,445,0,0,drop,66,66,0,1,0,1,0
32246,59535,445,0,0,drop,66,66,0,1,0,1,0
32247,59528,445,0,0,drop,66,66,0,1,0,1,0
32248,59531,445,0,0,drop,66,66,0,1,0,1,0
32249,59529,445,0,0,drop,66,66,0,1,0,1,0
32250,17548,36829,0,0,deny,62,62,0,1,0,1,0
32251,9687,57470,0,0,deny,78,78,0,1,0,1,0
32252,1091,37965,0,0,deny,62,62,0,1,0,1,0
32253,59288,445,0,0,drop,70,70,0,1,0,1,0
32254,54866,37965,0,0,deny,62,62,0,1,0,1,0
32255,23415,11392,0,0,deny,66,66,0,1,0,1,0
32256,48857,50584,0,0,deny,66,66,0,1,0,1,0
32257,11256,47967,0,0,deny,143,143,0,1,0,1,0
32258,59287,445,0,0,drop,70,70,0,1,0,1,0
32259,8592,35993,0,0,deny,66,66,0,1,0,1,0
32260,51382,56205,0,0,deny,66,66,0,1,0,1,0
32261,24301,6881,0,0,deny,146,146,0,1,0,1,0
32262,10447,30317,0,0,deny,146,146,0,1,0,1,0
32263,59285,445,0,0,drop,70,70,0,1,0,1,0
32264,10480,26467,0,0,deny,62,62,0,1,0,1,0
32265,26323,50584,0,0,deny,146,146,0,1,0,1,0
32266,10477,44847,0,0,deny,62,62,0,1,0,1,0
32267,55644,53,55094,53,allow,184,94,90,2,30,1,1
32268,34154,443,26354,443,allow,45554,1695,43859,50,30,15,35
32269,1024,44847,0,0,deny,62,62,0,1,0,1,0
32270,13917,18033,0,0,deny,62,62,0,1,0,1,0
32271,55444,23,0,0,deny,60,60,0,1,0,1,0
32272,64131,445,0,0,drop,70,70,0,1,0,1,0
32273,64122,445,0,0,drop,70,70,0,1,0,1,0
32274,64123,445,0,0,drop,70,70,0,1,0,1,0
32275,64121,445,0,0,drop,70,70,0,1,0,1,0
32276,41734,57470,0,0,deny,62,62,0,1,0,1,0
32277,2464,50584,0,0,deny,66,66,0,1,0,1,0
32278,22409,55442,0,0,deny,74,74,0,1,0,1,0
32279,59514,445,0,0,drop,66,66,0,1,0,1,0
32280,59513,445,0,0,drop,66,66,0,1,0,1,0
32281,59512,445,0,0,drop,66,66,0,1,0,1,0
32282,56098,55442,0,0,deny,66,66,0,1,0,1,0
32283,59278,445,0,0,drop,70,70,0,1,0,1,0
32284,14336,64147,0,0,deny,62,62,0,1,0,1,0
32285,26601,22114,0,0,deny,66,66,0,1,0,1,0
32286,56218,43890,0,0,deny,66,66,0,1,0,1,0
32287,59276,445,0,0,drop,70,70,0,1,0,1,0
32288,9445,56205,0,0,deny,66,66,0,1,0,1,0
32289,20724,19750,0,0,deny,78,78,0,1,0,1,0
32290,64112,445,0,0,drop,70,70,0,1,0,1,0
32291,51429,22114,0,0,deny,66,66,0,1,0,1,0
32292,59275,445,0,0,drop,70,70,0,1,0,1,0
32293,56413,53,33044,53,allow,338,110,228,2,30,1,1
32294,56785,53,32079,53,allow,193,102,91,2,30,1,1
32295,57416,53,15222,53,allow,193,102,91,2,30,1,1
32296,64862,53,5762,53,allow,211,110,101,2,30,1,1
32297,39890,443,25429,443,allow,18127,8010,10117,41,116,24,17
32298,49552,80,31507,80,allow,1963,1067,896,11,15,6,5
32299,56690,443,7139,443,allow,7914,1925,5989,20,15,11,9
32300,58740,443,9858,443,allow,5228,700,4528,17,14,7,10
32301,60778,40010,59381,40010,allow,316,136,180,6,6,3,3
32302,57069,443,33403,443,allow,15125,2482,12643,53,38,27,26
32303,49663,53,4720,53,allow,195,102,93,2,29,1,1
32304,55828,53,62076,53,allow,181,94,87,2,29,1,1
32305,55344,53,42459,53,allow,212,110,102,2,29,1,1
32306,64534,53,57803,53,allow,214,110,104,2,30,1,1
32307,56824,443,13725,443,allow,18356,13354,5002,47,34,29,18
32308,49554,443,18292,443,allow,7540,1840,5700,18,15,10,8
32309,56317,53,56317,53,allow,216,82,134,2,32,1,1
32310,39326,53,39326,53,allow,233,90,143,2,32,1,1
32311,27005,32063,51455,32063,allow,889,126,763,3,31,2,1
32312,54677,443,22432,443,allow,10029,4115,5914,31,61,17,14
32313,50010,80,40489,80,allow,5058,4299,759,11,27,6,5
32314,46851,443,41590,443,allow,3998,1986,2012,20,255,10,10
32315,51962,1024,18199,1024,allow,316,136,180,6,5,3,3
32316,36821,443,10604,443,allow,5948,1553,4395,16,15,10,6
32317,65189,53,21618,53,allow,734,94,640,2,29,1,1
32318,49162,53,39735,53,allow,183,94,89,2,29,1,1
32319,58997,443,10081,443,allow,70,70,0,1,4,1,0
32320,64588,53,11970,53,allow,193,102,91,2,29,1,1
32321,42847,443,14614,443,allow,162,102,60,2,4,1,1
32322,65246,53,9355,53,allow,179,94,85,2,29,1,1
32323,46660,443,53403,443,allow,13699,2575,11124,30,135,15,15
32324,27691,53,27691,53,allow,235,90,145,2,32,1,1
32325,56444,53,36861,53,allow,730,102,628,2,29,1,1
32326,63960,53,45995,53,allow,178,94,84,2,30,1,1
32327,55830,53,49103,53,allow,184,94,90,2,29,1,1
32328,56415,53,18388,53,allow,179,94,85,2,29,1,1
32329,55155,53,2864,53,allow,183,94,89,2,29,1,1
32330,50156,53,35377,53,allow,178,94,84,2,29,1,1
32331,55533,53,54545,53,allow,183,94,89,2,29,1,1
32332,64244,53,64721,53,allow,199,102,97,2,29,1,1
32333,55155,53,64785,53,allow,183,94,89,2,29,1,1
32334,55130,53,39778,53,allow,216,110,106,2,29,1,1
32335,65042,53,26467,53,allow,183,94,89,2,29,1,1
32336,55822,53,10353,53,allow,324,126,198,2,30,1,1
32337,64837,53,39780,53,allow,195,102,93,2,30,1,1
32338,56687,443,42301,443,allow,7889,1900,5989,20,15,11,9
32339,49421,443,23073,443,allow,301494,6917,294577,306,48,101,205
32340,53853,53,0,0,allow,139,70,69,2,30,1,1
32341,65262,53,31670,53,allow,216,110,106,2,30,1,1
32342,56426,53,49161,53,allow,184,94,90,2,30,1,1
32343,64818,53,61380,53,allow,260,102,158,2,30,1,1
32344,64473,53,9936,53,allow,184,94,90,2,30,1,1
32345,64862,53,39051,53,allow,211,110,101,2,30,1,1
32346,49563,53,27885,53,allow,200,102,98,2,30,1,1
32347,51923,80,55461,80,allow,60441,6260,54181,79,29,35,44
32348,39910,80,12870,80,allow,1658,1344,314,10,15,5,5
32349,64460,53,29713,53,allow,196,102,94,2,30,1,1
32350,50553,443,23117,443,allow,1632,1023,609,16,133,9,7
32351,51927,63309,60569,63309,allow,70,70,0,1,5,1,0
32352,51920,80,17031,80,allow,5069,4443,626,11,30,6,5
32353,37611,443,45731,443,allow,11038,3875,7163,33,16,18,15
32354,57986,80,14489,80,allow,1898,1524,374,14,15,8,6
32355,64416,53,56387,53,allow,291,110,181,2,30,1,1
32356,2874,53,2874,53,allow,216,82,134,2,31,1,1
32357,37608,443,50721,443,allow,7866,2680,5186,26,16,14,12
32358,56889,53,22522,53,allow,211,110,101,2,30,1,1
32359,56358,53,65243,53,allow,210,110,100,2,33,1,1
32360,50664,443,33919,443,allow,9666,1682,7984,25,16,13,12
32361,49310,53,37425,53,allow,239,102,137,2,30,1,1
32362,51928,52520,11257,52520,allow,70,70,0,1,5,1,0
32363,58058,80,25761,80,allow,318,192,126,6,21,4,2
32364,56689,443,16946,443,allow,7890,1901,5989,20,15,11,9
32365,65246,53,26370,53,allow,179,94,85,2,30,1,1
32366,56688,443,60189,443,allow,7942,1953,5989,20,15,11,9
32367,56673,53,10759,53,allow,193,102,91,2,30,1,1
32368,64534,53,35373,53,allow,214,110,104,2,30,1,1
32369,64795,53,2622,53,allow,338,110,228,2,30,1,1
32370,65451,53,62075,53,allow,194,102,92,2,30,1,1
32371,64897,53,54215,53,allow,312,94,218,2,30,1,1
32372,49245,53,24840,53,allow,195,102,93,2,30,1,1
32373,49419,53,29016,53,allow,252,102,150,2,30,1,1
32374,65512,53,38019,53,allow,265,102,163,2,30,1,1
32375,55533,53,2426,53,allow,183,94,89,2,30,1,1
32376,56673,53,26407,53,allow,193,102,91,2,30,1,1
32377,37965,48477,53954,48477,allow,7097,4720,2377,89,3163,55,34
32378,49692,53,65365,53,allow,212,110,102,2,30,1,1
32379,64666,53,52653,53,allow,226,102,124,2,30,1,1
32380,51929,53371,28667,53371,allow,70,70,0,1,5,1,0
32381,51109,80,7098,80,allow,366,240,126,7,20,5,2
32382,39687,443,29168,443,allow,10412,5123,5289,36,236,19,17
32383,64200,53,27722,53,allow,193,102,91,2,30,1,1
32384,64200,53,25588,53,allow,193,102,91,2,30,1,1
32385,65107,53,27622,53,allow,193,102,91,2,30,1,1
32386,49692,53,33543,53,allow,212,110,102,2,30,1,1
32387,54453,443,34094,443,allow,257837,37453,220384,446,952,175,271
32388,59945,443,18013,443,allow,10477,3435,7042,34,20,18,16
32389,57336,443,14468,443,allow,6956,2856,4100,28,16,16,12
32390,35196,5222,52205,5222,allow,3376,1509,1867,32,83,16,16
32391,59754,80,41353,80,allow,1352,848,504,13,83,8,5
32392,64041,53,42434,53,allow,198,94,104,2,30,1,1
32393,49692,53,30173,53,allow,212,110,102,2,30,1,1
32394,63960,53,27823,53,allow,178,94,84,2,30,1,1
32395,56532,53,37108,53,allow,164,86,78,2,30,1,1
32396,49671,53,34167,53,allow,242,110,132,2,30,1,1
32397,27005,30006,1523,30006,allow,888,126,762,2,31,1,1
32398,6881,6881,14892,6881,allow,502,150,352,2,1200,1,1
32399,37877,80,30834,80,allow,991,483,508,9,181,5,4
32400,27005,33038,15973,33038,allow,892,126,766,2,31,1,1
32401,49327,443,33965,443,allow,54335,2550,51785,74,42,29,45
32402,54075,443,31475,443,allow,76388,4341,72047,107,169,48,59
32403,49551,80,48076,80,allow,1769,873,896,11,15,6,5
32404,54074,443,19199,443,allow,72465,3991,68474,98,169,43,55
32405,49553,443,65490,443,allow,6074,865,5209,16,15,9,7
32406,51952,50967,36786,50967,allow,70,70,0,2,7,2,0
32407,57436,66,13833,66,allow,70,70,0,2,7,2,0
32408,51325,443,47264,443,allow,2019,1219,800,15,17,8,7
32409,51954,12380,62025,12380,allow,70,70,0,2,7,2,0
32410,53739,27290,28914,27290,allow,70,70,0,1,4,1,0
32411,56661,53,7946,53,allow,297,102,195,4,33,2,2
32412,53720,443,39047,443,allow,11338,7078,4260,19,16,12,7
32413,64627,53,53750,53,allow,305,101,204,4,44,2,2
32414,50554,443,37415,443,allow,7343,1707,5636,26,134,14,12
32415,49828,53,44800,53,allow,733,86,647,2,29,1,1
32416,58999,443,40792,443,allow,9569,2606,6963,22,135,11,11
32417,56166,53,54206,53,allow,193,102,91,2,29,1,1
32418,41764,53,7946,53,allow,168,78,90,2,29,1,1
32419,64872,53,24466,53,allow,730,102,628,2,29,1,1
32420,51110,80,59490,80,allow,1524,1028,496,10,20,7,3
32421,57177,53,20677,53,allow,179,94,85,2,29,1,1
32422,63902,22928,21119,22928,allow,504,382,122,8,15,6,2
32423,49372,53,4796,53,allow,527,208,319,6,64,3,3
32424,56627,53,58271,53,allow,193,102,91,2,29,1,1
32425,55867,53,51725,53,allow,184,94,90,2,29,1,1
32426,49216,53,14364,53,allow,181,94,87,2,30,1,1
32427,49162,53,33526,53,allow,183,94,89,2,30,1,1
32428,49940,53,16387,53,allow,257,110,147,2,29,1,1
32429,55126,53,61612,53,allow,193,102,91,2,29,1,1
32430,55184,53,59449,53,allow,183,94,89,2,30,1,1
32431,56889,53,49457,53,allow,211,110,101,2,30,1,1
32432,49372,53,58789,53,allow,216,110,106,2,30,1,1
32433,56104,53,19874,53,allow,210,110,100,2,30,1,1
32434,65262,53,52236,53,allow,216,110,106,2,30,1,1
32435,49864,53,63965,53,allow,193,102,91,2,30,1,1
32436,27005,33059,8397,33059,allow,900,126,774,2,31,1,1
32437,64460,53,42311,53,allow,196,102,94,2,31,1,1
32438,49825,53,56726,53,allow,168,86,82,2,30,1,1
32439,64036,53,20328,53,allow,183,94,89,2,30,1,1
32440,32675,53,58212,53,allow,218,78,140,2,30,1,1
32441,65144,53,10538,53,allow,210,110,100,2,30,1,1
32442,49669,53,30235,53,allow,197,94,103,2,30,1,1
32443,27005,32078,44538,32078,allow,871,126,745,2,31,1,1
32444,56170,443,45296,443,allow,9201,4926,4275,19,120,10,9
32445,51539,443,52838,443,allow,94949,5974,88975,118,148,45,73
32446,55035,443,8425,443,allow,5653,2347,3306,33,361,18,15
32447,49435,53,45474,53,allow,720,94,626,2,30,1,1
32448,42846,443,19024,443,allow,162,102,60,2,5,1,1
32449,49247,53,7662,53,allow,478,196,282,6,63,3,3
32450,36483,80,36483,80,allow,1015966,37923,978043,1167,205,468,699
32451,39689,443,12729,443,allow,7259,3893,3366,34,236,18,16
32452,56673,53,29686,53,allow,193,102,91,2,30,1,1
32453,56041,53,26244,53,allow,179,94,85,2,30,1,1
32454,57416,53,53787,53,allow,193,102,91,2,30,1,1
32455,64417,53,10923,53,allow,231,102,129,2,30,1,1
32456,64555,53,55605,53,allow,167,86,81,2,30,1,1
32457,65262,53,62763,53,allow,216,110,106,2,30,1,1
32458,49216,53,15355,53,allow,181,94,87,2,30,1,1
32459,65176,53,39241,53,allow,193,102,91,2,30,1,1
32460,64862,53,53283,53,allow,211,110,101,2,30,1,1
32461,53262,443,28483,443,allow,4385,2869,1516,32,19,18,14
32462,49770,80,9129,80,allow,254,128,126,5,15,3,2
32463,52297,443,5562,443,allow,3055,1931,1124,16,16,9,7
32464,65246,53,35369,53,allow,179,94,85,2,30,1,1
32465,34153,443,49528,443,allow,7037,1282,5755,21,30,11,10
32466,55126,53,18152,53,allow,193,102,91,2,30,1,1
32467,64911,53,45523,53,allow,209,110,99,2,30,1,1
32468,65523,53,26977,53,allow,228,94,134,2,30,1,1
32469,64200,53,53095,53,allow,193,102,91,2,30,1,1
32470,57052,443,57052,443,allow,4616,1709,2907,19,28,11,8
32471,53261,443,49163,443,allow,12912,4288,8624,43,20,22,21
32472,50405,8080,50405,8080,allow,3985,2010,1975,17,51,10,7
32473,63939,24867,28601,24867,allow,312,132,180,6,6,3,3
32474,51951,65387,56923,65387,allow,70,70,0,2,8,2,0
32475,44158,443,51060,443,allow,232,172,60,3,5,2,1
32476,55130,53,20364,53,allow,216,110,106,2,30,1,1
32477,55344,53,59156,53,allow,212,110,102,2,30,1,1
32478,57038,53,2434,53,allow,186,102,84,2,30,1,1
32479,56387,53,17582,53,allow,183,94,89,2,30,1,1
32480,49235,53,22418,53,allow,172,94,78,2,30,1,1
32481,63960,53,31296,53,allow,178,94,84,2,30,1,1
32482,64514,53,1734,53,allow,209,102,107,2,30,1,1
32483,55630,53,39473,53,allow,197,102,95,2,30,1,1
32484,49864,53,57559,53,allow,193,102,91,2,30,1,1
32485,56041,53,56903,53,allow,179,94,85,2,30,1,1
32486,27005,33035,15064,33035,allow,864,126,738,2,31,1,1
32487,64473,53,39348,53,allow,184,94,90,2,31,1,1
32488,55184,53,63377,53,allow,183,94,89,2,30,1,1
32489,65025,53,23591,53,allow,347,94,253,2,30,1,1
32490,27005,33076,50946,33076,allow,889,126,763,2,31,1,1
32491,53829,53,12567,53,allow,258,86,172,2,31,1,1
32492,27005,50003,14417,50003,allow,887,126,761,2,31,1,1
32493,65451,53,9650,53,allow,194,102,92,2,31,1,1
32494,65107,53,31681,53,allow,193,102,91,2,31,1,1
32495,64319,53,34050,53,allow,193,102,91,2,31,1,1
32496,65251,53,39893,53,allow,179,94,85,2,31,1,1
32497,64619,53,39601,53,allow,179,94,85,2,31,1,1
32498,64872,53,64528,53,allow,166,86,80,2,31,1,1
32499,50037,53,63751,53,allow,195,102,93,2,31,1,1
32500,49501,53,63385,53,allow,193,102,91,2,31,1,1
32501,63035,443,64744,443,allow,1864,250,1614,8,120,4,4
32502,34319,443,65277,443,allow,15358,11148,4210,93,423,51,42
32503,58847,443,11614,443,allow,7014,1630,5384,20,120,10,10
32504,57603,80,12542,80,allow,886,886,0,1,120,1,0
32505,37484,443,55128,443,allow,59233,7514,51719,70,122,27,43
32506,6881,6889,64062,6889,allow,228,118,110,2,1199,1,1
32507,57470,52215,48091,52215,allow,528,528,0,9,1200,9,0
32508,52839,443,27104,443,allow,11808,5409,6399,73,123,33,40
32509,50037,53,12005,53,allow,195,102,93,2,30,1,1
32510,55630,53,11814,53,allow,197,102,95,2,30,1,1
32511,27005,33052,60950,33052,allow,873,126,747,2,31,1,1
32512,50972,3544,56182,3544,allow,409,107,302,4,31,2,2
32513,64070,53,32128,53,allow,243,94,149,2,31,1,1
32514,55184,53,41873,53,allow,183,94,89,2,31,1,1
32515,55456,443,5231,443,allow,7409,2302,5107,19,135,9,10
32516,56686,443,39990,443,allow,7941,1952,5989,20,16,11,9
32517,49216,53,46478,53,allow,316,91,225,4,32,2,2
32518,55669,62781,37625,62781,allow,320,140,180,6,7,3,3
32519,51949,5484,1068,5484,allow,70,70,0,2,8,2,0
32520,53734,22051,14778,22051,allow,70,70,0,1,5,1,0
32521,51052,80,32804,80,allow,5678,1692,3986,13,17,8,5
32522,39333,443,52867,443,allow,7832,1895,5937,24,83,14,10
32523,51957,56737,56106,56737,allow,316,136,180,6,6,3,3
32524,38346,80,22623,80,allow,1818,1504,314,13,16,8,5
32525,42317,443,11761,443,allow,416,210,206,7,27,4,3
32526,51504,443,9734,443,allow,6656,769,5887,14,16,9,5
32527,62514,37807,0,0,deny,66,66,0,1,0,1,0
32528,64104,445,0,0,drop,70,70,0,1,0,1,0
32529,64103,445,0,0,drop,70,70,0,1,0,1,0
32530,64102,445,0,0,drop,70,70,0,1,0,1,0
32531,47201,44847,0,0,deny,66,66,0,1,0,1,0
32532,59274,445,0,0,drop,70,70,0,1,0,1,0
32533,59273,445,0,0,drop,70,70,0,1,0,1,0
32534,10145,21247,0,0,deny,62,62,0,1,0,1,0
32535,59271,445,0,0,drop,70,70,0,1,0,1,0
32536,59267,445,0,0,drop,70,70,0,1,0,1,0
32537,44459,37807,0,0,deny,62,62,0,1,0,1,0
32538,11061,4229,0,0,deny,145,145,0,1,0,1,0
32539,59255,445,0,0,drop,70,70,0,1,0,1,0
32540,59254,445,0,0,drop,70,70,0,1,0,1,0
32541,1560,51505,0,0,deny,62,62,0,1,0,1,0
32542,59251,445,0,0,drop,70,70,0,1,0,1,0
32543,59244,445,0,0,drop,70,70,0,1,0,1,0
32544,59245,445,0,0,drop,70,70,0,1,0,1,0
32545,49522,21247,0,0,deny,66,66,0,1,0,1,0
32546,18224,23,0,0,deny,60,60,0,1,0,1,0
32547,64094,445,0,0,drop,70,70,0,1,0,1,0
32548,64093,445,0,0,drop,70,70,0,1,0,1,0
32549,64092,445,0,0,drop,70,70,0,1,0,1,0
32550,11907,57470,0,0,deny,66,66,0,1,0,1,0
32551,62257,2767,0,0,deny,66,66,0,1,0,1,0
32552,46837,57470,0,0,deny,62,62,0,1,0,1,0
32553,27309,6881,0,0,deny,146,146,0,1,0,1,0
32554,59503,445,0,0,drop,66,66,0,1,0,1,0
32555,37837,37965,0,0,deny,62,62,0,1,0,1,0
32556,55027,48051,0,0,deny,62,62,0,1,0,1,0
32557,52459,33890,0,0,deny,60,60,0,1,0,1,0
32558,52252,46314,0,0,deny,62,62,0,1,0,1,0
32559,56101,57470,0,0,deny,66,66,0,1,0,1,0
32560,62143,23,0,0,deny,60,60,0,1,0,1,0
32561,59233,445,0,0,drop,70,70,0,1,0,1,0
32562,64087,445,0,0,drop,70,70,0,1,0,1,0
32563,64084,445,0,0,drop,70,70,0,1,0,1,0
32564,61392,50584,0,0,deny,62,62,0,1,0,1,0
32565,59487,445,0,0,drop,66,66,0,1,0,1,0
32566,59486,445,0,0,drop,66,66,0,1,0,1,0
32567,59228,445,0,0,drop,70,70,0,1,0,1,0
32568,49113,50584,0,0,deny,66,66,0,1,0,1,0
32569,65398,7129,0,0,deny,66,66,0,1,0,1,0
32570,6404,64147,0,0,deny,145,145,0,1,0,1,0
32571,59220,445,0,0,drop,70,70,0,1,0,1,0
32572,59219,445,0,0,drop,70,70,0,1,0,1,0
32573,59218,445,0,0,drop,70,70,0,1,0,1,0
32574,31745,2323,0,0,deny,60,60,0,1,0,1,0
32575,64073,445,0,0,drop,70,70,0,1,0,1,0
32576,60557,23117,0,0,deny,66,66,0,1,0,1,0
32577,59215,445,0,0,drop,70,70,0,1,0,1,0
32578,59213,445,0,0,drop,70,70,0,1,0,1,0
32579,64070,445,0,0,drop,70,70,0,1,0,1,0
32580,64068,445,0,0,drop,70,70,0,1,0,1,0
32581,64067,445,0,0,drop,70,70,0,1,0,1,0
32582,443,45940,0,0,deny,85,85,0,1,0,1,0
32583,59481,445,0,0,drop,66,66,0,1,0,1,0
32584,50920,60182,0,0,deny,66,66,0,1,0,1,0
32585,59476,445,0,0,drop,66,66,0,1,0,1,0
32586,59475,445,0,0,drop,66,66,0,1,0,1,0
32587,59474,445,0,0,drop,66,66,0,1,0,1,0
32588,59466,445,0,0,drop,66,66,0,1,0,1,0
32589,59470,445,0,0,drop,66,66,0,1,0,1,0
32590,59467,445,0,0,drop,66,66,0,1,0,1,0
32591,59465,445,0,0,drop,66,66,0,1,0,1,0
32592,64824,36829,0,0,deny,66,66,0,1,0,1,0
32593,52914,37965,0,0,deny,66,66,0,1,0,1,0
32594,64059,445,0,0,drop,70,70,0,1,0,1,0
32595,16387,8455,0,0,deny,60,60,0,1,0,1,0
32596,16387,49252,0,0,deny,60,60,0,1,0,1,0
32597,16387,35244,0,0,deny,60,60,0,1,0,1,0
32598,50675,56205,0,0,deny,66,66,0,1,0,1,0
32599,64057,445,0,0,drop,70,70,0,1,0,1,0
32600,64056,445,0,0,drop,70,70,0,1,0,1,0
32601,64053,445,0,0,drop,70,70,0,1,0,1,0
32602,4110,35440,0,0,deny,66,66,0,1,0,1,0
32603,6666,5000,0,0,deny,60,60,0,1,0,1,0
32604,59206,445,0,0,drop,70,70,0,1,0,1,0
32605,59413,51505,0,0,deny,66,66,0,1,0,1,0
32606,63956,38211,0,0,deny,62,62,0,1,0,1,0
32607,41756,56205,0,0,deny,62,62,0,1,0,1,0
32608,59199,445,0,0,drop,70,70,0,1,0,1,0
32609,59197,445,0,0,drop,70,70,0,1,0,1,0
32610,39324,64147,0,0,deny,62,62,0,1,0,1,0
32611,64052,445,0,0,drop,70,70,0,1,0,1,0
32612,64049,445,0,0,drop,70,70,0,1,0,1,0
32613,64045,445,0,0,drop,70,70,0,1,0,1,0
32614,59458,445,0,0,drop,66,66,0,1,0,1,0
32615,57765,2767,0,0,deny,146,146,0,1,0,1,0
32616,64044,445,0,0,drop,70,70,0,1,0,1,0
32617,59456,445,0,0,drop,66,66,0,1,0,1,0
32618,59193,445,0,0,drop,70,70,0,1,0,1,0
32619,59454,445,0,0,drop,66,66,0,1,0,1,0
32620,59452,445,0,0,drop,66,66,0,1,0,1,0
32621,59191,445,0,0,drop,70,70,0,1,0,1,0
32622,16477,37807,0,0,deny,66,66,0,1,0,1,0
32623,59450,445,0,0,drop,66,66,0,1,0,1,0
32624,12031,36237,0,0,deny,66,66,0,1,0,1,0
32625,33003,28543,0,0,deny,62,62,0,1,0,1,0
32626,5132,23,0,0,deny,60,60,0,1,0,1,0
32627,54389,28543,0,0,deny,66,66,0,1,0,1,0
32628,36893,67,0,0,deny,60,60,0,1,0,1,0
32629,10445,46824,0,0,deny,62,62,0,1,0,1,0
32630,53725,64147,0,0,deny,66,66,0,1,0,1,0
32631,59187,445,0,0,drop,70,70,0,1,0,1,0
32632,65344,46824,0,0,deny,66,66,0,1,0,1,0
32633,50,38211,0,0,deny,66,66,0,1,0,1,0
32634,64037,445,0,0,drop,70,70,0,1,0,1,0
32635,64030,445,0,0,drop,70,70,0,1,0,1,0
32636,64029,445,0,0,drop,70,70,0,1,0,1,0
32637,59186,445,0,0,drop,70,70,0,1,0,1,0
32638,1054,57470,0,0,deny,62,62,0,1,0,1,0
32639,57368,7302,0,0,deny,66,66,0,1,0,1,0
32640,57170,38303,0,0,deny,66,66,0,1,0,1,0
32641,59440,445,0,0,drop,66,66,0,1,0,1,0
32642,59181,445,0,0,drop,70,70,0,1,0,1,0
32643,63527,50584,0,0,deny,62,62,0,1,0,1,0
32644,51320,37965,0,0,deny,62,62,0,1,0,1,0
32645,59432,445,0,0,drop,66,66,0,1,0,1,0
32646,64017,445,0,0,drop,70,70,0,1,0,1,0
32647,58745,30188,0,0,deny,66,66,0,1,0,1,0
32648,19841,50584,0,0,deny,62,62,0,1,0,1,0
32649,59429,445,0,0,drop,66,66,0,1,0,1,0
32650,26448,9192,0,0,deny,145,145,0,1,0,1,0
32651,39098,51505,0,0,deny,62,62,0,1,0,1,0
32652,13413,44847,0,0,deny,66,66,0,1,0,1,0
32653,16382,17500,0,0,deny,62,62,0,1,0,1,0
32654,59168,445,0,0,drop,70,70,0,1,0,1,0
32655,59422,445,0,0,drop,66,66,0,1,0,1,0
32656,51503,443,40605,443,allow,4801,702,4099,13,16,8,5
32657,38234,443,15725,443,allow,9807,2542,7265,47,19,24,23
32658,26929,443,8333,443,allow,7487,2728,4759,25,19,13,12
32659,50272,443,27135,443,allow,772,432,340,12,18,7,5
32660,42277,443,42277,443,allow,2200,1253,947,23,76,12,11
32661,49041,443,30685,443,allow,5144,847,4297,16,132,9,7
32662,59778,443,59778,443,allow,4580,1673,2907,19,28,11,8
32663,43311,80,24777,80,allow,811,671,140,6,31,4,2
32664,56572,53,56572,53,allow,253,99,154,2,32,1,1
32665,54319,53,54319,53,allow,253,99,154,2,32,1,1
32666,53732,22704,15296,22704,allow,70,70,0,1,5,1,0
32667,42282,443,42282,443,allow,2052,1187,865,21,76,11,10
32668,42280,443,42280,443,allow,2052,1187,865,21,76,11,10
32669,56722,80,63327,80,allow,41658,23230,18428,114,798,66,48
32670,64912,53,12678,53,allow,182,93,89,2,31,1,1
32671,56468,53,8242,53,allow,176,90,86,2,30,1,1
32672,47819,443,19809,443,allow,6258,956,5302,20,16,11,9
32673,60380,443,29465,443,allow,70,70,0,1,5,1,0
32674,53737,51456,42714,51456,allow,70,70,0,1,5,1,0
32675,47326,443,40388,443,allow,6318,1025,5293,17,33,9,8
32676,34141,53,34141,53,allow,217,87,130,2,30,1,1
32677,64319,53,16100,53,allow,186,95,91,2,30,1,1
32678,49501,53,44593,53,allow,186,95,91,2,31,1,1
32679,62439,443,62439,443,allow,4507,1600,2907,19,26,11,8
32680,39232,53,39232,53,allow,215,80,135,2,32,1,1
32681,11919,53,11919,53,allow,213,79,134,2,32,1,1
32682,54012,443,7741,443,allow,4318,726,3592,14,16,7,7
32683,54182,443,54182,443,allow,4581,1674,2907,19,29,11,8
32684,36548,443,36548,443,allow,4621,1714,2907,19,30,11,8
32685,5180,80,5180,80,allow,33443,797,32646,33,16,9,24
32686,50494,443,62791,443,allow,5331564,43954,5287610,4171,80,672,3499
32687,49837,53,8590,53,allow,176,90,86,2,30,1,1
32688,6881,6881,38378,6881,allow,231,111,120,2,1200,1,1
32689,51221,50861,60298,50861,allow,490,149,341,2,1200,1,1
32690,64357,53,4119,53,allow,182,93,89,2,31,1,1
32691,58467,53,16449,53,allow,235,95,140,2,31,1,1
32692,47744,80,34323,80,allow,1571,877,694,11,180,6,5
32693,49274,53,46367,53,allow,194,99,95,2,31,1,1
32694,49312,53,34351,53,allow,767,102,665,2,31,1,1
32695,32912,53,0,0,allow,82,82,0,1,31,1,0
32696,56395,53,20688,53,allow,170,87,83,2,31,1,1
32697,49385,31652,0,0,allow,66,66,0,1,91,1,0
32698,65524,53,51364,53,allow,182,93,89,2,31,1,1
32699,30960,45740,3924,45740,allow,330,330,0,6,3609,6,0
32700,59414,445,0,0,drop,66,66,0,1,0,1,0
32701,59165,445,0,0,drop,70,70,0,1,0,1,0
32702,28875,51505,0,0,deny,146,146,0,1,0,1,0
32703,43578,15503,0,0,deny,74,74,0,1,0,1,0
32704,57706,64147,0,0,deny,62,62,0,1,0,1,0
32705,64006,445,0,0,drop,70,70,0,1,0,1,0
32706,63459,443,62292,443,allow,7782,1280,6502,22,79,10,12
32707,64005,445,0,0,drop,70,70,0,1,0,1,0
32708,64004,445,0,0,drop,70,70,0,1,0,1,0
32709,59161,445,0,0,drop,70,70,0,1,0,1,0
32710,59402,445,0,0,drop,66,66,0,1,0,1,0
32711,59403,445,0,0,drop,66,66,0,1,0,1,0
32712,59404,445,0,0,drop,66,66,0,1,0,1,0
32713,59401,445,0,0,drop,66,66,0,1,0,1,0
32714,59405,445,0,0,drop,66,66,0,1,0,1,0
32715,59398,445,0,0,drop,66,66,0,1,0,1,0
32716,59399,445,0,0,drop,66,66,0,1,0,1,0
32717,59400,445,0,0,drop,66,66,0,1,0,1,0
32718,30135,37965,0,0,deny,62,62,0,1,0,1,0
32719,59876,44847,0,0,deny,66,66,0,1,0,1,0
32720,64104,22114,0,0,deny,66,66,0,1,0,1,0
32721,59159,445,0,0,drop,70,70,0,1,0,1,0
32722,64449,30188,0,0,deny,66,66,0,1,0,1,0
32723,54825,444,0,0,deny,60,60,0,1,0,1,0
32724,44922,57470,0,0,deny,74,74,0,1,0,1,0
32725,51926,58664,64074,58664,allow,70,70,0,1,5,1,0
32726,51502,443,41545,443,allow,7211,823,6388,16,15,10,6
32727,65322,443,20624,443,allow,8429792,268889,8160903,8985,135,2983,6002
32728,49245,53,23757,53,allow,195,102,93,2,30,1,1
32729,65107,53,53716,53,allow,193,102,91,2,30,1,1
32730,64619,53,61367,53,allow,438,89,349,4,44,2,2
32731,36699,443,33647,443,allow,11086707,166045,10920662,9176,172,1285,7891
32732,62348,443,31303,443,allow,1592,965,627,15,20,7,8
32733,55662,36445,15210,36445,allow,504,318,186,8,17,5,3
32734,49621,53,6731,53,allow,501,188,313,6,33,3,3
32735,53735,58869,24687,58869,allow,70,70,0,1,4,1,0
32736,53704,443,40944,443,allow,5743,1339,4404,18,180,8,10
32737,18743,53,18743,53,allow,235,90,145,2,31,1,1
32738,56919,443,47014,443,allow,54568,32686,21882,69,161,40,29
32739,48608,443,46175,443,allow,6371,848,5523,20,16,11,9
32740,44559,443,29969,443,allow,6903,1185,5718,26,255,12,14
32741,38689,443,13215,443,allow,1264333,25315,1239018,1197,16,355,842
32742,63930,44330,64385,44330,allow,66,66,0,2,7,2,0
32743,53736,37168,63835,37168,allow,70,70,0,1,4,1,0
32744,36166,80,26343,80,allow,1614,1300,314,10,15,5,5
32745,49621,53,59180,53,allow,287,93,194,4,56,2,2
32746,49864,53,49733,53,allow,193,102,91,2,29,1,1
32747,13826,443,17437,443,allow,7356,1014,6342,20,75,10,10
32748,57397,53,11845,53,allow,183,94,89,2,29,1,1
32749,64172,53,13713,53,allow,197,102,95,2,29,1,1
32750,5588,5588,0,0,allow,3354,1792,1562,46,193,23,23
32751,49621,53,9845,53,allow,183,94,89,2,29,1,1
32752,49825,53,31559,53,allow,168,86,82,2,29,1,1
32753,59402,53,59402,53,allow,216,90,126,2,29,1,1
32754,65332,53,1654,53,allow,226,86,140,2,29,1,1
32755,49563,53,41117,53,allow,200,102,98,2,29,1,1
32756,49837,53,4839,53,allow,180,94,86,2,29,1,1
32757,57397,53,24712,53,allow,183,94,89,2,30,1,1
32758,56426,53,8485,53,allow,184,94,90,2,30,1,1
32759,51925,29587,19217,29587,allow,70,70,0,1,5,1,0
32760,56936,80,5916,80,allow,1490,886,604,10,75,6,4
32761,63896,80,57609,80,allow,314,192,122,6,15,4,2
32762,64319,53,2772,53,allow,193,102,91,2,30,1,1
32763,49164,53,54796,53,allow,226,102,124,2,30,1,1
32764,64912,53,47656,53,allow,183,94,89,2,30,1,1
32765,51890,80,53517,80,allow,7097,3553,3544,15,31,8,7
32766,56685,443,20018,443,allow,7855,1866,5989,20,15,11,9
32767,58729,443,41982,443,allow,5167,700,4467,16,15,7,9
32768,15503,6881,43362,6881,allow,2310,2310,0,36,3136,36,0
32769,55229,53,60362,53,allow,720,94,626,2,30,1,1
32770,57397,53,3449,53,allow,183,94,89,2,30,1,1
32771,49337,53,51649,53,allow,258,126,132,2,30,1,1
32772,51675,443,51675,443,allow,4539,1632,2907,19,27,11,8
32773,64365,53,55898,53,allow,196,94,102,2,30,1,1
32774,50635,443,12337,443,allow,8252,1702,6550,26,72,13,13
32775,65049,53,51039,53,allow,184,94,90,2,30,1,1
32776,64460,53,1617,53,allow,196,102,94,2,30,1,1
32777,56497,443,18628,443,allow,1343,763,580,14,26,8,6
32778,56468,53,30389,53,allow,180,94,86,2,30,1,1
32779,50270,443,3425,443,allow,868,514,354,13,18,8,5
32780,55630,53,24833,53,allow,197,102,95,2,30,1,1
32781,56144,53,26768,53,allow,180,94,86,2,30,1,1
32782,51947,16935,29468,16935,allow,70,70,0,2,8,2,0
32783,64592,53,20935,53,allow,177,94,83,2,30,1,1
32784,65007,53,25080,53,allow,180,86,94,2,30,1,1
32785,56935,80,54520,80,allow,1482,878,604,10,75,6,4
32786,65144,53,24637,53,allow,210,110,100,2,30,1,1
32787,17282,7000,17282,7000,allow,2163,676,1487,14,15,7,7
32788,50349,80,24554,80,allow,3909,888,3021,12,15,6,6
32789,64678,53,43744,53,allow,289,102,187,2,30,1,1
32790,38688,443,23677,443,allow,90166,3481,86685,96,16,31,65
32791,56937,80,7429,80,allow,2567,1586,981,13,75,8,5
32792,49180,53,37264,53,allow,314,97,217,4,34,2,2
32793,56644,80,27121,80,allow,234,234,0,4,12,4,0
32794,56498,443,11650,443,allow,1343,763,580,14,26,8,6
32795,49193,80,37184,80,allow,6158,654,5504,15,16,8,7
32796,64036,53,28611,53,allow,360,93,267,4,57,2,2
32797,49876,53,42623,53,allow,211,102,109,2,30,1,1
32798,56468,53,1634,53,allow,180,94,86,2,30,1,1
32799,42316,443,23676,443,allow,6397,2103,4294,17,26,9,8
32800,49654,22,49654,22,allow,7791,3373,4418,54,36,26,28
32801,58040,80,24098,80,allow,9984,5333,4651,21,25,10,11
32802,51925,80,55386,80,allow,51645,3868,47777,67,28,30,37
32803,54468,443,26749,443,allow,2402,1444,958,18,81,10,8
32804,63929,48477,10688,48477,allow,66,66,0,2,7,2,0
32805,58038,80,30379,80,allow,5029,2608,2421,15,25,9,6
32806,44960,443,32145,443,allow,306066,33556,272510,414,196,162,252
32807,56938,80,50995,80,allow,1403,841,562,10,75,6,4
32808,53455,53,0,0,allow,82,82,0,2,40,2,0
32809,53757,1,21144,1,allow,70,70,0,2,8,2,0
32810,53722,6881,24173,6881,allow,552,306,246,9,15,5,4
32811,49192,80,39568,80,allow,2807,587,2220,13,16,7,6
32812,39032,443,17584,443,allow,5819,1571,4248,26,58,14,12
32813,50282,443,64648,443,allow,15775,3795,11980,48,18,32,16
32814,53733,40599,48603,40599,allow,70,70,0,1,4,1,0
32815,49247,53,56867,53,allow,478,196,282,6,63,3,3
32816,57862,443,61289,443,allow,448344,11729,436615,474,157,128,346
32817,36386,443,8343,443,allow,1209,709,500,14,28,8,6
32818,56684,443,53117,443,allow,7907,1918,5989,20,15,11,9
32819,57871,443,42705,443,allow,7716,3991,3725,50,125,25,25
32820,57416,53,53137,53,allow,193,102,91,2,29,1,1
32821,49323,53,47360,53,allow,196,102,94,2,29,1,1
32822,64872,53,61410,53,allow,166,86,80,2,29,1,1
32823,49510,53,6465,53,allow,329,118,211,2,29,1,1
32824,49355,53,58716,53,allow,193,102,91,2,29,1,1
32825,49825,53,18724,53,allow,168,86,82,2,29,1,1
32826,56532,53,65053,53,allow,164,86,78,2,29,1,1
32827,64319,53,63281,53,allow,193,102,91,2,29,1,1
32828,64475,53,62342,53,allow,184,94,90,2,29,1,1
32829,64095,53,51473,53,allow,269,110,159,2,30,1,1
32830,64105,53,29112,53,allow,300,102,198,2,30,1,1
32831,64473,53,45476,53,allow,184,94,90,2,30,1,1
32832,43628,443,48034,443,allow,13974,3774,10200,29,120,12,17
32833,52458,443,42668,443,allow,4550,1777,2773,17,135,8,9
32834,53750,27352,21637,27352,allow,70,70,0,2,8,2,0
32835,53754,25306,12188,25306,allow,70,70,0,2,8,2,0
32836,51924,28016,53313,28016,allow,70,70,0,1,5,1,0
32837,43702,443,33020,443,allow,1201,707,494,12,26,7,5
32838,39677,443,47798,443,allow,7123,1331,5792,22,81,11,11
32839,49191,80,25150,80,allow,2807,587,2220,13,16,7,6
32840,57870,443,40542,443,allow,1373,734,639,17,125,10,7
32841,48347,443,29830,443,allow,8415,883,7532,23,54,8,15
32842,50541,80,22542,80,allow,4296,3281,1015,12,33,7,5
32843,37604,443,53490,443,allow,8493,2314,6179,33,16,18,15
32844,58050,80,17128,80,allow,318,192,126,6,20,4,2
32845,49197,53,3341,53,allow,249,94,155,2,30,1,1
32846,13825,443,28678,443,allow,8844,949,7895,19,75,9,10
32847,58056,80,49652,80,allow,3518,1780,1738,12,20,7,5
32848,50275,443,24781,443,allow,708,362,346,11,18,6,5
32849,55668,80,2182,80,allow,70,70,0,2,8,2,0
32850,43027,80,42429,80,allow,1506,1446,60,2,5,1,1
32851,50633,443,56668,443,allow,6673,1791,4882,22,72,12,10
32852,58728,443,26266,443,allow,5167,700,4467,16,15,7,9
32853,60995,443,4422,443,allow,1351,846,505,12,19,7,5
32854,64592,53,18733,53,allow,177,94,83,2,30,1,1
32855,64026,53,2303,53,allow,244,94,150,2,31,1,1
32856,38125,443,63227,443,allow,497663,22937,474726,585,38,245,340
32857,50021,80,33696,80,allow,10026538,185017,9841521,9515,195,2989,6526
32858,43701,443,61661,443,allow,1201,707,494,12,26,7,5
32859,50279,443,26201,443,allow,1128,654,474,17,18,10,7
32860,44861,443,14296,443,allow,1625,1038,587,14,27,8,6
32861,50634,443,27378,443,allow,8220,1670,6550,26,71,13,13
32862,49355,53,27262,53,allow,193,102,91,2,30,1,1
32863,64475,53,56537,53,allow,184,94,90,2,30,1,1
32864,56771,53,12754,53,allow,261,94,167,2,30,1,1
32865,55432,443,59316,443,allow,256189,15094,241095,316,122,120,196
32866,56675,53,13397,53,allow,254,94,160,2,30,1,1
32867,65251,53,45927,53,allow,183,98,85,3,31,2,1
32868,38001,443,11115,443,allow,1652,817,835,17,186,9,8
32869,56534,443,31456,443,allow,3055,993,2062,10,120,5,5
32870,35165,443,20390,443,allow,7174,4658,2516,18,121,10,8
32871,54425,443,49600,443,allow,1648,813,835,17,186,9,8
32872,57179,53,11960,53,allow,325,94,231,2,30,1,1
32873,64912,53,33217,53,allow,183,94,89,2,31,1,1
32874,49654,53,58880,53,allow,214,110,104,2,31,1,1
32875,63976,443,11736,443,allow,1270998,514773,756225,3073,2384,1413,1660
32876,37999,443,54290,443,allow,1650,815,835,17,186,9,8
32877,56400,80,42500,80,allow,1281,398,883,16,392,4,12
32878,33017,443,62492,443,allow,11008,4624,6384,36,322,19,17
32879,36438,5223,19564,5223,allow,5243,1898,3345,34,3005,18,16
32880,43381,443,3948,443,allow,9551,2173,7378,33,25,17,16
32881,48452,443,56539,443,allow,9553,2175,7378,33,27,17,16
32882,31653,53,31653,53,allow,235,90,145,2,34,1,1
32883,52788,53,56727,53,allow,196,94,102,2,30,1,1
32884,64357,53,36127,53,allow,183,94,89,2,30,1,1
32885,49274,53,14620,53,allow,197,102,95,2,30,1,1
32886,50562,53,50562,53,allow,216,82,134,2,32,1,1
32887,31096,53,31096,53,allow,216,82,134,2,32,1,1
32888,54894,443,28940,443,allow,9829,2313,7516,37,25,19,18
32889,33774,443,40240,443,allow,9551,2173,7378,33,27,17,16
32890,53651,443,17075,443,allow,9485,2173,7312,32,27,17,15
32891,64381,443,33769,443,allow,4838,1059,3779,16,54,8,8
32892,64813,53,4341,53,allow,180,94,86,2,30,1,1
32893,49569,53,17630,53,allow,213,94,119,2,30,1,1
32894,49654,53,53040,53,allow,214,110,104,2,30,1,1
32895,49501,53,46075,53,allow,343,92,251,4,32,2,2
32896,58436,443,57353,443,allow,18290,3012,15278,46,136,24,22
32897,49355,53,60733,53,allow,193,102,91,2,30,1,1
32898,56468,53,3693,53,allow,180,94,86,2,30,1,1
32899,56920,23117,0,0,deny,146,146,0,1,0,1,0
32900,54826,444,0,0,deny,60,60,0,1,0,1,0
32901,59155,445,0,0,drop,70,70,0,1,0,1,0
32902,46516,57470,0,0,deny,62,62,0,1,0,1,0
32903,64824,37965,0,0,deny,62,62,0,1,0,1,0
32904,3181,53567,0,0,deny,66,66,0,1,0,1,0
32905,62493,50584,0,0,deny,146,146,0,1,0,1,0
32906,60425,15503,0,0,deny,145,145,0,1,0,1,0
32907,60786,51505,0,0,deny,66,66,0,1,0,1,0
32908,51148,9571,0,0,deny,66,66,0,1,0,1,0
32909,22784,9571,0,0,deny,62,62,0,1,0,1,0
32910,53500,1,0,0,deny,66,66,0,1,0,1,0
32911,64000,445,0,0,drop,70,70,0,1,0,1,0
32912,64001,445,0,0,drop,70,70,0,1,0,1,0
32913,63997,445,0,0,drop,70,70,0,1,0,1,0
32914,63987,445,0,0,drop,70,70,0,1,0,1,0
32915,43323,1,0,0,deny,62,62,0,1,0,1,0
32916,26889,50265,0,0,deny,62,62,0,1,0,1,0
32917,59191,35440,0,0,deny,66,66,0,1,0,1,0
32918,61451,17500,0,0,deny,62,62,0,1,0,1,0
32919,59148,445,0,0,drop,70,70,0,1,0,1,0
32920,20724,19750,0,0,deny,78,78,0,1,0,1,0
32921,59383,445,0,0,drop,66,66,0,1,0,1,0
32922,59384,445,0,0,drop,66,66,0,1,0,1,0
32923,59386,445,0,0,drop,66,66,0,1,0,1,0
32924,59146,445,0,0,drop,70,70,0,1,0,1,0
32925,39681,37965,0,0,deny,66,66,0,1,0,1,0
32926,23553,37965,0,0,deny,62,62,0,1,0,1,0
32927,38909,57470,0,0,deny,62,62,0,1,0,1,0
32928,53447,22114,0,0,deny,146,146,0,1,0,1,0
32929,59145,445,0,0,drop,70,70,0,1,0,1,0
32930,16319,44847,0,0,deny,62,62,0,1,0,1,0
32931,59144,445,0,0,drop,70,70,0,1,0,1,0
32932,63984,445,0,0,drop,70,70,0,1,0,1,0
32933,59143,445,0,0,drop,70,70,0,1,0,1,0
32934,1818,22114,0,0,deny,62,62,0,1,0,1,0
32935,50624,50584,0,0,deny,66,66,0,1,0,1,0
32936,59139,445,0,0,drop,70,70,0,1,0,1,0
32937,59141,445,0,0,drop,70,70,0,1,0,1,0
32938,63983,445,0,0,drop,70,70,0,1,0,1,0
32939,63981,445,0,0,drop,70,70,0,1,0,1,0
32940,63980,445,0,0,drop,70,70,0,1,0,1,0
32941,6881,26296,0,0,deny,143,143,0,1,0,1,0
32942,40512,57470,0,0,deny,74,74,0,1,0,1,0
32943,59125,445,0,0,drop,70,70,0,1,0,1,0
32944,59124,445,0,0,drop,70,70,0,1,0,1,0
32945,59119,445,0,0,drop,70,70,0,1,0,1,0
32946,51368,1900,0,0,deny,139,139,0,1,0,1,0
32947,13559,57866,0,0,deny,62,62,0,1,0,1,0
32948,59114,445,0,0,drop,70,70,0,1,0,1,0
32949,59115,445,0,0,drop,70,70,0,1,0,1,0
32950,2432,11392,0,0,deny,62,62,0,1,0,1,0
32951,50063,35776,0,0,deny,148,148,0,1,0,1,0
32952,63966,445,0,0,drop,70,70,0,1,0,1,0
32953,63964,445,0,0,drop,70,70,0,1,0,1,0
32954,63963,445,0,0,drop,70,70,0,1,0,1,0
32955,26835,47993,0,0,deny,62,62,0,1,0,1,0
32956,22987,15503,0,0,deny,146,146,0,1,0,1,0
32957,59373,445,0,0,drop,66,66,0,1,0,1,0
32958,32520,47993,0,0,deny,66,66,0,1,0,1,0
32959,54242,443,22470,443,allow,499,425,74,4,0,3,1
32960,54241,443,12202,443,allow,499,425,74,4,0,3,1
32961,64815,37965,0,0,deny,62,62,0,1,0,1,0
32962,59103,445,0,0,drop,70,70,0,1,0,1,0
32963,65081,26467,0,0,deny,66,66,0,1,0,1,0
32964,40571,26467,0,0,deny,62,62,0,1,0,1,0
32965,25237,57470,0,0,deny,62,62,0,1,0,1,0
32966,16693,36237,0,0,deny,66,66,0,1,0,1,0
32967,49168,57470,0,0,deny,66,66,0,1,0,1,0
32968,6666,5984,0,0,deny,60,60,0,1,0,1,0
32969,53024,57866,0,0,deny,146,146,0,1,0,1,0
32970,63958,445,0,0,drop,70,70,0,1,0,1,0
32971,63957,445,0,0,drop,70,70,0,1,0,1,0
32972,57034,44847,0,0,deny,66,66,0,1,0,1,0
32973,59099,445,0,0,drop,70,70,0,1,0,1,0
32974,59357,445,0,0,drop,66,66,0,1,0,1,0
32975,59355,445,0,0,drop,66,66,0,1,0,1,0
32976,13423,56205,0,0,deny,62,62,0,1,0,1,0
32977,12986,64147,0,0,deny,145,145,0,1,0,1,0
32978,59090,445,0,0,drop,70,70,0,1,0,1,0
32979,59089,445,0,0,drop,70,70,0,1,0,1,0
32980,59087,445,0,0,drop,70,70,0,1,0,1,0
32981,59084,445,0,0,drop,70,70,0,1,0,1,0
32982,1043,48817,0,0,deny,136,136,0,1,0,1,0
32983,59082,445,0,0,drop,70,70,0,1,0,1,0
32984,63945,445,0,0,drop,70,70,0,1,0,1,0
32985,63939,445,0,0,drop,70,70,0,1,0,1,0
32986,63942,445,0,0,drop,70,70,0,1,0,1,0
32987,63940,445,0,0,drop,70,70,0,1,0,1,0
32988,51743,64147,0,0,deny,62,62,0,1,0,1,0
32989,59350,445,0,0,drop,66,66,0,1,0,1,0
32990,44491,50584,0,0,deny,62,62,0,1,0,1,0
32991,13090,36237,0,0,deny,66,66,0,1,0,1,0
32992,3667,56205,0,0,deny,62,62,0,1,0,1,0
32993,59335,445,0,0,drop,66,66,0,1,0,1,0
32994,59336,445,0,0,drop,66,66,0,1,0,1,0
32995,59341,445,0,0,drop,66,66,0,1,0,1,0
32996,59343,445,0,0,drop,66,66,0,1,0,1,0
32997,59339,445,0,0,drop,66,66,0,1,0,1,0
32998,59338,445,0,0,drop,66,66,0,1,0,1,0
32999,59345,445,0,0,drop,66,66,0,1,0,1,0
33000,58858,15503,0,0,deny,66,66,0,1,0,1,0
33001,55854,54369,0,0,deny,74,74,0,1,0,1,0
33002,63931,445,0,0,drop,70,70,0,1,0,1,0
33003,58901,443,24407,443,allow,17071,1532,15539,17,27,3,14
33004,59077,445,0,0,drop,70,70,0,1,0,1,0
33005,49958,36829,0,0,deny,66,66,0,1,0,1,0
33006,63929,445,0,0,drop,70,70,0,1,0,1,0
33007,63928,445,0,0,drop,70,70,0,1,0,1,0
33008,63925,445,0,0,drop,70,70,0,1,0,1,0
33009,42640,11119,0,0,deny,148,148,0,1,0,1,0
33010,12951,50584,0,0,deny,66,66,0,1,0,1,0
33011,30129,37965,0,0,deny,72,72,0,1,0,1,0
33012,55966,35440,0,0,deny,62,62,0,1,0,1,0
33013,59069,445,0,0,drop,70,70,0,1,0,1,0
33014,59067,445,0,0,drop,70,70,0,1,0,1,0
33015,36579,30188,0,0,deny,66,66,0,1,0,1,0
33016,58582,50584,0,0,deny,62,62,0,1,0,1,0
33017,63924,445,0,0,drop,70,70,0,1,0,1,0
33018,63921,445,0,0,drop,70,70,0,1,0,1,0
33019,63919,445,0,0,drop,70,70,0,1,0,1,0
33020,51581,22114,0,0,deny,66,66,0,1,0,1,0
33021,59328,445,0,0,drop,66,66,0,1,0,1,0
33022,58972,57866,0,0,deny,66,66,0,1,0,1,0
33023,59062,445,0,0,drop,70,70,0,1,0,1,0
33024,63916,445,0,0,drop,70,70,0,1,0,1,0
33025,59061,445,0,0,drop,70,70,0,1,0,1,0
33026,59326,445,0,0,drop,66,66,0,1,0,1,0
33027,49286,23,0,0,deny,60,60,0,1,0,1,0
33028,32648,55108,0,0,deny,145,145,0,1,0,1,0
33029,59325,445,0,0,drop,66,66,0,1,0,1,0
33030,59324,445,0,0,drop,66,66,0,1,0,1,0
33031,59321,445,0,0,drop,66,66,0,1,0,1,0
33032,32137,44512,0,0,deny,62,62,0,1,0,1,0
33033,59057,445,0,0,drop,70,70,0,1,0,1,0
33034,7881,48817,0,0,deny,133,133,0,1,0,1,0
33035,59055,445,0,0,drop,70,70,0,1,0,1,0
33036,63909,445,0,0,drop,70,70,0,1,0,1,0
33037,63902,445,0,0,drop,70,70,0,1,0,1,0
33038,63898,445,0,0,drop,70,70,0,1,0,1,0
33039,27844,52700,0,0,deny,70,70,0,1,0,1,0
33040,26254,56205,0,0,deny,62,62,0,1,0,1,0
33041,59310,445,0,0,drop,66,66,0,1,0,1,0
33042,59051,445,0,0,drop,70,70,0,1,0,1,0
33043,12969,55777,0,0,deny,66,66,0,1,0,1,0
33044,54986,53,11167,53,allow,212,108,104,2,31,1,1
33045,51917,80,25082,80,allow,43399,5061,38338,55,29,24,31
33046,65417,443,43584,443,allow,2494,1643,851,17,25,9,8
33047,54648,443,56134,443,allow,9215,3253,5962,51,22,25,26
33048,54379,80,23086,80,allow,1466,729,737,12,16,7,5
33049,34471,53,34471,53,allow,253,99,154,2,32,1,1
33050,51508,4545,51508,4545,allow,156,156,0,3,8,3,0
33051,48728,443,2946,443,allow,2437,1321,1116,15,83,9,6
33052,64383,443,47790,443,allow,4017,978,3039,14,53,8,6
33053,34522,80,31284,80,allow,1420,715,705,12,16,7,5
33054,56594,53,29926,53,allow,788,108,680,2,30,1,1
33055,23127,53,23127,53,allow,233,91,142,2,30,1,1
33056,54008,443,44994,443,allow,4249,724,3525,13,15,7,6
33057,54005,443,23305,443,allow,4253,726,3527,13,15,7,6
33058,54782,443,13415,443,allow,9487,2103,7384,32,24,16,16
33059,64382,443,26649,443,allow,4017,978,3039,14,53,8,6
33060,49756,80,38066,80,allow,20926,3231,17695,37,51,17,20
33061,58890,80,50368,80,allow,23867,3316,20551,38,135,20,18
33062,49667,80,52853,80,allow,1165,468,697,8,125,5,3
33063,52714,443,48732,443,allow,26399,2076,24323,37,319,15,22
33064,50237,443,44543,443,allow,2994,1521,1473,15,83,9,6
33065,64813,53,27372,53,allow,176,90,86,2,30,1,1
33066,12776,53,12776,53,allow,239,94,145,2,30,1,1
33067,52715,443,11256,443,allow,26901,2286,24615,46,319,18,28
33068,55254,443,18680,443,allow,13275,3587,9688,38,27,20,18
33069,49117,443,48924,443,allow,9551,2173,7378,33,27,17,16
33070,42642,443,22756,443,allow,10548,2689,7859,38,24,19,19
33071,37346,443,8413,443,allow,7814,2339,5475,26,316,12,14
33072,51945,1587,22122,1587,allow,70,70,0,2,8,2,0
33073,5588,5588,0,0,allow,3354,1792,1562,46,193,23,23
33074,31976,53,31976,53,allow,241,95,146,2,30,1,1
33075,65238,53,13271,53,allow,86,86,0,1,30,1,0
33076,41577,53,15196,53,allow,168,78,90,2,30,1,1
33077,54550,443,54550,443,allow,13490,2525,10965,30,18,17,13
33078,57354,53,55769,53,allow,767,102,665,2,30,1,1
33079,52460,53,0,0,allow,82,82,0,1,30,1,0
33080,33008,53,33008,53,allow,263,104,159,2,30,1,1
33081,54486,443,15577,443,allow,3170,1036,2134,13,135,6,7
33082,51876,443,3089,443,allow,1852,1103,749,16,32,9,7
33083,51931,443,20564,443,allow,2328,1677,651,17,23,9,8
33084,51855,443,29819,443,allow,11894,2661,9233,32,32,18,14
33085,56413,53,30670,53,allow,224,94,130,2,30,1,1
33086,64297,443,21726,443,allow,56432,4371,52061,72,135,29,43
33087,56574,443,27778,443,allow,75732,15030,60702,137,138,56,81
33088,49201,53,5443,53,allow,200,102,98,2,31,1,1
33089,36767,53,36767,53,allow,237,93,144,2,31,1,1
33090,30960,45739,64773,45739,allow,330,330,0,6,3609,6,0
33091,48360,443,45618,443,allow,8400,2088,6312,33,20,18,15
33092,47000,53,0,0,allow,82,82,0,1,31,1,0
33093,42190,53,42190,53,allow,639,86,553,2,31,1,1
33094,37598,443,64510,443,allow,8102,2685,5417,24,17,15,9
33095,65428,53,7407,53,allow,731,85,646,2,31,1,1
33096,22131,53,22131,53,allow,172,76,96,2,31,1,1
33097,49621,53,49621,53,allow,231,90,141,2,31,1,1
33098,62449,443,11939,443,allow,9977,4364,5613,19,121,9,10
33099,46585,443,60959,443,allow,9439,3223,6216,27,137,13,14
33100,54380,60038,0,0,allow,66,66,0,1,90,1,0
33101,30960,45736,51969,45736,allow,396,396,0,7,3616,7,0
33102,51221,57274,16024,57274,allow,528,528,0,9,1201,9,0
33103,50424,55777,0,0,deny,62,62,0,1,0,1,0
33104,8403,46824,0,0,deny,62,62,0,1,0,1,0
33105,3978,35440,0,0,deny,62,62,0,1,0,1,0
33106,32704,46824,0,0,deny,66,66,0,1,0,1,0
33107,51188,64147,0,0,deny,62,62,0,1,0,1,0
33108,56521,32480,0,0,deny,62,62,0,1,0,1,0
33109,59303,445,0,0,drop,66,66,0,1,0,1,0
33110,63888,445,0,0,drop,70,70,0,1,0,1,0
33111,7226,50584,0,0,deny,62,62,0,1,0,1,0
33112,59301,445,0,0,drop,66,66,0,1,0,1,0
33113,8313,51505,0,0,deny,66,66,0,1,0,1,0
33114,38306,51221,0,0,deny,62,62,0,1,0,1,0
33115,64606,53,40619,53,allow,278,118,160,2,30,1,1
33116,54986,53,26600,53,allow,214,110,104,2,30,1,1
33117,37603,443,12094,443,allow,8493,2314,6179,33,15,18,15
33118,59053,53,2855,53,allow,227,86,141,2,30,1,1
33119,65524,53,59878,53,allow,183,94,89,2,30,1,1
33120,43523,53,26419,53,allow,168,78,90,2,30,1,1
33121,35579,443,65088,443,allow,13136,3596,9540,40,26,21,19
33122,58712,80,8787,80,allow,4176,3453,723,14,15,7,7
33123,51946,9407,10036,9407,allow,70,70,0,2,7,2,0
33124,53730,37096,48081,37096,allow,70,70,0,1,4,1,0
33125,63898,13205,50081,13205,allow,70,70,0,1,4,1,0
33126,64036,53,62200,53,allow,183,94,89,2,29,1,1
33127,65049,53,41682,53,allow,184,94,90,2,29,1,1
33128,56221,53,31091,53,allow,177,94,83,2,29,1,1
33129,64334,53,61866,53,allow,311,94,217,2,30,1,1
33130,64093,53,55556,53,allow,213,94,119,2,30,1,1
33131,48689,443,50166,443,allow,9681,2243,7438,35,24,18,17
33132,60270,443,42458,443,allow,9551,2173,7378,33,26,17,16
33133,57376,443,40721,443,allow,7211,823,6388,16,15,10,6
33134,56522,80,49102,80,allow,798,401,397,7,17,5,2
33135,48348,443,49861,443,allow,20838,2211,18627,40,14,20,20
33136,51943,55464,31100,55464,allow,70,70,0,2,8,2,0
33137,49520,80,52279,80,allow,2011,975,1036,13,70,7,6
33138,51922,18413,51851,18413,allow,70,70,0,1,5,1,0
33139,58533,443,53373,443,allow,17356,5096,12260,46,26,24,22
33140,51920,32678,28612,32678,allow,70,70,0,1,5,1,0
33141,60442,49556,41273,49556,allow,624,318,306,10,15,5,5
33142,49540,80,39259,80,allow,374,192,182,7,42,4,3
33143,48349,443,46666,443,allow,42932,2883,40049,63,14,31,32
33144,49516,80,21754,80,allow,1256,746,510,11,70,6,5
33145,21276,53,21276,53,allow,244,98,146,2,33,1,1
33146,49993,80,30030,80,allow,21812,900,20912,27,26,9,18
33147,52642,6881,49230,6881,allow,1106,800,306,10,14,5,5
33148,51966,443,65076,443,allow,9249,4498,4751,39,15,22,17
33149,63904,18268,33783,18268,allow,70,70,0,1,4,1,0
33150,49690,53,14782,53,allow,790,110,680,2,29,1,1
33151,55091,443,55091,443,allow,21122,2591,18531,36,17,18,18
33152,51914,5222,1180,5222,allow,5141,2331,2810,41,144,24,17
33153,63317,53,0,0,allow,181,86,95,2,30,1,1
33154,56395,53,28310,53,allow,177,94,83,2,30,1,1
33155,65049,53,38762,53,allow,184,94,90,2,30,1,1
33156,49245,53,64738,53,allow,195,102,93,2,30,1,1
33157,20641,53,20641,53,allow,240,98,142,2,29,1,1
33158,56221,53,42617,53,allow,177,94,83,2,29,1,1
33159,50345,80,27840,80,allow,736,670,66,6,15,5,1
33160,49178,80,4471,80,allow,2807,587,2220,13,16,7,6
33161,49179,80,7093,80,allow,2807,587,2220,13,16,7,6
33162,2348,3389,2348,3389,allow,4145,1976,2169,22,19,13,9
33163,51915,5222,45227,5222,allow,11827,5467,6360,100,144,54,46
33164,55559,53,14649,53,allow,1026,292,734,8,50,4,4
33165,55464,53,8236,53,allow,214,110,104,2,30,1,1
33166,54986,53,42487,53,allow,214,110,104,2,30,1,1
33167,37597,443,2780,443,allow,10497,3476,7021,34,17,18,16
33168,55695,53,46724,53,allow,209,102,107,2,30,1,1
33169,38720,5222,21758,5222,allow,6262,2015,4247,35,48,17,18
33170,58709,443,26417,443,allow,7924,702,7222,17,16,7,10
33171,55663,19994,59885,19994,allow,70,70,0,2,8,2,0
33172,64554,53,57103,53,allow,498,204,294,6,30,3,3
33173,55479,53,49461,53,allow,232,94,138,2,30,1,1
33174,41246,443,27215,443,allow,234,234,0,4,12,4,0
33175,51834,80,36073,80,allow,366,240,126,7,32,5,2
33176,49188,8108,9022,8108,allow,1788,1016,772,15,15,8,7
33177,60297,53,6955,53,allow,227,86,141,2,30,1,1
33178,51923,11542,51093,11542,allow,70,70,0,1,5,1,0
33179,41750,443,14251,443,allow,4636,792,3844,16,15,8,8
33180,56120,53,36940,53,allow,212,102,110,2,30,1,1
33181,49666,80,7693,80,allow,2356,499,1857,10,125,6,4
33182,55396,443,55396,443,allow,63319,6716,56603,91,19,45,46
33183,40050,53,42804,53,allow,168,78,90,2,30,1,1
33184,48966,53,48747,53,allow,168,78,90,2,30,1,1
33185,49181,80,37044,80,allow,6158,654,5504,15,16,8,7
33186,63135,443,47015,443,allow,7127,1737,5390,18,16,10,8
33187,49274,53,26954,53,allow,560,199,361,6,82,3,3
33188,64357,53,13293,53,allow,183,94,89,2,30,1,1
33189,55495,53,24897,53,allow,305,94,211,2,30,1,1
33190,65236,53,60243,53,allow,247,118,129,2,30,1,1
33191,51941,19333,28791,19333,allow,70,70,0,2,8,2,0
33192,49733,80,1914,80,allow,4198,2450,1748,20,148,15,5
33193,56252,53,46494,53,allow,531,90,441,4,41,2,2
33194,51090,80,46921,80,allow,10434,1041,9393,20,45,11,9
33195,54449,443,54449,443,allow,7974,2926,5048,25,17,15,10
33196,65377,53,55727,53,allow,207,86,121,2,30,1,1
33197,49793,53,56349,53,allow,271,102,169,2,30,1,1
33198,56470,53,27427,53,allow,168,78,90,2,30,1,1
33199,50266,443,13343,443,allow,6344,2063,4281,26,21,12,14
33200,36430,443,7560,443,allow,9423,2105,7318,31,26,16,15
33201,44710,443,12033,443,allow,13320,3575,9745,38,26,19,19
33202,43499,443,52568,443,allow,9685,2330,7355,23,15,12,11
33203,63906,36909,1381,36909,allow,70,70,0,1,4,1,0
33204,51274,24399,41980,24399,allow,70,70,0,1,5,1,0
33205,56337,443,18375,443,allow,9683,2173,7510,35,26,17,18
33206,65194,53,9315,53,allow,265,91,174,4,36,2,2
33207,39854,443,9295,443,allow,7903,3497,4406,38,72,22,16
33208,65491,443,49902,443,allow,452013,13200,438813,465,16,163,302
33209,37790,443,42788,443,allow,448,78,370,6,25,1,5
33210,53306,443,56801,443,allow,11114,3066,8048,41,119,22,19
33211,50347,80,44018,80,allow,1671,862,809,10,15,5,5
33212,58583,443,61583,443,allow,8605,3169,5436,19,17,12,7
33213,46492,80,56877,80,allow,1967,1133,834,12,45,7,5
33214,51953,62964,9503,62964,allow,316,136,180,6,5,3,3
33215,49190,80,2197,80,allow,6158,654,5504,15,15,8,7
33216,49539,80,49460,80,allow,378,192,186,7,42,4,3
33217,51891,80,21420,80,allow,7434,3830,3604,17,30,9,8
33218,55667,19667,52444,19667,allow,70,70,0,2,8,2,0
33219,51942,22272,51406,22272,allow,210,70,140,4,8,2,2
33220,53729,40721,47011,40721,allow,70,70,0,1,4,1,0
33221,41748,443,37689,443,allow,4570,792,3778,15,15,8,7
33222,63899,62015,51023,62015,allow,70,70,0,1,4,1,0
33223,56433,80,35239,80,allow,17188,1559,15629,25,25,10,15
33224,37653,5223,25600,5223,allow,142,142,0,1,5,1,0
33225,51922,80,2848,80,allow,52962,3994,48968,71,27,32,39
33226,49911,53,26669,53,allow,258,110,148,2,30,1,1
33227,50127,443,64951,443,allow,31982,9936,22046,61,16,33,28
33228,65238,53,22542,53,allow,168,86,82,2,29,1,1
33229,49582,443,23714,443,allow,29241,2457,26784,48,171,24,24
33230,64813,53,44563,53,allow,180,94,86,2,30,1,1
33231,56181,53,2631,53,allow,784,94,690,2,29,1,1
33232,50940,443,10678,443,allow,6888,1774,5114,25,210,14,11
33233,53812,443,40871,443,allow,2966,801,2165,13,135,6,7
33234,65144,53,2841,53,allow,210,110,100,2,29,1,1
33235,49762,53,15647,53,allow,195,94,101,2,30,1,1
33236,49703,53,48424,53,allow,198,86,112,2,30,1,1
33237,44847,15315,12919,15315,allow,150,150,0,1,1200,1,0
33238,55158,53,38311,53,allow,212,102,110,2,30,1,1
33239,64357,53,57507,53,allow,271,85,186,4,30,2,2
33240,49574,53,12004,53,allow,337,110,227,2,30,1,1
33241,55756,53,23922,53,allow,311,94,217,2,30,1,1
33242,27515,53,18456,53,allow,224,78,146,2,30,1,1
33243,63379,443,51286,443,allow,2649,330,2319,12,134,5,7
33244,53254,443,47275,443,allow,9949,4623,5326,45,150,23,22
33245,41815,5228,54746,5228,allow,7701,2155,5546,30,611,17,13
33246,51906,443,34093,443,allow,5685,1179,4506,18,29,10,8
33247,60150,443,32146,443,allow,7741,2692,5049,24,16,13,11
33248,48014,80,51000,80,allow,4006,3572,434,14,15,7,7
33249,55666,36653,26608,36653,allow,70,70,0,2,8,2,0
33250,41047,443,9579,443,allow,6423,744,5679,16,16,9,7
33251,51451,80,37614,80,allow,214,140,74,4,15,3,1
33252,49665,80,5154,80,allow,2237,508,1729,10,125,6,4
33253,65463,53,27388,53,allow,210,102,108,2,30,1,1
33254,59627,53,32997,53,allow,290,102,188,2,30,1,1
33255,49935,53,2977,53,allow,370,94,276,2,30,1,1
33256,55464,53,12452,53,allow,214,110,104,2,30,1,1
33257,35556,53,63282,53,allow,168,78,90,2,30,1,1
33258,60936,443,12668,443,allow,1864,250,1614,8,120,4,4
33259,49925,443,37960,443,allow,19134,7361,11773,40,148,19,21
33260,56263,53,57350,53,allow,385,134,251,2,31,1,1
33261,63466,443,61707,443,allow,5828,1439,4389,16,75,9,7
33262,57625,443,18316,443,allow,4751,909,3842,15,16,9,6
33263,41751,443,36135,443,allow,4570,792,3778,15,15,8,7
33264,65492,443,42698,443,allow,92573,4519,88054,105,16,39,66
33265,64374,53,45440,53,allow,239,102,137,2,30,1,1
33266,64912,53,24794,53,allow,183,94,89,2,30,1,1
33267,64384,53,2219,53,allow,333,94,239,2,30,1,1
33268,56680,53,8517,53,allow,211,102,109,2,30,1,1
33269,51194,443,35674,443,allow,1561,768,793,17,185,9,8
33270,38112,443,61056,443,allow,1053962,45604,1008358,1190,69,456,734
33271,50048,443,29440,443,allow,6887,2473,4414,20,15,11,9
33272,64813,53,11826,53,allow,335,90,245,4,35,2,2
33273,51921,37744,34923,37744,allow,70,70,0,1,5,1,0
33274,56492,443,36078,443,allow,3715,1659,2056,35,188,18,17
33275,64298,53,48284,53,allow,311,118,193,2,30,1,1
33276,44577,443,43261,443,allow,30773,9123,21650,90,104,48,42
33277,56395,53,7674,53,allow,177,94,83,2,30,1,1
33278,55204,53,12205,53,allow,263,94,169,2,30,1,1
33279,55654,443,49899,443,allow,186406,10415,175991,218,123,79,139
33280,56451,53,25472,53,allow,322,102,220,2,30,1,1
33281,64588,53,18701,53,allow,211,102,109,2,30,1,1
33282,25108,53,24919,53,allow,222,78,144,2,30,1,1
33283,65146,53,35272,53,allow,763,102,661,2,31,1,1
33284,49936,53,28353,53,allow,211,102,109,2,31,1,1
33285,16230,53,64249,53,allow,223,78,145,2,30,1,1
33286,49501,53,50847,53,allow,193,102,91,2,31,1,1
33287,64791,443,34950,443,allow,4725,1727,2998,11,121,6,5
33288,61887,443,28383,443,allow,81136,7785,73351,109,131,40,69
33289,6882,4443,56989,4443,allow,600,600,0,5,1200,5,0
33290,19473,35726,44271,35726,allow,481,150,331,2,1200,1,1
33291,44037,443,25209,443,allow,5839,3664,2175,13,120,8,5
33292,56035,53,29824,53,allow,337,94,243,2,30,1,1
33293,55242,53,7339,53,allow,373,126,247,2,30,1,1
33294,55333,123,5768,123,allow,184,94,90,2,30,1,1
33295,55634,53,46753,53,allow,308,102,206,2,30,1,1
33296,54986,53,61995,53,allow,214,110,104,2,30,1,1
33297,64789,443,4787,443,allow,1786,172,1614,7,121,3,4
33298,50724,443,63657,443,allow,3171,1369,1802,9,120,5,4
33299,30188,63853,28721,63853,allow,502,150,352,2,1200,1,1
33300,55034,443,13403,443,allow,7969,4870,3099,36,360,20,16
33301,51948,34853,60337,34853,allow,316,136,180,6,6,3,3
33302,63925,18912,65425,18912,allow,66,66,0,2,8,2,0
33303,51918,80,52022,80,allow,426,240,186,8,29,5,3
33304,49180,80,59682,80,allow,6158,654,5504,15,16,8,7
33305,57165,53,7622,53,allow,498,204,294,6,30,3,3
33306,56125,53,56568,53,allow,311,118,193,2,30,1,1
33307,65524,53,37598,53,allow,183,94,89,2,30,1,1
33308,56684,53,21413,53,allow,301,94,207,2,31,1,1
33309,64281,53,45768,53,allow,214,110,104,2,31,1,1
33310,50266,443,41683,443,allow,49981,15486,34495,269,138,136,133
33311,50271,443,3937,443,allow,10103,2342,7761,39,121,22,17
33312,53723,51501,24523,51501,allow,70,70,0,1,5,1,0
33313,53501,443,53501,443,allow,960,539,421,9,36,5,4
33314,51900,80,40398,80,allow,366,240,126,7,29,5,2
33315,50276,443,53649,443,allow,9984,2917,7067,49,102,28,21
33316,50270,443,45158,443,allow,9998,2237,7761,38,121,21,17
33317,50285,443,58128,443,allow,7210,2382,4828,33,100,19,14
33318,63924,26328,57332,26328,allow,66,66,0,2,8,2,0
33319,50337,80,47050,80,allow,1083,653,430,8,16,5,3
33320,51913,80,58997,80,allow,366,240,126,7,29,5,2
33321,51841,443,41534,443,allow,1686,984,702,15,32,8,7
33322,56853,443,46609,443,allow,7092,1795,5297,25,32,14,11
33323,49675,53,62009,53,allow,78,78,0,1,30,1,0
33324,65252,53,49878,53,allow,249,102,147,2,30,1,1
33325,51346,51221,0,0,deny,74,74,0,1,0,1,0
33326,59038,445,0,0,drop,70,70,0,1,0,1,0
33327,48676,53393,0,0,deny,60,60,0,1,0,1,0
33328,22409,55442,0,0,deny,74,74,0,1,0,1,0
33329,53746,36237,0,0,deny,66,66,0,1,0,1,0
33330,59293,445,0,0,drop,66,66,0,1,0,1,0
33331,59035,445,0,0,drop,70,70,0,1,0,1,0
33332,60204,2767,0,0,deny,62,62,0,1,0,1,0
33333,9448,57866,0,0,deny,62,62,0,1,0,1,0
33334,59290,445,0,0,drop,66,66,0,1,0,1,0
33335,55320,22114,0,0,deny,146,146,0,1,0,1,0
33336,45682,47993,0,0,deny,62,62,0,1,0,1,0
33337,36400,51505,0,0,deny,62,62,0,1,0,1,0
33338,18011,44847,0,0,deny,62,62,0,1,0,1,0
33339,21759,51505,0,0,deny,66,66,0,1,0,1,0
33340,25653,26296,0,0,deny,148,148,0,1,0,1,0
33341,56157,50584,0,0,deny,62,62,0,1,0,1,0
33342,59030,445,0,0,drop,70,70,0,1,0,1,0
33343,58981,50584,0,0,deny,146,146,0,1,0,1,0
33344,59029,445,0,0,drop,70,70,0,1,0,1,0
33345,63878,445,0,0,drop,70,70,0,1,0,1,0
33346,63877,445,0,0,drop,70,70,0,1,0,1,0
33347,63876,445,0,0,drop,70,70,0,1,0,1,0
33348,35229,32468,0,0,deny,62,62,0,1,0,1,0
33349,59271,445,0,0,drop,66,66,0,1,0,1,0
33350,59275,445,0,0,drop,66,66,0,1,0,1,0
33351,59277,445,0,0,drop,66,66,0,1,0,1,0
33352,59276,445,0,0,drop,66,66,0,1,0,1,0
33353,59272,445,0,0,drop,66,66,0,1,0,1,0
33354,59270,445,0,0,drop,66,66,0,1,0,1,0
33355,59274,445,0,0,drop,66,66,0,1,0,1,0
33356,59269,445,0,0,drop,66,66,0,1,0,1,0
33357,59027,445,0,0,drop,70,70,0,1,0,1,0
33358,62731,21247,0,0,deny,66,66,0,1,0,1,0
33359,20724,19750,0,0,deny,78,78,0,1,0,1,0
33360,55386,32480,0,0,deny,62,62,0,1,0,1,0
33361,5859,11392,0,0,deny,66,66,0,1,0,1,0
33362,27402,37628,0,0,deny,62,62,0,1,0,1,0
33363,54276,37628,0,0,deny,66,66,0,1,0,1,0
33364,59020,445,0,0,drop,70,70,0,1,0,1,0
33365,63872,445,0,0,drop,70,70,0,1,0,1,0
33366,63868,445,0,0,drop,70,70,0,1,0,1,0
33367,63871,445,0,0,drop,70,70,0,1,0,1,0
33368,63860,445,0,0,drop,70,70,0,1,0,1,0
33369,59018,445,0,0,drop,70,70,0,1,0,1,0
33370,59257,445,0,0,drop,66,66,0,1,0,1,0
33371,59254,445,0,0,drop,66,66,0,1,0,1,0
33372,59255,445,0,0,drop,66,66,0,1,0,1,0
33373,34932,38608,0,0,deny,62,62,0,1,0,1,0
33374,59017,445,0,0,drop,70,70,0,1,0,1,0
33375,59016,445,0,0,drop,70,70,0,1,0,1,0
33376,59015,445,0,0,drop,70,70,0,1,0,1,0
33377,59013,445,0,0,drop,70,70,0,1,0,1,0
33378,59009,445,0,0,drop,70,70,0,1,0,1,0
33379,48527,7302,0,0,deny,146,146,0,1,0,1,0
33380,50245,44847,0,0,deny,66,66,0,1,0,1,0
33381,41249,50584,0,0,deny,66,66,0,1,0,1,0
33382,63857,445,0,0,drop,70,70,0,1,0,1,0
33383,63851,445,0,0,drop,70,70,0,1,0,1,0
33384,63852,445,0,0,drop,70,70,0,1,0,1,0
33385,63849,445,0,0,drop,70,70,0,1,0,1,0
33386,56833,23117,0,0,deny,62,62,0,1,0,1,0
33387,1024,57470,0,0,deny,72,72,0,1,0,1,0
33388,55111,39004,0,0,deny,66,66,0,1,0,1,0
33389,58997,445,0,0,drop,70,70,0,1,0,1,0
33390,58996,445,0,0,drop,70,70,0,1,0,1,0
33391,54240,443,62221,443,allow,499,425,74,4,0,3,1
33392,54239,443,8377,443,allow,499,425,74,4,0,3,1
33393,54238,443,21116,443,allow,499,425,74,4,0,3,1
33394,54236,443,22668,443,allow,499,425,74,4,0,3,1
33395,54237,443,5337,443,allow,499,425,74,4,0,3,1
33396,58993,445,0,0,drop,70,70,0,1,0,1,0
33397,28413,64147,0,0,deny,66,66,0,1,0,1,0
33398,54305,39004,0,0,deny,62,62,0,1,0,1,0
33399,54305,39004,0,0,deny,145,145,0,1,0,1,0
33400,57173,44847,0,0,deny,62,62,0,1,0,1,0
33401,19617,39004,0,0,deny,62,62,0,1,0,1,0
33402,58986,445,0,0,drop,70,70,0,1,0,1,0
33403,58987,445,0,0,drop,70,70,0,1,0,1,0
33404,62912,26467,0,0,deny,62,62,0,1,0,1,0
33405,11541,40108,0,0,deny,148,148,0,1,0,1,0
33406,54779,50584,0,0,deny,66,66,0,1,0,1,0
33407,27947,26467,0,0,deny,66,66,0,1,0,1,0
33408,60514,39004,0,0,deny,66,66,0,1,0,1,0
33409,63839,445,0,0,drop,70,70,0,1,0,1,0
33410,63838,445,0,0,drop,70,70,0,1,0,1,0
33411,63836,445,0,0,drop,70,70,0,1,0,1,0
33412,43100,22114,0,0,deny,146,146,0,1,0,1,0
33413,59245,445,0,0,drop,66,66,0,1,0,1,0
33414,58975,445,0,0,drop,70,70,0,1,0,1,0
33415,45964,55559,0,0,deny,60,60,0,1,0,1,0
33416,29734,23,0,0,deny,60,60,0,1,0,1,0
33417,57233,50934,0,0,deny,66,66,0,1,0,1,0
33418,48323,35253,0,0,deny,146,146,0,1,0,1,0
33419,51015,64147,0,0,deny,62,62,0,1,0,1,0
33420,14923,51505,0,0,deny,62,62,0,1,0,1,0
33421,3068,36237,0,0,deny,62,62,0,1,0,1,0
33422,21750,39004,0,0,deny,66,66,0,1,0,1,0
33423,62388,39004,0,0,deny,145,145,0,1,0,1,0
33424,39920,22114,0,0,deny,62,62,0,1,0,1,0
33425,36665,23,0,0,deny,60,60,0,1,0,1,0
33426,24145,35440,0,0,deny,62,62,0,1,0,1,0
33427,63831,445,0,0,drop,70,70,0,1,0,1,0
33428,63830,445,0,0,drop,70,70,0,1,0,1,0
33429,58971,445,0,0,drop,70,70,0,1,0,1,0
33430,56035,1310,0,0,deny,66,66,0,1,0,1,0
33431,59647,47993,0,0,deny,62,62,0,1,0,1,0
33432,55854,54369,0,0,deny,74,74,0,1,0,1,0
33433,58961,445,0,0,drop,70,70,0,1,0,1,0
33434,58960,445,0,0,drop,70,70,0,1,0,1,0
33435,58959,445,0,0,drop,70,70,0,1,0,1,0
33436,59230,445,0,0,drop,66,66,0,1,0,1,0
33437,59228,445,0,0,drop,66,66,0,1,0,1,0
33438,58958,445,0,0,drop,70,70,0,1,0,1,0
33439,10797,50584,0,0,deny,62,62,0,1,0,1,0
33440,58955,445,0,0,drop,70,70,0,1,0,1,0
33441,35864,44847,0,0,deny,78,78,0,1,0,1,0
33442,62109,44847,0,0,deny,62,62,0,1,0,1,0
33443,51096,63710,0,0,deny,62,62,0,1,0,1,0
33444,0,0,0,0,allow,156,156,0,2,0,2,0
33445,0,0,0,0,allow,244,244,0,2,0,2,0
33446,63817,445,0,0,drop,70,70,0,1,0,1,0
33447,59796,23,0,0,deny,60,60,0,1,0,1,0
33448,63815,445,0,0,drop,70,70,0,1,0,1,0
33449,63812,445,0,0,drop,70,70,0,1,0,1,0
33450,63811,445,0,0,drop,70,70,0,1,0,1,0
33451,16387,8455,0,0,deny,60,60,0,1,0,1,0
33452,16387,49252,0,0,deny,60,60,0,1,0,1,0
33453,16387,35244,0,0,deny,60,60,0,1,0,1,0
33454,59222,445,0,0,drop,66,66,0,1,0,1,0
33455,59211,445,0,0,drop,66,66,0,1,0,1,0
33456,59214,445,0,0,drop,66,66,0,1,0,1,0
33457,59215,445,0,0,drop,66,66,0,1,0,1,0
33458,59213,445,0,0,drop,66,66,0,1,0,1,0
33459,59210,445,0,0,drop,66,66,0,1,0,1,0
33460,59216,445,0,0,drop,66,66,0,1,0,1,0
33461,59208,445,0,0,drop,66,66,0,1,0,1,0
33462,58949,445,0,0,drop,70,70,0,1,0,1,0
33463,54134,64147,0,0,deny,66,66,0,1,0,1,0
33464,63804,445,0,0,drop,70,70,0,1,0,1,0
33465,65166,62413,0,0,deny,66,66,0,1,0,1,0
33466,63801,445,0,0,drop,70,70,0,1,0,1,0
33467,63797,445,0,0,drop,70,70,0,1,0,1,0
33468,63799,445,0,0,drop,70,70,0,1,0,1,0
33469,58941,445,0,0,drop,70,70,0,1,0,1,0
33470,58938,445,0,0,drop,70,70,0,1,0,1,0
33471,13484,37965,0,0,deny,62,62,0,1,0,1,0
33472,49855,36180,0,0,deny,62,62,0,1,0,1,0
33473,60022,10387,0,0,deny,159,159,0,1,0,1,0
33474,45238,44847,0,0,deny,66,66,0,1,0,1,0
33475,28580,64147,0,0,deny,62,62,0,1,0,1,0
33476,11450,57470,0,0,deny,66,66,0,1,0,1,0
33477,41755,48817,0,0,deny,145,145,0,1,0,1,0
33478,50486,56205,0,0,deny,62,62,0,1,0,1,0
33479,7275,9524,0,0,deny,66,66,0,1,0,1,0
33480,15180,26467,0,0,deny,62,62,0,1,0,1,0
33481,60610,58414,0,0,deny,62,62,0,1,0,1,0
33482,58934,445,0,0,drop,70,70,0,1,0,1,0
33483,61766,44847,0,0,deny,66,66,0,1,0,1,0
33484,7286,44847,0,0,deny,66,66,0,1,0,1,0
33485,63795,445,0,0,drop,70,70,0,1,0,1,0
33486,63792,445,0,0,drop,70,70,0,1,0,1,0
33487,63790,445,0,0,drop,70,70,0,1,0,1,0
33488,58933,445,0,0,drop,70,70,0,1,0,1,0
33489,59200,445,0,0,drop,66,66,0,1,0,1,0
33490,63788,445,0,0,drop,70,70,0,1,0,1,0
33491,50095,50584,0,0,deny,62,62,0,1,0,1,0
33492,55600,22,0,0,deny,60,60,0,1,0,1,0
33493,59198,445,0,0,drop,66,66,0,1,0,1,0
33494,10480,26467,0,0,deny,62,62,0,1,0,1,0
33495,57302,62413,0,0,deny,66,66,0,1,0,1,0
33496,26872,44847,0,0,deny,62,62,0,1,0,1,0
33497,59195,445,0,0,drop,66,66,0,1,0,1,0
33498,59194,445,0,0,drop,66,66,0,1,0,1,0
33499,55706,443,29687,443,allow,5259,1203,4056,19,41,10,9
33500,49360,443,11814,443,allow,5782,1008,4774,17,16,8,9
33501,49223,80,54325,80,allow,1793,1030,763,11,15,6,5
33502,58051,443,3762,443,allow,8930,1529,7401,21,19,9,12
33503,56559,53,15416,53,allow,731,85,646,2,30,1,1
33504,50282,443,7706,443,allow,24856,2858,21998,57,100,30,27
33505,51882,443,57503,443,allow,366,180,186,7,30,4,3
33506,51849,80,48623,80,allow,366,240,126,7,31,5,2
33507,51881,443,23769,443,allow,4418,1116,3302,17,30,10,7
33508,51869,443,60062,443,allow,4435,1290,3145,17,31,9,8
33509,27480,443,15079,443,allow,11716,1007,10709,42,383,11,31
33510,51848,80,47789,80,allow,12009,5364,6645,23,31,12,11
33511,51842,443,3576,443,allow,1503,984,519,13,31,8,5
33512,43101,443,55812,443,allow,20846,11163,9683,55,318,30,25
33513,16647,53,16647,53,allow,233,91,142,2,30,1,1
33514,64281,53,18314,53,allow,212,108,104,2,30,1,1
33515,51880,443,34522,443,allow,4358,1056,3302,16,30,9,7
33516,51846,80,21384,80,allow,366,240,126,7,31,5,2
33517,50268,443,33459,443,allow,35251,25181,10070,121,123,63,58
33518,50272,443,15445,443,allow,8456,2502,5954,32,120,19,13
33519,7331,53,7331,53,allow,213,79,134,2,32,1,1
33520,60776,4156,9252,4156,allow,70,70,0,2,8,2,0
33521,53726,26083,31165,26083,allow,70,70,0,1,5,1,0
33522,58049,80,61142,80,allow,378,192,186,7,19,4,3
33523,2588,53,2588,53,allow,197,76,121,2,30,1,1
33524,44368,53,44368,53,allow,233,91,142,2,30,1,1
33525,52265,53,0,0,allow,233,89,144,2,30,1,1
33526,65353,53,60832,53,allow,170,87,83,2,30,1,1
33527,51847,80,28250,80,allow,366,240,126,7,31,5,2
33528,51874,443,24684,443,allow,1852,1103,749,16,31,9,7
33529,51840,443,42990,443,allow,246,120,126,5,32,3,2
33530,53500,443,53500,443,allow,960,539,421,9,35,5,4
33531,55046,53,59080,53,allow,300,102,198,4,40,2,2
33532,51879,443,43940,443,allow,4418,1116,3302,17,30,10,7
33533,50283,443,2548,443,allow,49752,4187,45565,87,100,45,42
33534,51348,7000,51348,7000,allow,2163,676,1487,14,15,7,7
33535,50326,80,17692,80,allow,7979,802,7177,17,47,8,9
33536,30859,53,30859,53,allow,213,79,134,2,32,1,1
33537,57328,53,13021,53,allow,1427,101,1326,4,48,2,2
33538,55886,443,32004,443,allow,161,101,60,2,5,1,1
33539,51866,443,8681,443,allow,2449,1794,655,17,31,10,7
33540,51221,33295,49216,33295,allow,528,528,0,9,1200,9,0
33541,51877,443,15246,443,allow,1852,1103,749,16,31,9,7
33542,49541,443,61178,443,allow,8464,2891,5573,20,30,10,10
33543,51861,80,40570,80,allow,366,240,126,7,31,5,2
33544,51875,443,48033,443,allow,1852,1103,749,16,31,9,7
33545,53724,64923,63918,64923,allow,70,70,0,1,5,1,0
33546,51845,80,46640,80,allow,502,310,192,9,31,6,3
33547,51940,26399,39116,26399,allow,70,70,0,2,8,2,0
33548,60184,443,60184,443,allow,4574,1667,2907,19,26,11,8
33549,60445,20555,43690,20555,allow,70,70,0,2,8,2,0
33550,63854,53,30633,53,allow,578,286,292,9,15,5,4
33551,60437,30889,62883,30889,allow,1729,1125,604,14,16,8,6
33552,52713,443,22767,443,allow,26235,2216,24019,39,318,17,22
33553,55004,80,20099,80,allow,2394,630,1764,9,16,6,3
33554,44684,443,12133,443,allow,4728,3417,1311,23,35,12,11
33555,50327,80,7970,80,allow,366,180,186,7,47,4,3
33556,57013,80,43644,80,allow,5696,703,4993,14,75,8,6
33557,49322,443,12551,443,allow,166663,77974,88689,368,2310,123,245
33558,46746,443,46746,443,allow,4427,1520,2907,19,30,11,8
33559,55694,53,54062,53,allow,166,85,81,2,31,1,1
33560,62861,443,20935,443,allow,4777,2262,2515,10,122,5,5
33561,50265,26650,50101,26650,allow,480,149,331,2,1201,1,1
33562,50535,80,30581,80,allow,62768,25796,36972,75,34,33,42
33563,54195,443,39081,443,allow,1786,172,1614,7,120,3,4
33564,50538,80,28093,80,allow,4314,3518,796,15,32,8,7
33565,49740,53,20655,53,allow,793,101,692,2,31,1,1
33566,137,137,54849,137,allow,96,96,0,2,31,2,0
33567,65507,53,3795,53,allow,166,85,81,2,31,1,1
33568,55203,443,52613,443,allow,12947,4309,8638,29,152,15,14
33569,62860,443,23047,443,allow,4954,2554,2400,11,122,6,5
33570,12929,41864,0,0,deny,145,145,0,1,0,1,0
33571,58929,445,0,0,drop,70,70,0,1,0,1,0
33572,59192,445,0,0,drop,66,66,0,1,0,1,0
33573,53656,11119,0,0,deny,148,148,0,1,0,1,0
33574,58928,445,0,0,drop,70,70,0,1,0,1,0
33575,25589,23,0,0,deny,60,60,0,1,0,1,0
33576,1025,51221,0,0,deny,62,62,0,1,0,1,0
33577,51382,56205,0,0,deny,66,66,0,1,0,1,0
33578,51413,57470,0,0,deny,72,72,0,1,0,1,0
33579,60720,23718,0,0,deny,62,62,0,1,0,1,0
33580,63780,445,0,0,drop,70,70,0,1,0,1,0
33581,54866,37965,0,0,deny,62,62,0,1,0,1,0
33582,51862,80,9823,80,allow,6106,5420,686,13,30,7,6
33583,49953,80,9395,80,allow,11209,819,10390,19,15,9,10
33584,60436,56687,61011,56687,allow,564,318,246,9,16,5,4
33585,51960,443,7003,443,allow,8830,1950,6880,27,25,14,13
33586,49959,80,5453,80,allow,9763,749,9014,17,15,8,9
33587,47200,443,56772,443,allow,11003,3821,7182,35,257,14,21
33588,50523,53,31491,53,allow,199,102,97,2,30,1,1
33589,55715,443,4116,443,allow,1648,114,1534,5,120,2,3
33590,51871,443,4793,443,allow,554,310,244,10,30,6,4
33591,51837,80,11115,80,allow,242,120,122,5,31,3,2
33592,52039,80,22816,80,allow,4185,3462,723,14,15,7,7
33593,49769,80,36678,80,allow,254,128,126,5,15,3,2
33594,58047,80,5646,80,allow,7453,2953,4500,19,21,10,9
33595,56138,53,30181,53,allow,284,94,190,2,29,1,1
33596,65353,53,4050,53,allow,177,94,83,2,29,1,1
33597,56311,53,2296,53,allow,311,94,217,2,30,1,1
33598,50047,80,4097,80,allow,1455,349,1106,10,15,5,5
33599,51836,443,36494,443,allow,4927,986,3941,21,31,12,9
33600,51908,80,63314,80,allow,4542,2962,1580,13,28,8,5
33601,51815,80,14356,80,allow,3910,2158,1752,15,32,10,5
33602,51830,80,53910,80,allow,486,300,186,9,31,6,3
33603,57914,443,43452,443,allow,4322,2383,1939,29,124,17,12
33604,50290,443,49413,443,allow,26064,2233,23831,44,97,23,21
33605,51826,443,55412,443,allow,682,370,312,12,32,7,5
33606,49455,443,62985,443,allow,12386,1821,10565,23,33,11,12
33607,53502,443,53502,443,allow,960,539,421,9,35,5,4
33608,53259,443,54002,443,allow,6250,1774,4476,27,17,14,13
33609,50284,443,42928,443,allow,13168,2875,10293,48,99,27,21
33610,63923,59177,7249,59177,allow,66,66,0,2,7,2,0
33611,51915,443,2041,443,allow,362,180,182,7,28,4,3
33612,53748,51413,38549,51413,allow,70,70,0,2,7,2,0
33613,63895,43729,7105,43729,allow,70,70,0,1,4,1,0
33614,56203,53,18895,53,allow,283,102,181,2,29,1,1
33615,56395,53,26847,53,allow,177,94,83,2,29,1,1
33616,49274,53,51381,53,allow,197,102,95,2,29,1,1
33617,56907,53,38903,53,allow,293,102,191,2,29,1,1
33618,50332,80,8939,80,allow,5517,2843,2674,19,47,10,9
33619,50056,27018,50062,27018,allow,546,390,156,6,30,4,2
33620,18125,53,18125,53,allow,235,90,145,2,33,1,1
33621,51917,26077,25405,26077,allow,70,70,0,1,5,1,0
33622,49358,443,2362,443,allow,9482,4710,4772,19,16,11,8
33623,55446,443,18400,443,allow,165191,6141,159050,184,30,67,117
33624,50085,80,41165,80,allow,5514,2362,3152,37,469,19,18
33625,37983,443,26799,443,allow,15668921,169545,15499376,12539,161,1284,11255
33626,49243,53,19778,53,allow,212,102,110,2,30,1,1
33627,29616,53,29616,53,allow,241,98,143,2,30,1,1
33628,56569,53,35579,53,allow,199,102,97,2,30,1,1
33629,56513,53,43170,53,allow,184,86,98,2,30,1,1
33630,57453,443,43967,443,allow,2233,1347,886,23,135,13,10
33631,39455,80,39455,80,allow,14349,1038,13311,26,20,13,13
33632,60438,17148,35885,17148,allow,70,70,0,1,5,1,0
33633,51918,41488,58958,41488,allow,70,70,0,1,5,1,0
33634,51889,80,18568,80,allow,15867,8841,7026,29,29,16,13
33635,51962,443,60648,443,allow,8600,1735,6865,27,25,14,13
33636,65115,53,32763,53,allow,167,86,81,2,30,1,1
33637,59653,80,58858,80,allow,1139,609,530,10,34,6,4
33638,33924,80,28051,80,allow,1139,609,530,10,61,6,4
33639,46298,443,58260,443,allow,52438,4244,48194,77,23,37,40
33640,46288,443,54873,443,allow,28173,21385,6788,100,41,51,49
33641,56681,443,56377,443,allow,8654,2150,6504,20,15,11,9
33642,49957,80,62910,80,allow,6389,690,5699,16,15,8,8
33643,49961,80,19985,80,allow,8315,820,7495,18,15,9,9
33644,46731,443,46731,443,allow,4603,1696,2907,19,30,11,8
33645,51919,10298,57387,10298,allow,70,70,0,1,5,1,0
33646,60336,5222,43827,5222,allow,32653,15160,17493,307,506,160,147
33647,49955,80,63565,80,allow,9810,819,8991,19,15,9,10
33648,59617,443,31345,443,allow,5682,1565,4117,23,66,13,10
33649,49207,443,63518,443,allow,19566,12185,7381,89,176,42,47
33650,64028,53,51007,53,allow,293,134,159,2,30,1,1
33651,63133,80,57043,80,allow,18055,904,17151,22,15,7,15
33652,64651,53,19265,53,allow,196,94,102,2,30,1,1
33653,49201,53,3474,53,allow,200,102,98,2,30,1,1
33654,64028,53,50736,53,allow,263,134,129,2,30,1,1
33655,50523,53,17417,53,allow,199,102,97,2,30,1,1
33656,64281,53,42063,53,allow,214,110,104,2,30,1,1
33657,56526,53,57484,53,allow,210,102,108,2,30,1,1
33658,63092,443,8576,443,allow,4771341,155341,4616000,5024,147,1667,3357
33659,45063,80,24999,80,allow,1892,1014,878,10,21,6,4
33660,51733,5228,35376,5228,allow,6967,1929,5038,25,128,14,11
33661,63132,80,36171,80,allow,19934,920,19014,23,15,7,16
33662,46285,443,47233,443,allow,40877,5947,34930,81,56,39,42
33663,50325,80,35970,80,allow,2535,783,1752,13,48,7,6
33664,50302,80,5947,80,allow,5100,1620,3480,17,114,10,7
33665,50329,80,27783,80,allow,1550,728,822,13,47,7,6
33666,49960,80,58313,80,allow,9718,819,8899,19,15,9,10
33667,49954,80,59970,80,allow,10841,821,10020,19,15,9,10
33668,48838,8080,7294,8080,allow,533,327,206,8,33,5,3
33669,51017,80,29159,80,allow,2654,796,1858,12,18,7,5
33670,65237,53,3519,53,allow,225,94,131,2,30,1,1
33671,49201,53,35149,53,allow,200,102,98,2,30,1,1
33672,63893,443,26379,443,allow,3071,804,2267,15,135,7,8
33673,49763,443,47715,443,allow,12767,8343,4424,31,122,17,14
33674,49890,443,49782,443,allow,2513598,90400,2423198,2658,280,896,1762
33675,49280,80,50074,80,allow,200808,6612,194196,217,3669,83,134
33676,51831,80,34274,80,allow,486,300,186,9,31,6,3
33677,21133,41620,37961,41620,allow,150,150,0,1,1199,1,0
33678,35221,443,12640,443,allow,146299,21774,124525,246,141,98,148
33679,51907,80,10230,80,allow,9189,3144,6045,19,28,11,8
33680,49224,80,15279,80,allow,2999,2271,728,11,15,6,5
33681,51914,80,46843,80,allow,366,240,126,7,28,5,2
33682,51835,443,47905,443,allow,546,300,246,10,31,6,4
33683,51825,443,16261,443,allow,4943,936,4007,21,32,11,10
33684,51898,80,53700,80,allow,366,240,126,7,28,5,2
33685,63134,80,1605,80,allow,18032,904,17128,22,15,7,15
33686,51928,80,8868,80,allow,1357,963,394,10,26,7,3
33687,50264,443,26394,443,allow,25435,5293,20142,104,138,54,50
33688,50269,80,46714,80,allow,1606,823,783,12,121,7,5
33689,60447,36396,16095,36396,allow,70,70,0,2,8,2,0
33690,50281,443,10698,443,allow,25811,4278,21533,73,100,38,35
33691,53138,15048,65155,15048,allow,70,70,0,1,4,1,0
33692,50287,443,3897,443,allow,8247,2761,5486,36,99,19,17
33693,51872,443,26165,443,allow,442,250,192,8,30,5,3
33694,50257,443,7570,443,allow,249660,21361,228299,416,141,191,225
33695,60439,47783,39683,47783,allow,70,70,0,1,5,1,0
33696,56860,49991,48987,49991,allow,70,70,0,1,5,1,0
33697,63892,8080,57373,8080,allow,1269,548,721,10,15,6,4
33698,53725,57418,10921,57418,allow,70,70,0,1,4,1,0
33699,60853,443,17952,443,allow,126,60,66,3,4,2,1
33700,50263,443,33451,443,allow,35817,18303,17514,160,138,85,75
33701,6977,53,6977,53,allow,235,90,145,2,32,1,1
33702,55046,53,5301,53,allow,300,102,198,4,40,2,2
33703,51275,10924,61359,10924,allow,70,70,0,2,8,2,0
33704,58186,443,61282,443,allow,5086,3296,1790,36,56,18,18
33705,55046,53,27327,53,allow,300,102,198,4,39,2,2
33706,55046,53,20538,53,allow,300,102,198,4,40,2,2
33707,55444,443,59927,443,allow,1455177,56285,1398892,1600,31,632,968
33708,55198,80,49692,80,allow,41822,2038,39784,56,15,27,29
33709,51982,80,47547,80,allow,14487990,289826,14198164,13259,54,3839,9420
33710,50323,80,57798,80,allow,2074,793,1281,11,48,6,5
33711,49958,80,11985,80,allow,11173,821,10352,19,15,9,10
33712,41576,443,6870,443,allow,5954,1607,4347,27,215,14,13
33713,49956,80,11904,80,allow,10819,819,10000,19,15,9,10
33714,49651,53,30768,53,allow,312,94,218,2,29,1,1
33715,55100,53,52662,53,allow,438,94,344,2,29,1,1
33716,64320,53,39088,53,allow,197,94,103,2,29,1,1
33717,65353,53,24740,53,allow,177,94,83,2,30,1,1
33718,55549,53,55549,53,allow,228,90,138,2,30,1,1
33719,58982,443,29770,443,allow,6400453,202937,6197516,6806,226,2259,4547
33720,43827,443,38851,443,allow,677212,30094,647118,785,136,282,503
33721,59920,443,55787,443,allow,3063,1068,1995,12,134,6,6
33722,6881,58293,28909,58293,allow,228,118,110,2,1200,1,1
33723,37851,443,26132,443,allow,14283,12630,1653,29,126,17,12
33724,56682,443,61779,443,allow,8654,2150,6504,20,15,11,9
33725,60908,443,62015,443,allow,10043,4993,5050,45,15,27,18
33726,49800,53,49800,53,allow,235,90,145,2,33,1,1
33727,9755,53,9755,53,allow,244,98,146,2,33,1,1
33728,55449,443,46191,443,allow,480989,16896,464093,507,22,178,329
33729,58013,80,34784,80,allow,3877,2069,1808,15,26,9,6
33730,54889,443,57896,443,allow,5541,3309,2232,19,61,11,8
33731,43863,80,21010,80,allow,2025,805,1220,12,46,7,5
33732,64471,53,53728,53,allow,264,110,154,2,30,1,1
33733,64998,53,50318,53,allow,214,94,120,2,30,1,1
33734,64281,53,44626,53,allow,214,110,104,2,30,1,1
33735,49591,53,31886,53,allow,198,94,104,2,30,1,1
33736,39995,443,64142,443,allow,6812,2910,3902,31,282,8,23
33737,58886,443,31172,443,allow,3404,2124,1280,18,135,10,8
33738,49547,443,10107,443,allow,6180,1249,4931,14,20,8,6
33739,49549,443,60727,443,allow,5903,1270,4633,14,17,8,6
33740,56007,53,28468,53,allow,197,102,95,2,33,1,1
33741,51939,34393,42807,34393,allow,70,70,0,2,8,2,0
33742,60441,64337,24616,64337,allow,70,70,0,1,5,1,0
33743,51916,24596,60319,24596,allow,70,70,0,1,5,1,0
33744,58575,443,10441,443,allow,6453,1742,4711,20,17,10,10
33745,50333,80,53972,80,allow,442,250,192,8,47,5,3
33746,49359,443,29384,443,allow,6261,1362,4899,22,15,12,10
33747,57355,53,57355,53,allow,242,98,144,2,30,1,1
33748,46002,53,40286,53,allow,168,78,90,2,30,1,1
33749,56569,53,62895,53,allow,199,102,97,2,30,1,1
33750,60769,443,35964,443,allow,3758,1691,2067,12,135,6,6
33751,51944,12470,26336,12470,allow,316,136,180,6,6,3,3
33752,51938,11218,50761,11218,allow,70,70,0,2,8,2,0
33753,60446,6882,2486,6882,allow,70,70,0,2,8,2,0
33754,55445,443,10778,443,allow,1373295,46189,1327106,1448,31,527,921
33755,50334,80,53374,80,allow,442,250,192,8,47,5,3
33756,57454,443,10249,443,allow,4881,1817,3064,30,135,16,14
33757,60971,443,28807,443,allow,396507,14667,381840,458,21,171,287
33758,60142,443,18976,443,allow,2998,1997,1001,16,16,8,8
33759,8836,53,8836,53,allow,203,82,121,2,30,1,1
33760,65115,53,14088,53,allow,167,86,81,2,30,1,1
33761,49401,53,41126,53,allow,258,102,156,2,30,1,1
33762,59930,443,17395,443,allow,58431,5847,52584,55,120,10,45
33763,57470,41013,23995,41013,allow,2128,875,1253,26,1980,13,13
33764,50022,80,11593,80,allow,10023148,180272,9842876,9438,193,2907,6531
33765,49201,53,51989,53,allow,200,102,98,2,30,1,1
33766,57470,1052,29632,1052,allow,132,132,0,3,1199,3,0
33767,57368,53,40892,53,allow,167,86,81,2,30,1,1
33768,64073,53,23568,53,allow,199,102,97,2,30,1,1
33769,55694,53,60951,53,allow,167,86,81,2,30,1,1
33770,64951,53,46883,53,allow,224,86,138,2,30,1,1
33771,54891,443,48520,443,allow,10035,2160,7875,35,120,18,17
33772,52838,443,36112,443,allow,14518,10453,4065,43,120,21,22
33773,50779,443,64325,443,allow,3247,1630,1617,8,120,4,4
33774,47337,443,13338,443,allow,14281,2906,11375,15,122,4,11
33775,44402,443,62685,443,allow,196732,11940,184792,257,139,103,154
33776,53755,45416,43327,45416,allow,320,140,180,6,6,3,3
33777,56642,80,4720,80,allow,234,234,0,4,12,4,0
33778,50665,443,30090,443,allow,22544,1481,21063,31,16,9,22
33779,58326,80,34084,80,allow,804,449,355,9,256,5,4
33780,47238,443,16760,443,allow,16131,4542,11589,45,139,21,24
33781,64073,53,37819,53,allow,520,211,309,6,39,3,3
33782,60777,40010,8810,40010,allow,316,136,180,6,6,3,3
33783,49187,2710,53094,2710,allow,70,70,0,1,5,1,0
33784,27348,80,31901,80,allow,1550,850,700,10,18,5,5
33785,9193,443,3894,443,allow,5043,432,4611,12,16,6,6
33786,123,123,52430,123,allow,184,94,90,2,30,1,1
33787,64669,53,24998,53,allow,198,94,104,2,30,1,1
33788,55694,53,12759,53,allow,167,86,81,2,30,1,1
33789,1091,37965,0,0,deny,62,62,0,1,0,1,0
33790,63775,445,0,0,drop,70,70,0,1,0,1,0
33791,63770,445,0,0,drop,70,70,0,1,0,1,0
33792,58923,445,0,0,drop,70,70,0,1,0,1,0
33793,28124,37965,0,0,deny,145,145,0,1,0,1,0
33794,59180,445,0,0,drop,66,66,0,1,0,1,0
33795,54280,3398,0,0,deny,60,60,0,1,0,1,0
33796,54280,3398,0,0,deny,60,60,0,1,0,1,0
33797,62088,56205,0,0,deny,62,62,0,1,0,1,0
33798,2464,50584,0,0,deny,66,66,0,1,0,1,0
33799,22409,55442,0,0,deny,74,74,0,1,0,1,0
33800,443,60496,0,0,deny,320,320,0,1,0,1,0
33801,44922,57470,0,0,deny,74,74,0,1,0,1,0
33802,51429,22114,0,0,deny,66,66,0,1,0,1,0
33803,45308,22114,0,0,deny,146,146,0,1,0,1,0
33804,59173,445,0,0,drop,66,66,0,1,0,1,0
33805,63760,445,0,0,drop,70,70,0,1,0,1,0
33806,7249,30349,0,0,deny,143,143,0,1,0,1,0
33807,51313,33669,0,0,deny,100,100,0,1,0,1,0
33808,51313,40573,0,0,deny,100,100,0,1,0,1,0
33809,47201,44847,0,0,deny,66,66,0,1,0,1,0
33810,57260,51221,0,0,deny,66,66,0,1,0,1,0
33811,58910,445,0,0,drop,70,70,0,1,0,1,0
33812,45908,33330,0,0,deny,60,60,0,1,0,1,0
33813,59171,445,0,0,drop,66,66,0,1,0,1,0
33814,14036,48817,0,0,deny,66,66,0,1,0,1,0
33815,58907,445,0,0,drop,70,70,0,1,0,1,0
33816,53044,36237,0,0,deny,66,66,0,1,0,1,0
33817,59162,445,0,0,drop,66,66,0,1,0,1,0
33818,52836,36829,0,0,deny,62,62,0,1,0,1,0
33819,60855,35440,0,0,deny,66,66,0,1,0,1,0
33820,16522,26467,0,0,deny,62,62,0,1,0,1,0
33821,59155,445,0,0,drop,66,66,0,1,0,1,0
33822,3549,64147,0,0,deny,62,62,0,1,0,1,0
33823,15465,64147,0,0,deny,66,66,0,1,0,1,0
33824,24212,21247,0,0,deny,146,146,0,1,0,1,0
33825,58345,24748,0,0,deny,148,148,0,1,0,1,0
33826,62257,2767,0,0,deny,66,66,0,1,0,1,0
33827,58902,445,0,0,drop,70,70,0,1,0,1,0
33828,5683,50584,0,0,deny,66,66,0,1,0,1,0
33829,56883,22114,0,0,deny,62,62,0,1,0,1,0
33830,58901,445,0,0,drop,70,70,0,1,0,1,0
33831,49001,48983,0,0,deny,161,161,0,1,0,1,0
33832,13287,16933,0,0,deny,62,62,0,1,0,1,0
33833,58899,445,0,0,drop,70,70,0,1,0,1,0
33834,42361,23,0,0,deny,60,60,0,1,0,1,0
33835,63751,445,0,0,drop,70,70,0,1,0,1,0
33836,63750,445,0,0,drop,70,70,0,1,0,1,0
33837,63748,445,0,0,drop,70,70,0,1,0,1,0
33838,59148,445,0,0,drop,66,66,0,1,0,1,0
33839,59147,445,0,0,drop,66,66,0,1,0,1,0
33840,59146,445,0,0,drop,66,66,0,1,0,1,0
33841,59142,445,0,0,drop,66,66,0,1,0,1,0
33842,59140,445,0,0,drop,66,66,0,1,0,1,0
33843,59145,445,0,0,drop,66,66,0,1,0,1,0
33844,59143,445,0,0,drop,66,66,0,1,0,1,0
33845,59141,445,0,0,drop,66,66,0,1,0,1,0
33846,52018,57866,0,0,deny,62,62,0,1,0,1,0
33847,10145,21247,0,0,deny,62,62,0,1,0,1,0
33848,58892,445,0,0,drop,70,70,0,1,0,1,0
33849,32051,37965,0,0,deny,62,62,0,1,0,1,0
33850,58890,445,0,0,drop,70,70,0,1,0,1,0
33851,63742,445,0,0,drop,70,70,0,1,0,1,0
33852,63740,445,0,0,drop,70,70,0,1,0,1,0
33853,63732,445,0,0,drop,70,70,0,1,0,1,0
33854,63730,445,0,0,drop,70,70,0,1,0,1,0
33855,54234,443,2984,443,allow,499,425,74,4,0,3,1
33856,54233,443,10183,443,allow,499,425,74,4,0,3,1
33857,57499,80,57499,80,allow,343853,13570,330283,445,3,223,222
33858,58889,445,0,0,drop,70,70,0,1,0,1,0
33859,59128,445,0,0,drop,66,66,0,1,0,1,0
33860,59127,445,0,0,drop,66,66,0,1,0,1,0
33861,59125,445,0,0,drop,66,66,0,1,0,1,0
33862,58888,445,0,0,drop,70,70,0,1,0,1,0
33863,58887,445,0,0,drop,70,70,0,1,0,1,0
33864,39730,17372,0,0,deny,66,66,0,1,0,1,0
33865,58884,445,0,0,drop,70,70,0,1,0,1,0
33866,58881,445,0,0,drop,70,70,0,1,0,1,0
33867,10218,2323,0,0,deny,60,60,0,1,0,1,0
33868,47910,7454,0,0,deny,60,60,0,1,0,1,0
33869,63728,445,0,0,drop,70,70,0,1,0,1,0
33870,50106,31573,0,0,deny,66,66,0,1,0,1,0
33871,63723,445,0,0,drop,70,70,0,1,0,1,0
33872,63719,445,0,0,drop,70,70,0,1,0,1,0
33873,63717,445,0,0,drop,70,70,0,1,0,1,0
33874,58869,445,0,0,drop,70,70,0,1,0,1,0
33875,58862,445,0,0,drop,70,70,0,1,0,1,0
33876,50920,60182,0,0,deny,66,66,0,1,0,1,0
33877,58858,445,0,0,drop,70,70,0,1,0,1,0
33878,58859,445,0,0,drop,70,70,0,1,0,1,0
33879,62765,16933,0,0,deny,66,66,0,1,0,1,0
33880,64824,36829,0,0,deny,66,66,0,1,0,1,0
33881,4110,35440,0,0,deny,66,66,0,1,0,1,0
33882,24731,51505,0,0,deny,62,62,0,1,0,1,0
33883,48840,50584,0,0,deny,62,62,0,1,0,1,0
33884,49113,50584,0,0,deny,66,66,0,1,0,1,0
33885,7968,2767,0,0,deny,62,62,0,1,0,1,0
33886,52740,51505,0,0,deny,66,66,0,1,0,1,0
33887,63710,445,0,0,drop,70,70,0,1,0,1,0
33888,50330,53,50330,53,allow,237,93,144,2,0,1,1
33889,49355,53,16925,53,allow,186,95,91,2,0,1,1
33890,63708,445,0,0,drop,70,70,0,1,0,1,0
33891,63709,445,0,0,drop,70,70,0,1,0,1,0
33892,58847,445,0,0,drop,70,70,0,1,0,1,0
33893,59116,445,0,0,drop,66,66,0,1,0,1,0
33894,13285,29892,0,0,deny,145,145,0,1,0,1,0
33895,53218,56205,0,0,deny,62,62,0,1,0,1,0
33896,16477,37807,0,0,deny,66,66,0,1,0,1,0
33897,58842,445,0,0,drop,70,70,0,1,0,1,0
33898,52650,44847,0,0,deny,66,66,0,1,0,1,0
33899,63703,445,0,0,drop,70,70,0,1,0,1,0
33900,63702,445,0,0,drop,70,70,0,1,0,1,0
33901,58686,18375,0,0,deny,66,66,0,1,0,1,0
33902,58834,445,0,0,drop,70,70,0,1,0,1,0
33903,58833,445,0,0,drop,70,70,0,1,0,1,0
33904,58832,445,0,0,drop,70,70,0,1,0,1,0
33905,26758,50584,0,0,deny,62,62,0,1,0,1,0
33906,58830,445,0,0,drop,70,70,0,1,0,1,0
33907,58826,445,0,0,drop,70,70,0,1,0,1,0
33908,50,38211,0,0,deny,66,66,0,1,0,1,0
33909,63956,38211,0,0,deny,62,62,0,1,0,1,0
33910,59099,445,0,0,drop,66,66,0,1,0,1,0
33911,59101,445,0,0,drop,66,66,0,1,0,1,0
33912,31727,57470,0,0,deny,62,62,0,1,0,1,0
33913,64237,51505,0,0,deny,66,66,0,1,0,1,0
33914,63691,445,0,0,drop,70,70,0,1,0,1,0
33915,63686,445,0,0,drop,70,70,0,1,0,1,0
33916,63685,445,0,0,drop,70,70,0,1,0,1,0
33917,63684,445,0,0,drop,70,70,0,1,0,1,0
33918,61278,56205,0,0,deny,62,62,0,1,0,1,0
33919,59094,445,0,0,drop,66,66,0,1,0,1,0
33920,58821,445,0,0,drop,70,70,0,1,0,1,0
33921,65012,2767,0,0,deny,66,66,0,1,0,1,0
33922,19875,30170,0,0,deny,145,145,0,1,0,1,0
33923,59078,445,0,0,drop,66,66,0,1,0,1,0
33924,59083,445,0,0,drop,66,66,0,1,0,1,0
33925,59082,445,0,0,drop,66,66,0,1,0,1,0
33926,59088,445,0,0,drop,66,66,0,1,0,1,0
33927,59086,445,0,0,drop,66,66,0,1,0,1,0
33928,59079,445,0,0,drop,66,66,0,1,0,1,0
33929,59077,445,0,0,drop,66,66,0,1,0,1,0
33930,13445,44847,0,0,deny,66,66,0,1,0,1,0
33931,63676,445,0,0,drop,70,70,0,1,0,1,0
33932,1024,44847,0,0,deny,62,62,0,1,0,1,0
33933,63673,445,0,0,drop,70,70,0,1,0,1,0
33934,63672,445,0,0,drop,70,70,0,1,0,1,0
33935,63669,445,0,0,drop,70,70,0,1,0,1,0
33936,58813,445,0,0,drop,70,70,0,1,0,1,0
33937,58812,445,0,0,drop,70,70,0,1,0,1,0
33938,59898,443,21573,443,allow,5429,2835,2594,19,140,9,10
33939,54599,443,16547,443,allow,6410,2001,4409,27,28,16,11
33940,26782,443,49572,443,allow,7407,2650,4757,24,20,12,12
33941,63921,23758,6337,23758,allow,312,132,180,6,7,3,3
33942,57585,443,55906,443,allow,9273,2712,6561,50,615,25,25
33943,14341,80,14341,80,allow,3360,2260,1100,19,61,11,8
33944,57227,443,51779,443,allow,9322,2994,6328,26,22,16,10
33945,51868,443,55642,443,allow,4375,1230,3145,16,30,8,8
33946,56858,32330,59933,32330,allow,66,66,0,1,5,1,0
33947,37920,53,0,0,allow,82,82,0,1,30,1,0
33948,52786,443,34018,443,allow,8160,2216,5944,22,38,14,8
33949,23216,53,23216,53,allow,235,90,145,2,33,1,1
33950,5239,6064,8462,6064,allow,217199,128,217071,316,37,3,313
33951,32820,443,45406,443,allow,11455,5836,5619,40,317,20,20
33952,49459,443,9422,443,allow,39932,34025,5907,52,21,34,18
33953,32955,80,30230,80,allow,14961,937,14024,25,16,11,14
33954,52788,443,17904,443,allow,21915,3929,17986,40,31,23,17
33955,47422,80,55452,80,allow,1614,1300,314,10,18,5,5
33956,50575,443,8721,443,allow,149414,8612,140802,208,25,107,101
33957,58744,443,37896,443,allow,42954,12409,30545,154,319,67,87
33958,50980,443,34954,443,allow,7959,3288,4671,19,97,11,8
33959,51937,38056,36648,38056,allow,70,70,0,2,8,2,0
33960,54610,443,65041,443,allow,9948,2463,7485,41,27,22,19
33961,14692,443,14692,443,allow,95958,6670,89288,139,80,68,71
33962,54792,443,48996,443,allow,9515,2231,7284,25,22,14,11
33963,60381,80,60381,80,allow,448865,6437,442428,380,151,67,313
33964,5588,5588,0,0,allow,3498,1872,1626,48,201,24,24
33965,51913,52188,58050,52188,allow,66,66,0,1,5,1,0
33966,50537,80,34758,80,allow,4186,3559,627,15,31,8,7
33967,64073,53,57961,53,allow,304,101,203,4,38,2,2
33968,15503,62336,46736,62336,allow,127653507,122661116,4992391,161030,2162,82907,78123
33969,57226,443,27047,443,allow,7924,2027,5897,23,22,14,9
33970,55252,443,43197,443,allow,16179,1763,14416,38,46,17,21
33971,49680,443,50049,443,allow,63100,10145,52955,87,147,37,50
33972,49929,443,35482,443,allow,2484,330,2154,12,136,5,7
33973,44971,443,53632,443,allow,6861,2809,4052,33,407,11,22
33974,59018,443,37679,443,allow,1786,172,1614,7,120,3,4
33975,65194,53,10314,53,allow,178,91,87,2,31,1,1
33976,57964,44847,0,0,deny,62,62,0,1,0,1,0
33977,42108,23,0,0,deny,60,60,0,1,0,1,0
33978,58338,3353,0,0,deny,60,60,0,1,0,1,0
33979,35154,42707,0,0,deny,62,62,0,1,0,1,0
33980,22300,51505,0,0,deny,62,62,0,1,0,1,0
33981,58806,445,0,0,drop,70,70,0,1,0,1,0
33982,58805,445,0,0,drop,70,70,0,1,0,1,0
33983,63668,445,0,0,drop,70,70,0,1,0,1,0
33984,63662,445,0,0,drop,70,70,0,1,0,1,0
33985,63665,445,0,0,drop,70,70,0,1,0,1,0
33986,33627,36237,0,0,deny,62,62,0,1,0,1,0
33987,49001,48983,0,0,deny,161,161,0,1,0,1,0
33988,47102,123,23383,123,allow,184,94,90,2,30,1,1
33989,55824,80,14752,80,allow,1281,398,883,16,393,4,12
33990,50871,443,47245,443,allow,9241,2001,7240,24,28,14,10
33991,53017,80,55649,80,allow,1658,1344,314,10,15,5,5
33992,53715,62348,45392,62348,allow,672,306,366,11,14,5,6
33993,57003,443,38569,443,allow,8592,3700,4892,39,108,21,18
33994,49545,443,43829,443,allow,6606,936,5670,17,23,9,8
33995,50481,443,48883,443,allow,7653,1188,6465,21,15,12,9
33996,57892,80,46739,80,allow,6519,1210,5309,15,17,8,7
33997,57077,443,42602,443,allow,7159,1851,5308,22,31,13,9
33998,55664,45682,37882,45682,allow,320,140,180,6,6,3,3
33999,49186,443,54954,443,allow,508520,13734,494786,527,18,192,335
34000,61661,53,61661,53,allow,235,90,145,2,33,1,1
34001,44052,80,38453,80,allow,282,60,222,5,12,2,3
34002,45537,80,48297,80,allow,1638,1324,314,10,15,5,5
34003,51926,80,62359,80,allow,36720,3404,33316,51,25,22,29
34004,65222,53,8527,53,allow,212,102,110,2,30,1,1
34005,49542,80,57907,80,allow,1012,531,481,8,25,5,3
34006,60945,443,30602,443,allow,7771,2691,5080,34,28,19,15
34007,55107,443,57254,443,allow,12000,3846,8154,29,28,17,12
34008,55659,37787,37419,37787,allow,70,70,0,1,5,1,0
34009,14417,443,14417,443,allow,15556,2973,12583,41,80,22,19
34010,50539,80,55226,80,allow,5912,3532,2380,15,31,8,7
34011,56504,53,9210,53,allow,195,94,101,2,30,1,1
34012,49160,3800,35343,3800,allow,854,150,704,4,1200,2,2
34013,64940,53,23084,53,allow,250,94,156,2,30,1,1
34014,53320,443,39301,443,allow,30796,3050,27746,60,30,32,28
34015,64673,53,43122,53,allow,213,94,119,2,30,1,1
34016,54035,443,43754,443,allow,7724,2555,5169,26,47,15,11
34017,55694,53,17874,53,allow,274,85,189,4,35,2,2
34018,60978,443,39156,443,allow,1004246,35992,968254,1127,90,451,676
34019,56339,443,15948,443,allow,8991,1756,7235,28,26,15,13
34020,63237,443,45268,443,allow,1369,670,699,17,141,9,8
34021,41632,443,12669,443,allow,7670,2131,5539,30,27,15,15
34022,50730,443,12545,443,allow,3514,1609,1905,30,51,16,14
34023,36776,443,7923,443,allow,2866,1674,1192,14,15,8,6
34024,37567,443,42814,443,allow,214,140,74,4,15,3,1
34025,49972,80,64274,80,allow,95065,52092,42973,148,259,77,71
34026,49589,443,40471,443,allow,327575,8400,319175,334,316,113,221
34027,43382,443,40551,443,allow,9624,2231,7393,24,22,14,10
34028,65507,53,47508,53,allow,167,86,81,2,30,1,1
34029,41636,123,47665,123,allow,184,94,90,2,30,1,1
34030,17750,50321,45531,50321,allow,491,150,341,2,1200,1,1
34031,50276,5223,4771,5223,allow,552,280,272,9,16,5,4
34032,64410,53,32197,53,allow,286,98,188,4,40,2,2
34033,45196,443,61474,443,allow,6357,1546,4811,26,17,14,12
34034,65445,53,12722,53,allow,254,102,152,2,30,1,1
34035,37568,443,50535,443,allow,214,140,74,4,15,3,1
34036,40254,443,35283,443,allow,7646,1024,6622,19,15,11,8
34037,55661,49671,27582,49671,allow,70,70,0,1,5,1,0
34038,64073,53,53984,53,allow,304,101,203,4,37,2,2
34039,43479,443,6073,443,allow,6990,2019,4971,29,20,16,13
34040,52247,53,24197,53,allow,216,86,130,2,30,1,1
34041,65507,53,3700,53,allow,167,86,81,2,30,1,1
34042,63973,53,57018,53,allow,346,98,248,4,31,2,2
34043,38115,443,13490,443,allow,281978,16098,265880,405,67,204,201
34044,52146,443,52659,443,allow,774806,25835,748971,772,52,253,519
34045,51935,38639,4270,38639,allow,70,70,0,2,8,2,0
34046,51936,17650,3009,17650,allow,70,70,0,2,8,2,0
34047,9172,443,4913,443,allow,89362,3092,86270,100,21,37,63
34048,39265,443,4436,443,allow,46879,2864,44015,74,179,34,40
34049,14137,443,14137,443,allow,155070,7155,147915,186,81,74,112
34050,50482,443,60480,443,allow,7653,1188,6465,21,15,12,9
34051,52793,443,12880,443,allow,130,70,60,2,14,1,1
34052,60812,80,61213,80,allow,1658,1344,314,10,14,5,5
34053,35217,443,22630,443,allow,4113,2625,1488,25,79,13,12
34054,40217,443,1676,443,allow,14944,7430,7514,32,25,19,13
34055,55813,443,20333,443,allow,15097,2888,12209,40,28,20,20
34056,49742,443,14299,443,allow,16041,1805,14236,30,20,14,16
34057,44890,443,50264,443,allow,232,172,60,3,4,2,1
34058,63922,32305,41561,32305,allow,312,132,180,6,6,3,3
34059,60773,20010,46646,20010,allow,70,70,0,1,5,1,0
34060,63236,443,2158,443,allow,4945,2798,2147,27,141,14,13
34061,9108,443,64667,443,allow,5510,901,4609,15,26,8,7
34062,53652,443,55573,443,allow,11041,3217,7824,26,24,15,11
34063,52425,443,26865,443,allow,6527,1142,5385,23,32,13,10
34064,32967,443,43142,443,allow,5327,963,4364,19,15,11,8
34065,64704,53,49716,53,allow,213,102,111,2,29,1,1
34066,57368,53,45045,53,allow,167,86,81,2,29,1,1
34067,57600,443,30518,443,allow,2614,1689,925,18,21,10,8
34068,52435,53,3973,53,allow,216,78,138,2,29,1,1
34069,50871,53,48869,53,allow,86,86,0,1,30,1,0
34070,65295,53,10641,53,allow,212,102,110,2,29,1,1
34071,46704,80,21758,80,allow,1193,451,742,10,15,6,4
34072,59792,80,7891,80,allow,1453540,37280,1416260,1552,96,507,1045
34073,42868,443,8590,443,allow,10049,2289,7760,35,27,19,16
34074,56338,443,8628,443,allow,11148,3099,8049,26,24,15,11
34075,49448,443,41135,443,allow,186882,17018,169864,206,29,84,122
34076,65168,53,15649,53,allow,230,110,120,2,30,1,1
34077,56265,53,56216,53,allow,213,94,119,2,30,1,1
34078,60138,443,19544,443,allow,2993,1992,1001,16,15,8,8
34079,37569,443,62678,443,allow,214,140,74,4,15,3,1
34080,53113,443,2940,443,allow,11030,4292,6738,32,61,17,15
34081,49967,53,55984,53,allow,303,100,203,4,40,2,2
34082,28479,53,28479,53,allow,235,90,145,2,33,1,1
34083,26385,53,26385,53,allow,235,90,145,2,33,1,1
34084,53660,443,43128,443,allow,350,210,140,6,24,4,2
34085,56370,443,11997,443,allow,26040,2148,23892,44,22,21,23
34086,43654,443,39718,443,allow,8761,2571,6190,24,17,14,10
34087,39118,443,64547,443,allow,206769,6309,200460,215,27,77,138
34088,51892,443,20369,443,allow,5671,1556,4115,23,274,13,10
34089,39447,443,60525,443,allow,7878,1909,5969,31,28,16,15
34090,37566,443,56010,443,allow,214,140,74,4,15,3,1
34091,63962,53,22978,53,allow,274,93,181,4,64,2,2
34092,15016,443,15016,443,allow,21083,3108,17975,45,80,24,21
34093,56698,443,19362,443,allow,106055,8460,97595,168,26,79,89
34094,60265,443,40784,443,allow,11048,3161,7887,26,24,15,11
34095,48690,443,27547,443,allow,19402,10414,8988,35,22,21,14
34096,49546,443,3244,443,allow,5519,945,4574,15,23,8,7
34097,65491,53,6276,53,allow,889,404,485,10,30,5,5
34098,65044,443,31714,443,allow,4446,2496,1950,9,120,5,4
34099,65045,443,13703,443,allow,4305,2217,2088,11,120,5,6
34100,64876,53,13922,53,allow,718,94,624,2,31,1,1
34101,65046,53,1859,53,allow,211,94,117,2,31,1,1
34102,40404,443,18265,443,allow,280,140,140,5,130,3,2
34103,57392,443,58743,443,allow,12347,6378,5969,39,208,20,19
34104,49332,443,12336,443,allow,4425,1910,2515,36,3656,12,24
34105,63914,32805,62469,32805,allow,66,66,0,2,8,2,0
34106,51418,443,34735,443,allow,7653,1188,6465,21,17,12,9
34107,58230,443,58230,443,allow,4465,1558,2907,19,27,11,8
34108,5588,5588,0,0,allow,3354,1792,1562,46,194,23,23
34109,55618,53,36676,53,allow,199,94,105,2,30,1,1
34110,46919,443,8853,443,allow,7094,1672,5422,21,361,10,11
34111,57470,6881,10823,6881,allow,132,132,0,3,1200,3,0
34112,60241,443,3002,443,allow,92975,3289,89686,107,316,40,67
34113,53745,18569,48041,18569,allow,70,70,0,2,8,2,0
34114,43608,53,16507,53,allow,199,94,105,2,30,1,1
34115,50549,53,21467,53,allow,199,94,105,2,30,1,1
34116,50479,443,65060,443,allow,25979,7217,18762,36,16,19,17
34117,45896,443,44655,443,allow,211720,46699,165021,332,109,152,180
34118,63951,53,53032,53,allow,345,106,239,4,38,2,2
34119,53743,23915,28798,23915,allow,70,70,0,2,8,2,0
34120,62232,80,62232,80,allow,2158,1419,739,11,150,6,5
34121,57994,443,31591,443,allow,10027,2130,7897,27,27,16,11
34122,59072,445,0,0,drop,66,66,0,1,0,1,0
34123,63660,445,0,0,drop,70,70,0,1,0,1,0
34124,59068,445,0,0,drop,66,66,0,1,0,1,0
34125,27160,64147,0,0,deny,66,66,0,1,0,1,0
34126,58801,445,0,0,drop,70,70,0,1,0,1,0
34127,44922,57470,0,0,deny,74,74,0,1,0,1,0
34128,59066,445,0,0,drop,66,66,0,1,0,1,0
34129,59064,445,0,0,drop,66,66,0,1,0,1,0
34130,61419,57470,0,0,deny,66,66,0,1,0,1,0
34131,4760,44847,0,0,deny,62,62,0,1,0,1,0
34132,26229,21247,0,0,deny,62,62,0,1,0,1,0
34133,56869,17637,0,0,deny,66,66,0,1,0,1,0
34134,59063,445,0,0,drop,66,66,0,1,0,1,0
34135,58799,445,0,0,drop,70,70,0,1,0,1,0
34136,28009,36237,0,0,deny,62,62,0,1,0,1,0
34137,53906,37965,0,0,deny,62,62,0,1,0,1,0
34138,64449,30188,0,0,deny,66,66,0,1,0,1,0
34139,63652,445,0,0,drop,70,70,0,1,0,1,0
34140,63651,445,0,0,drop,70,70,0,1,0,1,0
34141,63643,445,0,0,drop,70,70,0,1,0,1,0
34142,58795,445,0,0,drop,70,70,0,1,0,1,0
34143,59191,35440,0,0,deny,66,66,0,1,0,1,0
34144,59051,445,0,0,drop,66,66,0,1,0,1,0
34145,12550,37807,0,0,deny,146,146,0,1,0,1,0
34146,59044,445,0,0,drop,66,66,0,1,0,1,0
34147,63633,445,0,0,drop,70,70,0,1,0,1,0
34148,50624,50584,0,0,deny,66,66,0,1,0,1,0
34149,35619,12883,0,0,deny,159,159,0,1,0,1,0
34150,58782,445,0,0,drop,70,70,0,1,0,1,0
34151,1530,62413,0,0,deny,62,62,0,1,0,1,0
34152,54016,42707,0,0,deny,66,66,0,1,0,1,0
34153,59042,445,0,0,drop,66,66,0,1,0,1,0
34154,58779,445,0,0,drop,70,70,0,1,0,1,0
34155,1036,64147,0,0,deny,145,145,0,1,0,1,0
34156,59035,445,0,0,drop,66,66,0,1,0,1,0
34157,5462,21247,0,0,deny,62,62,0,1,0,1,0
34158,11362,64147,0,0,deny,145,145,0,1,0,1,0
34159,59027,445,0,0,drop,66,66,0,1,0,1,0
34160,30365,45991,0,0,deny,60,60,0,1,0,1,0
34161,14844,37965,0,0,deny,62,62,0,1,0,1,0
34162,48388,44847,0,0,deny,62,62,0,1,0,1,0
34163,58774,445,0,0,drop,70,70,0,1,0,1,0
34164,58773,445,0,0,drop,70,70,0,1,0,1,0
34165,1484,22114,0,0,deny,146,146,0,1,0,1,0
34166,58771,445,0,0,drop,70,70,0,1,0,1,0
34167,58338,3369,0,0,deny,60,60,0,1,0,1,0
34168,48676,53399,0,0,deny,60,60,0,1,0,1,0
34169,6338,23117,0,0,deny,66,66,0,1,0,1,0
34170,56367,44847,0,0,deny,66,66,0,1,0,1,0
34171,53835,62413,0,0,deny,62,62,0,1,0,1,0
34172,26642,57470,0,0,deny,62,62,0,1,0,1,0
34173,63622,445,0,0,drop,70,70,0,1,0,1,0
34174,63621,445,0,0,drop,70,70,0,1,0,1,0
34175,63620,445,0,0,drop,70,70,0,1,0,1,0
34176,59018,445,0,0,drop,66,66,0,1,0,1,0
34177,59019,445,0,0,drop,66,66,0,1,0,1,0
34178,59016,445,0,0,drop,66,66,0,1,0,1,0
34179,59013,445,0,0,drop,66,66,0,1,0,1,0
34180,59014,445,0,0,drop,66,66,0,1,0,1,0
34181,59017,445,0,0,drop,66,66,0,1,0,1,0
34182,59011,445,0,0,drop,66,66,0,1,0,1,0
34183,59015,445,0,0,drop,66,66,0,1,0,1,0
34184,25237,57470,0,0,deny,62,62,0,1,0,1,0
34185,16319,44847,0,0,deny,62,62,0,1,0,1,0
34186,59626,22114,0,0,deny,62,62,0,1,0,1,0
34187,49168,57470,0,0,deny,66,66,0,1,0,1,0
34188,58764,445,0,0,drop,70,70,0,1,0,1,0
34189,54298,48983,0,0,deny,159,159,0,1,0,1,0
34190,1026,64147,0,0,deny,62,62,0,1,0,1,0
34191,16693,36237,0,0,deny,66,66,0,1,0,1,0
34192,28999,37807,0,0,deny,146,146,0,1,0,1,0
34193,58762,445,0,0,drop,70,70,0,1,0,1,0
34194,58761,445,0,0,drop,70,70,0,1,0,1,0
34195,63617,445,0,0,drop,70,70,0,1,0,1,0
34196,63618,445,0,0,drop,70,70,0,1,0,1,0
34197,63610,445,0,0,drop,70,70,0,1,0,1,0
34198,63602,445,0,0,drop,70,70,0,1,0,1,0
34199,58760,445,0,0,drop,70,70,0,1,0,1,0
34200,58759,445,0,0,drop,70,70,0,1,0,1,0
34201,58757,445,0,0,drop,70,70,0,1,0,1,0
34202,58754,445,0,0,drop,70,70,0,1,0,1,0
34203,13408,44847,0,0,deny,66,66,0,1,0,1,0
34204,27147,22114,0,0,deny,146,146,0,1,0,1,0
34205,58999,445,0,0,drop,66,66,0,1,0,1,0
34206,58998,445,0,0,drop,66,66,0,1,0,1,0
34207,58996,445,0,0,drop,66,66,0,1,0,1,0
34208,3047,50584,0,0,deny,62,62,0,1,0,1,0
34209,36096,51505,0,0,deny,146,146,0,1,0,1,0
34210,61477,57470,0,0,deny,66,66,0,1,0,1,0
34211,3667,56205,0,0,deny,62,62,0,1,0,1,0
34212,58741,445,0,0,drop,70,70,0,1,0,1,0
34213,58740,445,0,0,drop,70,70,0,1,0,1,0
34214,58736,445,0,0,drop,70,70,0,1,0,1,0
34215,63600,445,0,0,drop,70,70,0,1,0,1,0
34216,53362,23,0,0,deny,60,60,0,1,0,1,0
34217,58730,445,0,0,drop,70,70,0,1,0,1,0
34218,58731,445,0,0,drop,70,70,0,1,0,1,0
34219,63599,445,0,0,drop,70,70,0,1,0,1,0
34220,63595,445,0,0,drop,70,70,0,1,0,1,0
34221,63594,445,0,0,drop,70,70,0,1,0,1,0
34222,28385,26467,0,0,deny,66,66,0,1,0,1,0
34223,11951,45026,0,0,deny,60,60,0,1,0,1,0
34224,0,0,0,0,allow,320,320,0,5,0,5,0
34225,51592,51505,0,0,deny,62,62,0,1,0,1,0
34226,20743,23,0,0,deny,60,60,0,1,0,1,0
34227,58719,445,0,0,drop,70,70,0,1,0,1,0
34228,55835,62413,0,0,deny,66,66,0,1,0,1,0
34229,65085,22114,0,0,deny,62,62,0,1,0,1,0
34230,63581,445,0,0,drop,70,70,0,1,0,1,0
34231,63582,445,0,0,drop,70,70,0,1,0,1,0
34232,63580,445,0,0,drop,70,70,0,1,0,1,0
34233,1818,22114,0,0,deny,62,62,0,1,0,1,0
34234,1818,22114,0,0,deny,146,146,0,1,0,1,0
34235,58986,445,0,0,drop,66,66,0,1,0,1,0
34236,18904,57470,0,0,deny,62,62,0,1,0,1,0
34237,56202,15503,0,0,deny,146,146,0,1,0,1,0
34238,58715,445,0,0,drop,70,70,0,1,0,1,0
34239,54219,443,4628,443,allow,499,425,74,4,0,3,1
34240,54227,443,59982,443,allow,499,425,74,4,0,3,1
34241,54221,443,30528,443,allow,499,425,74,4,0,3,1
34242,54229,443,56153,443,allow,499,425,74,4,0,3,1
34243,54225,443,6300,443,allow,499,425,74,4,0,3,1
34244,54226,443,4295,443,allow,499,425,74,4,0,3,1
34245,54224,443,19866,443,allow,499,425,74,4,0,3,1
34246,54228,443,39518,443,allow,499,425,74,4,0,3,1
34247,54223,443,38222,443,allow,499,425,74,4,0,3,1
34248,54218,443,2874,443,allow,499,425,74,4,0,3,1
34249,54222,443,54407,443,allow,499,425,74,4,0,3,1
34250,54220,443,37468,443,allow,499,425,74,4,0,3,1
34251,13963,50584,0,0,deny,66,66,0,1,0,1,0
34252,58706,445,0,0,drop,70,70,0,1,0,1,0
34253,58703,445,0,0,drop,70,70,0,1,0,1,0
34254,63573,445,0,0,drop,70,70,0,1,0,1,0
34255,63574,445,0,0,drop,70,70,0,1,0,1,0
34256,59694,50584,0,0,deny,66,66,0,1,0,1,0
34257,58701,445,0,0,drop,70,70,0,1,0,1,0
34258,58699,445,0,0,drop,70,70,0,1,0,1,0
34259,47013,44512,0,0,deny,62,62,0,1,0,1,0
34260,58971,445,0,0,drop,66,66,0,1,0,1,0
34261,58968,445,0,0,drop,66,66,0,1,0,1,0
34262,1187,64147,0,0,deny,66,66,0,1,0,1,0
34263,51387,443,47138,443,allow,9584,1871,7713,28,106,14,14
34264,41462,443,21403,443,allow,10331,2157,8174,37,137,18,19
34265,40367,80,26121,80,allow,2119,808,1311,12,16,7,5
34266,56336,53,36932,53,allow,198,93,105,2,30,1,1
34267,60894,443,14726,443,allow,3507,900,2607,13,135,6,7
34268,49331,443,20933,443,allow,4889,763,4126,18,30,8,10
34269,57949,443,49783,443,allow,19190,13041,6149,64,389,33,31
34270,59896,443,22952,443,allow,1537,934,603,14,32,7,7
34271,38115,80,9146,80,allow,6442,1404,5038,23,30,12,11
34272,58077,36653,14563,36653,allow,204,64,140,4,10,2,2
34273,50018,3389,50018,3389,allow,3413,1458,1955,16,18,8,8
34274,54717,443,54717,443,allow,4608,1701,2907,19,27,11,8
34275,51916,80,61338,80,allow,182,60,122,4,26,2,2
34276,56546,443,13186,443,allow,19236,2292,16944,45,55,23,22
34277,9474,53,9474,53,allow,237,91,146,2,33,1,1
34278,47677,80,49789,80,allow,1304,850,454,11,31,6,5
34279,55553,53,10197,53,allow,711,87,624,2,30,1,1
34280,60118,53,0,0,allow,216,84,132,2,30,1,1
34281,50604,443,50604,443,allow,4401,1494,2907,19,28,11,8
34282,50128,80,27649,80,allow,20575,11455,9120,92,966,47,45
34283,59895,443,59498,443,allow,1537,934,603,14,32,7,7
34284,49859,443,46970,443,allow,18811,1868,16943,22,142,7,15
34285,59894,443,37643,443,allow,1537,934,603,14,33,7,7
34286,47595,33441,0,0,allow,106,106,0,1,60,1,0
34287,10850,53,10850,53,allow,237,91,146,2,34,1,1
34288,56560,443,46506,443,allow,84111,3300,80811,104,54,41,63
34289,53719,49306,15851,49306,allow,70,70,0,1,5,1,0
34290,60443,50284,16097,50284,allow,258,70,188,4,8,2,2
34291,56857,43237,51679,43237,allow,66,66,0,1,5,1,0
34292,55052,443,42502,443,allow,4425,876,3549,15,29,8,7
34293,38612,443,17131,443,allow,20651533,655694,19995839,24885,362,8746,16139
34294,38608,443,19892,443,allow,17473899,604274,16869625,22165,408,7731,14434
34295,38610,443,57889,443,allow,19092095,654744,18437351,24079,407,8531,15548
34296,51864,38544,39396,38544,allow,1345,679,666,9,30,5,4
34297,59897,443,7806,443,allow,1743,934,809,15,32,7,8
34298,50020,3389,50020,3389,allow,3347,1458,1889,15,18,8,7
34299,56611,80,8801,80,allow,1114,534,580,12,16,7,5
34300,59899,443,64399,443,allow,1401,864,537,12,30,6,6
34301,60410,443,3323,443,allow,3683,1899,1784,20,20,10,10
34302,45119,443,35597,443,allow,2227,1018,1209,17,16,8,9
34303,58039,80,32642,80,allow,318,192,126,6,21,4,2
34304,50697,80,53956,80,allow,2525,1403,1122,22,272,12,10
34305,51910,60443,42638,60443,allow,66,66,0,1,5,1,0
34306,18964,443,18964,443,allow,5157,2180,2977,21,16,12,9
34307,57339,53,43284,53,allow,184,80,104,2,30,1,1
34308,48371,53,57320,53,allow,198,93,105,2,30,1,1
34309,62875,53,0,0,allow,205,80,125,2,30,1,1
34310,53007,443,38198,443,allow,25010,3519,21491,42,135,17,25
34311,6881,12999,32088,12999,allow,622,356,266,4,1201,2,2
34312,41799,443,41969,443,allow,10518,3356,7162,24,121,11,13
34313,51594,53,61639,53,allow,172,80,92,2,31,1,1
34314,46285,443,49897,443,allow,36209,28887,7322,65,364,34,31
34315,6889,47807,0,0,deny,143,143,0,1,0,1,0
34316,32342,62413,0,0,deny,62,62,0,1,0,1,0
34317,63563,445,0,0,drop,70,70,0,1,0,1,0
34318,31974,51505,0,0,deny,66,66,0,1,0,1,0
34319,58692,445,0,0,drop,70,70,0,1,0,1,0
34320,63558,445,0,0,drop,70,70,0,1,0,1,0
34321,63557,445,0,0,drop,70,70,0,1,0,1,0
34322,63554,445,0,0,drop,70,70,0,1,0,1,0
34323,58963,445,0,0,drop,66,66,0,1,0,1,0
34324,57131,31061,0,0,deny,145,145,0,1,0,1,0
34325,26799,6881,0,0,deny,62,62,0,1,0,1,0
34326,25234,1,0,0,reset-both,62,62,0,1,0,1,0
34327,30389,53,30389,53,allow,235,90,145,2,33,1,1
34328,58959,445,0,0,drop,66,66,0,1,0,1,0
34329,58956,445,0,0,drop,66,66,0,1,0,1,0
34330,58958,445,0,0,drop,66,66,0,1,0,1,0
34331,58955,445,0,0,drop,66,66,0,1,0,1,0
34332,58952,445,0,0,drop,66,66,0,1,0,1,0
34333,58949,445,0,0,drop,66,66,0,1,0,1,0
34334,58948,445,0,0,drop,66,66,0,1,0,1,0
34335,5223,13602,0,0,deny,66,66,0,1,0,1,0
34336,58685,445,0,0,drop,70,70,0,1,0,1,0
34337,63547,445,0,0,drop,70,70,0,1,0,1,0
34338,58683,445,0,0,drop,70,70,0,1,0,1,0
34339,63545,445,0,0,drop,70,70,0,1,0,1,0
34340,63544,445,0,0,drop,70,70,0,1,0,1,0
34341,63542,445,0,0,drop,70,70,0,1,0,1,0
34342,7166,64147,0,0,deny,66,66,0,1,0,1,0
34343,58678,445,0,0,drop,70,70,0,1,0,1,0
34344,58677,445,0,0,drop,70,70,0,1,0,1,0
34345,10416,64147,0,0,deny,62,62,0,1,0,1,0
34346,50663,443,7277,443,allow,7136,1421,5715,18,15,8,10
34347,56543,443,33644,443,allow,8659,1687,6972,30,55,16,14
34348,49253,53,0,0,allow,218,78,140,2,30,1,1
34349,60771,80,37890,80,allow,254,128,126,5,15,3,2
34350,50670,443,29531,443,allow,11940,3585,8355,43,16,24,19
34351,50477,443,6875,443,allow,25979,7217,18762,36,15,19,17
34352,53716,6881,32283,6881,allow,70,70,0,1,4,1,0
34353,50210,80,7597,80,allow,1277,460,817,16,71,5,11
34354,49558,53,61665,53,allow,423,104,319,4,39,2,2
34355,65507,53,22060,53,allow,167,86,81,2,29,1,1
34356,64096,53,55413,53,allow,197,94,103,2,29,1,1
34357,57470,18560,34437,18560,allow,150,150,0,1,1199,1,0
34358,65265,3389,65265,3389,allow,4213,2429,1784,18,31,9,9
34359,49484,443,58905,443,allow,407843,11895,395948,436,271,157,279
34360,50708,80,15427,80,allow,3114,1695,1419,15,196,11,4
34361,57070,443,3388,443,allow,18227,6731,11496,63,18,34,29
34362,50713,80,55082,80,allow,708,384,324,12,195,7,5
34363,8802,80,39611,80,allow,4999,1313,3686,36,667,8,28
34364,57993,443,27022,443,allow,8647,1990,6657,23,26,14,9
34365,54997,443,59177,443,allow,10817,4402,6415,31,23,17,14
34366,64768,53,30558,53,allow,394,102,292,2,29,1,1
34367,58025,80,19163,80,allow,708,384,324,12,23,7,5
34368,53746,7546,3408,7546,allow,70,70,0,2,7,2,0
34369,57431,80,59179,80,allow,11357,5000,6357,22,30,11,11
34370,64656,53,17241,53,allow,387,102,285,2,29,1,1
34371,57012,53,13483,53,allow,230,86,144,2,29,1,1
34372,55131,53,55323,53,allow,244,94,150,2,30,1,1
34373,39666,443,38106,443,allow,7522,2433,5089,16,120,8,8
34374,50662,443,10724,443,allow,6518,1200,5318,17,16,8,9
34375,51932,36498,31404,36498,allow,70,70,0,2,8,2,0
34376,64410,53,3799,53,allow,196,102,94,2,35,1,1
34377,55062,80,41792,80,allow,486,240,246,9,28,5,4
34378,58044,80,31147,80,allow,2742,1116,1626,11,20,6,5
34379,58042,80,52870,80,allow,318,192,126,6,20,4,2
34380,54352,443,38196,443,allow,12594,5098,7496,32,34,17,15
34381,51418,53,32808,53,allow,168,78,90,2,30,1,1
34382,64215,53,28280,53,allow,196,94,102,2,30,1,1
34383,43197,80,55210,80,allow,3605,1700,1905,16,186,9,7
34384,57239,5228,64844,5228,allow,16135,7514,8621,173,9115,72,101
34385,49593,53,25320,53,allow,253,102,151,2,30,1,1
34386,50710,80,11292,80,allow,708,384,324,12,195,7,5
34387,50712,80,10227,80,allow,708,384,324,12,195,7,5
34388,60287,80,11423,80,allow,130,70,60,2,15,1,1
34389,51931,19416,65025,19416,allow,70,70,0,2,8,2,0
34390,65115,53,63102,53,allow,301,95,206,4,36,2,2
34391,65090,53,43740,53,allow,209,102,107,2,30,1,1
34392,50400,53,28411,53,allow,177,94,83,2,30,1,1
34393,50400,53,9416,53,allow,177,94,83,2,30,1,1
34394,46567,443,46567,443,allow,4398,1491,2907,19,29,11,8
34395,64025,53,10807,53,allow,199,94,105,2,30,1,1
34396,34092,53,13668,53,allow,168,78,90,2,30,1,1
34397,41739,53,41739,53,allow,235,90,145,2,32,1,1
34398,57850,3389,57850,3389,allow,3347,1458,1889,15,18,8,7
34399,43817,53,43817,53,allow,203,82,121,2,30,1,1
34400,62724,443,24098,443,allow,11195,2218,8977,36,80,18,18
34401,55933,53,17036,53,allow,212,102,110,2,30,1,1
34402,55653,443,8699,443,allow,7267,2312,4955,16,120,7,9
34403,53522,8765,27669,8765,allow,199,75,124,4,59,2,2
34404,55271,53,16538,53,allow,268,102,166,2,30,1,1
34405,43195,80,21562,80,allow,3477,1572,1905,16,186,9,7
34406,57169,53,0,0,allow,208,86,122,2,30,1,1
34407,48931,53,2346,53,allow,168,78,90,2,30,1,1
34408,64425,53,47922,53,allow,216,94,122,2,30,1,1
34409,64579,443,6221,443,allow,24686,1935,22751,36,20,17,19
34410,53083,80,12541,80,allow,5259,1904,3355,30,15,23,7
34411,46999,53,31962,53,allow,168,78,90,2,30,1,1
34412,55699,443,1921,443,allow,4170,1901,2269,14,120,7,7
34413,56214,53,47113,53,allow,200,102,98,2,33,1,1
34414,55075,53,41245,53,allow,181,94,87,2,33,1,1
34415,42890,80,22504,80,allow,2030,586,1444,10,30,6,4
34416,57689,443,27070,443,allow,10855,1786,9069,32,180,15,17
34417,50050,53,17602,53,allow,253,87,166,4,52,2,2
34418,64050,53,59472,53,allow,389,94,295,2,30,1,1
34419,64765,53,34365,53,allow,195,94,101,2,30,1,1
34420,56214,53,47362,53,allow,200,102,98,2,30,1,1
34421,57225,53,35274,53,allow,177,94,83,2,30,1,1
34422,50265,59362,35253,59362,allow,4228,2471,1757,55,2758,31,24
34423,49352,53,48466,53,allow,214,94,120,2,30,1,1
34424,65453,53,27266,53,allow,251,94,157,2,31,1,1
34425,44455,443,5697,443,allow,6972,1375,5597,20,31,10,10
34426,57045,53,2181,53,allow,177,94,83,2,30,1,1
34427,37208,443,37628,443,allow,9621,7389,2232,33,256,14,19
34428,52220,22,52220,22,allow,8248,3445,4803,57,38,26,31
34429,41320,443,41281,443,allow,1743946,54876,1689070,1870,360,678,1192
34430,56812,443,43977,443,allow,11568,9158,2410,42,80,23,19
34431,53425,443,1934,443,allow,7208,2237,4971,26,32,16,10
34432,53020,443,6371,443,allow,3183,2180,1003,16,15,8,8
34433,51893,80,59031,80,allow,14289,7263,7026,27,27,14,13
34434,49355,443,38735,443,allow,4960,896,4064,14,16,8,6
34435,63131,34880,2031,34880,allow,316,190,126,5,15,3,2
34436,50478,443,59774,443,allow,25979,7217,18762,36,15,19,17
34437,51420,443,42852,443,allow,7653,1188,6465,21,16,12,9
34438,40956,443,7227,443,allow,10836,1733,9103,34,180,15,19
34439,39926,443,4012,443,allow,40820,4400,36420,81,81,42,39
34440,51421,443,61384,443,allow,9345,3051,6294,22,15,13,9
34441,50664,443,64015,443,allow,7767,1421,6346,20,15,8,12
34442,63916,56318,49851,56318,allow,66,66,0,2,7,2,0
34443,49295,53,11197,53,allow,280,96,184,4,36,2,2
34444,63917,57826,24551,57826,allow,66,66,0,2,7,2,0
34445,33938,443,14561,443,allow,6919,2112,4807,19,15,10,9
34446,50714,80,62410,80,allow,708,384,324,12,195,7,5
34447,37562,443,51859,443,allow,13836,6371,7465,34,23,20,14
34448,58043,80,57225,80,allow,378,192,186,7,20,4,3
34449,50210,1688,10212,1688,allow,70,70,0,1,5,1,0
34450,53650,53,49968,53,allow,199,94,105,2,29,1,1
34451,42749,443,12087,443,allow,6172,1310,4862,28,468,10,18
34452,49753,80,62550,80,allow,32910,18450,14460,143,1647,75,68
34453,55384,53,19331,53,allow,94,94,0,1,30,1,0
34454,49683,53,44598,53,allow,262,94,168,2,29,1,1
34455,64283,53,39891,53,allow,337,110,227,2,29,1,1
34456,48292,80,5673,80,allow,14038,3554,10484,45,1142,16,29
34457,52817,443,5709,443,allow,2658,1126,1532,25,120,12,13
34458,64052,443,61598,443,allow,4395,1673,2722,14,119,7,7
34459,49308,53,5550,53,allow,195,94,101,2,29,1,1
34460,65097,53,14229,53,allow,718,94,624,2,30,1,1
34461,59116,443,24457,443,allow,48923,5417,43506,61,122,25,36
34462,53087,443,59846,443,allow,408922,10621,398301,421,121,145,276
34463,6881,6889,14083,6889,allow,228,118,110,2,1199,1,1
34464,51910,80,31121,80,allow,4994,3658,1336,11,26,6,5
34465,64420,53,48861,53,allow,294,95,199,4,42,2,2
34466,55049,443,41973,443,allow,5587,3950,1637,26,55,15,11
34467,50709,80,20258,80,allow,708,384,324,12,195,7,5
34468,49686,53,9507,53,allow,343,94,249,2,30,1,1
34469,49805,53,26905,53,allow,296,102,194,2,30,1,1
34470,57349,53,0,0,allow,222,86,136,2,30,1,1
34471,49305,53,42044,53,allow,177,94,83,2,30,1,1
34472,64743,53,57022,53,allow,210,102,108,2,30,1,1
34473,43196,80,6981,80,allow,3494,1589,1905,16,186,9,7
34474,6881,6881,57384,6881,allow,238,118,120,2,1200,1,1
34475,47661,80,24519,80,allow,2865,2000,865,12,15,7,5
34476,43440,80,5073,80,allow,2093,825,1268,12,45,7,5
34477,54485,80,18876,80,allow,130,70,60,2,15,1,1
34478,55061,80,17010,80,allow,486,240,246,9,28,5,4
34479,53260,443,64697,443,allow,6136,1916,4220,28,15,16,12
34480,57075,53,9642,53,allow,199,94,105,2,30,1,1
34481,55077,53,49404,53,allow,394,94,300,2,30,1,1
34482,55075,53,35995,53,allow,181,94,87,2,30,1,1
34483,49914,53,9646,53,allow,718,94,624,2,30,1,1
34484,44454,443,1457,443,allow,7092,1495,5597,22,31,12,10
34485,50602,80,38980,80,allow,1658,1247,411,8,15,5,3
34486,51682,80,11682,80,allow,59786,3488,56298,119,55,45,74
34487,51852,80,36581,80,allow,182,60,122,4,29,2,2
34488,51909,33509,56937,33509,allow,70,70,0,1,5,1,0
34489,51911,14543,20500,14543,allow,70,70,0,1,5,1,0
34490,50711,80,56692,80,allow,708,384,324,12,195,7,5
34491,50661,443,13443,443,allow,298067,6719,291348,307,17,98,209
34492,51450,80,49507,80,allow,214,140,74,4,15,3,1
34493,50050,53,12626,53,allow,253,87,166,4,51,2,2
34494,49901,53,32175,53,allow,231,102,129,2,30,1,1
34495,64517,53,41461,53,allow,211,102,109,2,30,1,1
34496,57225,53,63764,53,allow,177,94,83,2,30,1,1
34497,49281,53,63913,53,allow,251,102,149,2,30,1,1
34498,55144,443,5039,443,allow,3522,869,2653,13,121,6,7
34499,51221,1338,12971,1338,allow,132,132,0,3,1200,3,0
34500,49347,443,51852,443,allow,611644,29314,582330,793,132,333,460
34501,61358,3389,61358,3389,allow,3488,1774,1714,17,33,9,8
34502,37042,53,37042,53,allow,237,98,139,2,30,1,1
34503,54093,5228,31167,5228,allow,7608,1824,5784,34,171,19,15
34504,60343,443,27332,443,allow,36547,3840,32707,88,241,43,45
34505,56641,80,60111,80,allow,234,234,0,4,12,4,0
34506,55474,80,42098,80,allow,25970,2371,23599,52,17,26,26
34507,63597,443,64564,443,allow,19821,11622,8199,77,135,39,38
34508,63588,443,6782,443,allow,11301,2292,9009,37,165,20,17
34509,63592,443,55191,443,allow,6485,1871,4614,27,140,14,13
34510,64664,53,45386,53,allow,250,86,164,4,33,2,2
34511,36413,443,33262,443,allow,2064683,47545,2017138,1994,33,657,1337
34512,63583,443,3577,443,allow,7339,2638,4701,33,167,18,15
34513,63584,443,2301,443,allow,7146,2010,5136,34,167,18,16
34514,49001,55108,0,0,deny,160,160,0,1,0,1,0
34515,58338,3375,0,0,deny,60,60,0,1,0,1,0
34516,21419,23,0,0,deny,60,60,0,1,0,1,0
34517,57538,30188,0,0,deny,66,66,0,1,0,1,0
34518,63539,445,0,0,drop,70,70,0,1,0,1,0
34519,63537,445,0,0,drop,70,70,0,1,0,1,0
34520,63533,445,0,0,drop,70,70,0,1,0,1,0
34521,58944,445,0,0,drop,66,66,0,1,0,1,0
34522,24062,51505,0,0,deny,146,146,0,1,0,1,0
34523,63532,445,0,0,drop,70,70,0,1,0,1,0
34524,58939,445,0,0,drop,66,66,0,1,0,1,0
34525,33543,44847,0,0,deny,62,62,0,1,0,1,0
34526,53746,36237,0,0,deny,66,66,0,1,0,1,0
34527,58671,445,0,0,drop,70,70,0,1,0,1,0
34528,21759,51505,0,0,deny,66,66,0,1,0,1,0
34529,9017,6881,0,0,deny,62,62,0,1,0,1,0
34530,58936,445,0,0,drop,66,66,0,1,0,1,0
34531,58935,445,0,0,drop,66,66,0,1,0,1,0
34532,49001,48983,0,0,deny,161,161,0,1,0,1,0
34533,58076,21247,0,0,deny,66,66,0,1,0,1,0
34534,58933,445,0,0,drop,66,66,0,1,0,1,0
34535,43578,15503,0,0,deny,74,74,0,1,0,1,0
34536,52003,44512,0,0,deny,66,66,0,1,0,1,0
34537,34470,57470,0,0,deny,66,66,0,1,0,1,0
34538,62731,21247,0,0,deny,66,66,0,1,0,1,0
34539,36400,51505,0,0,deny,62,62,0,1,0,1,0
34540,58667,445,0,0,drop,70,70,0,1,0,1,0
34541,61798,35440,0,0,deny,66,66,0,1,0,1,0
34542,63529,445,0,0,drop,70,70,0,1,0,1,0
34543,63513,445,0,0,deny,70,70,0,1,0,1,0
34544,18423,51505,0,0,deny,66,66,0,1,0,1,0
34545,5859,11392,0,0,deny,66,66,0,1,0,1,0
34546,58923,445,0,0,drop,66,66,0,1,0,1,0
34547,5894,44847,0,0,deny,62,62,0,1,0,1,0
34548,54300,22114,0,0,deny,62,62,0,1,0,1,0
34549,54458,64147,0,0,deny,62,62,0,1,0,1,0
34550,40512,57470,0,0,deny,74,74,0,1,0,1,0
34551,55874,64147,0,0,deny,66,66,0,1,0,1,0
34552,39230,23,0,0,deny,60,60,0,1,0,1,0
34553,39742,62413,0,0,deny,62,62,0,1,0,1,0
34554,51262,35440,0,0,deny,62,62,0,1,0,1,0
34555,62388,39004,0,0,deny,62,62,0,1,0,1,0
34556,58654,445,0,0,drop,70,70,0,1,0,1,0
34557,50086,57470,0,0,deny,66,66,0,1,0,1,0
34558,41249,50584,0,0,deny,66,66,0,1,0,1,0
34559,58915,445,0,0,drop,66,66,0,1,0,1,0
34560,63504,445,0,0,drop,70,70,0,1,0,1,0
34561,50283,49169,0,0,deny,62,62,0,1,0,1,0
34562,41815,50265,0,0,deny,146,146,0,1,0,1,0
34563,58651,445,0,0,drop,70,70,0,1,0,1,0
34564,58913,445,0,0,drop,66,66,0,1,0,1,0
34565,58085,57470,0,0,deny,62,62,0,1,0,1,0
34566,45941,23386,0,0,deny,60,60,0,1,0,1,0
34567,58904,445,0,0,drop,66,66,0,1,0,1,0
34568,54779,50584,0,0,deny,66,66,0,1,0,1,0
34569,58646,445,0,0,drop,70,70,0,1,0,1,0
34570,58895,445,0,0,drop,66,66,0,1,0,1,0
34571,58645,445,0,0,drop,70,70,0,1,0,1,0
34572,60514,39004,0,0,deny,66,66,0,1,0,1,0
34573,19617,39004,0,0,deny,62,62,0,1,0,1,0
34574,58643,445,0,0,drop,70,70,0,1,0,1,0
34575,443,60496,0,0,deny,320,320,0,1,0,1,0
34576,62912,26467,0,0,deny,62,62,0,1,0,1,0
34577,65317,51221,0,0,deny,78,78,0,1,0,1,0
34578,2180,63710,0,0,deny,66,66,0,1,0,1,0
34579,63494,445,0,0,drop,70,70,0,1,0,1,0
34580,63493,445,0,0,drop,70,70,0,1,0,1,0
34581,63492,445,0,0,drop,70,70,0,1,0,1,0
34582,27038,63836,0,0,deny,145,145,0,1,0,1,0
34583,58884,445,0,0,drop,66,66,0,1,0,1,0
34584,58889,445,0,0,drop,66,66,0,1,0,1,0
34585,58885,445,0,0,drop,66,66,0,1,0,1,0
34586,58890,445,0,0,drop,66,66,0,1,0,1,0
34587,58883,445,0,0,drop,66,66,0,1,0,1,0
34588,58887,445,0,0,drop,66,66,0,1,0,1,0
34589,58886,445,0,0,drop,66,66,0,1,0,1,0
34590,58882,445,0,0,drop,66,66,0,1,0,1,0
34591,62051,11392,0,0,deny,62,62,0,1,0,1,0
34592,60351,50584,0,0,deny,66,66,0,1,0,1,0
34593,58636,445,0,0,drop,70,70,0,1,0,1,0
34594,43700,30188,0,0,deny,62,62,0,1,0,1,0
34595,1057,57470,0,0,deny,62,62,0,1,0,1,0
34596,58634,445,0,0,drop,70,70,0,1,0,1,0
34597,58791,15503,0,0,deny,66,66,0,1,0,1,0
34598,12644,11392,0,0,deny,66,66,0,1,0,1,0
34599,58633,445,0,0,drop,70,70,0,1,0,1,0
34600,58632,445,0,0,drop,70,70,0,1,0,1,0
34601,58631,445,0,0,drop,70,70,0,1,0,1,0
34602,51996,57470,0,0,deny,66,66,0,1,0,1,0
34603,5222,7493,0,0,deny,66,66,0,1,0,1,0
34604,58628,445,0,0,drop,70,70,0,1,0,1,0
34605,58626,445,0,0,drop,70,70,0,1,0,1,0
34606,63488,445,0,0,drop,70,70,0,1,0,1,0
34607,63482,445,0,0,drop,70,70,0,1,0,1,0
34608,63480,445,0,0,drop,70,70,0,1,0,1,0
34609,63476,445,0,0,drop,70,70,0,1,0,1,0
34610,443,48120,0,0,deny,97,97,0,1,0,1,0
34611,35864,44847,0,0,deny,78,78,0,1,0,1,0
34612,50674,35440,0,0,deny,62,62,0,1,0,1,0
34613,58868,445,0,0,drop,66,66,0,1,0,1,0
34614,58869,445,0,0,drop,66,66,0,1,0,1,0
34615,58867,445,0,0,drop,66,66,0,1,0,1,0
34616,80,7597,0,0,deny,66,66,0,1,0,1,0
34617,27337,51505,0,0,deny,66,66,0,1,0,1,0
34618,50135,50584,0,0,deny,146,146,0,1,0,1,0
34619,58613,445,0,0,drop,70,70,0,1,0,1,0
34620,58612,445,0,0,drop,70,70,0,1,0,1,0
34621,58610,445,0,0,drop,70,70,0,1,0,1,0
34622,58602,445,0,0,drop,70,70,0,1,0,1,0
34623,58603,445,0,0,drop,70,70,0,1,0,1,0
34624,63472,445,0,0,drop,70,70,0,1,0,1,0
34625,63469,445,0,0,drop,70,70,0,1,0,1,0
34626,63467,445,0,0,drop,70,70,0,1,0,1,0
34627,63463,445,0,0,drop,70,70,0,1,0,1,0
34628,54976,2273,0,0,deny,60,60,0,1,0,1,0
34629,51374,30317,0,0,deny,62,62,0,1,0,1,0
34630,53766,51505,0,0,deny,66,66,0,1,0,1,0
34631,58591,445,0,0,drop,70,70,0,1,0,1,0
34632,63455,445,0,0,drop,70,70,0,1,0,1,0
34633,63453,445,0,0,drop,70,70,0,1,0,1,0
34634,63448,445,0,0,drop,70,70,0,1,0,1,0
34635,61766,44847,0,0,deny,66,66,0,1,0,1,0
34636,11450,57470,0,0,deny,66,66,0,1,0,1,0
34637,7286,44847,0,0,deny,66,66,0,1,0,1,0
34638,9394,51505,0,0,deny,62,62,0,1,0,1,0
34639,58858,445,0,0,drop,66,66,0,1,0,1,0
34640,56876,30188,0,0,deny,62,62,0,1,0,1,0
34641,58587,445,0,0,drop,70,70,0,1,0,1,0
34642,26872,44847,0,0,deny,62,62,0,1,0,1,0
34643,28429,23,0,0,deny,60,60,0,1,0,1,0
34644,54984,80,56260,80,allow,2487,680,1807,9,17,6,3
34645,53747,21698,30276,21698,allow,320,140,180,6,7,3,3
34646,63572,443,58406,443,allow,125798,40014,85784,276,171,125,151
34647,63059,443,42784,443,allow,5772,3849,1923,27,270,14,13
34648,48022,5228,46270,5228,allow,10096,2251,7845,41,3747,16,25
34649,50908,443,7886,443,allow,124,64,60,2,15,1,1
34650,54977,80,22361,80,allow,4259,1114,3145,12,18,8,4
34651,51430,443,37453,443,allow,7318,1585,5733,24,50,14,10
34652,55754,53,32469,53,allow,170,87,83,2,31,1,1
34653,21975,3389,21975,3389,allow,3910,1805,2105,20,19,12,8
34654,53141,8595,63363,8595,allow,70,70,0,2,8,2,0
34655,59902,443,47216,443,allow,6196,746,5450,17,28,8,9
34656,49341,443,40823,443,allow,484,210,274,8,135,4,4
34657,51429,443,6993,443,allow,8804,1597,7207,25,50,14,11
34658,55304,53,64050,53,allow,711,87,624,2,30,1,1
34659,49348,80,58488,80,allow,2695,601,2094,14,17,7,7
34660,60339,7010,60339,7010,allow,3322,2027,1295,16,16,9,7
34661,51905,65253,44295,65253,allow,66,66,0,1,5,1,0
34662,54716,443,54716,443,allow,4728,1821,2907,19,29,11,8
34663,54985,80,44594,80,allow,2452,680,1772,9,17,6,3
34664,40599,443,4488,443,allow,7338,2419,4919,19,23,12,7
34665,50469,80,50469,80,allow,350722,14506,336216,459,26,231,228
34666,49350,80,17216,80,allow,2485,529,1956,12,17,6,6
34667,58325,53,35330,53,allow,251,79,172,2,30,1,1
34668,56358,53,16023,53,allow,104,104,0,1,30,1,0
34669,63594,443,17345,443,allow,7673,2645,5028,31,137,17,14
34670,50907,443,12062,443,allow,124,64,60,2,15,1,1
34671,56856,47715,25916,47715,allow,66,66,0,1,5,1,0
34672,49632,7000,49632,7000,allow,1236,676,560,13,15,7,6
34673,9098,443,52183,443,allow,6177,969,5208,17,26,9,8
34674,58888,443,13119,443,allow,274616,12640,261976,352,28,167,185
34675,57045,53,27906,53,allow,170,87,83,2,30,1,1
34676,30960,45737,31575,45737,allow,330,330,0,6,3609,6,0
34677,43918,5228,35546,5228,allow,2276,1356,920,15,3601,7,8
34678,58124,80,58124,80,allow,125299,3364,121935,129,19,44,85
34679,63591,443,24703,443,allow,11746,3874,7872,44,141,22,22
34680,35085,443,56294,443,allow,1617,1062,555,13,45,8,5
34681,49012,443,59626,443,allow,44584,2838,41746,66,31,31,35
34682,52054,80,49202,80,allow,1682,642,1040,13,54,4,9
34683,52708,443,22649,443,allow,10748,1634,9114,22,316,10,12
34684,55822,80,1122,80,allow,1052,612,440,10,16,5,5
34685,56206,53,48081,53,allow,711,87,624,2,30,1,1
34686,61581,443,25669,443,allow,5103,2363,2740,11,120,6,5
34687,65444,3389,65444,3389,allow,4305,2521,1784,19,34,10,9
34688,62343,443,28448,443,allow,13709,1675,12034,25,31,11,14
34689,38576,443,42458,443,allow,10853,8227,2626,30,360,15,15
34690,48817,47719,48817,47719,allow,1837,852,985,8,1200,4,4
34691,32609,64097,0,0,deny,62,62,0,1,0,1,0
34692,58578,445,0,0,drop,70,70,0,1,0,1,0
34693,58577,445,0,0,drop,70,70,0,1,0,1,0
34694,58576,445,0,0,drop,70,70,0,1,0,1,0
34695,35408,56205,0,0,deny,66,66,0,1,0,1,0
34696,58574,445,0,0,drop,70,70,0,1,0,1,0
34697,39098,51505,0,0,deny,146,146,0,1,0,1,0
34698,58570,445,0,0,drop,70,70,0,1,0,1,0
34699,48857,50584,0,0,deny,66,66,0,1,0,1,0
34700,63446,445,0,0,drop,70,70,0,1,0,1,0
34701,63443,445,0,0,drop,70,70,0,1,0,1,0
34702,58869,57470,0,0,deny,145,145,0,1,0,1,0
34703,53321,443,65410,443,allow,416,210,206,7,28,4,3
34704,35775,443,51834,443,allow,6665,3913,2752,33,98,19,14
34705,63599,443,32617,443,allow,10050,1802,8248,30,39,16,14
34706,58976,43890,0,0,deny,62,62,0,1,0,1,0
34707,58843,445,0,0,drop,66,66,0,1,0,1,0
34708,58839,445,0,0,drop,66,66,0,1,0,1,0
34709,10477,44847,0,0,deny,66,66,0,1,0,1,0
34710,13917,18033,0,0,deny,62,62,0,1,0,1,0
34711,58565,445,0,0,drop,70,70,0,1,0,1,0
34712,63433,445,0,0,drop,70,70,0,1,0,1,0
34713,2691,64147,0,0,deny,62,62,0,1,0,1,0
34714,63427,445,0,0,drop,70,70,0,1,0,1,0
34715,63425,445,0,0,drop,70,70,0,1,0,1,0
34716,63424,445,0,0,drop,70,70,0,1,0,1,0
34717,54552,64147,0,0,deny,62,62,0,1,0,1,0
34718,39920,22114,0,0,deny,62,62,0,1,0,1,0
34719,58835,445,0,0,drop,66,66,0,1,0,1,0
34720,10243,36237,0,0,deny,62,62,0,1,0,1,0
34721,58555,445,0,0,drop,70,70,0,1,0,1,0
34722,53656,31573,0,0,deny,62,62,0,1,0,1,0
34723,48420,31755,0,0,deny,146,146,0,1,0,1,0
34724,58827,445,0,0,drop,66,66,0,1,0,1,0
34725,58825,445,0,0,drop,66,66,0,1,0,1,0
34726,58818,445,0,0,drop,66,66,0,1,0,1,0
34727,58830,445,0,0,drop,66,66,0,1,0,1,0
34728,58826,445,0,0,drop,66,66,0,1,0,1,0
34729,58819,445,0,0,drop,66,66,0,1,0,1,0
34730,58829,445,0,0,drop,66,66,0,1,0,1,0
34731,58553,445,0,0,drop,70,70,0,1,0,1,0
34732,62514,37807,0,0,deny,66,66,0,1,0,1,0
34733,1025,51221,0,0,deny,62,62,0,1,0,1,0
34734,57260,51221,0,0,deny,66,66,0,1,0,1,0
34735,63419,445,0,0,drop,70,70,0,1,0,1,0
34736,63417,445,0,0,drop,70,70,0,1,0,1,0
34737,63416,445,0,0,drop,70,70,0,1,0,1,0
34738,63413,445,0,0,drop,70,70,0,1,0,1,0
34739,43350,58414,0,0,deny,62,62,0,1,0,1,0
34740,58549,445,0,0,drop,70,70,0,1,0,1,0
34741,41734,57470,0,0,deny,62,62,0,1,0,1,0
34742,58547,445,0,0,drop,70,70,0,1,0,1,0
34743,14036,48817,0,0,deny,66,66,0,1,0,1,0
34744,15465,64147,0,0,deny,66,66,0,1,0,1,0
34745,6881,6881,0,0,deny,146,146,0,1,0,1,0
34746,53044,36237,0,0,deny,66,66,0,1,0,1,0
34747,3549,64147,0,0,deny,62,62,0,1,0,1,0
34748,62131,50584,0,0,deny,66,66,0,1,0,1,0
34749,48420,26672,0,0,deny,146,146,0,1,0,1,0
34750,58543,445,0,0,drop,70,70,0,1,0,1,0
34751,63411,445,0,0,drop,70,70,0,1,0,1,0
34752,63409,445,0,0,drop,70,70,0,1,0,1,0
34753,63405,445,0,0,drop,70,70,0,1,0,1,0
34754,63598,443,20938,443,allow,164604,5676,158928,188,39,70,118
34755,59898,443,27640,443,allow,1265,684,581,13,30,6,7
34756,60121,443,30083,443,allow,6351,1857,4494,20,16,11,9
34757,49343,443,10308,443,allow,1556,769,787,17,134,9,8
34758,55675,53,34777,53,allow,287,91,196,4,60,2,2
34759,37965,29299,52257,29299,allow,858,858,0,14,1199,14,0
34760,58883,443,6061,443,allow,5476,3102,2374,42,132,23,19
34761,53258,443,34531,443,allow,5916,1774,4142,25,15,14,11
34762,49885,7000,49885,7000,allow,3132,815,2317,14,15,7,7
34763,50470,80,50470,80,allow,2144,900,1244,11,26,7,4
34764,57556,443,56704,443,allow,162,102,60,2,5,1,1
34765,49346,443,21624,443,allow,4312,2524,1788,34,132,19,15
34766,61802,443,61802,443,allow,4521,1614,2907,19,26,11,8
34767,64274,53,5372,53,allow,197,102,95,2,32,1,1
34768,51928,52520,20049,52520,allow,258,70,188,4,8,2,2
34769,38446,443,2799,443,allow,46008,3750,42258,77,48,39,38
34770,49305,53,59053,53,allow,177,94,83,2,29,1,1
34771,65126,443,41319,443,allow,958,384,574,14,34,7,7
34772,60911,53,23878,53,allow,335,78,257,2,29,1,1
34773,57045,53,5353,53,allow,177,94,83,2,29,1,1
34774,65250,53,12810,53,allow,900,110,790,2,30,1,1
34775,49817,53,29101,53,allow,401,91,310,4,29,2,2
34776,63596,443,27876,443,allow,8104,2201,5903,28,135,15,13
34777,58870,443,14754,443,allow,7415,2363,5052,17,120,9,8
34778,56301,53,2529,53,allow,177,94,83,2,30,1,1
34779,50245,443,54814,443,allow,6866,1958,4908,21,20,13,8
34780,60444,47094,7095,47094,allow,320,140,180,6,7,3,3
34781,38427,443,30130,443,allow,12591,2902,9689,40,55,19,21
34782,49383,53,44225,53,allow,94,94,0,1,30,1,0
34783,34489,443,45344,443,allow,8363,1573,6790,24,49,14,10
34784,60791,443,31785,443,allow,15013,10159,4854,34,46,19,15
34785,63887,80,15748,80,allow,314,192,122,6,15,4,2
34786,60126,443,24609,443,allow,3015,2086,929,16,15,9,7
34787,60775,40010,2313,40010,allow,316,136,180,6,6,3,3
34788,46764,443,46764,443,allow,4401,1494,2907,19,29,11,8
34789,30201,53,30201,53,allow,235,90,145,2,33,1,1
34790,42615,443,10393,443,allow,117381,60398,56983,518,4126,256,262
34791,51929,53371,7224,53371,allow,70,70,0,2,8,2,0
34792,9099,443,46908,443,allow,6677,1097,5580,21,25,11,10
34793,56358,53,42887,53,allow,210,110,100,2,33,1,1
34794,59464,443,49741,443,allow,7333,1933,5400,27,16,15,12
34795,56913,53,62016,53,allow,247,94,153,2,30,1,1
34796,49438,443,56148,443,allow,180,60,120,4,15,2,2
34797,58037,80,32783,80,allow,2339,1122,1217,11,20,6,5
34798,57045,53,16294,53,allow,177,94,83,2,30,1,1
34799,34424,53,34424,53,allow,235,90,145,2,33,1,1
34800,38445,443,60732,443,allow,23571,4700,18871,60,48,30,30
34801,64814,53,63374,53,allow,212,102,110,2,30,1,1
34802,44009,443,15754,443,allow,1392,731,661,14,80,8,6
34803,57243,53,28936,53,allow,168,78,90,2,30,1,1
34804,38425,443,45581,443,allow,103112,8212,94900,165,55,80,85
34805,9152,443,16352,443,allow,15550,1508,14042,28,19,13,15
34806,42727,53,0,0,allow,82,82,0,2,40,2,0
34807,60476,80,59400,80,allow,613,539,74,7,15,6,1
34808,47504,443,4278,443,allow,6496,3631,2865,71,606,39,32
34809,50873,443,51953,443,allow,350,210,140,6,26,4,2
34810,56283,53,17978,53,allow,315,102,213,2,30,1,1
34811,64809,53,47769,53,allow,312,78,234,2,30,1,1
34812,50662,443,44987,443,allow,3306,1714,1592,17,16,9,8
34813,51927,63309,55046,63309,allow,70,70,0,2,8,2,0
34814,52539,80,47321,80,allow,1152,712,440,10,15,5,5
34815,50061,80,3362,80,allow,405,285,120,5,15,3,2
34816,54350,443,24025,443,allow,10318,2117,8201,38,371,19,19
34817,49839,53,21176,53,allow,315,102,213,2,30,1,1
34818,56222,53,43289,53,allow,168,78,90,2,30,1,1
34819,65409,53,62247,53,allow,200,94,106,2,30,1,1
34820,51595,443,19980,443,allow,632,158,474,2,30,1,1
34821,58362,53,30634,53,allow,167,78,89,2,30,1,1
34822,40994,443,58076,443,allow,1396,735,661,14,80,8,6
34823,49348,443,47501,443,allow,2879984,113967,2766017,3396,129,1423,1973
34824,51417,443,60924,443,allow,25865,7151,18714,36,15,19,17
34825,56706,80,18045,80,allow,214,140,74,4,25,3,1
34826,14436,443,7159,443,allow,2601,1455,1146,18,15,8,10
34827,51906,17491,7245,17491,allow,70,70,0,1,5,1,0
34828,46812,80,23325,80,allow,1137,679,458,10,15,6,4
34829,51892,80,28935,80,allow,15867,8841,7026,29,26,16,13
34830,53739,27290,11218,27290,allow,70,70,0,2,7,2,0
34831,53741,43800,53441,43800,allow,70,70,0,2,7,2,0
34832,34487,443,45811,443,allow,8363,1573,6790,24,49,14,10
34833,53256,443,33815,443,allow,6185,1994,4191,27,16,16,11
34834,38448,443,13312,443,allow,18512,3109,15403,45,48,22,23
34835,43094,443,34606,443,allow,6443,1973,4470,19,16,11,8
34836,48340,443,49643,443,allow,18198,13269,4929,47,324,20,27
34837,58052,80,61267,80,allow,1550,853,697,9,15,5,4
34838,56478,53,6625,53,allow,177,94,83,2,29,1,1
34839,56007,53,24693,53,allow,197,102,95,2,35,1,1
34840,56478,53,29572,53,allow,177,94,83,2,29,1,1
34841,34488,443,33891,443,allow,8363,1573,6790,24,49,14,10
34842,55754,53,35474,53,allow,177,94,83,2,30,1,1
34843,53678,443,40421,443,allow,6697,1606,5091,23,24,13,10
34844,64082,53,61850,53,allow,329,102,227,2,30,1,1
34845,53708,23280,6417,23280,allow,1903,968,935,16,16,9,7
34846,49266,53,8623,53,allow,86,86,0,1,30,1,0
34847,57546,443,50936,443,allow,34428,22220,12208,84,122,41,43
34848,63595,443,51163,443,allow,8062,2186,5876,29,136,15,14
34849,53706,59208,42614,59208,allow,164,70,94,2,8,1,1
34850,60792,443,58920,443,allow,5037,1343,3694,18,45,11,7
34851,51538,443,28169,443,allow,6384,1899,4485,16,75,9,7
34852,51894,80,51074,80,allow,7434,3830,3604,17,26,9,8
34853,60367,443,5802,443,allow,12979,6398,6581,39,115,22,17
34854,55754,53,39478,53,allow,177,94,83,2,30,1,1
34855,60166,443,54772,443,allow,7639,2673,4966,36,255,17,19
34856,38447,443,18020,443,allow,9824,2902,6922,38,48,19,19
34857,56833,28571,3493,28571,allow,5436,3022,2414,17,32,11,6
34858,58364,53,50367,53,allow,167,78,89,2,30,1,1
34859,58363,53,45299,53,allow,167,78,89,2,30,1,1
34860,56852,443,47368,443,allow,8215,2882,5333,32,90,16,16
34861,53707,44209,9971,44209,allow,1513,989,524,17,16,10,7
34862,42204,443,21062,443,allow,6197,942,5255,19,361,10,9
34863,60864,5223,16379,5223,allow,194,134,60,2,5,1,1
34864,38685,443,17432,443,allow,749731,23099,726632,823,16,326,497
34865,39851,443,44930,443,allow,9355,3422,5933,56,16,28,28
34866,64731,53,43372,53,allow,241,110,131,2,30,1,1
34867,64723,53,15149,53,allow,229,110,119,2,30,1,1
34868,52720,443,21173,443,allow,11732,4753,6979,41,397,17,24
34869,42203,443,25522,443,allow,6345,1024,5321,21,361,11,10
34870,42202,443,2028,443,allow,6610,1106,5504,23,361,12,11
34871,53460,443,49234,443,allow,6118,5698,420,12,124,6,6
34872,55704,53,8827,53,allow,177,94,83,2,31,1,1
34873,60123,443,13855,443,allow,6485,1957,4528,22,16,11,11
34874,50566,443,28525,443,allow,7367,1149,6218,18,27,9,9
34875,49477,53,44035,53,allow,168,78,90,2,30,1,1
34876,65350,53,62383,53,allow,168,86,82,2,30,1,1
34877,65350,53,48988,53,allow,168,86,82,2,30,1,1
34878,38684,443,33741,443,allow,90449,3289,87160,93,16,28,65
34879,56388,53,23027,53,allow,186,95,91,3,34,2,1
34880,45726,443,40256,443,allow,130,70,60,3,6,2,1
34881,50284,443,28484,443,allow,208,60,148,4,12,2,2
34882,38687,443,37401,443,allow,13923,1728,12195,24,16,10,14
34883,37264,443,41734,443,allow,130,70,60,3,5,2,1
34884,63888,6881,45286,6881,allow,70,70,0,1,5,1,0
34885,50565,443,52646,443,allow,1313,876,437,11,27,6,5
34886,50562,443,27211,443,allow,1313,876,437,11,27,6,5
34887,55761,53,38695,53,allow,168,78,90,2,30,1,1
34888,58665,53,16877,53,allow,260,86,174,2,30,1,1
34889,55704,53,43154,53,allow,177,94,83,2,30,1,1
34890,64179,53,19210,53,allow,212,102,110,2,30,1,1
34891,65350,53,48602,53,allow,168,86,82,2,31,1,1
34892,58813,445,0,0,drop,66,66,0,1,0,1,0
34893,58542,445,0,0,drop,70,70,0,1,0,1,0
34894,56883,22114,0,0,deny,62,62,0,1,0,1,0
34895,63404,445,0,0,drop,70,70,0,1,0,1,0
34896,58809,445,0,0,deny,66,66,0,1,0,1,0
34897,63342,53,0,0,deny,72,72,0,1,0,1,0
34898,58808,445,0,0,drop,66,66,0,1,0,1,0
34899,58807,445,0,0,drop,66,66,0,1,0,1,0
34900,37837,37965,0,0,deny,62,62,0,1,0,1,0
34901,58805,445,0,0,drop,66,66,0,1,0,1,0
34902,1038,37965,0,0,deny,62,62,0,1,0,1,0
34903,26085,10387,0,0,deny,148,148,0,1,0,1,0
34904,41840,50584,0,0,deny,66,66,0,1,0,1,0
34905,56101,57470,0,0,deny,66,66,0,1,0,1,0
34906,58537,445,0,0,drop,70,70,0,1,0,1,0
34907,4438,23,0,0,deny,60,60,0,1,0,1,0
34908,63399,445,0,0,drop,70,70,0,1,0,1,0
34909,5688,44847,0,0,deny,62,62,0,1,0,1,0
34910,63390,445,0,0,drop,70,70,0,1,0,1,0
34911,63391,445,0,0,drop,70,70,0,1,0,1,0
34912,52711,37965,0,0,deny,62,62,0,1,0,1,0
34913,52925,3389,0,0,deny,60,60,0,1,0,1,0
34914,58793,445,0,0,drop,66,66,0,1,0,1,0
34915,51646,37965,0,0,deny,62,62,0,1,0,1,0
34916,39730,17372,0,0,deny,66,66,0,1,0,1,0
34917,58524,445,0,0,drop,70,70,0,1,0,1,0
34918,58786,445,0,0,drop,66,66,0,1,0,1,0
34919,63376,445,0,0,drop,70,70,0,1,0,1,0
34920,50106,31573,0,0,deny,66,66,0,1,0,1,0
34921,58521,445,0,0,drop,70,70,0,1,0,1,0
34922,25453,35776,0,0,deny,145,145,0,1,0,1,0
34923,58784,445,0,0,drop,66,66,0,1,0,1,0
34924,50675,56205,0,0,deny,66,66,0,1,0,1,0
34925,56494,15503,0,0,deny,146,146,0,1,0,1,0
34926,52914,37965,0,0,deny,66,66,0,1,0,1,0
34927,24731,51505,0,0,deny,62,62,0,1,0,1,0
34928,58516,445,0,0,drop,70,70,0,1,0,1,0
34929,52537,37965,0,0,deny,62,62,0,1,0,1,0
34930,9506,2323,0,0,deny,60,60,0,1,0,1,0
34931,58515,445,0,0,drop,70,70,0,1,0,1,0
34932,58775,445,0,0,drop,66,66,0,1,0,1,0
34933,41756,56205,0,0,deny,62,62,0,1,0,1,0
34934,58773,445,0,0,drop,66,66,0,1,0,1,0
34935,58513,445,0,0,drop,70,70,0,1,0,1,0
34936,64438,23,0,0,deny,60,60,0,1,0,1,0
34937,39324,64147,0,0,deny,62,62,0,1,0,1,0
34938,63027,35440,0,0,deny,62,62,0,1,0,1,0
34939,63367,445,0,0,drop,70,70,0,1,0,1,0
34940,63365,445,0,0,drop,70,70,0,1,0,1,0
34941,63364,445,0,0,drop,70,70,0,1,0,1,0
34942,58506,445,0,0,drop,70,70,0,1,0,1,0
34943,58758,445,0,0,drop,66,66,0,1,0,1,0
34944,58760,445,0,0,drop,66,66,0,1,0,1,0
34945,58755,445,0,0,drop,66,66,0,1,0,1,0
34946,58761,445,0,0,drop,66,66,0,1,0,1,0
34947,58756,445,0,0,drop,66,66,0,1,0,1,0
34948,58759,445,0,0,drop,66,66,0,1,0,1,0
34949,58754,445,0,0,drop,66,66,0,1,0,1,0
34950,58753,445,0,0,drop,66,66,0,1,0,1,0
34951,43724,35440,0,0,deny,146,146,0,1,0,1,0
34952,443,60496,0,0,deny,320,320,0,1,0,1,0
34953,59147,51505,0,0,deny,62,62,0,1,0,1,0
34954,58504,445,0,0,drop,70,70,0,1,0,1,0
34955,12031,36237,0,0,deny,66,66,0,1,0,1,0
34956,52650,44847,0,0,deny,66,66,0,1,0,1,0
34957,16377,21247,0,0,deny,62,62,0,1,0,1,0
34958,58686,18375,0,0,deny,66,66,0,1,0,1,0
34959,40005,36237,0,0,deny,62,62,0,1,0,1,0
34960,58503,445,0,0,drop,70,70,0,1,0,1,0
34961,58502,445,0,0,drop,70,70,0,1,0,1,0
34962,58501,445,0,0,drop,70,70,0,1,0,1,0
34963,58497,445,0,0,drop,70,70,0,1,0,1,0
34964,58499,445,0,0,drop,70,70,0,1,0,1,0
34965,59095,57470,0,0,deny,66,66,0,1,0,1,0
34966,43129,15503,0,0,deny,62,62,0,1,0,1,0
34967,61008,5555,0,0,deny,60,60,0,1,0,1,0
34968,61147,22114,0,0,deny,62,62,0,1,0,1,0
34969,56186,57470,0,0,deny,62,62,0,1,0,1,0
34970,23900,64147,0,0,deny,62,62,0,1,0,1,0
34971,1054,57470,0,0,deny,62,62,0,1,0,1,0
34972,63360,445,0,0,drop,70,70,0,1,0,1,0
34973,63358,445,0,0,drop,70,70,0,1,0,1,0
34974,63352,445,0,0,drop,70,70,0,1,0,1,0
34975,63348,445,0,0,drop,70,70,0,1,0,1,0
34976,57368,7302,0,0,deny,66,66,0,1,0,1,0
34977,51300,64147,0,0,deny,62,62,0,1,0,1,0
34978,61744,11392,0,0,deny,66,66,0,1,0,1,0
34979,58483,445,0,0,drop,70,70,0,1,0,1,0
34980,58741,445,0,0,drop,66,66,0,1,0,1,0
34981,58739,445,0,0,drop,66,66,0,1,0,1,0
34982,58738,445,0,0,drop,66,66,0,1,0,1,0
34983,58482,445,0,0,drop,70,70,0,1,0,1,0
34984,58476,445,0,0,drop,70,70,0,1,0,1,0
34985,64237,51505,0,0,deny,66,66,0,1,0,1,0
34986,58472,445,0,0,drop,70,70,0,1,0,1,0
34987,58473,445,0,0,drop,70,70,0,1,0,1,0
34988,51320,37965,0,0,deny,62,62,0,1,0,1,0
34989,63527,50584,0,0,deny,66,66,0,1,0,1,0
34990,51185,37965,0,0,deny,62,62,0,1,0,1,0
34991,65012,2767,0,0,deny,66,66,0,1,0,1,0
34992,14023,37965,0,0,deny,62,62,0,1,0,1,0
34993,59985,57470,0,0,deny,62,62,0,1,0,1,0
34994,63344,445,0,0,drop,70,70,0,1,0,1,0
34995,64586,50584,0,0,deny,62,62,0,1,0,1,0
34996,63343,445,0,0,drop,70,70,0,1,0,1,0
34997,63339,445,0,0,drop,70,70,0,1,0,1,0
34998,63334,445,0,0,drop,70,70,0,1,0,1,0
34999,35261,15503,0,0,deny,74,74,0,1,0,1,0
35000,13445,44847,0,0,deny,66,66,0,1,0,1,0
35001,24281,23,0,0,deny,60,60,0,1,0,1,0
35002,1024,44847,0,0,deny,62,62,0,1,0,1,0
35003,10669,49756,0,0,deny,60,60,0,1,0,1,0
35004,58461,445,0,0,drop,70,70,0,1,0,1,0
35005,10669,49756,0,0,deny,60,60,0,1,0,1,0
35006,10669,49756,0,0,deny,60,60,0,1,0,1,0
35007,10669,49756,0,0,deny,60,60,0,1,0,1,0
35008,10669,49756,0,0,deny,60,60,0,1,0,1,0
35009,8889,9806,0,0,deny,60,60,0,1,0,1,0
35010,57020,36237,0,0,deny,62,62,0,1,0,1,0
35011,55009,1114,14128,1114,allow,6562,1873,4689,25,16,15,10
35012,53737,51456,15956,51456,allow,70,70,0,2,8,2,0
35013,443,6793,0,0,allow,169,169,0,2,90,2,0
35014,55704,53,24414,53,allow,170,87,83,2,30,1,1
35015,50561,80,19741,80,allow,318,192,126,6,26,4,2
35016,50573,80,11289,80,allow,318,192,126,6,26,4,2
35017,51231,443,6800,443,allow,63550,10766,52784,98,131,43,55
35018,29011,7000,29011,7000,allow,3756,2125,1631,18,17,10,8
35019,64274,53,57250,53,allow,104,104,0,2,35,2,0
35020,50571,80,62731,80,allow,318,192,126,6,26,4,2
35021,54034,443,22227,443,allow,43491,8521,34970,69,50,34,35
35022,41390,443,29292,443,allow,7240,2035,5205,25,316,12,13
35023,65350,53,19451,53,allow,75,75,0,1,30,1,0
35024,8531,53,8531,53,allow,213,87,126,2,30,1,1
35025,50559,80,62420,80,allow,318,192,126,6,26,4,2
35026,29746,53,29746,53,allow,235,90,145,2,32,1,1
35027,55517,443,55517,443,allow,274414,45529,228885,359,170,186,173
35028,56810,53,59842,53,allow,751,95,656,2,30,1,1
35029,37134,53,0,0,allow,82,82,0,1,30,1,0
35030,52049,443,18143,443,allow,7710,2476,5234,18,135,8,10
35031,6825,53,6825,53,allow,217,87,130,2,30,1,1
35032,50254,53,7590,53,allow,749,94,655,2,30,1,1
35033,64379,53,64379,53,allow,235,90,145,2,33,1,1
35034,53732,22704,63994,22704,allow,70,70,0,2,8,2,0
35035,57634,5228,55639,5228,allow,165,105,60,2,5,1,1
35036,4083,443,26942,443,allow,2227,1018,1209,17,16,8,9
35037,38674,80,36626,80,allow,1114,534,580,12,16,7,5
35038,56721,53,12920,53,allow,711,87,624,2,30,1,1
35039,47733,443,46776,443,allow,556154,55291,500863,1146,559,440,706
35040,64603,34021,0,0,allow,66,66,0,1,90,1,0
35041,55721,53,57546,53,allow,170,87,83,2,31,1,1
35042,45499,443,58024,443,allow,17031,8260,8771,39,128,19,20
35043,50572,80,10361,80,allow,318,192,126,6,26,4,2
35044,60338,7000,60338,7000,allow,3486,1983,1503,15,16,8,7
35045,60380,443,8139,443,allow,70,70,0,2,8,2,0
35046,50570,80,64078,80,allow,318,192,126,6,26,4,2
35047,40474,1488,40474,1488,allow,156,156,0,3,8,3,0
35048,50568,80,17182,80,allow,318,192,126,6,26,4,2
35049,50569,80,5164,80,allow,318,192,126,6,26,4,2
35050,53137,35111,32550,35111,allow,70,70,0,1,5,1,0
35051,50560,80,54497,80,allow,318,192,126,6,26,4,2
35052,60930,443,60930,443,allow,16379,2214,14165,39,18,20,19
35053,54455,443,54455,443,allow,324001,46592,277409,409,177,203,206
35054,35061,80,46318,80,allow,15651782,355118,15296664,15172,45,5065,10107
35055,57051,53,59033,53,allow,711,87,624,2,30,1,1
35056,40204,40028,12239,40028,allow,143,81,62,2,30,1,1
35057,38834,53,64506,53,allow,168,78,90,2,30,1,1
35058,55094,53,26727,53,allow,754,94,660,2,31,1,1
35059,56559,53,54246,53,allow,711,87,624,2,31,1,1
35060,62293,53,18482,53,allow,232,88,144,2,31,1,1
35061,47119,5228,18356,5228,allow,3630,2427,1203,21,3601,11,10
35062,61938,443,24031,443,allow,3663,1097,2566,13,136,6,7
35063,47564,5900,0,0,deny,60,60,0,1,0,1,0
35064,10933,23,0,0,deny,60,60,0,1,0,1,0
35065,39617,50584,0,0,deny,62,62,0,1,0,1,0
35066,42044,60043,0,0,deny,62,62,0,1,0,1,0
35067,16382,17500,0,0,deny,62,62,0,1,0,1,0
35068,63325,445,0,0,drop,70,70,0,1,0,1,0
35069,63324,445,0,0,drop,70,70,0,1,0,1,0
35070,63322,445,0,0,drop,70,70,0,1,0,1,0
35071,21502,44847,0,0,deny,66,66,0,1,0,1,0
35072,58457,445,0,0,drop,70,70,0,1,0,1,0
35073,58728,445,0,0,drop,66,66,0,1,0,1,0
35074,47944,50584,0,0,deny,146,146,0,1,0,1,0
35075,7226,50584,0,0,deny,146,146,0,1,0,1,0
35076,27160,64147,0,0,deny,66,66,0,1,0,1,0
35077,58447,445,0,0,drop,70,70,0,1,0,1,0
35078,58446,445,0,0,drop,70,70,0,1,0,1,0
35079,58444,445,0,0,drop,70,70,0,1,0,1,0
35080,58443,445,0,0,drop,70,70,0,1,0,1,0
35081,58439,445,0,0,drop,70,70,0,1,0,1,0
35082,30135,37965,0,0,deny,66,66,0,1,0,1,0
35083,31727,57470,0,0,deny,62,62,0,1,0,1,0
35084,61419,57470,0,0,deny,66,66,0,1,0,1,0
35085,59948,22114,0,0,deny,146,146,0,1,0,1,0
35086,61451,17500,0,0,deny,66,66,0,1,0,1,0
35087,26889,50265,0,0,deny,66,66,0,1,0,1,0
35088,57706,64147,0,0,deny,66,66,0,1,0,1,0
35089,61033,39004,0,0,deny,66,66,0,1,0,1,0
35090,63318,445,0,0,drop,70,70,0,1,0,1,0
35091,63316,445,0,0,drop,70,70,0,1,0,1,0
35092,28009,36237,0,0,deny,62,62,0,1,0,1,0
35093,61522,64147,0,0,deny,62,62,0,1,0,1,0
35094,38637,22,0,0,deny,60,60,0,1,0,1,0
35095,64824,37965,0,0,deny,62,62,0,1,0,1,0
35096,37260,21247,0,0,deny,66,66,0,1,0,1,0
35097,58713,445,0,0,drop,66,66,0,1,0,1,0
35098,58710,445,0,0,drop,66,66,0,1,0,1,0
35099,49128,18593,0,0,deny,157,157,0,1,0,1,0
35100,58434,445,0,0,drop,70,70,0,1,0,1,0
35101,61323,23117,0,0,deny,146,146,0,1,0,1,0
35102,48706,23393,0,0,deny,60,60,0,1,0,1,0
35103,63305,445,0,0,drop,70,70,0,1,0,1,0
35104,63301,445,0,0,drop,70,70,0,1,0,1,0
35105,49159,53,5839,53,allow,195,86,109,2,30,1,1
35106,34642,53,34642,53,allow,220,90,130,2,30,1,1
35107,56905,53,61024,53,allow,239,110,129,2,30,1,1
35108,50600,80,53751,80,allow,1658,1247,411,8,15,5,3
35109,49354,443,37956,443,allow,22643,7456,15187,32,15,17,15
35110,56301,53,31707,53,allow,177,94,83,2,29,1,1
35111,65171,53,52756,53,allow,194,94,100,2,29,1,1
35112,42642,443,27903,443,allow,6826,1804,5022,21,137,11,10
35113,50567,443,48889,443,allow,7367,1149,6218,18,26,9,9
35114,50591,80,63944,80,allow,318,192,126,6,25,4,2
35115,50563,443,65476,443,allow,1313,876,437,11,26,6,5
35116,41033,443,54265,443,allow,4974,2311,2663,29,79,15,14
35117,9137,80,35596,80,allow,908,842,66,7,18,6,1
35118,52730,7000,52730,7000,allow,2163,676,1487,14,15,7,7
35119,50564,443,57456,443,allow,1313,876,437,11,26,6,5
35120,53744,10030,43880,10030,allow,320,140,180,6,5,3,3
35121,42295,443,63348,443,allow,9164,2473,6691,22,17,13,9
35122,53252,443,50911,443,allow,6899,2368,4531,27,27,14,13
35123,53088,443,43774,443,allow,161938,137946,23992,412,384,227,185
35124,57433,443,58515,443,allow,11243,4236,7007,47,15,22,25
35125,53733,40599,57099,40599,allow,70,70,0,2,7,2,0
35126,35292,8100,45355,8100,allow,78,78,0,1,4,1,0
35127,50700,80,35384,80,allow,142,142,0,1,4,1,0
35128,59470,53,45081,53,allow,184,86,98,2,29,1,1
35129,49250,53,39996,53,allow,225,110,115,2,29,1,1
35130,55704,53,10411,53,allow,177,94,83,2,31,1,1
35131,40204,40002,65519,40002,allow,148,86,62,2,30,1,1
35132,56356,53,26889,53,allow,277,118,159,2,30,1,1
35133,57470,39113,45501,39113,allow,14689,8867,5822,93,3051,67,26
35134,49715,53,39049,53,allow,807,94,713,2,30,1,1
35135,50556,80,38454,80,allow,378,192,186,7,26,4,3
35136,56854,17067,27330,17067,allow,70,70,0,1,5,1,0
35137,47821,443,31829,443,allow,71624,60795,10829,194,131,110,84
35138,42578,443,53109,443,allow,3857,2757,1100,27,22,14,13
35139,58029,80,1723,80,allow,374,192,182,7,21,4,3
35140,55457,53,12461,53,allow,177,94,83,2,30,1,1
35141,65104,53,46686,53,allow,311,94,217,2,30,1,1
35142,56726,53,58672,53,allow,223,102,121,2,30,1,1
35143,55457,53,25879,53,allow,177,94,83,2,30,1,1
35144,50557,80,9717,80,allow,318,192,126,6,26,4,2
35145,64364,53,34718,53,allow,323,110,213,2,30,1,1
35146,57270,53,35020,53,allow,211,102,109,2,30,1,1
35147,51925,29587,42996,29587,allow,70,70,0,2,8,2,0
35148,49487,53,45596,53,allow,267,102,165,2,30,1,1
35149,50577,80,17204,80,allow,2350,896,1454,13,25,7,6
35150,65489,443,61860,443,allow,92240,4799,87441,107,16,43,64
35151,54985,53,45907,53,allow,177,94,83,2,30,1,1
35152,55280,53,18692,53,allow,258,110,148,2,30,1,1
35153,65490,443,45608,443,allow,405489,12010,393479,416,16,146,270
35154,51195,123,46436,123,allow,184,94,90,2,30,1,1
35155,52426,443,50838,443,allow,782,428,354,12,28,7,5
35156,50575,80,13060,80,allow,318,192,126,6,25,4,2
35157,50555,80,24136,80,allow,318,192,126,6,26,4,2
35158,53648,31637,13598,31637,allow,744,618,126,10,28,8,2
35159,43093,443,25301,443,allow,7028,2558,4470,19,16,11,8
35160,62335,443,30924,443,allow,73341,3336,70005,85,48,27,58
35161,41371,53,41371,53,allow,220,90,130,2,30,1,1
35162,56613,53,57106,53,allow,307,134,173,2,30,1,1
35163,54985,53,30088,53,allow,177,94,83,2,30,1,1
35164,57195,53,47926,53,allow,195,102,93,2,33,1,1
35165,41639,8080,18114,8080,allow,78,78,0,2,8,2,0
35166,34782,443,56417,443,allow,15321,1796,13525,26,326,11,15
35167,64838,53,23821,53,allow,338,110,228,2,30,1,1
35168,57201,53,57201,53,allow,220,90,130,2,30,1,1
35169,60186,53,47856,53,allow,199,94,105,2,30,1,1
35170,50552,53,38940,53,allow,164,78,86,2,30,1,1
35171,49195,53,13959,53,allow,239,110,129,2,30,1,1
35172,55721,53,26269,53,allow,177,94,83,2,30,1,1
35173,49606,53,17957,53,allow,258,110,148,2,30,1,1
35174,57340,53,43547,53,allow,370,94,276,2,30,1,1
35175,30188,39920,5702,39920,allow,501,150,351,2,1200,1,1
35176,49272,53,30273,53,allow,168,86,82,2,31,1,1
35177,53232,443,40771,443,allow,69742,34581,35161,105,63,52,53
35178,57556,443,34647,443,allow,7087,2587,4500,21,30,12,9
35179,33825,443,12586,443,allow,15400,12233,3167,75,995,38,37
35180,47140,443,13289,443,allow,7669,3355,4314,33,38,19,14
35181,50545,443,13694,443,allow,10127,1872,8255,26,27,13,13
35182,55247,443,30780,443,allow,9656,3460,6196,22,46,12,10
35183,50550,80,15717,80,allow,374,192,182,7,26,4,3
35184,58512,5222,4015,5222,allow,2834,1238,1596,26,34,13,13
35185,43837,443,18055,443,allow,5733,1543,4190,24,28,13,11
35186,50551,80,44425,80,allow,374,192,182,7,26,4,3
35187,49863,8100,10467,8100,allow,78,78,0,1,4,1,0
35188,51924,28016,24796,28016,allow,70,70,0,2,8,2,0
35189,53735,58869,2598,58869,allow,70,70,0,2,7,2,0
35190,56724,443,8554,443,allow,14956,2081,12875,30,20,16,14
35191,44062,443,39025,443,allow,4614,853,3761,16,127,9,7
35192,53734,22051,59968,22051,allow,70,70,0,2,7,2,0
35193,50261,443,64119,443,allow,10320,3495,6825,45,136,25,20
35194,53736,37168,47120,37168,allow,70,70,0,2,7,2,0
35195,51903,35904,40844,35904,allow,70,70,0,1,5,1,0
35196,57436,53,11754,53,allow,728,102,626,2,29,1,1
35197,64807,53,32139,53,allow,246,118,128,2,29,1,1
35198,37936,443,26226,443,allow,5463,1378,4085,16,145,10,6
35199,55754,53,48167,53,allow,177,94,83,2,29,1,1
35200,58666,53,17306,53,allow,167,78,89,2,29,1,1
35201,58026,80,26240,80,allow,454,262,192,8,21,5,3
35202,59181,53,28620,53,allow,260,86,174,2,29,1,1
35203,49962,53,32122,53,allow,402,118,284,2,30,1,1
35204,52858,443,52858,443,allow,313243,267937,45306,456,5925,210,246
35205,53986,443,26855,443,allow,6734,2264,4470,19,16,11,8
35206,56682,53,9242,53,allow,196,86,110,2,30,1,1
35207,58860,53,53609,53,allow,209,102,107,2,29,1,1
35208,64510,53,63517,53,allow,280,118,162,2,29,1,1
35209,60053,53,50009,53,allow,199,94,105,2,30,1,1
35210,44921,53,22635,53,allow,168,78,90,2,30,1,1
35211,56786,443,47874,443,allow,36203,1763,34440,46,119,17,29
35212,52050,443,62804,443,allow,9896,3586,6310,27,134,13,14
35213,56185,443,34268,443,allow,5415,1730,3685,20,120,9,11
35214,3304,80,1558,80,allow,2340,1419,921,10,15,5,5
35215,51926,58664,36241,58664,allow,70,70,0,2,8,2,0
35216,49345,443,62638,443,allow,26156,6762,19394,37,16,16,21
35217,50194,443,13497,443,allow,50338,5239,45099,54,165,19,35
35218,56682,53,37640,53,allow,168,86,82,2,30,1,1
35219,37840,53,37840,53,allow,216,90,126,2,30,1,1
35220,38515,443,54100,443,allow,12624,5203,7421,48,274,24,24
35221,40204,40027,54251,40027,allow,245,182,63,2,30,1,1
35222,55721,53,41720,53,allow,177,94,83,2,30,1,1
35223,57309,53,41723,53,allow,316,110,206,2,30,1,1
35224,49715,53,16817,53,allow,184,94,90,2,30,1,1
35225,6333,53,6333,53,allow,216,90,126,2,30,1,1
35226,55475,443,50971,443,allow,8714,1456,7258,25,32,13,12
35227,39154,80,25294,80,allow,1504,926,578,15,36,9,6
35228,50540,80,53400,80,allow,2175,1539,636,13,27,8,5
35229,50582,443,54824,443,allow,7453,1467,5986,19,25,10,9
35230,50553,80,13843,80,allow,378,192,186,7,26,4,3
35231,50554,80,7103,80,allow,378,192,186,7,26,4,3
35232,50558,80,10581,80,allow,318,192,126,6,26,4,2
35233,51904,51883,50262,51883,allow,70,70,0,1,5,1,0
35234,65003,53,32396,53,allow,94,94,0,1,30,1,0
35235,57195,53,17608,53,allow,195,102,93,2,30,1,1
35236,53105,53,53105,53,allow,216,90,126,2,30,1,1
35237,65509,53,55791,53,allow,321,102,219,2,30,1,1
35238,47625,53,55385,53,allow,168,78,90,2,30,1,1
35239,36194,443,29201,443,allow,5674,1556,4118,23,271,13,10
35240,50574,80,28738,80,allow,318,192,126,6,25,4,2
35241,64430,53,25685,53,allow,245,118,127,2,30,1,1
35242,6929,53,6929,53,allow,197,90,107,2,30,1,1
35243,64913,53,34114,53,allow,211,102,109,2,30,1,1
35244,60873,443,46332,443,allow,4265,1678,2587,21,142,10,11
35245,15503,63684,7728,63684,allow,481,150,331,2,1200,1,1
35246,60355,443,30669,443,allow,5341,2434,2907,19,135,9,10
35247,34912,443,42889,443,allow,36366,2297,34069,51,139,21,30
35248,6882,9220,16555,9220,allow,654,150,504,3,1200,1,2
35249,44847,30066,30079,30066,allow,150,150,0,1,1200,1,0
35250,45423,80,20264,80,allow,2259,1830,429,11,150,6,5
35251,61886,443,1075,443,allow,8829,3335,5494,16,126,9,7
35252,55286,53,26564,53,allow,268,87,181,4,35,2,2
35253,63899,62015,4677,62015,allow,66,66,0,2,8,2,0
35254,56914,53,35890,53,allow,100,100,0,2,35,2,0
35255,51457,443,49898,443,allow,642,582,60,2,15,1,1
35256,53713,26085,40044,26085,allow,70,70,0,1,5,1,0
35257,51976,443,51253,443,allow,14912,9611,5301,36,57,21,15
35258,36756,443,3567,443,allow,6112,1553,4559,18,16,10,8
35259,1100,27540,53473,27540,allow,132,70,62,2,30,1,1
35260,37434,443,37114,443,allow,11113,2993,8120,26,143,14,12
35261,52043,443,36100,443,allow,7847,1904,5943,21,361,10,11
35262,53729,40721,59100,40721,allow,70,70,0,2,8,2,0
35263,55740,8060,53740,8060,allow,70,70,0,1,5,1,0
35264,55286,53,17426,53,allow,268,87,181,4,35,2,2
35265,50052,53,23158,53,allow,789,102,687,2,30,1,1
35266,64805,53,48699,53,allow,278,102,176,2,31,1,1
35267,63297,445,0,0,drop,70,70,0,1,0,1,0
35268,63296,445,0,0,drop,70,70,0,1,0,1,0
35269,43578,15503,0,0,deny,74,74,0,1,0,1,0
35270,58426,445,0,0,drop,70,70,0,1,0,1,0
35271,58708,445,0,0,drop,66,66,0,1,0,1,0
35272,23197,44847,0,0,deny,146,146,0,1,0,1,0
35273,58425,445,0,0,drop,70,70,0,1,0,1,0
35274,58700,445,0,0,drop,66,66,0,1,0,1,0
35275,58692,445,0,0,drop,66,66,0,1,0,1,0
35276,58698,445,0,0,drop,66,66,0,1,0,1,0
35277,58690,445,0,0,drop,66,66,0,1,0,1,0
35278,58702,445,0,0,drop,66,66,0,1,0,1,0
35279,58691,445,0,0,drop,66,66,0,1,0,1,0
35280,58701,445,0,0,drop,66,66,0,1,0,1,0
35281,60361,57470,0,0,deny,62,62,0,1,0,1,0
35282,1530,62413,0,0,deny,62,62,0,1,0,1,0
35283,35154,42707,0,0,deny,62,62,0,1,0,1,0
35284,62348,30349,0,0,deny,148,148,0,1,0,1,0
35285,63291,445,0,0,drop,70,70,0,1,0,1,0
35286,54016,42707,0,0,deny,66,66,0,1,0,1,0
35287,58420,445,0,0,drop,70,70,0,1,0,1,0
35288,63289,445,0,0,drop,70,70,0,1,0,1,0
35289,63288,445,0,0,drop,70,70,0,1,0,1,0
35290,63286,445,0,0,drop,70,70,0,1,0,1,0
35291,58418,445,0,0,drop,70,70,0,1,0,1,0
35292,443,60496,0,0,deny,320,320,0,1,0,1,0
35293,27528,35440,0,0,deny,62,62,0,1,0,1,0
35294,40512,57470,0,0,deny,74,74,0,1,0,1,0
35295,61135,50265,0,0,deny,62,62,0,1,0,1,0
35296,61150,11392,0,0,deny,62,62,0,1,0,1,0
35297,51401,6881,0,0,deny,62,62,0,1,0,1,0
35298,58414,445,0,0,drop,70,70,0,1,0,1,0
35299,13559,57866,0,0,deny,66,66,0,1,0,1,0
35300,58413,445,0,0,drop,70,70,0,1,0,1,0
35301,63284,445,0,0,drop,70,70,0,1,0,1,0
35302,63280,445,0,0,drop,70,70,0,1,0,1,0
35303,63278,445,0,0,drop,70,70,0,1,0,1,0
35304,21034,50265,0,0,deny,66,66,0,1,0,1,0
35305,58685,445,0,0,drop,66,66,0,1,0,1,0
35306,48388,44847,0,0,deny,62,62,0,1,0,1,0
35307,51535,44847,0,0,deny,62,62,0,1,0,1,0
35308,63276,445,0,0,drop,70,70,0,1,0,1,0
35309,58682,445,0,0,drop,66,66,0,1,0,1,0
35310,6338,23117,0,0,deny,66,66,0,1,0,1,0
35311,64815,37965,0,0,deny,66,66,0,1,0,1,0
35312,56367,44847,0,0,deny,66,66,0,1,0,1,0
35313,58678,445,0,0,drop,66,66,0,1,0,1,0
35314,58680,445,0,0,drop,66,66,0,1,0,1,0
35315,53835,62413,0,0,deny,62,62,0,1,0,1,0
35316,57964,44847,0,0,deny,62,62,0,1,0,1,0
35317,58676,445,0,0,drop,66,66,0,1,0,1,0
35318,58408,445,0,0,drop,70,70,0,1,0,1,0
35319,26642,57470,0,0,deny,62,62,0,1,0,1,0
35320,48676,53389,0,0,deny,60,60,0,1,0,1,0
35321,58338,3369,0,0,deny,60,60,0,1,0,1,0
35322,24874,55108,0,0,deny,145,145,0,1,0,1,0
35323,56794,46824,0,0,deny,66,66,0,1,0,1,0
35324,63272,445,0,0,drop,70,70,0,1,0,1,0
35325,63266,445,0,0,drop,70,70,0,1,0,1,0
35326,63265,445,0,0,drop,70,70,0,1,0,1,0
35327,46516,57470,0,0,deny,62,62,0,1,0,1,0
35328,58665,445,0,0,drop,66,66,0,1,0,1,0
35329,58395,445,0,0,drop,70,70,0,1,0,1,0
35330,13408,44847,0,0,deny,66,66,0,1,0,1,0
35331,3047,50584,0,0,deny,62,62,0,1,0,1,0
35332,45908,33330,0,0,deny,60,60,0,1,0,1,0
35333,58392,445,0,0,drop,70,70,0,1,0,1,0
35334,58658,445,0,0,drop,66,66,0,1,0,1,0
35335,63248,445,0,0,drop,70,70,0,1,0,1,0
35336,4935,3389,0,0,deny,66,66,0,1,0,1,0
35337,56869,17637,0,0,deny,66,66,0,1,0,1,0
35338,58655,445,0,0,drop,66,66,0,1,0,1,0
35339,6889,7363,0,0,deny,143,143,0,1,0,1,0
35340,58387,445,0,0,drop,70,70,0,1,0,1,0
35341,443,60496,0,0,deny,320,320,0,1,0,1,0
35342,49958,36829,0,0,deny,66,66,0,1,0,1,0
35343,58386,445,0,0,drop,70,70,0,1,0,1,0
35344,13285,29892,0,0,deny,145,145,0,1,0,1,0
35345,0,0,0,0,allow,480,244,236,4,0,2,2
35346,58384,445,0,0,drop,70,70,0,1,0,1,0
35347,55966,35440,0,0,deny,66,66,0,1,0,1,0
35348,58648,445,0,0,drop,66,66,0,1,0,1,0
35349,12951,50584,0,0,deny,66,66,0,1,0,1,0
35350,62089,8604,0,0,deny,62,62,0,1,0,1,0
35351,58642,445,0,0,drop,66,66,0,1,0,1,0
35352,47063,15503,0,0,deny,146,146,0,1,0,1,0
35353,55835,62413,0,0,deny,66,66,0,1,0,1,0
35354,8103,65473,0,0,deny,157,157,0,1,0,1,0
35355,16330,50584,0,0,deny,62,62,0,1,0,1,0
35356,58582,50584,0,0,deny,66,66,0,1,0,1,0
35357,13160,7905,0,0,deny,62,62,0,1,0,1,0
35358,25620,50432,0,0,deny,146,146,0,1,0,1,0
35359,51581,17546,0,0,deny,62,62,0,1,0,1,0
35360,36579,30188,0,0,deny,66,66,0,1,0,1,0
35361,58377,445,0,0,drop,70,70,0,1,0,1,0
35362,63239,445,0,0,drop,70,70,0,1,0,1,0
35363,63237,445,0,0,drop,70,70,0,1,0,1,0
35364,63236,445,0,0,drop,70,70,0,1,0,1,0
35365,58375,445,0,0,drop,70,70,0,1,0,1,0
35366,58629,445,0,0,drop,66,66,0,1,0,1,0
35367,58633,445,0,0,drop,66,66,0,1,0,1,0
35368,58628,445,0,0,drop,66,66,0,1,0,1,0
35369,58632,445,0,0,drop,66,66,0,1,0,1,0
35370,58631,445,0,0,drop,66,66,0,1,0,1,0
35371,58630,445,0,0,drop,66,66,0,1,0,1,0
35372,58627,445,0,0,drop,66,66,0,1,0,1,0
35373,58625,445,0,0,drop,66,66,0,1,0,1,0
35374,44821,64147,0,0,deny,62,62,0,1,0,1,0
35375,6881,6881,0,0,deny,146,146,0,1,0,1,0
35376,58374,445,0,0,drop,70,70,0,1,0,1,0
35377,13963,50584,0,0,deny,66,66,0,1,0,1,0
35378,58373,445,0,0,drop,70,70,0,1,0,1,0
35379,58372,445,0,0,drop,70,70,0,1,0,1,0
35380,59694,50584,0,0,deny,66,66,0,1,0,1,0
35381,58367,445,0,0,drop,70,70,0,1,0,1,0
35382,58366,445,0,0,drop,70,70,0,1,0,1,0
35383,1026,64147,0,0,deny,62,62,0,1,0,1,0
35384,19875,30170,0,0,deny,145,145,0,1,0,1,0
35385,1187,64147,0,0,deny,66,66,0,1,0,1,0
35386,27947,26467,0,0,deny,66,66,0,1,0,1,0
35387,443,60496,0,0,deny,187,187,0,1,0,1,0
35388,27844,52700,0,0,deny,74,74,0,1,0,1,0
35389,60374,57470,0,0,deny,62,62,0,1,0,1,0
35390,26254,56205,0,0,deny,66,66,0,1,0,1,0
35391,60374,57470,0,0,deny,145,145,0,1,0,1,0
35392,63234,445,0,0,drop,70,70,0,1,0,1,0
35393,63228,445,0,0,drop,70,70,0,1,0,1,0
35394,63226,445,0,0,drop,70,70,0,1,0,1,0
35395,63220,445,0,0,drop,70,70,0,1,0,1,0
35396,58353,445,0,0,drop,70,70,0,1,0,1,0
35397,58352,445,0,0,drop,70,70,0,1,0,1,0
35398,58349,445,0,0,drop,70,70,0,1,0,1,0
35399,63589,44847,0,0,deny,62,62,0,1,0,1,0
35400,12242,51221,0,0,deny,62,62,0,1,0,1,0
35401,51114,443,50404,443,allow,10301,4593,5708,21,121,10,11
35402,65114,53,6427,53,allow,253,87,166,4,31,2,2
35403,56568,53,15733,53,allow,711,87,624,2,30,1,1
35404,42279,443,42279,443,allow,3414,1979,1435,22,69,11,11
35405,42278,443,42278,443,allow,1916,1121,795,19,69,10,9
35406,56280,53,50135,53,allow,1335,87,1248,4,59,2,2
35407,39672,443,58171,443,allow,6540,5046,1494,19,115,12,7
35408,55286,53,19401,53,allow,268,87,181,4,35,2,2
35409,49295,53,50273,53,allow,280,96,184,4,34,2,2
35410,56007,53,3946,53,allow,99,99,0,1,30,1,0
35411,56896,53,19605,53,allow,256,87,169,2,30,1,1
35412,57470,62348,3608,62348,allow,149,149,0,1,1200,1,0
35413,37035,443,37035,443,allow,4510,1603,2907,19,28,11,8
35414,59530,53,58720,53,allow,578,286,292,9,15,5,4
35415,54086,443,46250,443,allow,4982,2205,2777,46,61,24,22
35416,58908,443,56510,443,allow,6278402,111931,6166471,5306,1119,732,4574
35417,64303,53,50389,53,allow,253,87,166,4,31,2,2
35418,51870,443,29475,443,allow,4375,1230,3145,16,26,8,8
35419,18063,53,18063,53,allow,219,87,132,2,30,1,1
35420,9084,53,9084,53,allow,224,88,136,2,30,1,1
35421,56214,53,17373,53,allow,200,102,98,2,30,1,1
35422,55075,53,29760,53,allow,178,91,87,2,30,1,1
35423,37965,33738,46824,33738,allow,1548,265,1283,4,1200,2,2
35424,55457,443,46084,443,allow,8447,2129,6318,26,250,15,11
35425,9189,443,50417,443,allow,4941,429,4512,12,15,6,6
35426,9188,443,11737,443,allow,5955,728,5227,17,15,8,9
35427,38366,15000,19494,15000,allow,130,70,60,2,6,1,1
35428,55060,80,45377,80,allow,1289,724,565,11,26,6,5
35429,50283,443,36964,443,allow,290,142,148,5,11,3,2
35430,45847,443,35477,443,allow,1134,490,644,18,42,8,10
35431,5588,5588,0,0,allow,3354,1792,1562,46,193,23,23
35432,51800,443,3294,443,allow,36048,2364,33684,54,28,23,31
35433,38163,53,38163,53,allow,216,89,127,2,30,1,1
35434,50460,53,9714,53,allow,751,95,656,2,30,1,1
35435,58605,443,40025,443,allow,3301,1240,2061,14,135,7,7
35436,55168,53,23617,53,allow,816,97,719,2,31,1,1
35437,24985,443,23171,443,allow,2227,1018,1209,17,15,8,9
35438,9190,443,45715,443,allow,4943,429,4514,12,15,6,6
35439,56631,80,27363,80,allow,61771,2713,59058,80,45,35,45
35440,48982,15000,10476,15000,allow,130,70,60,2,5,1,1
35441,51899,47537,11729,47537,allow,66,66,0,1,5,1,0
35442,64664,53,51475,53,allow,168,86,82,2,34,1,1
35443,49569,53,48621,53,allow,91,91,0,2,37,2,0
35444,60957,443,60957,443,allow,70839,5466,65373,98,19,47,51
35445,40786,53,0,0,allow,82,82,0,1,30,1,0
35446,65026,53,20362,53,allow,188,96,92,2,30,1,1
35447,54653,53,54653,53,allow,231,90,141,2,30,1,1
35448,49788,53,44900,53,allow,196,100,96,2,30,1,1
35449,53727,53,60009,53,allow,172,72,100,2,30,1,1
35450,35154,60038,0,0,allow,66,66,0,1,91,1,0
35451,61939,443,12700,443,allow,3698,1049,2649,13,135,6,7
35452,39473,443,53063,443,allow,9590,3811,5779,20,122,10,10
35453,56835,53,37097,53,allow,170,87,83,2,31,1,1
35454,27988,40002,58461,40002,allow,144,82,62,2,31,1,1
35455,8881,443,2247,443,allow,27459,19126,8333,67,402,30,37
35456,27988,40034,46189,40034,allow,141,79,62,2,31,1,1
35457,27988,40023,43847,40023,allow,143,81,62,2,31,1,1
35458,58342,445,0,0,drop,70,70,0,1,0,1,0
35459,58343,445,0,0,drop,70,70,0,1,0,1,0
35460,58612,445,0,0,drop,66,66,0,1,0,1,0
35461,58611,445,0,0,drop,66,66,0,1,0,1,0
35462,58610,445,0,0,drop,66,66,0,1,0,1,0
35463,31974,51505,0,0,deny,66,66,0,1,0,1,0
35464,53971,50265,0,0,deny,62,62,0,1,0,1,0
35465,55733,51505,0,0,deny,66,66,0,1,0,1,0
35466,10416,64147,0,0,deny,62,62,0,1,0,1,0
35467,7166,64147,0,0,deny,66,66,0,1,0,1,0
35468,5222,21212,0,0,deny,66,66,0,1,0,1,0
35469,47365,10387,0,0,deny,159,159,0,1,0,1,0
35470,443,60496,0,0,deny,187,187,0,1,0,1,0
35471,2170,43227,0,0,deny,62,62,0,1,0,1,0
35472,63217,445,0,0,drop,70,70,0,1,0,1,0
35473,51918,27015,0,0,deny,67,67,0,1,0,1,0
35474,63214,445,0,0,drop,70,70,0,1,0,1,0
35475,63210,445,0,0,drop,70,70,0,1,0,1,0
35476,56509,53,49839,53,allow,1165,94,1071,2,30,1,1
35477,23338,53,23338,53,allow,242,98,144,2,30,1,1
35478,64813,53,46374,53,allow,177,94,83,2,30,1,1
35479,55872,123,4281,123,allow,184,94,90,2,30,1,1
35480,56590,53,44528,53,allow,305,94,211,2,30,1,1
35481,50653,80,33144,80,allow,124643,7017,117626,163,21,75,88
35482,57062,80,49519,80,allow,864,507,357,8,38,5,3
35483,56640,80,54626,80,allow,234,234,0,4,11,4,0
35484,50412,80,11804,80,allow,22200,11865,10335,38,86,24,14
35485,60473,443,60473,443,allow,18018,4407,13611,36,100,19,17
35486,65479,53,45836,53,allow,728,102,626,2,29,1,1
35487,65095,53,43220,53,allow,718,94,624,2,30,1,1
35488,46763,443,11187,443,allow,11876848,256539,11620309,11266,74,3584,7682
35489,33893,80,46490,80,allow,1376,788,588,10,23,6,4
35490,51853,80,50403,80,allow,4903,4061,842,11,26,6,5
35491,55022,80,15142,80,allow,1080714,29230,1051484,1137,174,436,701
35492,63906,36909,30978,36909,allow,66,66,0,2,7,2,0
35493,50576,80,30685,80,allow,4189,1691,2498,16,24,9,7
35494,42281,443,42281,443,allow,1530,817,713,17,68,9,8
35495,58021,80,10301,80,allow,318,192,126,6,20,4,2
35496,51090,80,51090,80,allow,19837,2061,17776,30,21,14,16
35497,56694,53,2840,53,allow,427,88,339,4,55,2,2
35498,55249,443,62038,443,allow,3056958,73055,2983903,3016,43,1023,1993
35499,53730,37096,47492,37096,allow,70,70,0,2,7,2,0
35500,64559,53,32115,53,allow,193,102,91,2,29,1,1
35501,55313,53,17189,53,allow,198,94,104,2,29,1,1
35502,57086,53,59882,53,allow,228,102,126,2,29,1,1
35503,55780,53,61304,53,allow,322,134,188,2,29,1,1
35504,65327,53,49765,53,allow,822,102,720,2,29,1,1
35505,50565,53,50708,53,allow,707,94,613,2,30,1,1
35506,64413,53,4808,53,allow,209,102,107,2,30,1,1
35507,65026,53,1071,53,allow,194,102,92,2,30,1,1
35508,57330,53,57913,53,allow,177,94,83,2,30,1,1
35509,51921,37744,59756,37744,allow,70,70,0,2,8,2,0
35510,49538,53,59762,53,allow,754,94,660,2,30,1,1
35511,49937,53,46761,53,allow,718,94,624,2,30,1,1
35512,64361,53,3934,53,allow,194,94,100,2,30,1,1
35513,48553,443,14731,443,allow,49428,2702,46726,70,136,30,40
35514,50265,49083,4910,49083,allow,132,132,0,3,1200,3,0
35515,64868,53,56069,53,allow,216,102,114,2,30,1,1
35516,51920,32678,45180,32678,allow,70,70,0,2,8,2,0
35517,56138,53,23162,53,allow,177,94,83,2,30,1,1
35518,42853,443,44169,443,allow,130,70,60,3,5,2,1
35519,63885,6969,58102,6969,allow,70,70,0,1,5,1,0
35520,57377,53,26653,53,allow,2235,93,2142,4,30,2,2
35521,58824,53,47620,53,allow,358,96,262,4,50,2,2
35522,37297,443,46820,443,allow,232,172,60,3,5,2,1
35523,56579,443,24024,443,allow,23150,13858,9292,52,49,32,20
35524,50754,443,43460,443,allow,10133,2663,7470,35,255,18,17
35525,56206,53,31271,53,allow,211,102,109,2,30,1,1
35526,40001,53,40001,53,allow,218,90,128,2,30,1,1
35527,35556,443,19765,443,allow,2988,1649,1339,17,255,9,8
35528,55059,80,26318,80,allow,306,180,126,6,26,4,2
35529,64647,53,15086,53,allow,718,94,624,2,30,1,1
35530,50199,443,58943,443,allow,8641,2459,6182,22,16,12,10
35531,58024,80,1081,80,allow,318,192,126,6,20,4,2
35532,49461,53,60884,53,allow,314,102,212,2,30,1,1
35533,20495,53,20495,53,allow,217,90,127,2,30,1,1
35534,55007,443,50452,443,allow,9726,4743,4983,41,15,24,17
35535,39057,53,39057,53,allow,222,90,132,2,30,1,1
35536,55442,53,42681,53,allow,177,94,83,2,30,1,1
35537,37614,53,37614,53,allow,209,98,111,2,30,1,1
35538,55300,53,49492,53,allow,308,94,214,2,30,1,1
35539,57377,53,64833,53,allow,1165,94,1071,2,30,1,1
35540,49558,53,18984,53,allow,177,94,83,2,30,1,1
35541,47213,443,42653,443,allow,8166,2498,5668,16,120,8,8
35542,49857,443,44578,443,allow,18811,1868,16943,22,139,7,15
35543,49558,53,29414,53,allow,177,94,83,2,30,1,1
35544,55057,80,24701,80,allow,306,180,126,6,26,4,2
35545,49448,80,49448,80,allow,3193,2163,1030,17,79,10,7
35546,41738,53,43971,53,allow,168,78,90,2,30,1,1
35547,49930,53,6830,53,allow,361,94,267,2,30,1,1
35548,51274,24399,41569,24399,allow,70,70,0,2,8,2,0
35549,51686,80,25444,80,allow,45058,2444,42614,90,52,33,57
35550,49554,443,54292,443,allow,10104,2646,7458,28,186,14,14
35551,63924,53,40615,53,allow,214,102,112,2,30,1,1
35552,50265,45682,34420,45682,allow,330,330,0,6,1200,6,0
35553,49509,443,14742,443,allow,17660,7465,10195,44,201,23,21
35554,51459,443,47605,443,allow,379,259,120,4,16,2,2
35555,44011,443,64228,443,allow,1056,569,487,10,78,6,4
35556,47879,443,13971,443,allow,37598,2397,35201,53,239,22,31
35557,49489,443,58403,443,allow,3170,977,2193,13,135,6,7
35558,56580,443,8692,443,allow,20897,11903,8994,52,49,30,22
35559,51500,443,60787,443,allow,451,259,192,5,23,2,3
35560,59618,443,47989,443,allow,5682,1562,4120,23,61,13,10
35561,55657,53,56154,53,allow,101,101,0,2,34,2,0
35562,63898,13205,16525,13205,allow,66,66,0,2,7,2,0
35563,53714,6882,41499,6882,allow,70,70,0,1,4,1,0
35564,63904,18268,47003,18268,allow,66,66,0,2,7,2,0
35565,42934,443,24809,443,allow,232,172,60,3,5,2,1
35566,55075,53,54293,53,allow,181,94,87,2,33,1,1
35567,55246,443,12271,443,allow,6144,1810,4334,18,45,11,7
35568,56415,443,20835,443,allow,6032,1722,4310,22,117,13,9
35569,49788,53,45773,53,allow,198,102,96,2,33,1,1
35570,58016,80,61881,80,allow,378,192,186,7,21,4,3
35571,53710,27935,34512,27935,allow,70,70,0,1,4,1,0
35572,51802,443,43953,443,allow,4976,1826,3150,19,151,9,10
35573,65317,53,60723,53,allow,195,102,93,2,29,1,1
35574,64559,53,14656,53,allow,816,102,714,2,29,1,1
35575,54833,443,46650,443,allow,3894,969,2925,20,153,9,11
35576,42860,80,52081,80,allow,1346,842,504,13,123,8,5
35577,56363,2710,2278,2710,allow,1222,747,475,10,25,5,5
35578,55721,53,12194,53,allow,177,94,83,2,29,1,1
35579,7954,53,7954,53,allow,226,90,136,2,29,1,1
35580,61980,53,64563,53,allow,374,104,270,4,50,2,2
35581,64969,53,18068,53,allow,329,118,211,2,30,1,1
35582,64408,53,53381,53,allow,199,94,105,2,29,1,1
35583,50207,53,4187,53,allow,195,102,93,2,29,1,1
35584,65113,53,56187,53,allow,232,102,130,2,29,1,1
35585,64813,53,49645,53,allow,177,94,83,2,30,1,1
35586,26180,53,26180,53,allow,245,98,147,2,30,1,1
35587,41093,53,34774,53,allow,78,78,0,1,30,1,0
35588,48565,53,48565,53,allow,197,90,107,2,30,1,1
35589,57330,53,61035,53,allow,177,94,83,2,30,1,1
35590,10844,53,10844,53,allow,222,90,132,2,30,1,1
35591,49272,53,51922,53,allow,266,94,172,2,30,1,1
35592,49841,53,36944,53,allow,227,110,117,2,30,1,1
35593,36476,5228,61709,5228,allow,21282,7311,13971,96,1216,47,49
35594,55774,443,58031,443,allow,6092,3093,2999,16,120,8,8
35595,43092,443,2375,443,allow,7011,2541,4470,19,15,11,8
35596,49569,53,65331,53,allow,181,94,87,2,32,1,1
35597,35623,443,1828,443,allow,9685,2504,7181,26,153,11,15
35598,35441,5222,17710,5222,allow,10854,4776,6078,80,119,41,39
35599,64670,53,9827,53,allow,183,86,97,2,30,1,1
35600,49741,53,44929,53,allow,177,94,83,2,30,1,1
35601,64449,53,62626,53,allow,249,94,155,2,30,1,1
35602,38941,443,59649,443,allow,13623,2693,10930,22,123,10,12
35603,50489,443,43121,443,allow,8389,1077,7312,24,140,12,12
35604,44719,80,51210,80,allow,1998,1422,576,10,15,6,4
35605,62843,53,62843,53,allow,235,90,145,2,32,1,1
35606,56214,53,46867,53,allow,200,102,98,2,33,1,1
35607,51503,443,56151,443,allow,887,635,252,7,23,3,4
35608,54828,443,7869,443,allow,150,150,0,1,5,1,0
35609,56515,995,45992,995,allow,2901,1472,1429,27,17,12,15
35610,57506,443,36392,443,allow,2696,1695,1001,24,105,13,11
35611,55045,53,21912,53,allow,261,102,159,2,30,1,1
35612,50265,35344,29716,35344,allow,1386,1386,0,22,2342,22,0
35613,51922,18413,55909,18413,allow,70,70,0,2,8,2,0
35614,51923,11542,38262,11542,allow,70,70,0,2,8,2,0
35615,55286,53,22881,53,allow,268,87,181,4,35,2,2
35616,55056,80,26189,80,allow,306,180,126,6,26,4,2
35617,55055,80,30882,80,allow,306,180,126,6,26,4,2
35618,50579,80,48781,80,allow,265114,13651,251463,346,76,161,185
35619,5588,5588,0,0,allow,3498,1872,1626,48,197,24,24
35620,49741,53,17465,53,allow,177,94,83,2,30,1,1
35621,50223,53,39269,53,allow,165,86,79,2,30,1,1
35622,51388,443,52372,443,allow,20351,3359,16992,52,103,27,25
35623,50223,53,61828,53,allow,173,94,79,2,30,1,1
35624,55442,53,12898,53,allow,177,94,83,2,30,1,1
35625,49998,53,44432,53,allow,94,94,0,1,30,1,0
35626,10151,31964,38746,31964,allow,481,150,331,2,1200,1,1
35627,37965,6881,16163,6881,allow,452,248,204,4,1199,2,2
35628,58239,80,32964,80,allow,2444,2444,0,3,191,3,0
35629,51974,443,51489,443,allow,11486,5080,6406,24,121,12,12
35630,47509,443,17369,443,allow,7769,2586,5183,18,121,9,9
35631,50265,11035,48783,11035,allow,132,132,0,3,1200,3,0
35632,37965,16881,45844,16881,allow,448,246,202,4,1199,2,2
35633,37965,6881,34922,6881,allow,448,246,202,4,1199,2,2
35634,51221,6881,38542,6881,allow,469,150,319,2,1200,1,1
35635,64055,53,9885,53,allow,265,91,174,4,37,2,2
35636,50656,443,61533,443,allow,3815,1772,2043,18,16,10,8
35637,56138,53,22955,53,allow,177,94,83,2,30,1,1
35638,56518,53,3673,53,allow,177,94,83,2,31,1,1
35639,53705,30600,18470,30600,allow,492,306,186,8,15,5,3
35640,55256,53,58019,53,allow,79,79,0,2,35,2,0
35641,49989,443,4666,443,allow,300,168,132,4,6,2,2
35642,44354,80,44354,80,allow,250076,10158,239918,315,24,146,169
35643,56307,53,64603,53,allow,168,78,90,2,30,1,1
35644,55156,53,44381,53,allow,194,102,92,2,30,1,1
35645,60293,53,33499,53,allow,312,78,234,2,30,1,1
35646,59932,443,1750,443,allow,333535,35190,298345,555,285,257,298
35647,53725,57418,1375,57418,allow,70,70,0,2,8,2,0
35648,56611,80,46294,80,allow,4296,2076,2220,31,128,15,16
35649,56298,53,17699,53,allow,173,94,79,2,30,1,1
35650,51189,53,6847,53,allow,312,78,234,2,30,1,1
35651,55156,53,26617,53,allow,194,102,92,2,31,1,1
35652,62929,443,8515,443,allow,46033,7524,38509,103,141,49,54
35653,63206,445,0,0,drop,70,70,0,1,0,1,0
35654,58331,445,0,0,drop,70,70,0,1,0,1,0
35655,48420,48637,0,0,deny,146,146,0,1,0,1,0
35656,48420,35974,0,0,deny,146,146,0,1,0,1,0
35657,28378,56205,0,0,deny,62,62,0,1,0,1,0
35658,27869,51221,0,0,deny,66,66,0,1,0,1,0
35659,50116,22,0,0,deny,60,60,0,1,0,1,0
35660,45941,23388,0,0,deny,60,60,0,1,0,1,0
35661,9687,57470,0,0,deny,78,78,0,1,0,1,0
35662,11066,50584,0,0,deny,62,62,0,1,0,1,0
35663,60204,2767,0,0,deny,66,66,0,1,0,1,0
35664,58327,445,0,0,drop,70,70,0,1,0,1,0
35665,32845,9797,0,0,deny,60,60,0,1,0,1,0
35666,63197,445,0,0,drop,70,70,0,1,0,1,0
35667,63194,445,0,0,drop,70,70,0,1,0,1,0
35668,63192,445,0,0,drop,70,70,0,1,0,1,0
35669,50292,22114,0,0,deny,62,62,0,1,0,1,0
35670,57799,10387,0,0,deny,145,145,0,1,0,1,0
35671,6546,37965,0,0,deny,62,62,0,1,0,1,0
35672,58076,21247,0,0,deny,66,66,0,1,0,1,0
35673,57538,30188,0,0,deny,66,66,0,1,0,1,0
35674,58599,445,0,0,drop,66,66,0,1,0,1,0
35675,18011,44847,0,0,deny,66,66,0,1,0,1,0
35676,6889,8055,0,0,deny,143,143,0,1,0,1,0
35677,56521,32480,0,0,deny,62,62,0,1,0,1,0
35678,58318,445,0,0,drop,70,70,0,1,0,1,0
35679,58317,445,0,0,drop,70,70,0,1,0,1,0
35680,58316,445,0,0,drop,70,70,0,1,0,1,0
35681,23537,35253,0,0,deny,62,62,0,1,0,1,0
35682,48420,54532,0,0,deny,146,146,0,1,0,1,0
35683,58314,445,0,0,drop,70,70,0,1,0,1,0
35684,56157,50584,0,0,deny,66,66,0,1,0,1,0
35685,58311,445,0,0,drop,70,70,0,1,0,1,0
35686,65179,44847,0,0,deny,62,62,0,1,0,1,0
35687,443,1785,0,0,deny,97,97,0,1,0,1,0
35688,52003,44512,0,0,deny,66,66,0,1,0,1,0
35689,47013,44512,0,0,deny,62,62,0,1,0,1,0
35690,50052,65008,0,0,deny,60,60,0,1,0,1,0
35691,45682,47993,0,0,deny,62,62,0,1,0,1,0
35692,63190,445,0,0,drop,70,70,0,1,0,1,0
35693,34772,15503,0,0,deny,146,146,0,1,0,1,0
35694,27089,30627,0,0,deny,146,146,0,1,0,1,0
35695,43578,15503,0,0,deny,74,74,0,1,0,1,0
35696,55386,32480,0,0,deny,66,66,0,1,0,1,0
35697,34470,57470,0,0,deny,66,66,0,1,0,1,0
35698,18904,57470,0,0,deny,62,62,0,1,0,1,0
35699,61798,35440,0,0,deny,66,66,0,1,0,1,0
35700,58305,445,0,0,drop,70,70,0,1,0,1,0
35701,53208,18375,0,0,deny,62,62,0,1,0,1,0
35702,58583,445,0,0,drop,66,66,0,1,0,1,0
35703,58582,445,0,0,drop,66,66,0,1,0,1,0
35704,18423,51505,0,0,deny,66,66,0,1,0,1,0
35705,64115,2767,0,0,deny,62,62,0,1,0,1,0
35706,41916,53,0,0,deny,60,60,0,1,0,1,0
35707,60962,64147,0,0,deny,66,66,0,1,0,1,0
35708,39981,57470,0,0,deny,62,62,0,1,0,1,0
35709,40512,57470,0,0,deny,74,74,0,1,0,1,0
35710,8999,55783,0,0,deny,146,146,0,1,0,1,0
35711,63179,445,0,0,drop,70,70,0,1,0,1,0
35712,58297,445,0,0,drop,70,70,0,1,0,1,0
35713,1262,23,0,0,deny,60,60,0,1,0,1,0
35714,58295,445,0,0,drop,70,70,0,1,0,1,0
35715,63174,445,0,0,drop,70,70,0,1,0,1,0
35716,63170,445,0,0,drop,70,70,0,1,0,1,0
35717,63172,445,0,0,drop,70,70,0,1,0,1,0
35718,17008,35440,0,0,deny,146,146,0,1,0,1,0
35719,58580,445,0,0,drop,66,66,0,1,0,1,0
35720,50086,57470,0,0,deny,66,66,0,1,0,1,0
35721,59227,11392,0,0,deny,62,62,0,1,0,1,0
35722,58022,5601,0,0,deny,60,60,0,1,0,1,0
35723,48079,43227,0,0,deny,62,62,0,1,0,1,0
35724,58570,445,0,0,drop,66,66,0,1,0,1,0
35725,58574,445,0,0,drop,66,66,0,1,0,1,0
35726,58572,445,0,0,drop,66,66,0,1,0,1,0
35727,58567,445,0,0,drop,66,66,0,1,0,1,0
35728,58569,445,0,0,drop,66,66,0,1,0,1,0
35729,58568,445,0,0,drop,66,66,0,1,0,1,0
35730,58564,445,0,0,drop,66,66,0,1,0,1,0
35731,58290,445,0,0,drop,70,70,0,1,0,1,0
35732,40216,50265,0,0,deny,62,62,0,1,0,1,0
35733,58289,445,0,0,drop,70,70,0,1,0,1,0
35734,63165,445,0,0,drop,70,70,0,1,0,1,0
35735,63161,445,0,0,drop,70,70,0,1,0,1,0
35736,63160,445,0,0,drop,70,70,0,1,0,1,0
35737,63157,445,0,0,drop,70,70,0,1,0,1,0
35738,19068,37965,0,0,deny,62,62,0,1,0,1,0
35739,57698,64147,0,0,deny,62,62,0,1,0,1,0
35740,39531,19473,0,0,deny,62,62,0,1,0,1,0
35741,58285,445,0,0,drop,70,70,0,1,0,1,0
35742,49426,57470,0,0,deny,62,62,0,1,0,1,0
35743,45908,33330,0,0,deny,60,60,0,1,0,1,0
35744,57131,31061,0,0,deny,145,145,0,1,0,1,0
35745,58284,445,0,0,drop,70,70,0,1,0,1,0
35746,10860,55108,0,0,deny,148,148,0,1,0,1,0
35747,63153,445,0,0,drop,70,70,0,1,0,1,0
35748,63151,445,0,0,drop,70,70,0,1,0,1,0
35749,63149,445,0,0,drop,70,70,0,1,0,1,0
35750,33432,5900,0,0,deny,60,60,0,1,0,1,0
35751,58556,445,0,0,drop,66,66,0,1,0,1,0
35752,63148,445,0,0,drop,70,70,0,1,0,1,0
35753,58553,445,0,0,drop,66,66,0,1,0,1,0
35754,58279,445,0,0,drop,70,70,0,1,0,1,0
35755,53465,57470,0,0,deny,62,62,0,1,0,1,0
35756,58552,445,0,0,drop,66,66,0,1,0,1,0
35757,58550,445,0,0,drop,66,66,0,1,0,1,0
35758,5223,21557,0,0,deny,91,91,0,1,0,1,0
35759,58549,445,0,0,drop,66,66,0,1,0,1,0
35760,57233,50934,0,0,deny,66,66,0,1,0,1,0
35761,14923,51505,0,0,deny,66,66,0,1,0,1,0
35762,37927,50265,0,0,deny,66,66,0,1,0,1,0
35763,2180,63710,0,0,deny,66,66,0,1,0,1,0
35764,60351,50584,0,0,deny,66,66,0,1,0,1,0
35765,63147,445,0,0,drop,70,70,0,1,0,1,0
35766,50298,37965,0,0,deny,62,62,0,1,0,1,0
35767,51015,64147,0,0,deny,62,62,0,1,0,1,0
35768,63137,445,0,0,drop,70,70,0,1,0,1,0
35769,63133,445,0,0,drop,70,70,0,1,0,1,0
35770,58791,15503,0,0,deny,66,66,0,1,0,1,0
35771,59647,47993,0,0,deny,66,66,0,1,0,1,0
35772,10521,15503,0,0,deny,146,146,0,1,0,1,0
35773,62109,44847,0,0,deny,66,66,0,1,0,1,0
35774,51996,57470,0,0,deny,66,66,0,1,0,1,0
35775,1057,57470,0,0,deny,62,62,0,1,0,1,0
35776,58266,445,0,0,drop,70,70,0,1,0,1,0
35777,58537,445,0,0,drop,66,66,0,1,0,1,0
35778,15581,46713,0,0,deny,66,66,0,1,0,1,0
35779,58263,445,0,0,drop,70,70,0,1,0,1,0
35780,63196,445,0,0,deny,62,62,0,1,0,1,0
35781,61137,40740,0,0,deny,145,145,0,1,0,1,0
35782,46409,35440,0,0,deny,62,62,0,1,0,1,0
35783,58530,445,0,0,drop,66,66,0,1,0,1,0
35784,63122,445,0,0,drop,70,70,0,1,0,1,0
35785,51505,17372,0,0,deny,62,62,0,1,0,1,0
35786,443,39851,0,0,deny,112,112,0,1,0,1,0
35787,58259,445,0,0,drop,70,70,0,1,0,1,0
35788,54134,64147,0,0,deny,66,66,0,1,0,1,0
35789,58257,445,0,0,drop,70,70,0,1,0,1,0
35790,58528,445,0,0,drop,66,66,0,1,0,1,0
35791,51096,63710,0,0,deny,66,66,0,1,0,1,0
35792,22390,19473,0,0,deny,62,62,0,1,0,1,0
35793,58255,445,0,0,drop,70,70,0,1,0,1,0
35794,53766,51505,0,0,deny,66,66,0,1,0,1,0
35795,13484,37965,0,0,deny,66,66,0,1,0,1,0
35796,58519,445,0,0,drop,66,66,0,1,0,1,0
35797,11337,15503,0,0,deny,62,62,0,1,0,1,0
35798,58510,445,0,0,drop,66,66,0,1,0,1,0
35799,50486,56205,0,0,deny,66,66,0,1,0,1,0
35800,29159,39004,0,0,deny,62,62,0,1,0,1,0
35801,53608,39004,0,0,deny,66,66,0,1,0,1,0
35802,58248,445,0,0,drop,70,70,0,1,0,1,0
35803,41207,5900,0,0,deny,60,60,0,1,0,1,0
35804,48840,50584,0,0,deny,62,62,0,1,0,1,0
35805,58246,445,0,0,drop,70,70,0,1,0,1,0
35806,50095,50584,0,0,deny,66,66,0,1,0,1,0
35807,49981,44847,0,0,deny,62,62,0,1,0,1,0
35808,63113,445,0,0,drop,70,70,0,1,0,1,0
35809,63109,445,0,0,drop,70,70,0,1,0,1,0
35810,63108,445,0,0,drop,70,70,0,1,0,1,0
35811,25222,37965,0,0,deny,62,62,0,1,0,1,0
35812,35408,56205,0,0,deny,66,66,0,1,0,1,0
35813,58500,445,0,0,drop,66,66,0,1,0,1,0
35814,58504,445,0,0,drop,66,66,0,1,0,1,0
35815,58505,445,0,0,drop,66,66,0,1,0,1,0
35816,27988,40029,26130,40029,allow,140,78,62,2,30,1,1
35817,57987,3478,22536,3478,allow,312,140,172,4,30,2,2
35818,53724,64923,33470,64923,allow,70,70,0,2,8,2,0
35819,52425,80,64946,80,allow,1630,918,712,12,16,7,5
35820,49483,53,49626,53,allow,172,88,84,2,30,1,1
35821,49907,53,29279,53,allow,308,92,216,2,30,1,1
35822,57997,80,61005,80,allow,318,192,126,6,21,4,2
35823,63908,33945,27378,33945,allow,312,132,180,6,7,3,3
35824,56637,53,42734,53,allow,711,87,624,2,30,1,1
35825,55340,53,32896,53,allow,184,94,90,2,31,1,1
35826,64251,53,51222,53,allow,170,87,83,2,31,1,1
35827,60337,7000,60337,7000,allow,2163,676,1487,14,16,7,7
35828,63905,19899,5860,19899,allow,312,132,180,6,7,3,3
35829,15503,58675,42815,58675,allow,2227,1224,1003,20,1200,11,9
35830,55924,53,5985,53,allow,711,87,624,2,31,1,1
35831,27988,40027,35628,40027,allow,140,78,62,2,30,1,1
35832,57987,3478,8652,3478,allow,312,140,172,4,30,2,2
35833,48625,443,29976,443,allow,7605,2028,5577,23,159,11,12
35834,49701,53,52830,53,allow,488,110,378,4,32,2,2
35835,63877,51413,26586,51413,allow,564,382,182,9,18,6,3
35836,11962,53,11962,53,allow,194,87,107,2,30,1,1
35837,56518,53,9053,53,allow,170,87,83,2,30,1,1
35838,53498,3389,53498,3389,allow,3549,1594,1955,18,18,10,8
35839,59046,443,4447,443,allow,8279,2876,5403,22,155,9,13
35840,46640,9002,46640,9002,allow,124,60,64,2,5,1,1
35841,51349,80,65226,80,allow,1056,682,374,10,15,6,4
35842,62346,80,27241,80,allow,2328,580,1748,12,16,6,6
35843,49629,53,32885,53,allow,742,88,654,2,30,1,1
35844,55156,53,61392,53,allow,188,96,92,2,30,1,1
35845,56775,53,28683,53,allow,170,87,83,2,30,1,1
35846,49472,53,22827,53,allow,751,95,656,2,31,1,1
35847,45099,443,21949,443,allow,94099,5885,88214,140,104,69,71
35848,53726,26083,18088,26083,allow,70,70,0,2,8,2,0
35849,49453,53,4294,53,allow,763,101,662,2,31,1,1
35850,37247,443,37247,443,allow,4401,1494,2907,19,25,11,8
35851,56567,53,47104,53,allow,701,88,613,2,30,1,1
35852,32854,443,34612,443,allow,9695,4412,5283,22,172,13,9
35853,31750,53,31750,53,allow,200,90,110,2,30,1,1
35854,50615,443,36645,443,allow,1577,949,628,16,71,9,7
35855,53728,19442,57763,19442,allow,320,140,180,6,7,3,3
35856,58782,53,58782,53,allow,310,94,216,2,30,1,1
35857,57998,80,49916,80,allow,318,192,126,6,21,4,2
35858,58007,80,40862,80,allow,318,192,126,6,21,4,2
35859,64958,53,27605,53,allow,216,94,122,2,30,1,1
35860,56509,53,27088,53,allow,1164,93,1071,2,30,1,1
35861,62912,53,42026,53,allow,214,76,138,2,30,1,1
35862,49691,53,43996,53,allow,378,127,251,2,30,1,1
35863,27988,40022,50196,40022,allow,146,84,62,2,30,1,1
35864,27988,40031,63445,40031,allow,140,78,62,2,30,1,1
35865,57411,53,38630,53,allow,711,87,624,2,31,1,1
35866,37565,443,47595,443,allow,8553,3392,5161,25,202,13,12
35867,57470,6881,26091,6881,allow,330,330,0,6,1201,6,0
35868,65436,53,35308,53,allow,332,98,234,3,58,2,1
35869,55471,53,40426,53,allow,760,97,663,2,31,1,1
35870,57195,53,29138,53,allow,190,97,93,2,31,1,1
35871,8884,443,38785,443,allow,5307,3288,2019,25,397,8,17
35872,54159,443,24398,443,allow,4723,2593,2130,16,137,8,8
35873,49771,53,11315,53,allow,728,96,632,2,31,1,1
35874,61746,443,1496,443,allow,251,69,182,3,120,1,2
35875,37965,61872,44512,61872,allow,1548,265,1283,4,1201,2,2
35876,55649,5228,61882,5228,allow,5378,2359,3019,35,3786,16,19
35877,58502,445,0,0,drop,66,66,0,1,0,1,0
35878,58503,445,0,0,drop,66,66,0,1,0,1,0
35879,58498,445,0,0,drop,66,66,0,1,0,1,0
35880,58501,445,0,0,drop,66,66,0,1,0,1,0
35881,64841,6881,0,0,deny,62,62,0,1,0,1,0
35882,58497,445,0,0,drop,66,66,0,1,0,1,0
35883,58245,445,0,0,drop,70,70,0,1,0,1,0
35884,58244,445,0,0,drop,70,70,0,1,0,1,0
35885,58243,445,0,0,drop,70,70,0,1,0,1,0
35886,58238,445,0,0,drop,70,70,0,1,0,1,0
35887,58239,445,0,0,drop,70,70,0,1,0,1,0
35888,21588,52700,0,0,deny,145,145,0,1,0,1,0
35889,64546,57470,0,0,deny,66,66,0,1,0,1,0
35890,48857,50584,0,0,deny,66,66,0,1,0,1,0
35891,28435,23,0,0,deny,60,60,0,1,0,1,0
35892,42731,23,0,0,deny,60,60,0,1,0,1,0
35893,19885,64147,0,0,deny,62,62,0,1,0,1,0
35894,35494,22114,0,0,deny,62,62,0,1,0,1,0
35895,60720,23718,0,0,deny,66,66,0,1,0,1,0
35896,58225,445,0,0,drop,70,70,0,1,0,1,0
35897,58223,445,0,0,drop,70,70,0,1,0,1,0
35898,58221,445,0,0,drop,70,70,0,1,0,1,0
35899,10477,44847,0,0,deny,66,66,0,1,0,1,0
35900,33896,57470,0,0,deny,74,74,0,1,0,1,0
35901,64870,53,1765,53,allow,200,102,98,2,33,1,1
35902,49712,53,62216,53,allow,178,94,84,2,30,1,1
35903,60438,17148,53794,17148,allow,70,70,0,2,8,2,0
35904,59904,53,31184,53,allow,312,78,234,2,29,1,1
35905,58215,445,0,0,drop,70,70,0,1,0,1,0
35906,58214,445,0,0,drop,70,70,0,1,0,1,0
35907,13917,18033,0,0,deny,62,62,0,1,0,1,0
35908,63104,445,0,0,drop,70,70,0,1,0,1,0
35909,63100,445,0,0,drop,70,70,0,1,0,1,0
35910,63095,445,0,0,drop,70,70,0,1,0,1,0
35911,63091,445,0,0,drop,70,70,0,1,0,1,0
35912,58483,445,0,0,drop,66,66,0,1,0,1,0
35913,58485,445,0,0,drop,66,66,0,1,0,1,0
35914,58484,445,0,0,drop,66,66,0,1,0,1,0
35915,15180,26467,0,0,deny,62,62,0,1,0,1,0
35916,62088,56205,0,0,deny,66,66,0,1,0,1,0
35917,43700,30188,0,0,deny,62,62,0,1,0,1,0
35918,52714,64147,0,0,deny,62,62,0,1,0,1,0
35919,63088,445,0,0,drop,70,70,0,1,0,1,0
35920,59236,17,0,0,deny,60,60,0,1,0,1,0
35921,58203,445,0,0,drop,70,70,0,1,0,1,0
35922,63086,445,0,0,drop,70,70,0,1,0,1,0
35923,63084,445,0,0,drop,70,70,0,1,0,1,0
35924,63082,445,0,0,drop,70,70,0,1,0,1,0
35925,5223,21557,0,0,deny,60,60,0,1,0,1,0
35926,62514,37807,0,0,deny,66,66,0,1,0,1,0
35927,50674,35440,0,0,deny,62,62,0,1,0,1,0
35928,60136,56205,0,0,deny,62,62,0,1,0,1,0
35929,58199,445,0,0,drop,70,70,0,1,0,1,0
35930,60855,35440,0,0,deny,66,66,0,1,0,1,0
35931,16522,26467,0,0,deny,66,66,0,1,0,1,0
35932,63071,445,0,0,drop,70,70,0,1,0,1,0
35933,63069,445,0,0,drop,70,70,0,1,0,1,0
35934,63064,445,0,0,drop,70,70,0,1,0,1,0
35935,54742,37965,0,0,deny,66,66,0,1,0,1,0
35936,58189,445,0,0,drop,70,70,0,1,0,1,0
35937,58190,445,0,0,drop,70,70,0,1,0,1,0
35938,58188,445,0,0,drop,70,70,0,1,0,1,0
35939,58185,445,0,0,drop,70,70,0,1,0,1,0
35940,58472,445,0,0,drop,66,66,0,1,0,1,0
35941,9997,53,9997,53,allow,235,90,145,2,32,1,1
35942,45052,80,23641,80,allow,1539,553,986,10,14,6,4
35943,64303,53,30875,53,allow,298,87,211,4,34,2,2
35944,51914,20777,59494,20777,allow,256,136,120,5,8,3,2
35945,49988,443,12921,443,allow,214,82,132,4,5,2,2
35946,63895,43729,42252,43729,allow,66,66,0,2,7,2,0
35947,53723,51501,50854,51501,allow,70,70,0,2,7,2,0
35948,53318,56648,63034,56648,allow,672,432,240,10,142,6,4
35949,26751,443,19482,443,allow,11513,2842,8671,31,18,15,16
35950,58044,443,46397,443,allow,24527,2438,22089,43,329,19,24
35951,65114,53,53193,53,allow,177,94,83,2,29,1,1
35952,65333,53,15875,53,allow,197,94,103,2,29,1,1
35953,65026,53,61151,53,allow,194,102,92,2,29,1,1
35954,65194,53,43835,53,allow,181,94,87,2,29,1,1
35955,56509,53,12733,53,allow,1165,94,1071,2,29,1,1
35956,56775,53,64956,53,allow,177,94,83,2,29,1,1
35957,56518,53,42205,53,allow,177,94,83,2,29,1,1
35958,24202,53,24202,53,allow,220,90,130,2,29,1,1
35959,56835,53,60962,53,allow,177,94,83,2,29,1,1
35960,65114,53,14258,53,allow,177,94,83,2,29,1,1
35961,58563,53,4425,53,allow,312,78,234,2,29,1,1
35962,27005,1308,46544,1308,allow,855,126,729,2,30,1,1
35963,56835,53,48670,53,allow,177,94,83,2,30,1,1
35964,60439,47783,16622,47783,allow,70,70,0,2,8,2,0
35965,27005,1105,38006,1105,allow,855,126,729,2,30,1,1
35966,56518,53,9121,53,allow,177,94,83,2,30,1,1
35967,55340,53,17205,53,allow,184,94,90,2,30,1,1
35968,27988,40017,42811,40017,allow,148,86,62,2,30,1,1
35969,9179,443,30869,443,allow,5731,495,5236,14,15,7,7
35970,51918,41488,54208,41488,allow,70,70,0,2,8,2,0
35971,51898,50677,8224,50677,allow,70,70,0,1,5,1,0
35972,58309,53,16090,53,allow,255,86,169,2,30,1,1
35973,50596,443,51132,443,allow,9573,1963,7610,25,72,12,13
35974,64766,53,54775,53,allow,195,102,93,2,30,1,1
35975,58006,80,48045,80,allow,318,192,126,6,21,4,2
35976,27005,1306,39345,1306,allow,858,126,732,2,30,1,1
35977,38011,443,43234,443,allow,6900,4387,2513,37,98,19,18
35978,63962,53,52393,53,allow,483,189,294,6,85,3,3
35979,59180,53,28928,53,allow,260,86,174,2,30,1,1
35980,59986,53,15041,53,allow,186,86,100,2,30,1,1
35981,57987,3478,44464,3478,allow,312,140,172,4,30,2,2
35982,59341,53,56377,53,allow,187,78,109,2,30,1,1
35983,64877,53,52528,53,allow,94,94,0,1,30,1,0
35984,44007,123,12438,123,allow,184,94,90,2,30,1,1
35985,56775,53,53871,53,allow,177,94,83,2,30,1,1
35986,49483,53,48622,53,allow,178,94,84,2,30,1,1
35987,27005,1104,16545,1104,allow,870,126,744,2,30,1,1
35988,27005,1106,55769,1106,allow,903,126,777,2,30,1,1
35989,27005,1103,38860,1103,allow,822,126,696,2,30,1,1
35990,64251,53,6102,53,allow,177,94,83,2,30,1,1
35991,62766,443,11804,443,allow,3370,1226,2144,13,135,6,7
35992,46556,443,5923,443,allow,9316,1720,7596,25,16,13,12
35993,50643,443,60929,443,allow,1512,844,668,16,64,9,7
35994,59680,80,46564,80,allow,5762500,128192,5634308,5613,134,1854,3759
35995,59199,53,18550,53,allow,228,94,134,2,30,1,1
35996,27988,40013,46561,40013,allow,148,86,62,2,30,1,1
35997,27988,40027,31364,40027,allow,148,86,62,2,30,1,1
35998,27988,40001,35761,40001,allow,148,86,62,2,30,1,1
35999,42479,80,8740,80,allow,696,413,283,7,15,5,2
36000,63903,56016,63323,56016,allow,312,132,180,6,6,3,3
36001,51916,24596,6622,24596,allow,70,70,0,2,8,2,0
36002,56860,49991,37577,49991,allow,70,70,0,2,8,2,0
36003,60441,64337,31545,64337,allow,70,70,0,2,8,2,0
36004,53138,15048,61968,15048,allow,70,70,0,2,7,2,0
36005,56596,53,10703,53,allow,194,102,92,2,31,1,1
36006,57990,80,35454,80,allow,42086,9535,32551,48,21,19,29
36007,50652,80,2519,80,allow,97934,5018,92916,124,20,55,69
36008,50914,443,57800,443,allow,22211,8661,13550,173,854,77,96
36009,62985,8920,45375,8920,allow,823,577,246,9,15,5,4
36010,49184,443,9767,443,allow,493152,13222,479930,509,19,184,325
36011,56651,80,31520,80,allow,11855,7269,4586,28,115,15,13
36012,64524,53,20476,53,allow,274,94,180,4,33,2,2
36013,64086,53,31835,53,allow,241,94,147,2,29,1,1
36014,59516,443,21075,443,allow,9943,1882,8061,32,33,15,17
36015,50281,5223,28986,5223,allow,208,60,148,4,11,2,2
36016,65264,53,8238,53,allow,256,88,168,4,35,2,2
36017,55631,53,42735,53,allow,422,96,326,4,42,2,2
36018,36368,80,60128,80,allow,78,78,0,1,5,1,0
36019,40006,80,2393,80,allow,7086,1841,5245,15,92,8,7
36020,48092,443,48092,443,allow,4398,1491,2907,19,27,11,8
36021,53240,443,24615,443,allow,46348,20067,26281,75,60,37,38
36022,56298,53,16841,53,allow,173,94,79,2,29,1,1
36023,55340,53,11264,53,allow,184,94,90,2,30,1,1
36024,57319,53,57319,53,allow,198,90,108,2,29,1,1
36025,39252,53,39252,53,allow,197,90,107,2,29,1,1
36026,39583,53,11422,53,allow,86,86,0,1,30,1,0
36027,64303,53,57962,53,allow,177,94,83,2,29,1,1
36028,55547,53,1923,53,allow,339,94,245,2,30,1,1
36029,56950,53,38998,53,allow,183,86,97,2,29,1,1
36030,64251,53,24532,53,allow,177,94,83,2,30,1,1
36031,56775,53,45440,53,allow,177,94,83,2,30,1,1
36032,27005,1202,59034,1202,allow,865,126,739,2,30,1,1
36033,56896,53,21578,53,allow,177,94,83,2,30,1,1
36034,50263,53,58515,53,allow,771,102,669,2,30,1,1
36035,56509,53,37473,53,allow,1165,94,1071,2,30,1,1
36036,27005,1102,43095,1102,allow,867,126,741,2,30,1,1
36037,48831,443,51436,443,allow,10129,5016,5113,18,120,9,9
36038,60873,53,0,0,allow,86,86,0,1,30,1,0
36039,56583,53,58946,53,allow,177,94,83,2,31,1,1
36040,49701,53,39669,53,allow,197,102,95,2,31,1,1
36041,6881,60026,38643,60026,allow,509,150,359,2,1199,1,1
36042,27988,40005,9616,40005,allow,148,86,62,2,30,1,1
36043,27988,40003,22369,40003,allow,148,86,62,2,30,1,1
36044,37965,44056,39211,44056,allow,158,158,0,1,1199,1,0
36045,53760,443,58528,443,allow,13059,3730,9329,73,3729,32,41
36046,56563,53,56693,53,allow,177,94,83,2,30,1,1
36047,58850,443,9120,443,allow,18715,10778,7937,39,96,16,23
36048,39978,443,47110,443,allow,8030,7064,966,22,30,13,9
36049,60913,80,45601,80,allow,613,539,74,7,15,6,1
36050,42862,443,59113,443,allow,10233,2198,8035,25,81,14,11
36051,38118,443,33958,443,allow,574857,27894,546963,745,57,346,399
36052,57098,53,51101,53,allow,229,94,135,2,30,1,1
36053,50255,53,26984,53,allow,199,102,97,2,30,1,1
36054,50748,443,45400,443,allow,12166,8765,3401,52,561,25,27
36055,51983,443,27301,443,allow,23955,4211,19744,42,46,21,21
36056,9180,443,3139,443,allow,5731,495,5236,14,15,7,7
36057,45458,443,14560,443,allow,7144,4917,2227,36,561,18,18
36058,64251,53,65162,53,allow,177,94,83,2,30,1,1
36059,56038,53,33876,53,allow,177,94,83,2,30,1,1
36060,27988,40005,15276,40005,allow,148,86,62,2,30,1,1
36061,27988,40002,6353,40002,allow,140,78,62,2,30,1,1
36062,50379,53,12803,53,allow,197,102,95,2,30,1,1
36063,62723,443,17496,443,allow,126815,114702,12113,243,86,139,104
36064,50655,80,4984,80,allow,91198,3990,87208,113,19,49,64
36065,51917,26077,8998,26077,allow,70,70,0,2,8,2,0
36066,51919,10298,22024,10298,allow,70,70,0,2,8,2,0
36067,49342,443,27856,443,allow,6944,2404,4540,21,15,10,11
36068,9178,443,33091,443,allow,5731,495,5236,14,15,7,7
36069,58009,80,11441,80,allow,495,192,303,6,21,4,2
36070,56896,53,58642,53,allow,177,94,83,2,30,1,1
36071,27005,1108,29177,1108,allow,873,126,747,2,30,1,1
36072,27005,1305,52487,1305,allow,855,126,729,2,30,1,1
36073,57987,3478,50170,3478,allow,312,140,172,4,30,2,2
36074,64725,53,58713,53,allow,757,102,655,2,30,1,1
36075,50493,443,55037,443,allow,8164,1206,6958,24,139,12,12
36076,49160,38098,52628,38098,allow,676,367,309,6,1200,3,3
36077,27988,40006,7041,40006,allow,148,86,62,2,30,1,1
36078,55084,53,9496,53,allow,177,94,83,2,31,1,1
36079,26081,53,34120,53,allow,75510,75228,282,904,90,902,2
36080,26081,53,4535,53,allow,243667,236247,7420,2897,90,2851,46
36081,19473,12430,61068,12430,allow,491,150,341,2,1200,1,1
36082,48412,443,30459,443,allow,47703,2616,45087,62,120,24,38
36083,62284,443,22217,443,allow,3419,1275,2144,13,135,6,7
36084,37965,51413,62222,51413,allow,158,158,0,1,1200,1,0
36085,21133,39263,6580,39263,allow,323,150,173,2,1200,1,1
36086,57094,443,45074,443,allow,8180,2643,5537,19,121,9,10
36087,64767,443,64767,443,allow,4507,1600,2907,19,31,11,8
36088,50603,443,4652,443,allow,3443,2189,1254,23,72,13,10
36089,60774,40010,46436,40010,allow,316,136,180,6,7,3,3
36090,56639,80,24086,80,allow,234,234,0,4,12,4,0
36091,49270,443,33027,443,allow,10367,2273,8094,43,730,22,21
36092,53702,51413,55761,51413,allow,70,70,0,1,5,1,0
36093,49640,443,18216,443,allow,8607,3608,4999,25,256,14,11
36094,39359,443,36397,443,allow,46113,6913,39200,86,34,41,45
36095,37715,53,37715,53,allow,235,90,145,2,32,1,1
36096,53449,443,9843,443,allow,12474,4810,7664,39,66,19,20
36097,54707,443,60614,443,allow,5826,1199,4627,21,42,11,10
36098,51927,80,21213,80,allow,1945,1002,943,11,20,7,4
36099,49310,53,42489,53,allow,816,102,714,2,30,1,1
36100,50447,53,27142,53,allow,765,102,663,2,30,1,1
36101,49230,53,1845,53,allow,168,86,82,2,31,1,1
36102,55340,53,63068,53,allow,184,94,90,2,31,1,1
36103,58183,445,0,0,drop,70,70,0,1,0,1,0
36104,52018,57866,0,0,deny,66,66,0,1,0,1,0
36105,56101,57470,0,0,deny,66,66,0,1,0,1,0
36106,63060,445,0,0,drop,70,70,0,1,0,1,0
36107,63059,445,0,0,drop,70,70,0,1,0,1,0
36108,41734,57470,0,0,deny,62,62,0,1,0,1,0
36109,58176,445,0,0,drop,70,70,0,1,0,1,0
36110,46859,50584,0,0,deny,62,62,0,1,0,1,0
36111,11821,64147,0,0,deny,146,146,0,1,0,1,0
36112,58457,445,0,0,drop,66,66,0,1,0,1,0
36113,58455,445,0,0,drop,66,66,0,1,0,1,0
36114,6721,37965,0,0,deny,66,66,0,1,0,1,0
36115,63097,44847,0,0,deny,62,62,0,1,0,1,0
36116,1880,57470,0,0,deny,146,146,0,1,0,1,0
36117,6828,64322,0,0,deny,60,60,0,1,0,1,0
36118,53260,36237,0,0,deny,146,146,0,1,0,1,0
36119,58169,445,0,0,drop,70,70,0,1,0,1,0
36120,58168,445,0,0,drop,70,70,0,1,0,1,0
36121,47910,7461,0,0,deny,60,60,0,1,0,1,0
36122,5223,21557,0,0,deny,60,60,0,1,0,1,0
36123,5223,21557,0,0,deny,91,91,0,1,0,1,0
36124,13287,16933,0,0,deny,62,62,0,1,0,1,0
36125,63052,445,0,0,drop,70,70,0,1,0,1,0
36126,26889,50265,0,0,deny,66,66,0,1,0,1,0
36127,7968,2767,0,0,deny,66,66,0,1,0,1,0
36128,63046,445,0,0,drop,70,70,0,1,0,1,0
36129,63043,445,0,0,drop,70,70,0,1,0,1,0
36130,63042,445,0,0,drop,70,70,0,1,0,1,0
36131,61595,50939,0,0,deny,145,145,0,1,0,1,0
36132,58450,445,0,0,drop,66,66,0,1,0,1,0
36133,58163,445,0,0,drop,70,70,0,1,0,1,0
36134,58161,445,0,0,drop,70,70,0,1,0,1,0
36135,62937,30975,0,0,deny,185,185,0,1,0,1,0
36136,58446,445,0,0,drop,66,66,0,1,0,1,0
36137,58442,445,0,0,drop,66,66,0,1,0,1,0
36138,58445,445,0,0,drop,66,66,0,1,0,1,0
36139,58436,445,0,0,drop,66,66,0,1,0,1,0
36140,58439,445,0,0,drop,66,66,0,1,0,1,0
36141,58435,445,0,0,drop,66,66,0,1,0,1,0
36142,58440,445,0,0,drop,66,66,0,1,0,1,0
36143,10243,36237,0,0,deny,62,62,0,1,0,1,0
36144,1054,57470,0,0,deny,62,62,0,1,0,1,0
36145,45941,23386,0,0,deny,60,60,0,1,0,1,0
36146,63036,445,0,0,drop,70,70,0,1,0,1,0
36147,63033,445,0,0,drop,70,70,0,1,0,1,0
36148,63032,445,0,0,drop,70,70,0,1,0,1,0
36149,63029,445,0,0,drop,70,70,0,1,0,1,0
36150,58157,445,0,0,drop,70,70,0,1,0,1,0
36151,50675,56205,0,0,deny,66,66,0,1,0,1,0
36152,62765,16933,0,0,deny,66,66,0,1,0,1,0
36153,52914,37965,0,0,deny,66,66,0,1,0,1,0
36154,37837,37965,0,0,deny,62,62,0,1,0,1,0
36155,993,16279,0,0,deny,129,129,0,1,0,1,0
36156,58155,445,0,0,drop,70,70,0,1,0,1,0
36157,58973,57470,0,0,deny,62,62,0,1,0,1,0
36158,52740,51505,0,0,deny,66,66,0,1,0,1,0
36159,41756,56205,0,0,deny,62,62,0,1,0,1,0
36160,9494,23,0,0,deny,60,60,0,1,0,1,0
36161,63765,51221,0,0,deny,62,62,0,1,0,1,0
36162,63027,445,0,0,drop,70,70,0,1,0,1,0
36163,63022,445,0,0,drop,70,70,0,1,0,1,0
36164,63026,445,0,0,drop,70,70,0,1,0,1,0
36165,58430,445,0,0,drop,66,66,0,1,0,1,0
36166,58151,445,0,0,drop,70,70,0,1,0,1,0
36167,63020,445,0,0,drop,70,70,0,1,0,1,0
36168,58426,445,0,0,drop,66,66,0,1,0,1,0
36169,58424,445,0,0,drop,66,66,0,1,0,1,0
36170,58422,445,0,0,drop,66,66,0,1,0,1,0
36171,53218,56205,0,0,deny,66,66,0,1,0,1,0
36172,35722,30188,0,0,deny,62,62,0,1,0,1,0
36173,58420,445,0,0,drop,66,66,0,1,0,1,0
36174,32051,37965,0,0,deny,62,62,0,1,0,1,0
36175,63015,445,0,0,drop,70,70,0,1,0,1,0
36176,26758,50584,0,0,deny,66,66,0,1,0,1,0
36177,12031,36237,0,0,deny,66,66,0,1,0,1,0
36178,63008,445,0,0,drop,70,70,0,1,0,1,0
36179,63007,445,0,0,drop,70,70,0,1,0,1,0
36180,65529,35440,0,0,deny,62,62,0,1,0,1,0
36181,58138,445,0,0,drop,70,70,0,1,0,1,0
36182,52836,36829,0,0,deny,66,66,0,1,0,1,0
36183,58409,445,0,0,drop,66,66,0,1,0,1,0
36184,58135,445,0,0,drop,70,70,0,1,0,1,0
36185,57368,7302,0,0,deny,66,66,0,1,0,1,0
36186,59563,30188,0,0,deny,66,66,0,1,0,1,0
36187,61278,56205,0,0,deny,66,66,0,1,0,1,0
36188,63527,50584,0,0,deny,66,66,0,1,0,1,0
36189,58402,445,0,0,drop,66,66,0,1,0,1,0
36190,62992,445,0,0,drop,70,70,0,1,0,1,0
36191,58131,445,0,0,drop,70,70,0,1,0,1,0
36192,58129,445,0,0,drop,70,70,0,1,0,1,0
36193,45941,23388,0,0,deny,60,60,0,1,0,1,0
36194,40005,36237,0,0,deny,62,62,0,1,0,1,0
36195,26448,9192,0,0,deny,145,145,0,1,0,1,0
36196,58127,445,0,0,drop,70,70,0,1,0,1,0
36197,58399,445,0,0,drop,66,66,0,1,0,1,0
36198,51320,37965,0,0,deny,62,62,0,1,0,1,0
36199,14997,57470,0,0,deny,72,72,0,1,0,1,0
36200,58392,445,0,0,drop,66,66,0,1,0,1,0
36201,48660,21622,0,0,deny,143,143,0,1,0,1,0
36202,58387,445,0,0,drop,66,66,0,1,0,1,0
36203,50264,443,29730,443,allow,430,60,370,7,24,2,5
36204,43310,80,46970,80,allow,811,671,140,6,32,4,2
36205,14102,80,14102,80,allow,722,300,422,11,158,5,6
36206,45846,443,37447,443,allow,4819,829,3990,15,40,8,7
36207,57987,80,45212,80,allow,2803,1625,1178,16,21,9,7
36208,57031,53,13224,53,allow,711,87,624,2,30,1,1
36209,34784,53,61391,53,allow,168,78,90,2,30,1,1
36210,55655,63670,50631,63670,allow,70,70,0,1,5,1,0
36211,61489,443,63810,443,allow,4624,1191,3433,23,75,14,9
36212,51964,443,28760,443,allow,54794,16744,38050,82,71,42,40
36213,64396,53,52154,53,allow,349,91,258,2,30,1,1
36214,61091,443,61091,443,allow,18924,5378,13546,33,18,19,14
36215,65486,53,11134,53,allow,760,97,663,2,30,1,1
36216,55905,53,39225,53,allow,754,94,660,2,30,1,1
36217,56583,53,53516,53,allow,170,87,83,2,31,1,1
36218,55508,53,1825,53,allow,814,110,704,2,30,1,1
36219,59892,443,22013,443,allow,1813,1004,809,16,28,8,8
36220,49712,53,29972,53,allow,172,88,84,2,30,1,1
36221,65361,53,33877,53,allow,760,97,663,2,30,1,1
36222,59890,443,5968,443,allow,1401,864,537,12,28,6,6
36223,50390,53,29650,53,allow,772,103,669,2,30,1,1
36224,55466,53,2778,53,allow,170,87,83,2,30,1,1
36225,59887,443,6975,443,allow,1576,973,603,14,28,7,7
36226,59891,443,7306,443,allow,1813,1004,809,16,28,8,8
36227,50601,443,53899,443,allow,5035,3194,1841,23,72,12,11
36228,59881,443,61673,443,allow,302,120,182,6,31,3,3
36229,57400,443,4312,443,allow,10169,1957,8212,26,136,11,15
36230,40309,443,48693,443,allow,51588,40242,11346,107,418,53,54
36231,51913,52188,11778,52188,allow,70,70,0,2,8,2,0
36232,62344,80,50382,80,allow,1892,583,1309,12,16,6,6
36233,57843,443,8894,443,allow,130,70,60,2,15,1,1
36234,50277,443,65171,443,allow,268,120,148,5,11,3,2
36235,49254,53,31955,53,allow,814,110,704,2,30,1,1
36236,49690,53,24171,53,allow,216,110,106,2,30,1,1
36237,47994,443,47994,443,allow,4485,1578,2907,19,28,11,8
36238,60659,443,57729,443,allow,8175,3047,5128,26,165,12,14
36239,56596,53,38999,53,allow,188,96,92,2,31,1,1
36240,60899,7275,19563,7275,allow,2875,449,2426,12,16,7,5
36241,49302,443,39111,443,allow,454,262,192,8,27,5,3
36242,59888,443,28259,443,allow,1401,864,537,12,28,6,6
36243,59884,443,34275,443,allow,1401,864,537,12,28,6,6
36244,56858,32330,62382,32330,allow,70,70,0,2,8,2,0
36245,45964,59999,45964,59999,allow,60,60,0,1,5,1,0
36246,59889,443,31832,443,allow,1576,973,603,14,28,7,7
36247,55658,45261,61900,45261,allow,70,70,0,1,5,1,0
36248,59885,443,10109,443,allow,1401,864,537,12,28,6,6
36249,60884,443,60884,443,allow,4918,1626,3292,17,17,10,7
36250,41247,80,40368,80,allow,78,78,0,1,5,1,0
36251,50493,443,36062,443,allow,2147464,35144,2112320,1951,72,540,1411
36252,61273,443,61273,443,allow,8480,2451,6029,21,17,12,9
36253,49901,53,7736,53,allow,272,122,150,2,30,1,1
36254,64857,53,57218,53,allow,332,104,228,2,30,1,1
36255,56038,53,40412,53,allow,170,87,83,2,30,1,1
36256,49234,53,23533,53,allow,206,97,109,2,30,1,1
36257,49989,53,26196,53,allow,346,111,235,2,30,1,1
36258,49690,53,35001,53,allow,216,110,106,2,30,1,1
36259,65111,443,62828,443,allow,3255,1259,1996,13,135,7,6
36260,57366,53,36112,53,allow,711,87,624,2,31,1,1
36261,54956,53,35292,53,allow,711,87,624,2,31,1,1
36262,47595,33440,0,0,allow,106,106,0,1,61,1,0
36263,57348,443,25316,443,allow,13048,4976,8072,40,140,18,22
36264,52850,443,50911,443,allow,4982,3414,1568,19,362,9,10
36265,57218,53,55252,53,allow,789,110,679,2,31,1,1
36266,49414,53,16481,53,allow,770,102,668,2,31,1,1
36267,49929,53,13431,53,allow,260,124,136,2,31,1,1
36268,56464,53,12940,53,allow,170,87,83,2,31,1,1
36269,49862,53,62626,53,allow,744,89,655,2,31,1,1
36270,50178,53,23159,53,allow,758,96,662,2,31,1,1
36271,56420,443,5096,443,allow,9876,5607,4269,66,122,35,31
36272,42555,443,40081,443,allow,14262,5874,8388,31,138,15,16
36273,49191,53,32868,53,allow,186,95,91,2,31,1,1
36274,52838,443,32099,443,allow,207289,9233,198056,234,136,83,151
36275,22300,51505,0,0,deny,66,66,0,1,0,1,0
36276,58922,57470,0,0,deny,66,66,0,1,0,1,0
36277,58120,445,0,0,drop,70,70,0,1,0,1,0
36278,4760,44847,0,0,deny,62,62,0,1,0,1,0
36279,33627,36237,0,0,deny,66,66,0,1,0,1,0
36280,58118,445,0,0,drop,70,70,0,1,0,1,0
36281,60754,53,60754,53,allow,198,90,108,2,30,1,1
36282,49300,5228,46650,5228,allow,12589,6479,6110,172,4146,86,86
36283,52853,443,45061,443,allow,130,70,60,2,15,1,1
36284,60943,443,53022,443,allow,4960,896,4064,14,18,8,6
36285,49690,53,62022,53,allow,322,110,212,4,30,2,2
36286,49690,53,31414,53,allow,216,110,106,2,30,1,1
36287,9160,443,28992,443,allow,5727,491,5236,14,15,7,7
36288,43934,443,29568,443,allow,2548,1257,1291,15,416,8,7
36289,55240,443,28397,443,allow,6902,1936,4966,22,45,11,11
36290,52802,53,8957,53,allow,350,210,140,6,14,4,2
36291,53139,50285,41730,50285,allow,320,140,180,6,6,3,3
36292,53721,8999,32848,8999,allow,320,140,180,6,6,3,3
36293,38261,443,49964,443,allow,134,60,74,3,4,2,1
36294,9136,80,1532,80,allow,908,842,66,7,15,6,1
36295,49178,53,11567,53,allow,822,102,720,2,29,1,1
36296,50379,53,49959,53,allow,197,102,95,2,29,1,1
36297,57610,443,60687,443,allow,4327,674,3653,14,25,8,6
36298,49339,80,8376,80,allow,1467,361,1106,10,15,5,5
36299,49839,443,39363,443,allow,17843,13076,4767,27,134,17,10
36300,54819,443,51134,443,allow,8093,1263,6830,25,39,13,12
36301,55241,443,32846,443,allow,8080,2630,5450,24,45,12,12
36302,54708,443,18474,443,allow,5702,1143,4559,21,41,12,9
36303,60513,443,43919,443,allow,9047,2015,7032,25,39,13,12
36304,54709,443,26640,443,allow,5493,933,4560,18,41,9,9
36305,53695,21965,20178,21965,allow,2044,1143,901,19,16,9,10
36306,52801,443,38731,443,allow,8308,3201,5107,36,1401,19,17
36307,53704,15000,63052,15000,allow,70,70,0,1,4,1,0
36308,57210,8525,57210,8525,allow,138,78,60,2,5,1,1
36309,9161,443,17981,443,allow,5658,501,5157,14,15,7,7
36310,1558,80,1558,80,allow,6377,703,5674,13,15,6,7
36311,50650,80,8138,80,allow,129929,6216,123713,164,21,74,90
36312,54033,443,63656,443,allow,190,70,120,4,15,2,2
36313,49187,2710,40478,2710,allow,70,70,0,2,7,2,0
36314,34951,443,13510,443,allow,3308,2109,1199,30,751,16,14
36315,51961,443,43999,443,allow,6913,1658,5255,22,17,12,10
36316,57986,443,51773,443,allow,124014,6270,117744,175,27,69,106
36317,48740,443,37273,443,allow,7868,2194,5674,26,36,13,13
36318,42881,443,29777,443,allow,134,60,74,3,4,2,1
36319,51820,80,11900,80,allow,366,240,126,7,25,5,2
36320,53703,16426,38652,16426,allow,70,70,0,1,4,1,0
36321,60706,443,17990,443,allow,4974,836,4138,16,40,8,8
36322,50605,443,56643,443,allow,1766,975,791,15,71,9,6
36323,49852,53,8412,53,allow,94,94,0,1,29,1,0
36324,64766,53,31618,53,allow,195,102,93,2,29,1,1
36325,56835,53,56114,53,allow,177,94,83,2,29,1,1
36326,38264,443,28661,443,allow,134,60,74,3,4,2,1
36327,65264,53,15709,53,allow,178,94,84,2,29,1,1
36328,55084,53,64405,53,allow,177,94,83,2,29,1,1
36329,49230,53,46684,53,allow,168,86,82,2,30,1,1
36330,50255,53,25168,53,allow,199,102,97,2,29,1,1
36331,53306,53,0,0,allow,86,86,0,1,29,1,0
36332,55656,31165,38946,31165,allow,70,70,0,1,5,1,0
36333,40701,5223,47765,5223,allow,5723,1105,4618,27,473,10,17
36334,44583,443,45015,443,allow,6834,3797,3037,48,97,23,25
36335,38114,443,10061,443,allow,863998,37140,826858,1072,61,479,593
36336,57431,53,35038,53,allow,392,134,258,2,30,1,1
36337,55466,53,45668,53,allow,177,94,83,2,30,1,1
36338,59654,53,16319,53,allow,199,94,105,2,30,1,1
36339,65200,53,5141,53,allow,214,110,104,2,30,1,1
36340,64524,53,42733,53,allow,184,94,90,2,31,1,1
36341,9156,443,14551,443,allow,5734,498,5236,14,15,7,7
36342,65496,53,41450,53,allow,280,96,184,4,34,2,2
36343,49874,443,49241,443,allow,15358,8278,7080,47,19,24,23
36344,57195,53,19593,53,allow,195,102,93,2,33,1,1
36345,53718,1053,4101,1053,allow,320,140,180,6,8,3,3
36346,51896,43357,20029,43357,allow,70,70,0,1,5,1,0
36347,35570,443,53736,443,allow,3297,2327,970,22,37,11,11
36348,55239,443,1727,443,allow,9352,2524,6828,27,46,14,13
36349,64908,53,50064,53,allow,812,110,702,2,30,1,1
36350,57332,53,48938,53,allow,168,86,82,2,30,1,1
36351,64888,53,19204,53,allow,718,94,624,2,30,1,1
36352,55659,37787,47813,37787,allow,70,70,0,2,8,2,0
36353,64274,53,64916,53,allow,110,110,0,1,30,1,0
36354,56583,53,7154,53,allow,177,94,83,2,30,1,1
36355,49742,53,51185,53,allow,216,110,106,2,30,1,1
36356,6881,63963,28408,63963,allow,207,118,89,2,1200,1,1
36357,63988,53,36168,53,allow,195,102,93,2,30,1,1
36358,30188,17677,54608,17677,allow,11116,4642,6474,64,1457,30,34
36359,65200,53,50135,53,allow,214,110,104,2,30,1,1
36360,50713,53,50713,53,allow,198,90,108,2,30,1,1
36361,49593,5228,25502,5228,allow,9720,2717,7003,67,1019,34,33
36362,64576,443,6624,443,allow,8503,1969,6534,24,32,13,11
36363,43835,443,28215,443,allow,11422,2361,9061,26,505,10,16
36364,51893,63924,1367,63924,allow,70,70,0,1,5,1,0
36365,9167,443,11467,443,allow,4072,434,3638,12,15,6,6
36366,56954,80,1117,80,allow,1469,970,499,9,65,6,3
36367,49386,443,47173,443,allow,6250,1765,4485,22,15,12,10
36368,38119,53,41188,53,allow,199,94,105,2,30,1,1
36369,49742,53,16673,53,allow,216,110,106,2,30,1,1
36370,49257,53,6745,53,allow,199,102,97,2,30,1,1
36371,56596,53,31650,53,allow,194,102,92,2,30,1,1
36372,57201,53,54960,53,allow,173,94,79,2,30,1,1
36373,7946,23,7946,23,allow,130,66,64,2,5,1,1
36374,64274,53,21757,53,allow,299,104,195,4,35,2,2
36375,39350,3389,39350,3389,allow,3910,1805,2105,20,18,12,8
36376,53699,36887,39756,36887,allow,492,306,186,8,15,5,3
36377,53254,443,33543,443,allow,4498,916,3582,18,17,9,9
36378,9162,443,30671,443,allow,5658,501,5157,14,15,7,7
36379,9155,443,45491,443,allow,5734,498,5236,14,15,7,7
36380,49698,53,53512,53,allow,184,102,82,2,30,1,1
36381,49742,53,36313,53,allow,216,110,106,2,30,1,1
36382,60740,443,50087,443,allow,12605,5558,7047,42,101,18,24
36383,57554,443,18344,443,allow,7323,2654,4669,23,30,13,10
36384,48739,443,34033,443,allow,7107,1636,5471,24,38,11,13
36385,52892,443,14885,443,allow,130,70,60,2,14,1,1
36386,57885,80,59656,80,allow,32460,9354,23106,67,71,40,27
36387,48736,443,16569,443,allow,371295,17988,353307,571,40,233,338
36388,56493,443,6298,443,allow,10532,6786,3746,55,81,28,27
36389,53727,8999,52156,8999,allow,320,140,180,6,5,3,3
36390,49310,53,61139,53,allow,186,95,91,3,33,2,1
36391,51818,80,64733,80,allow,366,240,126,7,25,5,2
36392,50642,443,51887,443,allow,10981,2295,8686,32,63,16,16
36393,42880,443,28151,443,allow,134,60,74,3,4,2,1
36394,51894,26116,8093,26116,allow,70,70,0,1,5,1,0
36395,37886,443,62818,443,allow,134,60,74,3,5,2,1
36396,49561,80,28691,80,allow,57215,680,56535,47,135,7,40
36397,9163,443,23024,443,allow,5658,501,5157,14,15,7,7
36398,49429,443,22034,443,allow,990201,31101,959100,1061,192,383,678
36399,49438,443,47897,443,allow,135574,9426,126148,201,183,102,99
36400,56707,443,1984,443,allow,5928,1558,4370,22,20,13,9
36401,49178,53,26968,53,allow,199,102,97,2,29,1,1
36402,56563,53,35411,53,allow,177,94,83,2,29,1,1
36403,9157,443,57140,443,allow,5734,498,5236,14,15,7,7
36404,49698,53,38054,53,allow,184,102,82,2,30,1,1
36405,51897,57057,43684,57057,allow,70,70,0,1,5,1,0
36406,50255,53,55681,53,allow,199,102,97,2,29,1,1
36407,49257,53,51437,53,allow,199,102,97,2,30,1,1
36408,49712,53,30095,53,allow,178,94,84,2,29,1,1
36409,49423,443,63927,443,allow,4287346,130607,4156739,4409,282,1473,2936
36410,33418,443,42698,443,allow,4764,1876,2888,22,81,10,12
36411,39661,7275,31233,7275,allow,8822,1485,7337,26,15,13,13
36412,56038,53,20578,53,allow,177,94,83,2,29,1,1
36413,55466,53,37366,53,allow,177,94,83,2,30,1,1
36414,49712,53,3465,53,allow,178,94,84,2,30,1,1
36415,57201,53,44480,53,allow,165,86,79,2,30,1,1
36416,56038,53,24286,53,allow,177,94,83,2,30,1,1
36417,49701,53,24977,53,allow,197,102,95,2,30,1,1
36418,51120,53,11316,53,allow,168,78,90,2,30,1,1
36419,49713,53,44635,53,allow,177,94,83,2,30,1,1
36420,23283,53,47679,53,allow,344,78,266,2,30,1,1
36421,33638,443,11926,443,allow,1784,1010,774,16,185,9,7
36422,57470,56250,44821,56250,allow,330,330,0,6,1199,6,0
36423,37965,54777,17164,54777,allow,158,158,0,1,1200,1,0
36424,59879,443,12932,443,allow,302,120,182,6,32,3,3
36425,51895,17172,22553,17172,allow,70,70,0,1,5,1,0
36426,55657,37273,52099,37273,allow,70,70,0,1,5,1,0
36427,39796,443,39796,443,allow,4744,1837,2907,19,27,11,8
36428,49508,53,13388,53,allow,199,102,97,2,30,1,1
36429,56953,80,31471,80,allow,37311,3340,33971,52,65,26,26
36430,38269,443,44100,443,allow,130,70,60,2,15,1,1
36431,54537,80,39580,80,allow,4096,3455,641,13,15,8,5
36432,65040,53,27133,53,allow,256,88,168,4,32,2,2
36433,55661,49671,9206,49671,allow,70,70,0,2,8,2,0
36434,60773,20010,34411,20010,allow,70,70,0,2,8,2,0
36435,51674,80,17494,80,allow,533166,22786,510380,905,50,321,584
36436,53700,45682,9190,45682,allow,492,306,186,8,15,5,3
36437,9158,443,59645,443,allow,5727,491,5236,14,15,7,7
36438,49713,53,37729,53,allow,177,94,83,2,30,1,1
36439,49359,53,8497,53,allow,216,110,106,2,30,1,1
36440,65020,443,45828,443,allow,5507,3397,2110,13,120,7,6
36441,50583,80,64336,80,allow,630930,27504,603426,812,74,381,431
36442,9159,443,37775,443,allow,5727,491,5236,14,15,7,7
36443,49535,53,29045,53,allow,771,102,669,2,30,1,1
36444,42996,53,58544,53,allow,168,78,90,2,30,1,1
36445,57332,53,59062,53,allow,184,102,82,2,30,1,1
36446,57389,53,29962,53,allow,193,102,91,2,30,1,1
36447,60546,443,51628,443,allow,52666,33941,18725,95,139,49,46
36448,63567,443,49835,443,allow,2467,1198,1269,22,186,11,11
36449,57470,51745,40205,51745,allow,3214,1260,1954,33,1371,17,16
36450,64410,53,61695,53,allow,196,102,94,2,30,1,1
36451,21054,53,21054,53,allow,216,98,118,2,30,1,1
36452,50022,53,19595,53,allow,182,94,88,2,30,1,1
36453,63988,53,51956,53,allow,195,102,93,2,30,1,1
36454,55503,53,56462,53,allow,216,110,106,2,30,1,1
36455,57333,53,18124,53,allow,342,110,232,2,30,1,1
36456,56469,53,63453,53,allow,177,94,83,2,31,1,1
36457,56939,53,41325,53,allow,216,110,106,2,31,1,1
36458,59090,443,47184,443,allow,1469,702,767,20,120,10,10
36459,52339,443,45302,443,allow,4362,1266,3096,26,129,11,15
36460,62692,443,51155,443,allow,14518,2409,12109,23,135,10,13
36461,58056,443,56911,443,allow,866223,30135,836088,916,138,300,616
36462,55921,443,24781,443,allow,4348,1536,2812,14,121,6,8
36463,37965,1025,42195,1025,allow,158,158,0,1,1200,1,0
36464,37965,6881,15418,6881,allow,1534,248,1286,4,1200,2,2
36465,65493,443,24258,443,allow,7975,423,7552,15,120,6,9
36466,6881,7999,34044,7999,allow,238,118,120,2,1199,1,1
36467,57389,53,9146,53,allow,193,102,91,2,31,1,1
36468,33748,443,24979,443,allow,70,70,0,2,5,2,0
36469,59607,53,65103,53,allow,209,102,107,2,30,1,1
36470,49954,53,49870,53,allow,216,110,106,2,30,1,1
36471,55513,53,1888,53,allow,184,94,90,2,30,1,1
36472,50375,53,64896,53,allow,211,110,101,2,30,1,1
36473,49359,53,18321,53,allow,216,110,106,2,30,1,1
36474,56520,53,53336,53,allow,177,94,83,2,31,1,1
36475,63566,443,27176,443,allow,2537,1268,1269,23,186,12,11
36476,37965,32405,17637,32405,allow,766,248,518,4,1200,2,2
36477,28021,443,4074,443,allow,5578,1390,4188,19,16,9,10
36478,49508,53,17731,53,allow,199,102,97,2,30,1,1
36479,55503,53,44075,53,allow,216,110,106,2,30,1,1
36480,49701,53,55177,53,allow,197,102,95,2,30,1,1
36481,56388,53,20771,53,allow,816,102,714,2,30,1,1
36482,56484,53,42861,53,allow,214,110,104,2,31,1,1
36483,57917,6789,34924,6789,allow,8164,1336,6828,34,18,18,16
36484,55370,443,38504,443,allow,3055,953,2102,23,50,10,13
36485,50473,80,50473,80,allow,78355,11395,66960,122,27,62,60
36486,26847,443,30937,443,allow,10585,3919,6666,33,80,16,17
36487,5588,5588,0,0,allow,3498,1872,1626,48,199,24,24
36488,55740,53,13751,53,allow,228,110,118,2,30,1,1
36489,56413,51221,0,0,deny,62,62,0,1,0,1,0
36490,58117,445,0,0,drop,70,70,0,1,0,1,0
36491,62983,445,0,0,drop,70,70,0,1,0,1,0
36492,62982,445,0,0,drop,70,70,0,1,0,1,0
36493,62980,445,0,0,drop,70,70,0,1,0,1,0
36494,58115,445,0,0,drop,70,70,0,1,0,1,0
36495,58480,57470,0,0,deny,66,66,0,1,0,1,0
36496,58375,445,0,0,drop,66,66,0,1,0,1,0
36497,58113,445,0,0,drop,70,70,0,1,0,1,0
36498,58377,445,0,0,drop,66,66,0,1,0,1,0
36499,58376,445,0,0,drop,66,66,0,1,0,1,0
36500,58112,445,0,0,drop,70,70,0,1,0,1,0
36501,58374,445,0,0,drop,66,66,0,1,0,1,0
36502,58373,445,0,0,drop,66,66,0,1,0,1,0
36503,58372,445,0,0,drop,66,66,0,1,0,1,0
36504,58371,445,0,0,drop,66,66,0,1,0,1,0
36505,58369,445,0,0,drop,66,66,0,1,0,1,0
36506,4419,23,0,0,deny,60,60,0,1,0,1,0
36507,26229,21247,0,0,deny,66,66,0,1,0,1,0
36508,39324,64147,0,0,deny,62,62,0,1,0,1,0
36509,57706,64147,0,0,deny,66,66,0,1,0,1,0
36510,58097,445,0,0,drop,70,70,0,1,0,1,0
36511,58096,445,0,0,drop,70,70,0,1,0,1,0
36512,58091,445,0,0,drop,70,70,0,1,0,1,0
36513,28809,50584,0,0,deny,62,62,0,1,0,1,0
36514,58086,445,0,0,drop,70,70,0,1,0,1,0
36515,58087,445,0,0,drop,70,70,0,1,0,1,0
36516,12465,11392,0,0,deny,62,62,0,1,0,1,0
36517,53906,37965,0,0,deny,62,62,0,1,0,1,0
36518,62977,445,0,0,drop,70,70,0,1,0,1,0
36519,62976,445,0,0,drop,70,70,0,1,0,1,0
36520,62972,445,0,0,drop,70,70,0,1,0,1,0
36521,62965,445,0,0,drop,70,70,0,1,0,1,0
36522,9494,23,0,0,deny,60,60,0,1,0,1,0
36523,58356,445,0,0,drop,66,66,0,1,0,1,0
36524,58355,445,0,0,drop,66,66,0,1,0,1,0
36525,58354,445,0,0,drop,66,66,0,1,0,1,0
36526,61451,17500,0,0,deny,66,66,0,1,0,1,0
36527,16382,17500,0,0,deny,62,62,0,1,0,1,0
36528,44554,5900,0,0,deny,60,60,0,1,0,1,0
36529,16377,21247,0,0,deny,62,62,0,1,0,1,0
36530,51414,22,0,0,deny,60,60,0,1,0,1,0
36531,58075,445,0,0,drop,70,70,0,1,0,1,0
36532,62960,445,0,0,drop,70,70,0,1,0,1,0
36533,52655,15503,0,0,deny,146,146,0,1,0,1,0
36534,62956,445,0,0,drop,70,70,0,1,0,1,0
36535,62954,445,0,0,drop,70,70,0,1,0,1,0
36536,62953,445,0,0,drop,70,70,0,1,0,1,0
36537,17344,62413,0,0,deny,62,62,0,1,0,1,0
36538,46286,21247,0,0,deny,62,62,0,1,0,1,0
36539,14925,57470,0,0,deny,145,145,0,1,0,1,0
36540,58071,445,0,0,drop,70,70,0,1,0,1,0
36541,5462,21247,0,0,deny,66,66,0,1,0,1,0
36542,56381,51505,0,0,deny,62,62,0,1,0,1,0
36543,25651,48817,0,0,deny,140,140,0,1,0,1,0
36544,40369,57470,0,0,deny,62,62,0,1,0,1,0
36545,1044,23,0,0,deny,60,60,0,1,0,1,0
36546,58062,445,0,0,drop,70,70,0,1,0,1,0
36547,58061,445,0,0,drop,70,70,0,1,0,1,0
36548,58059,445,0,0,drop,70,70,0,1,0,1,0
36549,13559,57866,0,0,deny,66,66,0,1,0,1,0
36550,64586,50584,0,0,deny,62,62,0,1,0,1,0
36551,39516,23,0,0,deny,60,60,0,1,0,1,0
36552,58058,445,0,0,drop,70,70,0,1,0,1,0
36553,62941,445,0,0,drop,70,70,0,1,0,1,0
36554,62938,445,0,0,drop,70,70,0,1,0,1,0
36555,62936,445,0,0,drop,70,70,0,1,0,1,0
36556,58054,445,0,0,drop,70,70,0,1,0,1,0
36557,21034,50265,0,0,deny,66,66,0,1,0,1,0
36558,58344,445,0,0,drop,66,66,0,1,0,1,0
36559,51535,44847,0,0,deny,62,62,0,1,0,1,0
36560,8999,57470,0,0,deny,146,146,0,1,0,1,0
36561,64824,37965,0,0,deny,62,62,0,1,0,1,0
36562,64815,37965,0,0,deny,66,66,0,1,0,1,0
36563,58048,445,0,0,drop,70,70,0,1,0,1,0
36564,39617,50584,0,0,deny,62,62,0,1,0,1,0
36565,62935,445,0,0,drop,70,70,0,1,0,1,0
36566,62933,445,0,0,drop,70,70,0,1,0,1,0
36567,59626,22114,0,0,deny,66,66,0,1,0,1,0
36568,48488,50584,0,0,deny,62,62,0,1,0,1,0
36569,16654,50265,0,0,deny,62,62,0,1,0,1,0
36570,58327,445,0,0,drop,66,66,0,1,0,1,0
36571,58326,445,0,0,drop,66,66,0,1,0,1,0
36572,58041,445,0,0,drop,70,70,0,1,0,1,0
36573,14844,37965,0,0,deny,62,62,0,1,0,1,0
36574,58040,445,0,0,drop,70,70,0,1,0,1,0
36575,62396,51050,0,0,deny,146,146,0,1,0,1,0
36576,35833,23,0,0,deny,60,60,0,1,0,1,0
36577,12074,10197,0,0,deny,72,72,0,1,0,1,0
36578,28899,37965,0,0,deny,62,62,0,1,0,1,0
36579,62923,445,0,0,drop,70,70,0,1,0,1,0
36580,58034,445,0,0,drop,70,70,0,1,0,1,0
36581,62916,445,0,0,drop,70,70,0,1,0,1,0
36582,62914,445,0,0,drop,70,70,0,1,0,1,0
36583,62913,445,0,0,drop,70,70,0,1,0,1,0
36584,58033,445,0,0,drop,70,70,0,1,0,1,0
36585,58321,445,0,0,drop,66,66,0,1,0,1,0
36586,47134,37965,0,0,deny,62,62,0,1,0,1,0
36587,15933,64147,0,0,deny,62,62,0,1,0,1,0
36588,9494,23,0,0,deny,60,60,0,1,0,1,0
36589,11574,51505,0,0,deny,62,62,0,1,0,1,0
36590,58313,445,0,0,drop,66,66,0,1,0,1,0
36591,58315,445,0,0,drop,66,66,0,1,0,1,0
36592,58318,445,0,0,drop,66,66,0,1,0,1,0
36593,58314,445,0,0,drop,66,66,0,1,0,1,0
36594,58311,445,0,0,drop,66,66,0,1,0,1,0
36595,58309,445,0,0,drop,66,66,0,1,0,1,0
36596,58308,445,0,0,drop,66,66,0,1,0,1,0
36597,48219,55442,0,0,deny,62,62,0,1,0,1,0
36598,58029,445,0,0,drop,70,70,0,1,0,1,0
36599,62907,445,0,0,drop,70,70,0,1,0,1,0
36600,62905,445,0,0,drop,70,70,0,1,0,1,0
36601,62903,445,0,0,drop,70,70,0,1,0,1,0
36602,62902,445,0,0,drop,70,70,0,1,0,1,0
36603,33359,443,23934,443,allow,9818,2036,7782,28,31,12,16
36604,9494,23,0,0,deny,60,60,0,1,0,1,0
36605,52432,50265,0,0,deny,66,66,0,1,0,1,0
36606,58028,445,0,0,drop,70,70,0,1,0,1,0
36607,49958,36829,0,0,deny,66,66,0,1,0,1,0
36608,45833,13494,0,0,deny,60,60,0,1,0,1,0
36609,19204,48817,0,0,deny,148,148,0,1,0,1,0
36610,0,0,0,0,allow,320,320,0,5,0,5,0
36611,50767,57470,0,0,deny,62,62,0,1,0,1,0
36612,12951,50584,0,0,deny,66,66,0,1,0,1,0
36613,51592,51505,0,0,deny,66,66,0,1,0,1,0
36614,55966,35440,0,0,deny,66,66,0,1,0,1,0
36615,16330,50584,0,0,deny,62,62,0,1,0,1,0
36616,52614,44847,0,0,deny,62,62,0,1,0,1,0
36617,57849,50584,0,0,deny,66,66,0,1,0,1,0
36618,65085,22114,0,0,deny,66,66,0,1,0,1,0
36619,58023,445,0,0,drop,70,70,0,1,0,1,0
36620,62900,445,0,0,drop,70,70,0,1,0,1,0
36621,62896,445,0,0,drop,70,70,0,1,0,1,0
36622,62895,445,0,0,drop,70,70,0,1,0,1,0
36623,18876,44847,0,0,deny,66,66,0,1,0,1,0
36624,58582,50584,0,0,deny,66,66,0,1,0,1,0
36625,58301,445,0,0,drop,66,66,0,1,0,1,0
36626,36579,30188,0,0,deny,66,66,0,1,0,1,0
36627,62892,445,0,0,drop,70,70,0,1,0,1,0
36628,58298,445,0,0,drop,66,66,0,1,0,1,0
36629,58296,445,0,0,drop,66,66,0,1,0,1,0
36630,58294,445,0,0,drop,66,66,0,1,0,1,0
36631,9018,23,0,0,deny,60,60,0,1,0,1,0
36632,61408,30188,0,0,deny,62,62,0,1,0,1,0
36633,58292,445,0,0,drop,66,66,0,1,0,1,0
36634,1035,64147,0,0,deny,145,145,0,1,0,1,0
36635,34301,21247,0,0,deny,146,146,0,1,0,1,0
36636,55553,37965,0,0,deny,66,66,0,1,0,1,0
36637,58010,445,0,0,drop,70,70,0,1,0,1,0
36638,62887,445,0,0,drop,70,70,0,1,0,1,0
36639,62883,445,0,0,drop,70,70,0,1,0,1,0
36640,62880,445,0,0,drop,70,70,0,1,0,1,0
36641,46516,57470,0,0,deny,62,62,0,1,0,1,0
36642,27844,52700,0,0,deny,74,74,0,1,0,1,0
36643,26254,56205,0,0,deny,66,66,0,1,0,1,0
36644,58007,445,0,0,drop,70,70,0,1,0,1,0
36645,58282,445,0,0,drop,66,66,0,1,0,1,0
36646,41674,5900,0,0,deny,60,60,0,1,0,1,0
36647,57747,15000,28219,15000,allow,130,70,60,2,6,1,1
36648,57134,53,50387,53,allow,1425,97,1328,4,53,2,2
36649,57438,53,17355,53,allow,782,105,677,2,30,1,1
36650,64902,53,51695,53,allow,414,106,308,2,30,1,1
36651,50669,80,58976,80,allow,1485,806,679,13,15,7,6
36652,55803,53,50944,53,allow,760,97,663,2,30,1,1
36653,57315,53,60318,53,allow,748,95,653,2,30,1,1
36654,56661,443,26302,443,allow,18375,7252,11123,47,40,24,23
36655,53589,3389,53589,3389,allow,3407,1518,1889,16,16,9,7
36656,53719,49306,59032,49306,allow,70,70,0,2,8,2,0
36657,57188,53,2618,53,allow,744,89,655,2,30,1,1
36658,49359,53,18838,53,allow,216,110,106,2,30,1,1
36659,50475,80,50475,80,allow,26023,3118,22905,38,24,18,20
36660,63882,49163,63966,49163,allow,66,66,0,1,5,1,0
36661,33387,80,58397,80,allow,9105,1930,7175,18,16,9,9
36662,64971,53,64971,53,allow,218,85,133,2,30,1,1
36663,49257,53,2534,53,allow,198,101,97,2,30,1,1
36664,5612,53,5612,53,allow,227,89,138,2,30,1,1
36665,56433,53,27409,53,allow,170,87,83,2,31,1,1
36666,50418,53,2799,53,allow,760,96,664,2,31,1,1
36667,65387,53,24725,53,allow,272,122,150,2,30,1,1
36668,50253,53,9014,53,allow,756,95,661,2,30,1,1
36669,55377,53,19699,53,allow,1428,103,1325,4,32,2,2
36670,55083,53,35659,53,allow,216,110,106,2,30,1,1
36671,55582,53,45316,53,allow,170,87,83,2,30,1,1
36672,64332,53,24629,53,allow,374,96,278,4,55,2,2
36673,55513,53,5223,53,allow,184,94,90,2,30,1,1
36674,61499,443,53254,443,allow,15584,2626,12958,34,37,18,16
36675,65055,53,55759,53,allow,1426,98,1328,4,55,2,2
36676,57011,53,6103,53,allow,770,101,669,2,30,1,1
36677,51910,60443,64340,60443,allow,70,70,0,2,8,2,0
36678,38060,443,63699,443,allow,27679,15839,11840,75,103,39,36
36679,50476,80,50476,80,allow,28872,5086,23786,50,24,24,26
36680,49337,53,4969,53,allow,303,97,206,4,56,2,2
36681,57284,53,3184,53,allow,212,108,104,2,31,1,1
36682,65419,53,10153,53,allow,198,101,97,2,31,1,1
36683,49619,53,50189,53,allow,789,110,679,2,30,1,1
36684,61059,80,61059,80,allow,16824,810,16014,22,15,8,14
36685,56601,443,39654,443,allow,8978,3243,5735,22,45,13,9
36686,57215,53,55858,53,allow,810,108,702,2,30,1,1
36687,56390,53,2004,53,allow,701,88,613,2,30,1,1
36688,50478,80,50478,80,allow,28032,3868,24164,47,24,23,24
36689,56857,43237,16433,43237,allow,70,70,0,2,8,2,0
36690,64530,53,49179,53,allow,782,105,677,2,30,1,1
36691,49757,80,22692,80,allow,1396,864,532,9,15,5,4
36692,64993,53,50463,53,allow,748,95,653,2,30,1,1
36693,50005,53,45437,53,allow,295,101,194,4,30,2,2
36694,55102,53,40717,53,allow,190,97,93,2,30,1,1
36695,63988,53,39055,53,allow,190,97,93,2,30,1,1
36696,61651,123,29529,123,allow,184,94,90,2,30,1,1
36697,57389,53,59363,53,allow,186,95,91,2,30,1,1
36698,55110,53,57772,53,allow,770,102,668,2,30,1,1
36699,56568,53,49055,53,allow,206,105,101,2,30,1,1
36700,49845,53,18683,53,allow,168,86,82,2,31,1,1
36701,49777,53,49271,53,allow,168,78,90,2,31,1,1
36702,64055,53,63061,53,allow,178,91,87,2,31,1,1
36703,44915,443,17055,443,allow,23886,6994,16892,26,129,12,14
36704,64880,53,46886,53,allow,164,84,80,2,30,1,1
36705,56275,53,15148,53,allow,164,84,80,2,31,1,1
36706,56861,53,42758,53,allow,756,95,661,2,31,1,1
36707,49961,53,46234,53,allow,216,110,106,2,31,1,1
36708,56939,53,50675,53,allow,216,110,106,2,31,1,1
36709,56156,53,34308,53,allow,711,87,624,2,31,1,1
36710,64565,53,49218,53,allow,802,104,698,2,31,1,1
36711,61810,443,52096,443,allow,3109,812,2297,13,136,6,7
36712,55629,53,44695,53,allow,168,86,82,2,31,1,1
36713,56356,53,2062,53,allow,758,96,662,2,31,1,1
36714,55633,53,26791,53,allow,793,101,692,2,31,1,1
36715,56621,53,7810,53,allow,760,96,664,2,31,1,1
36716,55549,53,31074,53,allow,202,103,99,2,31,1,1
36717,56429,53,7462,53,allow,762,98,664,2,31,1,1
36718,65115,53,30947,53,allow,170,87,83,2,31,1,1
36719,55181,53,51083,53,allow,815,95,720,2,31,1,1
36720,56070,53,55660,53,allow,186,95,91,2,31,1,1
36721,56969,53,8130,53,allow,754,94,660,2,31,1,1
36722,55357,53,12869,53,allow,754,94,660,2,31,1,1
36723,49152,53,51402,53,allow,206,105,101,2,31,1,1
36724,64524,53,34078,53,allow,184,94,90,2,31,1,1
36725,64675,53,55719,53,allow,749,94,655,2,31,1,1
36726,55010,53,38368,53,allow,190,97,93,2,31,1,1
36727,56668,53,31919,53,allow,198,101,97,2,31,1,1
36728,49275,53,59894,53,allow,190,97,93,2,31,1,1
36729,37965,16253,55858,16253,allow,5892,3784,2108,81,3115,47,34
36730,60319,53,31437,53,allow,316,80,236,2,31,1,1
36731,50265,26512,31440,26512,allow,480,149,331,2,1200,1,1
36732,64870,53,47029,53,allow,200,102,98,2,31,1,1
36733,64697,53,42927,53,allow,198,101,97,2,31,1,1
36734,57896,46783,0,0,deny,100,100,0,1,0,1,0
36735,53234,48817,0,0,deny,148,148,0,1,0,1,0
36736,57896,49903,0,0,deny,100,100,0,1,0,1,0
36737,32342,62413,0,0,deny,66,66,0,1,0,1,0
36738,45941,23386,0,0,deny,60,60,0,1,0,1,0
36739,45941,23386,0,0,deny,60,60,0,1,0,1,0
36740,20012,8443,0,0,deny,60,60,0,1,0,1,0
36741,58002,445,0,0,drop,70,70,0,1,0,1,0
36742,53971,55442,0,0,deny,62,62,0,1,0,1,0
36743,58001,445,0,0,drop,70,70,0,1,0,1,0
36744,58274,445,0,0,drop,66,66,0,1,0,1,0
36745,62864,445,0,0,drop,70,70,0,1,0,1,0
36746,60204,2767,0,0,deny,66,66,0,1,0,1,0
36747,57999,445,0,0,drop,70,70,0,1,0,1,0
36748,58272,445,0,0,drop,66,66,0,1,0,1,0
36749,32137,44512,0,0,deny,62,62,0,1,0,1,0
36750,58263,445,0,0,drop,66,66,0,1,0,1,0
36751,8999,15503,0,0,deny,146,146,0,1,0,1,0
36752,42216,53,45740,53,allow,199,94,105,2,30,1,1
36753,51909,33509,44942,33509,allow,70,70,0,2,8,2,0
36754,56484,53,39719,53,allow,214,110,104,2,30,1,1
36755,51940,53,28110,53,allow,199,94,105,2,30,1,1
36756,61078,123,41282,123,allow,184,94,90,2,30,1,1
36757,55382,53,35558,53,allow,199,102,97,2,30,1,1
36758,56577,53,47746,53,allow,198,110,88,2,30,1,1
36759,51585,443,25112,443,allow,2840,330,2510,12,135,5,7
36760,59872,443,27152,443,allow,6239,800,5439,18,32,8,10
36761,55809,443,47324,443,allow,62,62,0,1,4,1,0
36762,49436,443,51591,443,allow,784271,38715,745556,1017,183,465,552
36763,65200,53,41473,53,allow,214,110,104,2,29,1,1
36764,49954,53,53212,53,allow,216,110,106,2,29,1,1
36765,65386,53,46279,53,allow,168,86,82,2,29,1,1
36766,53716,6881,40646,6881,allow,70,70,0,2,7,2,0
36767,57553,443,21487,443,allow,7075,2575,4500,21,30,12,9
36768,54080,443,18578,443,allow,6673,1531,5142,22,341,10,12
36769,55115,53,50368,53,allow,313,110,203,4,35,2,2
36770,58434,443,57588,443,allow,170342,10231,160111,264,136,130,134
36771,38632,443,3130,443,allow,9606,1228,8378,20,115,9,11
36772,49437,443,14429,443,allow,586175,29694,556481,753,182,349,404
36773,56374,53,20604,53,allow,177,94,83,2,29,1,1
36774,65059,53,56951,53,allow,197,94,103,2,29,1,1
36775,55102,53,13108,53,allow,195,102,93,2,29,1,1
36776,65496,53,16227,53,allow,194,102,92,2,29,1,1
36777,55466,53,26661,53,allow,177,94,83,2,29,1,1
36778,53588,3389,53588,3389,allow,3489,1534,1955,17,16,9,8
36779,65386,53,22726,53,allow,184,102,82,2,29,1,1
36780,59727,3389,59727,3389,allow,8409,1841,6568,27,20,11,16
36781,56374,53,12810,53,allow,177,94,83,2,29,1,1
36782,49315,53,15991,53,allow,94,94,0,1,30,1,0
36783,64880,53,31529,53,allow,166,86,80,2,30,1,1
36784,53458,443,20818,443,allow,7584,7094,490,14,123,7,7
36785,56464,53,12026,53,allow,177,94,83,2,30,1,1
36786,55608,53,12316,53,allow,195,102,93,2,30,1,1
36787,47523,443,49117,443,allow,429929,11379,418550,456,21,174,282
36788,51890,31122,11914,31122,allow,70,70,0,1,5,1,0
36789,49434,443,8627,443,allow,197635,12994,184641,287,183,143,144
36790,56728,443,61064,443,allow,5367,725,4642,15,15,8,7
36791,63879,80,50871,80,allow,314,192,122,6,15,4,2
36792,59763,443,10249,443,allow,24828,8387,16441,80,111,44,36
36793,23157,53,23157,53,allow,228,90,138,2,30,1,1
36794,64790,53,64538,53,allow,779,86,693,2,30,1,1
36795,55292,53,15138,53,allow,274,94,180,2,30,1,1
36796,65419,53,45268,53,allow,199,102,97,2,30,1,1
36797,56433,53,26629,53,allow,177,94,83,2,30,1,1
36798,56626,443,37778,443,allow,45304,28614,16690,82,41,45,37
36799,51891,23238,29444,23238,allow,70,70,0,1,5,1,0
36800,55115,53,46461,53,allow,313,110,203,4,35,2,2
36801,56800,443,33972,443,allow,7518,2862,4656,18,75,10,8
36802,55502,53,25311,53,allow,193,102,91,2,30,1,1
36803,40600,53,40600,53,allow,228,90,138,2,30,1,1
36804,42384,443,3442,443,allow,101952,6925,95027,143,333,72,71
36805,54079,443,34399,443,allow,6931,1974,4957,24,342,11,13
36806,60104,80,20513,80,allow,18480,7940,10540,48,71,27,21
36807,49856,53,57011,53,allow,168,78,90,2,30,1,1
36808,55516,123,34894,123,allow,184,94,90,2,30,1,1
36809,23984,53,23984,53,allow,216,98,118,2,30,1,1
36810,50005,53,14000,53,allow,199,102,97,2,30,1,1
36811,56701,53,54684,53,allow,211,110,101,2,30,1,1
36812,56433,53,3210,53,allow,177,94,83,2,30,1,1
36813,48164,53,51985,53,allow,199,94,105,2,30,1,1
36814,49936,53,12720,53,allow,754,94,660,2,30,1,1
36815,65040,53,33364,53,allow,178,94,84,2,30,1,1
36816,49226,53,53578,53,allow,765,102,663,2,30,1,1
36817,51522,443,43510,443,allow,190,70,120,4,15,2,2
36818,55504,53,20782,53,allow,199,94,105,2,30,1,1
36819,64983,53,5979,53,allow,181,94,87,2,30,1,1
36820,55614,53,42097,53,allow,309,110,199,2,30,1,1
36821,65067,53,28760,53,allow,86,86,0,1,30,1,0
36822,54224,53,18536,53,allow,199,94,105,2,30,1,1
36823,55453,53,1077,53,allow,730,102,628,2,30,1,1
36824,65139,53,54576,53,allow,443,182,261,6,30,3,3
36825,56861,33412,8103,33412,allow,70,70,0,1,5,1,0
36826,58035,80,7543,80,allow,4168,2906,1262,11,15,6,5
36827,28020,443,11039,443,allow,5576,1388,4188,19,15,9,10
36828,58980,123,62249,123,allow,184,94,90,2,30,1,1
36829,55083,53,1182,53,allow,216,110,106,2,30,1,1
36830,55582,53,5858,53,allow,177,94,83,2,30,1,1
36831,49472,53,31228,53,allow,772,102,670,2,30,1,1
36832,65056,53,13429,53,allow,168,94,74,2,30,1,1
36833,65056,53,16740,53,allow,168,94,74,2,30,1,1
36834,57284,53,19677,53,allow,214,110,104,2,30,1,1
36835,51648,443,53191,443,allow,30116,4336,25780,44,123,18,26
36836,17750,39318,52655,39318,allow,481,150,331,2,1200,1,1
36837,48368,443,5888,443,allow,9157,3805,5352,39,100,18,21
36838,10003,443,7102,443,allow,7617,4161,3456,34,332,15,19
36839,42273,443,42273,443,allow,4398,1491,2907,19,26,11,8
36840,51911,14543,57115,14543,allow,70,70,0,2,8,2,0
36841,63962,53,21344,53,allow,185,93,92,3,58,2,1
36842,35499,443,34865,443,allow,2270,1303,967,20,102,11,9
36843,60440,53830,1700,53830,allow,320,140,180,6,6,3,3
36844,55981,80,6270,80,allow,130,70,60,2,15,1,1
36845,49174,53,31879,53,allow,199,102,97,2,33,1,1
36846,38084,443,21809,443,allow,2697,1520,1177,21,182,10,11
36847,60951,53,52563,53,allow,164,78,86,2,29,1,1
36848,51892,46647,6843,46647,allow,70,70,0,1,5,1,0
36849,33445,53,19899,53,allow,168,78,90,2,29,1,1
36850,60287,53,28366,53,allow,168,78,90,2,29,1,1
36851,58843,80,20341,80,allow,1439485,27511,1411974,1308,108,369,939
36852,56520,53,9113,53,allow,177,94,83,2,29,1,1
36853,40749,5222,28403,5222,allow,3474,915,2559,34,685,10,24
36854,56577,53,39696,53,allow,182,94,88,2,30,1,1
36855,50022,53,4784,53,allow,198,110,88,2,29,1,1
36856,55503,53,6618,53,allow,216,110,106,2,29,1,1
36857,46369,443,62410,443,allow,12157,3583,8574,81,480,34,47
36858,50962,53,0,0,allow,229,85,144,2,29,1,1
36859,50375,53,45862,53,allow,211,110,101,2,30,1,1
36860,55513,53,13816,53,allow,184,94,90,2,30,1,1
36861,56464,53,56163,53,allow,177,94,83,2,30,1,1
36862,55382,53,48828,53,allow,199,102,97,2,30,1,1
36863,64983,53,54706,53,allow,181,94,87,2,30,1,1
36864,56610,443,5877,443,allow,100002,5891,94111,138,44,60,78
36865,56583,53,33992,53,allow,177,94,83,2,29,1,1
36866,50510,53,6283,53,allow,734,94,640,2,30,1,1
36867,55582,53,57520,53,allow,177,94,83,2,30,1,1
36868,65486,53,53853,53,allow,193,102,91,2,30,1,1
36869,55102,53,6205,53,allow,195,102,93,2,30,1,1
36870,50005,53,15477,53,allow,199,102,97,2,30,1,1
36871,56469,53,24320,53,allow,177,94,83,2,30,1,1
36872,57284,53,51341,53,allow,214,110,104,2,30,1,1
36873,56701,53,21171,53,allow,211,110,101,2,30,1,1
36874,50005,53,1672,53,allow,199,102,97,2,30,1,1
36875,56523,53,49008,53,allow,184,102,82,2,30,1,1
36876,49659,53,53164,53,allow,730,102,628,2,30,1,1
36877,56568,53,16992,53,allow,211,110,101,2,30,1,1
36878,58282,53,59362,53,allow,215,102,113,2,30,1,1
36879,49713,53,20450,53,allow,821,102,719,2,30,1,1
36880,50584,53,19282,53,allow,738,86,652,2,30,1,1
36881,55778,53,54108,53,allow,181,94,87,2,30,1,1
36882,56984,53,44033,53,allow,209,102,107,2,30,1,1
36883,43604,53,41746,53,allow,168,78,90,2,30,1,1
36884,39461,53,45858,53,allow,168,78,90,2,30,1,1
36885,56275,53,46209,53,allow,166,86,80,2,30,1,1
36886,55010,53,9213,53,allow,195,102,93,2,31,1,1
36887,49161,53,58186,53,allow,168,86,82,2,30,1,1
36888,43298,53,31678,53,allow,199,94,105,2,30,1,1
36889,56803,53,10846,53,allow,195,102,93,2,30,1,1
36890,56993,53,49057,53,allow,168,86,82,2,30,1,1
36891,65348,53,57406,53,allow,214,102,112,2,31,1,1
36892,56137,53,23667,53,allow,199,102,97,2,31,1,1
36893,57180,53,28550,53,allow,305,86,219,2,31,1,1
36894,37335,443,52361,443,allow,4734755,152171,4582584,5334,405,2083,3251
36895,65147,53,63811,53,allow,194,102,92,2,31,1,1
36896,57444,443,62310,443,allow,7975,1742,6233,24,81,14,10
36897,51889,44348,37588,44348,allow,70,70,0,1,5,1,0
36898,56523,53,57340,53,allow,168,86,82,2,30,1,1
36899,56023,53,18673,53,allow,195,102,93,2,30,1,1
36900,43563,53,1876,53,allow,164,78,86,2,30,1,1
36901,56596,53,43071,53,allow,194,102,92,2,30,1,1
36902,52926,443,36627,443,allow,5458,1390,4068,17,15,9,8
36903,63130,55860,38620,55860,allow,1426,964,462,7,15,4,3
36904,50210,1688,19159,1688,allow,70,70,0,2,8,2,0
36905,51443,443,36286,443,allow,70,70,0,1,5,1,0
36906,55083,53,24986,53,allow,325,110,215,4,44,2,2
36907,52925,443,23150,443,allow,5582,1388,4194,19,15,9,10
36908,56484,53,12661,53,allow,214,110,104,2,30,1,1
36909,65486,53,8619,53,allow,193,102,91,2,30,1,1
36910,56939,53,27310,53,allow,216,110,106,2,30,1,1
36911,50368,53,63672,53,allow,763,102,661,2,30,1,1
36912,38008,443,10885,443,allow,11784,6760,5024,50,247,30,20
36913,51311,22,51311,22,allow,5624,2099,3525,30,23,17,13
36914,60434,11339,17493,11339,allow,70,70,0,1,5,1,0
36915,56464,53,58795,53,allow,177,94,83,2,30,1,1
36916,56568,53,45144,53,allow,211,110,101,2,30,1,1
36917,55083,53,56476,53,allow,216,110,106,2,30,1,1
36918,49161,53,58630,53,allow,184,102,82,2,30,1,1
36919,50040,53,5250,53,allow,193,102,91,2,30,1,1
36920,49713,53,3397,53,allow,198,102,96,2,30,1,1
36921,55413,53,7034,53,allow,779,86,693,2,30,1,1
36922,55199,53,62068,53,allow,152,78,74,2,30,1,1
36923,55032,443,19722,443,allow,8965,3021,5944,39,360,22,17
36924,6881,34635,39166,34635,allow,228,118,110,2,1200,1,1
36925,53530,53,6923,53,allow,164,78,86,2,30,1,1
36926,48604,53,57366,53,allow,164,78,86,2,30,1,1
36927,49125,53,10970,53,allow,168,78,90,2,30,1,1
36928,45607,53,29195,53,allow,168,78,90,2,30,1,1
36929,56433,53,56287,53,allow,177,94,83,2,30,1,1
36930,55102,53,47869,53,allow,195,102,93,2,30,1,1
36931,56070,53,23575,53,allow,193,102,91,2,30,1,1
36932,65499,53,27912,53,allow,182,102,80,2,30,1,1
36933,50237,53,53638,53,allow,183,94,89,2,31,1,1
36934,56758,53,35324,53,allow,173,94,79,2,31,1,1
36935,51847,53,49805,53,allow,164,78,86,2,31,1,1
36936,49411,53,17691,53,allow,195,102,93,2,31,1,1
36937,57284,53,21102,53,allow,214,110,104,2,31,1,1
36938,49152,53,17272,53,allow,307,105,202,4,31,2,2
36939,56137,53,37448,53,allow,199,102,97,2,30,1,1
36940,65180,53,26372,53,allow,165,86,79,2,30,1,1
36941,50622,53,57483,53,allow,185,102,83,2,30,1,1
36942,55549,53,9583,53,allow,209,110,99,2,30,1,1
36943,65115,53,30107,53,allow,253,87,166,4,31,2,2
36944,37387,443,27821,443,allow,64440,16508,47932,101,142,44,57
36945,49845,53,35831,53,allow,168,86,82,2,30,1,1
36946,49152,53,49230,53,allow,211,110,101,2,31,1,1
36947,64885,53,51711,53,allow,212,102,110,2,31,1,1
36948,56512,53,52518,53,allow,889,404,485,10,31,5,5
36949,57043,53,20251,53,allow,166,86,80,2,31,1,1
36950,64885,53,54457,53,allow,182,102,80,2,31,1,1
36951,56015,53,12325,53,allow,195,102,93,2,31,1,1
36952,41575,443,49577,443,allow,24256,1841,22415,41,131,18,23
36953,50622,53,8191,53,allow,177,94,83,2,31,1,1
36954,56982,53,27888,53,allow,177,94,83,2,31,1,1
36955,56803,53,20372,53,allow,195,102,93,2,31,1,1
36956,37576,53,58836,53,allow,168,78,90,2,30,1,1
36957,55000,53,36007,53,allow,193,102,91,2,31,1,1
36958,64586,53,19634,53,allow,252,94,158,2,31,1,1
36959,65350,53,14923,53,allow,212,102,110,2,31,1,1
36960,56939,53,59190,53,allow,216,110,106,2,31,1,1
36961,49275,53,35482,53,allow,195,102,93,2,31,1,1
36962,55851,53,26107,53,allow,167,86,81,2,31,1,1
36963,65218,53,5567,53,allow,194,102,92,2,31,1,1
36964,55133,53,17544,53,allow,443,182,261,6,31,3,3
36965,57389,53,16174,53,allow,193,102,91,2,31,1,1
36966,64276,53,55136,53,allow,197,102,95,2,31,1,1
36967,49961,53,61953,53,allow,322,110,212,4,31,2,2
36968,33705,443,51177,443,allow,4610,918,3692,15,135,7,8
36969,57470,60080,37928,60080,allow,12668,8506,4162,117,3745,74,43
36970,60864,5223,21557,5223,allow,6278,2408,3870,27,3600,15,12
36971,42718,443,45721,443,allow,7341,2111,5230,18,135,8,10
36972,9058,443,18160,443,allow,5655,934,4721,16,130,8,8
36973,65419,53,4348,53,allow,295,101,194,4,31,2,2
36974,53720,50795,49301,50795,allow,320,140,180,6,7,3,3
36975,33610,443,59796,443,allow,9490,1158,8332,24,257,13,11
36976,55673,53,34311,53,allow,179,94,85,2,31,1,1
36977,64751,53,23466,53,allow,458,188,270,6,31,3,3
36978,51915,35068,4331,35068,allow,316,136,180,6,6,3,3
36979,53698,8120,60768,8120,allow,70,70,0,1,5,1,0
36980,39937,443,39937,443,allow,4756,1849,2907,19,27,11,8
36981,56544,443,41897,443,allow,39717,3740,35977,76,53,39,37
36982,49272,53,48276,53,allow,168,86,82,2,33,1,1
36983,55233,443,14491,443,allow,10226,3230,6996,28,47,16,12
36984,50442,37807,0,0,deny,62,62,0,1,0,1,0
36985,58259,445,0,0,drop,66,66,0,1,0,1,0
36986,57990,445,0,0,drop,70,70,0,1,0,1,0
36987,60239,23,0,0,deny,60,60,0,1,0,1,0
36988,42968,56205,0,0,deny,62,62,0,1,0,1,0
36989,57988,445,0,0,drop,70,70,0,1,0,1,0
36990,5450,23,0,0,deny,60,60,0,1,0,1,0
36991,57987,445,0,0,drop,70,70,0,1,0,1,0
36992,18011,44847,0,0,deny,66,66,0,1,0,1,0
36993,57986,445,0,0,drop,70,70,0,1,0,1,0
36994,57985,445,0,0,drop,70,70,0,1,0,1,0
36995,56636,43890,0,0,deny,66,66,0,1,0,1,0
36996,56157,50584,0,0,deny,66,66,0,1,0,1,0
36997,57982,445,0,0,drop,70,70,0,1,0,1,0
36998,57981,445,0,0,drop,70,70,0,1,0,1,0
36999,62857,445,0,0,drop,70,70,0,1,0,1,0
37000,62854,445,0,0,drop,70,70,0,1,0,1,0
37001,62852,445,0,0,drop,70,70,0,1,0,1,0
37002,58247,445,0,0,drop,66,66,0,1,0,1,0
37003,22922,35440,0,0,deny,62,62,0,1,0,1,0
37004,58246,445,0,0,drop,66,66,0,1,0,1,0
37005,58249,445,0,0,drop,66,66,0,1,0,1,0
37006,58248,445,0,0,drop,66,66,0,1,0,1,0
37007,58244,445,0,0,drop,66,66,0,1,0,1,0
37008,58242,445,0,0,drop,66,66,0,1,0,1,0
37009,58245,445,0,0,drop,66,66,0,1,0,1,0
37010,58241,445,0,0,drop,66,66,0,1,0,1,0
37011,9017,6881,0,0,deny,66,66,0,1,0,1,0
37012,48676,53395,0,0,deny,60,60,0,1,0,1,0
37013,33543,44847,0,0,deny,66,66,0,1,0,1,0
37014,10438,23,0,0,deny,60,60,0,1,0,1,0
37015,27272,64147,0,0,deny,62,62,0,1,0,1,0
37016,57967,445,0,0,drop,70,70,0,1,0,1,0
37017,57966,445,0,0,drop,70,70,0,1,0,1,0
37018,57964,445,0,0,drop,70,70,0,1,0,1,0
37019,10669,49756,0,0,deny,60,60,0,1,0,1,0
37020,10669,49756,0,0,deny,60,60,0,1,0,1,0
37021,10669,49756,0,0,deny,60,60,0,1,0,1,0
37022,10669,49756,0,0,deny,60,60,0,1,0,1,0
37023,10669,49756,0,0,deny,60,60,0,1,0,1,0
37024,57957,445,0,0,drop,70,70,0,1,0,1,0
37025,57956,445,0,0,drop,70,70,0,1,0,1,0
37026,50529,44847,0,0,deny,66,66,0,1,0,1,0
37027,58501,44847,0,0,deny,62,62,0,1,0,1,0
37028,52626,44847,0,0,deny,62,62,0,1,0,1,0
37029,39742,62413,0,0,deny,66,66,0,1,0,1,0
37030,38781,51505,0,0,deny,62,62,0,1,0,1,0
37031,62844,445,0,0,drop,70,70,0,1,0,1,0
37032,62846,445,0,0,drop,70,70,0,1,0,1,0
37033,62840,445,0,0,drop,70,70,0,1,0,1,0
37034,62835,445,0,0,drop,70,70,0,1,0,1,0
37035,58229,445,0,0,drop,66,66,0,1,0,1,0
37036,58228,445,0,0,drop,66,66,0,1,0,1,0
37037,58227,445,0,0,drop,66,66,0,1,0,1,0
37038,5894,44847,0,0,deny,66,66,0,1,0,1,0
37039,55874,64147,0,0,deny,66,66,0,1,0,1,0
37040,57945,445,0,0,drop,70,70,0,1,0,1,0
37041,54300,22114,0,0,deny,66,66,0,1,0,1,0
37042,54458,64147,0,0,deny,62,62,0,1,0,1,0
37043,56521,32480,0,0,deny,62,62,0,1,0,1,0
37044,55386,32480,0,0,deny,66,66,0,1,0,1,0
37045,51262,35440,0,0,deny,66,66,0,1,0,1,0
37046,61000,15503,0,0,deny,146,146,0,1,0,1,0
37047,62832,445,0,0,drop,70,70,0,1,0,1,0
37048,62392,15503,0,0,deny,146,146,0,1,0,1,0
37049,50283,49169,0,0,deny,66,66,0,1,0,1,0
37050,62831,445,0,0,drop,70,70,0,1,0,1,0
37051,62825,445,0,0,drop,70,70,0,1,0,1,0
37052,62821,445,0,0,drop,70,70,0,1,0,1,0
37053,45964,2225,0,0,deny,60,60,0,1,0,1,0
37054,57940,445,0,0,drop,70,70,0,1,0,1,0
37055,62388,39004,0,0,deny,62,62,0,1,0,1,0
37056,58085,57470,0,0,deny,66,66,0,1,0,1,0
37057,57930,445,0,0,drop,70,70,0,1,0,1,0
37058,57931,445,0,0,drop,70,70,0,1,0,1,0
37059,57929,445,0,0,drop,70,70,0,1,0,1,0
37060,57927,445,0,0,drop,70,70,0,1,0,1,0
37061,57925,445,0,0,drop,70,70,0,1,0,1,0
37062,46774,51050,0,0,deny,146,146,0,1,0,1,0
37063,62810,445,0,0,drop,70,70,0,1,0,1,0
37064,62812,445,0,0,drop,70,70,0,1,0,1,0
37065,58206,445,0,0,drop,66,66,0,1,0,1,0
37066,47325,2323,0,0,deny,60,60,0,1,0,1,0
37067,14923,51505,0,0,deny,66,66,0,1,0,1,0
37068,28378,56205,0,0,deny,62,62,0,1,0,1,0
37069,57918,445,0,0,drop,70,70,0,1,0,1,0
37070,57233,50934,0,0,deny,66,66,0,1,0,1,0
37071,443,31367,0,0,deny,74,74,0,1,0,1,0
37072,62051,11392,0,0,deny,66,66,0,1,0,1,0
37073,62806,445,0,0,drop,70,70,0,1,0,1,0
37074,62804,445,0,0,drop,70,70,0,1,0,1,0
37075,59647,47993,0,0,deny,66,66,0,1,0,1,0
37076,45682,47993,0,0,deny,62,62,0,1,0,1,0
37077,51414,22,0,0,deny,60,60,0,1,0,1,0
37078,49644,30188,0,0,deny,62,62,0,1,0,1,0
37079,57911,445,0,0,drop,70,70,0,1,0,1,0
37080,57909,445,0,0,drop,70,70,0,1,0,1,0
37081,58201,445,0,0,drop,66,66,0,1,0,1,0
37082,58199,445,0,0,drop,66,66,0,1,0,1,0
37083,65285,50584,0,0,deny,62,62,0,1,0,1,0
37084,61150,11392,0,0,deny,66,66,0,1,0,1,0
37085,45941,23384,0,0,deny,60,60,0,1,0,1,0
37086,64740,53,21372,53,allow,204,96,108,2,0,1,1
37087,59611,56205,0,0,deny,62,62,0,1,0,1,0
37088,62109,44847,0,0,deny,66,66,0,1,0,1,0
37089,57905,445,0,0,drop,70,70,0,1,0,1,0
37090,9522,51505,0,0,deny,66,66,0,1,0,1,0
37091,62796,445,0,0,drop,70,70,0,1,0,1,0
37092,57903,445,0,0,drop,70,70,0,1,0,1,0
37093,0,0,0,0,deny,156,156,0,2,0,2,0
37094,0,0,0,0,deny,156,156,0,2,0,2,0
37095,0,0,0,0,deny,156,156,0,2,0,2,0
37096,0,0,0,0,deny,156,156,0,2,0,2,0
37097,62783,445,0,0,drop,70,70,0,1,0,1,0
37098,62789,445,0,0,drop,70,70,0,1,0,1,0
37099,62785,445,0,0,drop,70,70,0,1,0,1,0
37100,63098,35440,0,0,deny,62,62,0,1,0,1,0
37101,10427,32480,0,0,deny,62,62,0,1,0,1,0
37102,58193,445,0,0,drop,66,66,0,1,0,1,0
37103,57899,445,0,0,deny,70,70,0,1,0,1,0
37104,58185,445,0,0,drop,66,66,0,1,0,1,0
37105,58182,445,0,0,drop,66,66,0,1,0,1,0
37106,58190,445,0,0,drop,66,66,0,1,0,1,0
37107,58181,445,0,0,drop,66,66,0,1,0,1,0
37108,58180,445,0,0,drop,66,66,0,1,0,1,0
37109,58183,445,0,0,drop,66,66,0,1,0,1,0
37110,53208,18375,0,0,deny,62,62,0,1,0,1,0
37111,56863,5900,0,0,deny,60,60,0,1,0,1,0
37112,54134,64147,0,0,deny,66,66,0,1,0,1,0
37113,51015,64147,0,0,deny,62,62,0,1,0,1,0
37114,62779,445,0,0,drop,70,70,0,1,0,1,0
37115,57898,445,0,0,drop,70,70,0,1,0,1,0
37116,51096,63710,0,0,deny,66,66,0,1,0,1,0
37117,62775,445,0,0,drop,70,70,0,1,0,1,0
37118,62776,445,0,0,drop,70,70,0,1,0,1,0
37119,62774,445,0,0,drop,70,70,0,1,0,1,0
37120,51374,30317,0,0,deny,66,66,0,1,0,1,0
37121,13484,37965,0,0,deny,66,66,0,1,0,1,0
37122,9393,51505,0,0,deny,66,66,0,1,0,1,0
37123,58424,52700,0,0,deny,66,66,0,1,0,1,0
37124,51320,44847,0,0,deny,62,62,0,1,0,1,0
37125,57893,445,0,0,drop,70,70,0,1,0,1,0
37126,8889,60961,0,0,deny,60,60,0,1,0,1,0
37127,50486,56205,0,0,deny,66,66,0,1,0,1,0
37128,40099,23,0,0,deny,60,60,0,1,0,1,0
37129,19875,30170,0,0,deny,145,145,0,1,0,1,0
37130,62768,445,0,0,drop,70,70,0,1,0,1,0
37131,62767,445,0,0,drop,70,70,0,1,0,1,0
37132,62766,445,0,0,drop,70,70,0,1,0,1,0
37133,56876,30188,0,0,deny,66,66,0,1,0,1,0
37134,58174,445,0,0,drop,66,66,0,1,0,1,0
37135,62764,445,0,0,drop,70,70,0,1,0,1,0
37136,58170,445,0,0,drop,66,66,0,1,0,1,0
37137,50095,50584,0,0,deny,66,66,0,1,0,1,0
37138,58168,445,0,0,drop,66,66,0,1,0,1,0
37139,58166,445,0,0,drop,66,66,0,1,0,1,0
37140,49981,44847,0,0,deny,62,62,0,1,0,1,0
37141,58165,445,0,0,drop,66,66,0,1,0,1,0
37142,32609,64097,0,0,deny,66,66,0,1,0,1,0
37143,57880,445,0,0,drop,70,70,0,1,0,1,0
37144,55745,53,2082,53,allow,198,101,97,2,30,1,1
37145,56137,53,13627,53,allow,198,101,97,2,30,1,1
37146,57320,53,17715,53,allow,802,104,698,2,30,1,1
37147,56803,53,60073,53,allow,190,97,93,2,30,1,1
37148,45973,80,60960,80,allow,1114,534,580,12,16,7,5
37149,56848,19556,15601,19556,allow,66,66,0,1,5,1,0
37150,40911,443,37854,443,allow,11095,2599,8496,45,257,22,23
37151,58887,15000,7750,15000,allow,138,78,60,2,6,1,1
37152,41627,15000,9881,15000,allow,130,70,60,2,5,1,1
37153,58369,443,52510,443,allow,12779517,343310,12436207,12837,162,4589,8248
37154,56726,443,54514,443,allow,4221,666,3555,13,15,7,6
37155,56601,53,12996,53,allow,170,87,83,2,30,1,1
37156,65357,53,31464,53,allow,256,93,163,2,30,1,1
37157,49560,443,58104,443,allow,13516,6981,6535,61,2149,34,27
37158,46985,443,26507,443,allow,4957,3488,1469,25,51,15,10
37159,33505,80,10878,80,allow,130,70,60,2,15,1,1
37160,51905,65253,13795,65253,allow,70,70,0,2,8,2,0
37161,38598,80,50146,80,allow,1114,534,580,12,16,7,5
37162,53694,8999,50905,8999,allow,1179,606,573,12,17,7,5
37163,65416,443,30210,443,allow,3219,2242,977,19,25,9,10
37164,49708,53,19029,53,allow,186,95,91,2,31,1,1
37165,55238,443,54700,443,allow,6165,1407,4758,21,45,12,9
37166,65340,53,24167,53,allow,313,110,203,4,34,2,2
37167,55011,443,43208,443,allow,134,60,74,3,10,2,1
37168,34154,443,26311,443,allow,6107,2012,4095,18,25,10,8
37169,56015,53,32700,53,allow,190,97,93,2,31,1,1
37170,56754,53,1275,53,allow,751,95,656,2,30,1,1
37171,53096,443,46942,443,allow,13599,5335,8264,35,171,18,17
37172,51616,15000,27735,15000,allow,130,70,60,2,6,1,1
37173,40202,5222,32011,5222,allow,5958,2420,3538,40,25,20,20
37174,56849,23745,9953,23745,allow,66,66,0,1,5,1,0
37175,53247,443,23976,443,allow,10542,1216,9326,26,44,10,16
37176,55223,443,26672,443,allow,12583,2945,9638,31,47,16,15
37177,59900,3389,59900,3389,allow,3489,1534,1955,17,18,9,8
37178,49544,80,16588,80,allow,10192,3818,6374,20,16,9,11
37179,64617,53,32317,53,allow,756,95,661,2,30,1,1
37180,55747,53,60258,53,allow,186,95,91,2,30,1,1
37181,5588,5588,0,0,allow,3498,1872,1626,48,201,24,24
37182,50130,53,57806,53,allow,174,89,85,2,30,1,1
37183,60116,443,14734,443,allow,9454,2307,7147,40,19,17,23
37184,58373,443,64061,443,allow,78832,12408,66424,109,162,46,63
37185,45120,15000,54128,15000,allow,130,70,60,2,6,1,1
37186,55678,53,40642,53,allow,270,88,182,4,54,2,2
37187,56847,36370,51543,36370,allow,624,318,306,10,15,5,5
37188,63891,51350,44570,51350,allow,312,132,180,6,7,3,3
37189,56856,47715,33664,47715,allow,70,70,0,2,8,2,0
37190,52099,443,31661,443,allow,39798,12257,27541,68,97,27,41
37191,53836,15000,1937,15000,allow,130,70,60,2,5,1,1
37192,55654,18251,36307,18251,allow,70,70,0,1,5,1,0
37193,37483,443,13150,443,allow,70,70,0,2,5,2,0
37194,48273,15000,43622,15000,allow,130,70,60,2,5,1,1
37195,47166,15000,45851,15000,allow,130,70,60,2,5,1,1
37196,48978,443,3498,443,allow,10163,3585,6578,47,26,24,23
37197,51102,80,48661,80,allow,254,128,126,5,16,3,2
37198,40204,5222,16908,5222,allow,5097,2196,2901,36,25,18,18
37199,49973,53,28904,53,allow,747,93,654,2,30,1,1
37200,65028,53,48786,53,allow,182,93,89,2,31,1,1
37201,60261,53,9176,53,allow,233,81,152,2,31,1,1
37202,56754,53,54310,53,allow,182,93,89,2,31,1,1
37203,58452,5228,20449,5228,allow,2855,1780,1075,20,3600,10,10
37204,57030,53,10715,53,allow,749,94,655,2,30,1,1
37205,57043,53,11137,53,allow,164,84,80,2,31,1,1
37206,52744,53,32462,53,allow,218,81,137,2,31,1,1
37207,60205,53,4372,53,allow,491,115,376,2,31,1,1
37208,64155,53,47794,53,allow,182,93,89,2,31,1,1
37209,57432,53,52576,53,allow,186,95,91,2,31,1,1
37210,55057,53,28590,53,allow,188,80,108,2,31,1,1
37211,49411,53,5629,53,allow,764,99,665,2,31,1,1
37212,49411,53,16636,53,allow,190,97,93,2,31,1,1
37213,64502,53,19448,53,allow,198,101,97,2,31,1,1
37214,44847,26356,3716,26356,allow,501,150,351,2,1200,1,1
37215,56316,53,62474,53,allow,733,93,640,2,31,1,1
37216,57403,53,33479,53,allow,764,99,665,2,31,1,1
37217,49901,53,43057,53,allow,752,93,659,2,31,1,1
37218,55165,53,33843,53,allow,186,95,91,2,31,1,1
37219,55146,53,27596,53,allow,178,91,87,2,31,1,1
37220,55989,53,34510,53,allow,301,80,221,2,31,1,1
37221,55865,53,59187,53,allow,192,98,94,2,31,1,1
37222,56754,53,26868,53,allow,182,93,89,2,31,1,1
37223,56489,53,9715,53,allow,172,88,84,2,31,1,1
37224,43616,5228,36276,5228,allow,2322,1296,1026,15,3600,6,9
37225,61808,443,43689,443,allow,4625,2292,2333,14,135,7,7
37226,30960,45732,62764,45732,allow,330,330,0,6,3610,6,0
37227,52045,443,60420,443,allow,51604,4684,46920,70,133,28,42
37228,63951,53,13752,53,allow,186,95,91,2,31,1,1
37229,55673,53,33131,53,allow,174,89,85,2,31,1,1
37230,55365,53,41996,53,allow,184,94,90,2,31,1,1
37231,55379,53,30186,53,allow,256,93,163,2,31,1,1
37232,56304,53,54200,53,allow,184,94,90,2,31,1,1
37233,64275,53,47758,53,allow,192,90,102,2,31,1,1
37234,54329,443,26217,443,allow,5850,1617,4233,28,127,13,15
37235,54330,443,28162,443,allow,7329,3011,4318,30,127,14,16
37236,64276,53,40042,53,allow,194,99,95,2,31,1,1
37237,54992,53,12659,53,allow,190,97,93,2,31,1,1
37238,32520,50265,0,0,deny,145,145,0,1,0,1,0
37239,62758,445,0,0,drop,70,70,0,1,0,1,0
37240,60720,23718,0,0,deny,66,66,0,1,0,1,0
37241,58976,43890,0,0,deny,66,66,0,1,0,1,0
37242,57877,445,0,0,drop,70,70,0,1,0,1,0
37243,62747,445,0,0,drop,70,70,0,1,0,1,0
37244,49611,53,44426,53,allow,184,94,90,2,30,1,1
37245,57239,53,5025,53,allow,193,102,91,2,30,1,1
37246,64155,53,2380,53,allow,183,94,89,2,30,1,1
37247,49554,80,58941,80,allow,1515,481,1034,11,15,6,5
37248,56914,53,24598,53,allow,821,102,719,2,30,1,1
37249,49738,53,2728,53,allow,215,102,113,2,30,1,1
37250,56070,53,12726,53,allow,193,102,91,2,30,1,1
37251,55934,53,23725,53,allow,182,102,80,2,30,1,1
37252,49502,53,5291,53,allow,193,102,91,2,30,1,1
37253,49713,53,16907,53,allow,184,94,90,2,30,1,1
37254,55019,443,52718,443,allow,6484,1915,4569,26,131,14,12
37255,50580,443,17458,443,allow,2723,1383,1340,29,37,16,13
37256,54983,80,49933,80,allow,27816,7362,20454,69,240,41,28
37257,65250,53,37683,53,allow,353,98,255,4,32,2,2
37258,27005,27126,47087,27126,allow,636020,187240,448780,2701,104,1538,1163
37259,56568,53,6901,53,allow,365,105,260,4,47,2,2
37260,49667,443,39894,443,allow,8329,2188,6141,29,100,16,13
37261,49275,53,55214,53,allow,283,97,186,4,30,2,2
37262,53696,50321,3484,50321,allow,70,70,0,1,4,1,0
37263,60107,443,49027,443,allow,9766,3290,6476,40,57,20,20
37264,55232,443,11743,443,allow,9619,2504,7115,28,46,15,13
37265,55236,443,64536,443,allow,10293,2881,7412,25,45,14,11
37266,58495,443,34760,443,allow,1638,829,809,18,43,10,8
37267,49788,53,17656,53,allow,198,102,96,2,32,1,1
37268,56638,80,7412,80,allow,234,234,0,4,11,4,0
37269,59277,53,14948,53,allow,164,78,86,2,29,1,1
37270,47636,53,0,0,allow,86,86,0,1,29,1,0
37271,56070,53,26270,53,allow,193,102,91,2,30,1,1
37272,55657,53,52636,53,allow,822,102,720,2,30,1,1
37273,56993,53,24692,53,allow,184,102,82,2,29,1,1
37274,64055,53,52345,53,allow,181,94,87,2,29,1,1
37275,34317,53,53292,53,allow,168,78,90,2,29,1,1
37276,55549,53,24179,53,allow,209,110,99,2,29,1,1
37277,53552,53,3574,53,allow,168,78,90,2,29,1,1
37278,55000,53,31472,53,allow,193,102,91,2,29,1,1
37279,56982,53,54411,53,allow,177,94,83,2,29,1,1
37280,65040,53,11010,53,allow,178,94,84,2,29,1,1
37281,55199,53,24591,53,allow,152,78,74,2,29,1,1
37282,41783,443,41782,443,allow,23344,2097,21247,39,15,18,21
37283,50529,80,9935,80,allow,12874,6770,6104,26,28,13,13
37284,50533,80,13873,80,allow,3672,1976,1696,12,26,7,5
37285,44921,443,18740,443,allow,5440,846,4594,15,15,9,6
37286,49890,443,3826,443,allow,6370237,150385,6219852,6047,138,1688,4359
37287,64903,53,4073,53,allow,210,110,100,2,30,1,1
37288,64415,53,15855,53,allow,221,94,127,2,30,1,1
37289,50130,53,36317,53,allow,179,94,85,2,30,1,1
37290,55629,53,22449,53,allow,168,86,82,2,30,1,1
37291,49567,53,35834,53,allow,168,86,82,2,30,1,1
37292,64583,53,34573,53,allow,179,94,85,2,30,1,1
37293,55549,53,20623,53,allow,209,110,99,2,30,1,1
37294,56304,53,19681,53,allow,184,94,90,2,30,1,1
37295,49724,53,16397,53,allow,183,94,89,2,30,1,1
37296,64870,53,42981,53,allow,200,102,98,2,33,1,1
37297,54963,53,11032,53,allow,210,110,100,2,30,1,1
37298,36677,443,38465,443,allow,712,374,338,11,26,6,5
37299,49141,443,32844,443,allow,2595,1230,1365,18,16,9,9
37300,59970,443,20638,443,allow,7448,1347,6101,24,16,13,11
37301,50534,80,11143,80,allow,318,192,126,6,25,4,2
37302,56432,80,52279,80,allow,17128,1499,15629,24,25,9,15
37303,50463,80,63271,80,allow,214,140,74,4,15,3,1
37304,49713,53,39823,53,allow,184,94,90,2,30,1,1
37305,50549,80,64687,80,allow,378,192,186,7,21,4,3
37306,50548,80,23213,80,allow,378,192,186,7,21,4,3
37307,56560,53,11515,53,allow,198,102,96,2,31,1,1
37308,64859,53,38916,53,allow,385,134,251,2,30,1,1
37309,41776,443,58103,443,allow,3196404,47816,3148588,2668,147,469,2199
37310,54936,80,14845,80,allow,613,539,74,7,15,6,1
37311,55934,53,17194,53,allow,182,102,80,2,30,1,1
37312,59932,443,3310,443,allow,6065,1772,4293,27,1587,15,12
37313,65395,53,34335,53,allow,754,94,660,2,30,1,1
37314,59962,443,64092,443,allow,19201,1566,17635,34,16,16,18
37315,64903,53,57537,53,allow,210,110,100,2,30,1,1
37316,49451,53,64804,53,allow,211,102,109,2,30,1,1
37317,63982,53,27288,53,allow,244,94,150,2,30,1,1
37318,44922,443,33552,443,allow,5578,764,4814,14,15,8,6
37319,64903,53,16364,53,allow,210,110,100,2,30,1,1
37320,64870,53,51566,53,allow,200,102,98,2,30,1,1
37321,50536,80,24703,80,allow,24166,3105,21061,31,24,12,19
37322,64718,53,52565,53,allow,781,94,687,2,30,1,1
37323,57043,53,58233,53,allow,166,86,80,2,30,1,1
37324,63951,53,11656,53,allow,193,102,91,2,30,1,1
37325,64697,53,13382,53,allow,199,102,97,2,30,1,1
37326,55678,53,49821,53,allow,270,88,182,4,54,2,2
37327,56015,53,29304,53,allow,195,102,93,2,30,1,1
37328,52145,443,2383,443,allow,190,70,120,4,15,2,2
37329,65340,53,54833,53,allow,313,110,203,4,33,2,2
37330,59958,443,39480,443,allow,2303,1334,969,18,16,10,8
37331,59974,443,8585,443,allow,7820,1344,6476,24,16,13,11
37332,42154,80,50458,80,allow,73277,3302,69975,102,16,52,50
37333,59964,443,8853,443,allow,166170,5611,160559,189,16,78,111
37334,50547,80,14282,80,allow,378,192,186,7,21,4,3
37335,53691,11528,36171,11528,allow,492,306,186,8,16,5,3
37336,56758,53,14411,53,allow,165,86,79,2,30,1,1
37337,56601,53,17234,53,allow,177,94,83,2,30,1,1
37338,64633,53,57902,53,allow,231,110,121,2,30,1,1
37339,56779,53,27714,53,allow,165,86,79,2,30,1,1
37340,49502,53,58398,53,allow,193,102,91,2,30,1,1
37341,56601,53,46710,53,allow,177,94,83,2,30,1,1
37342,49891,53,31414,53,allow,243,94,149,2,30,1,1
37343,1930,80,62505,80,allow,214,140,74,4,15,3,1
37344,64664,53,7997,53,allow,168,86,82,2,32,1,1
37345,53136,41442,55511,41442,allow,70,70,0,1,5,1,0
37346,5238,36298,39762,36298,allow,179518,128,179390,173,37,3,170
37347,50532,80,48066,80,allow,4561,2110,2451,15,26,9,6
37348,57335,53,58927,53,allow,177,94,83,2,30,1,1
37349,57335,53,28128,53,allow,185,102,83,2,30,1,1
37350,37479,53,37479,53,allow,214,82,132,2,30,1,1
37351,55745,53,20797,53,allow,199,102,97,2,30,1,1
37352,59454,53,0,0,allow,86,86,0,1,30,1,0
37353,54963,53,23635,53,allow,210,110,100,2,30,1,1
37354,52073,443,26285,443,allow,22714,21388,1326,33,30,22,11
37355,14435,443,15912,443,allow,2569,1470,1099,17,15,8,9
37356,55678,53,55305,53,allow,270,88,182,4,54,2,2
37357,38680,443,52567,443,allow,90091,3481,86610,95,15,31,64
37358,56115,53,38646,53,allow,278,96,182,4,54,2,2
37359,33609,443,62063,443,allow,9348,1018,8330,22,256,11,11
37360,49655,443,28580,443,allow,50533,7291,43242,74,61,34,40
37361,38678,443,20008,443,allow,380978,8857,372121,373,16,115,258
37362,53697,6224,22057,6224,allow,70,70,0,1,4,1,0
37363,33611,443,49502,443,allow,9490,1158,8332,24,256,13,11
37364,49295,53,60133,53,allow,194,102,92,2,32,1,1
37365,50700,80,4259,80,allow,417,417,0,4,9,4,0
37366,59960,443,41281,443,allow,1953,1223,730,16,16,9,7
37367,43146,80,15239,80,allow,1102,545,557,10,16,6,4
37368,45472,443,53386,443,allow,1568,759,809,17,43,9,8
37369,35832,443,34150,443,allow,9276,1884,7392,23,32,13,10
37370,45470,443,49980,443,allow,1636,827,809,18,43,10,8
37371,59972,443,22705,443,allow,7152,1299,5853,22,16,12,10
37372,46728,443,17105,443,allow,7087,746,6341,16,15,9,7
37373,59956,443,50575,443,allow,2162,1113,1049,18,16,10,8
37374,35810,443,45947,443,allow,9276,1884,7392,23,94,13,10
37375,49127,53,16761,53,allow,199,94,105,2,29,1,1
37376,41775,443,57658,443,allow,7036547,93047,6943500,5816,186,995,4821
37377,65499,53,38166,53,allow,166,86,80,2,29,1,1
37378,64533,53,56786,53,allow,183,102,81,2,29,1,1
37379,65147,53,20335,53,allow,194,102,92,2,29,1,1
37380,41781,443,5729,443,allow,1820,1101,719,18,82,10,8
37381,55678,53,29354,53,allow,270,88,182,4,53,2,2
37382,64533,53,56074,53,allow,183,102,81,2,29,1,1
37383,55513,53,52238,53,allow,184,94,90,2,29,1,1
37384,55010,53,42242,53,allow,195,102,93,2,29,1,1
37385,47766,53,58844,53,allow,164,78,86,2,29,1,1
37386,64885,53,4392,53,allow,166,86,80,2,29,1,1
37387,65398,53,64087,53,allow,811,94,717,2,29,1,1
37388,33794,53,45704,53,allow,168,78,90,2,29,1,1
37389,55778,53,21245,53,allow,189,102,87,2,29,1,1
37390,65180,53,3585,53,allow,165,86,79,2,29,1,1
37391,56866,53,6471,53,allow,194,102,92,2,30,1,1
37392,39684,80,40129,80,allow,680,70,610,11,392,2,9
37393,50446,443,25780,443,allow,5471,2089,3382,17,121,8,9
37394,50265,31101,44674,31101,allow,150,150,0,1,1200,1,0
37395,64697,53,51206,53,allow,199,102,97,2,30,1,1
37396,49708,53,46475,53,allow,193,102,91,2,30,1,1
37397,65058,53,6038,53,allow,249,94,155,2,30,1,1
37398,49933,53,6937,53,allow,178,94,84,2,31,1,1
37399,55570,53,44028,53,allow,168,86,82,2,31,1,1
37400,34630,443,65434,443,allow,12120,5747,6373,22,120,10,12
37401,35601,443,47260,443,allow,6419,995,5424,21,360,11,10
37402,30188,14991,3855,14991,allow,501,150,351,2,1200,1,1
37403,57239,53,64762,53,allow,193,102,91,2,31,1,1
37404,55146,53,42848,53,allow,181,94,87,2,30,1,1
37405,59936,443,30573,443,allow,10879,3057,7822,38,32,21,17
37406,35579,443,33211,443,allow,130,70,60,2,15,1,1
37407,51906,17491,64843,17491,allow,70,70,0,2,8,2,0
37408,65488,443,64323,443,allow,92286,4799,87487,107,16,43,64
37409,56668,53,7163,53,allow,199,102,97,2,30,1,1
37410,56668,53,30534,53,allow,199,102,97,2,30,1,1
37411,49411,53,20667,53,allow,195,102,93,2,30,1,1
37412,55673,53,41151,53,allow,179,94,85,2,30,1,1
37413,49724,53,47705,53,allow,183,94,89,2,30,1,1
37414,34744,443,31137,443,allow,13175,2432,10743,52,3587,23,29
37415,50265,18417,40558,18417,allow,7282,4118,3164,57,1696,35,22
37416,51967,443,12004,443,allow,21063,13499,7564,47,68,25,22
37417,65340,53,38317,53,allow,313,110,203,4,33,2,2
37418,64614,53,45879,53,allow,616,188,428,6,35,3,3
37419,58497,443,60144,443,allow,1640,831,809,18,43,10,8
37420,53714,443,14989,443,allow,9842,4572,5270,22,76,12,10
37421,50587,80,51672,80,allow,378,192,186,7,20,4,3
37422,58492,443,51321,443,allow,5611,1560,4051,22,266,13,9
37423,51978,80,13488,80,allow,24474,2101,22373,38,48,19,19
37424,41779,443,29003,443,allow,618072,8505,609567,523,87,90,433
37425,56668,53,43075,53,allow,199,102,97,2,30,1,1
37426,49564,53,57263,53,allow,168,78,90,2,30,1,1
37427,55851,53,30574,53,allow,183,102,81,2,30,1,1
37428,49436,53,51466,53,allow,765,102,663,2,30,1,1
37429,56866,53,52471,53,allow,194,102,92,2,30,1,1
37430,50015,53,0,0,allow,234,86,148,2,30,1,1
37431,49708,53,49250,53,allow,193,102,91,2,30,1,1
37432,65315,53,23256,53,allow,178,94,84,2,30,1,1
37433,49708,53,50223,53,allow,193,102,91,2,30,1,1
37434,49724,53,13142,53,allow,183,94,89,2,30,1,1
37435,50810,443,16412,443,allow,10682,4653,6029,28,33,15,13
37436,59966,443,53241,443,allow,7165,1312,5853,22,16,12,10
37437,41784,443,54389,443,allow,20365,2035,18330,36,15,17,19
37438,65487,443,56960,443,allow,413465,12290,401175,427,16,150,277
37439,56859,32185,46564,32185,allow,70,70,0,1,5,1,0
37440,54631,443,8589,443,allow,130,70,60,3,5,2,1
37441,60474,53,36065,53,allow,195,94,101,2,30,1,1
37442,56779,53,5601,53,allow,173,94,79,2,30,1,1
37443,55745,53,56029,53,allow,199,102,97,2,30,1,1
37444,50237,53,33615,53,allow,183,94,89,2,30,1,1
37445,42041,443,41646,443,allow,2351,1546,805,20,54,11,9
37446,64697,53,40381,53,allow,199,102,97,2,30,1,1
37447,55146,53,47251,53,allow,181,94,87,2,30,1,1
37448,55786,53,7570,53,allow,193,102,91,2,30,1,1
37449,54963,53,30866,53,allow,210,110,100,2,30,1,1
37450,49431,53,23067,53,allow,353,94,259,2,30,1,1
37451,64155,53,25938,53,allow,183,94,89,2,30,1,1
37452,37469,53,51680,53,allow,168,78,90,2,30,1,1
37453,56304,53,49255,53,allow,184,94,90,2,30,1,1
37454,48954,53,0,0,allow,86,86,0,1,30,1,0
37455,60591,53,16493,53,allow,218,78,140,2,31,1,1
37456,56601,53,1857,53,allow,177,94,83,2,31,1,1
37457,49411,53,10560,53,allow,195,102,93,2,31,1,1
37458,57043,53,5336,53,allow,166,86,80,2,31,1,1
37459,56542,53,15813,53,allow,183,94,89,2,30,1,1
37460,65028,53,59262,53,allow,183,94,89,2,31,1,1
37461,49398,53,12765,53,allow,226,86,140,2,31,1,1
37462,57432,53,10564,53,allow,193,102,91,2,31,1,1
37463,49456,53,42586,53,allow,199,102,97,2,31,1,1
37464,59906,443,52197,443,allow,13657,5248,8409,33,171,17,16
37465,55673,53,34197,53,allow,179,94,85,2,31,1,1
37466,55365,53,47603,53,allow,184,94,90,2,31,1,1
37467,49952,53,65134,53,allow,195,102,93,2,31,1,1
37468,56587,53,8172,53,allow,184,94,90,2,31,1,1
37469,55748,53,53147,53,allow,194,102,92,2,31,1,1
37470,54990,53,13608,53,allow,168,86,82,2,31,1,1
37471,50458,443,34106,443,allow,44532,3294,41238,56,128,21,35
37472,64302,53,55170,53,allow,258,94,164,2,31,1,1
37473,6882,51508,23505,51508,allow,238,118,120,2,1200,1,1
37474,55636,443,29047,443,allow,13506,5979,7527,39,127,20,19
37475,58877,53,28014,53,allow,426,118,308,2,31,1,1
37476,64884,53,27376,53,allow,195,102,93,2,31,1,1
37477,56542,53,32612,53,allow,183,94,89,2,31,1,1
37478,54681,443,46461,443,allow,4417,2187,2230,16,135,8,8
37479,57470,15870,28583,15870,allow,149,149,0,2,1199,2,0
37480,37965,27261,16872,27261,allow,150,150,0,1,1199,1,0
37481,38679,443,29452,443,allow,484912,17317,467595,550,16,229,321
37482,58210,443,60868,443,allow,14898,12644,2254,32,316,18,14
37483,4567,80,4567,80,allow,23456,1005,22451,32,16,13,19
37484,55652,443,58286,443,allow,6672,2258,4414,19,16,10,9
37485,49532,53,59388,53,allow,331,92,239,4,40,2,2
37486,49392,53,35647,53,allow,398,93,305,4,45,2,2
37487,57810,80,62948,80,allow,104397,8436,95961,122,21,49,73
37488,59697,80,58873,80,allow,5326946,116544,5210402,5175,111,1695,3480
37489,50278,443,27147,443,allow,259911,11421,248490,336,92,144,192
37490,56719,80,46763,80,allow,1462,703,759,8,16,5,3
37491,63878,50829,35363,50829,allow,70,70,0,1,5,1,0
37492,52146,80,22638,80,allow,1868,1374,494,12,16,7,5
37493,62748,445,0,0,drop,70,70,0,1,0,1,0
37494,48706,23393,0,0,deny,60,60,0,1,0,1,0
37495,1441,51221,0,0,deny,62,62,0,1,0,1,0
37496,58154,445,0,0,drop,66,66,0,1,0,1,0
37497,62088,56205,0,0,deny,66,66,0,1,0,1,0
37498,57873,445,0,0,drop,70,70,0,1,0,1,0
37499,44923,23,0,0,deny,60,60,0,1,0,1,0
37500,57871,445,0,0,drop,70,70,0,1,0,1,0
37501,57869,445,0,0,drop,70,70,0,1,0,1,0
37502,58146,445,0,0,drop,66,66,0,1,0,1,0
37503,61242,35253,0,0,deny,62,62,0,1,0,1,0
37504,62736,445,0,0,drop,70,70,0,1,0,1,0
37505,59364,44847,0,0,deny,62,62,0,1,0,1,0
37506,50798,36237,0,0,deny,146,146,0,1,0,1,0
37507,53656,31573,0,0,deny,66,66,0,1,0,1,0
37508,58143,445,0,0,drop,66,66,0,1,0,1,0
37509,43350,58414,0,0,deny,66,66,0,1,0,1,0
37510,49977,57470,0,0,deny,62,62,0,1,0,1,0
37511,58255,50584,0,0,deny,62,62,0,1,0,1,0
37512,9687,57470,0,0,deny,78,78,0,1,0,1,0
37513,57862,445,0,0,drop,70,70,0,1,0,1,0
37514,1629,64147,0,0,deny,146,146,0,1,0,1,0
37515,58135,445,0,0,drop,66,66,0,1,0,1,0
37516,57860,445,0,0,drop,70,70,0,1,0,1,0
37517,57874,26467,0,0,deny,62,62,0,1,0,1,0
37518,58127,445,0,0,drop,66,66,0,1,0,1,0
37519,60855,35440,0,0,deny,66,66,0,1,0,1,0
37520,16215,6881,0,0,deny,146,146,0,1,0,1,0
37521,57859,445,0,0,drop,70,70,0,1,0,1,0
37522,15180,26467,0,0,deny,62,62,0,1,0,1,0
37523,16522,26467,0,0,deny,66,66,0,1,0,1,0
37524,57858,445,0,0,drop,70,70,0,1,0,1,0
37525,57857,445,0,0,drop,70,70,0,1,0,1,0
37526,1024,60043,0,0,deny,145,145,0,1,0,1,0
37527,57855,445,0,0,drop,70,70,0,1,0,1,0
37528,57851,445,0,0,drop,70,70,0,1,0,1,0
37529,33502,5529,0,0,deny,143,143,0,1,0,1,0
37530,11478,51221,0,0,deny,66,66,0,1,0,1,0
37531,62029,22114,0,0,deny,66,66,0,1,0,1,0
37532,62728,445,0,0,drop,70,70,0,1,0,1,0
37533,62725,445,0,0,drop,70,70,0,1,0,1,0
37534,62724,445,0,0,drop,70,70,0,1,0,1,0
37535,58121,445,0,0,drop,66,66,0,1,0,1,0
37536,58120,445,0,0,drop,66,66,0,1,0,1,0
37537,58117,445,0,0,drop,66,66,0,1,0,1,0
37538,58116,445,0,0,drop,66,66,0,1,0,1,0
37539,58118,445,0,0,drop,66,66,0,1,0,1,0
37540,58119,445,0,0,drop,66,66,0,1,0,1,0
37541,58114,445,0,0,drop,66,66,0,1,0,1,0
37542,58113,445,0,0,drop,66,66,0,1,0,1,0
37543,47910,7454,0,0,deny,60,60,0,1,0,1,0
37544,57839,445,0,0,drop,70,70,0,1,0,1,0
37545,1038,37965,0,0,deny,62,62,0,1,0,1,0
37546,57838,445,0,0,drop,70,70,0,1,0,1,0
37547,57834,445,0,0,drop,70,70,0,1,0,1,0
37548,57829,445,0,0,drop,70,70,0,1,0,1,0
37549,57828,445,0,0,drop,70,70,0,1,0,1,0
37550,52018,57866,0,0,deny,66,66,0,1,0,1,0
37551,41840,50584,0,0,deny,66,66,0,1,0,1,0
37552,58672,43890,0,0,deny,62,62,0,1,0,1,0
37553,65494,53,0,0,deny,88,88,0,1,0,1,0
37554,5688,44847,0,0,deny,66,66,0,1,0,1,0
37555,46859,50584,0,0,deny,62,62,0,1,0,1,0
37556,18001,35440,0,0,deny,146,146,0,1,0,1,0
37557,19245,64147,0,0,deny,62,62,0,1,0,1,0
37558,53667,56205,0,0,deny,62,62,0,1,0,1,0
37559,27898,52700,0,0,deny,62,62,0,1,0,1,0
37560,62721,445,0,0,drop,70,70,0,1,0,1,0
37561,62714,445,0,0,drop,70,70,0,1,0,1,0
37562,62709,445,0,0,drop,70,70,0,1,0,1,0
37563,62707,445,0,0,drop,70,70,0,1,0,1,0
37564,52989,51505,0,0,deny,66,66,0,1,0,1,0
37565,2691,64147,0,0,deny,62,62,0,1,0,1,0
37566,65515,22114,0,0,deny,62,62,0,1,0,1,0
37567,57817,445,0,0,drop,70,70,0,1,0,1,0
37568,58101,445,0,0,drop,66,66,0,1,0,1,0
37569,58099,445,0,0,drop,66,66,0,1,0,1,0
37570,58098,445,0,0,drop,66,66,0,1,0,1,0
37571,62704,445,0,0,drop,70,70,0,1,0,1,0
37572,7968,2767,0,0,deny,66,66,0,1,0,1,0
37573,62699,445,0,0,drop,70,70,0,1,0,1,0
37574,62693,445,0,0,drop,70,70,0,1,0,1,0
37575,62697,445,0,0,drop,70,70,0,1,0,1,0
37576,57813,445,0,0,drop,70,70,0,1,0,1,0
37577,54552,64147,0,0,deny,62,62,0,1,0,1,0
37578,57802,445,0,0,drop,70,70,0,1,0,1,0
37579,57803,445,0,0,drop,70,70,0,1,0,1,0
37580,57801,445,0,0,drop,70,70,0,1,0,1,0
37581,20409,23,0,0,deny,60,60,0,1,0,1,0
37582,62765,16933,0,0,deny,66,66,0,1,0,1,0
37583,57798,445,0,0,drop,70,70,0,1,0,1,0
37584,13287,16933,0,0,deny,62,62,0,1,0,1,0
37585,52537,37965,0,0,deny,66,66,0,1,0,1,0
37586,57797,445,0,0,drop,70,70,0,1,0,1,0
37587,52711,37965,0,0,deny,62,62,0,1,0,1,0
37588,52740,51505,0,0,deny,66,66,0,1,0,1,0
37589,62686,445,0,0,drop,70,70,0,1,0,1,0
37590,62685,445,0,0,drop,70,70,0,1,0,1,0
37591,62680,445,0,0,drop,70,70,0,1,0,1,0
37592,15875,50584,0,0,deny,62,62,0,1,0,1,0
37593,24288,23,0,0,deny,60,60,0,1,0,1,0
37594,45682,37965,0,0,deny,62,62,0,1,0,1,0
37595,57790,445,0,0,drop,70,70,0,1,0,1,0
37596,49622,50584,0,0,deny,62,62,0,1,0,1,0
37597,53218,56205,0,0,deny,66,66,0,1,0,1,0
37598,63027,35440,0,0,deny,66,66,0,1,0,1,0
37599,18750,57866,0,0,deny,146,146,0,1,0,1,0
37600,35722,30188,0,0,deny,62,62,0,1,0,1,0
37601,0,0,0,0,allow,156,156,0,2,0,2,0
37602,0,0,0,0,allow,244,244,0,2,0,2,0
37603,53966,57470,0,0,deny,62,62,0,1,0,1,0
37604,58079,445,0,0,drop,66,66,0,1,0,1,0
37605,62679,445,0,0,drop,70,70,0,1,0,1,0
37606,62678,445,0,0,drop,70,70,0,1,0,1,0
37607,57783,445,0,0,drop,70,70,0,1,0,1,0
37608,57781,445,0,0,drop,70,70,0,1,0,1,0
37609,56186,57470,0,0,deny,62,62,0,1,0,1,0
37610,52976,31573,0,0,deny,62,62,0,1,0,1,0
37611,59147,51505,0,0,deny,66,66,0,1,0,1,0
37612,18472,5278,0,0,deny,145,145,0,1,0,1,0
37613,26758,50584,0,0,deny,66,66,0,1,0,1,0
37614,52836,36829,0,0,deny,66,66,0,1,0,1,0
37615,57239,161,0,0,deny,82,82,0,1,0,1,0
37616,57239,161,0,0,deny,85,85,0,1,0,1,0
37617,55375,44847,0,0,deny,62,62,0,1,0,1,0
37618,58072,445,0,0,drop,66,66,0,1,0,1,0
37619,58069,445,0,0,drop,66,66,0,1,0,1,0
37620,10036,44847,0,0,deny,66,66,0,1,0,1,0
37621,59095,57470,0,0,deny,66,66,0,1,0,1,0
37622,4876,42920,0,0,deny,146,146,0,1,0,1,0
37623,35558,15503,0,0,deny,66,66,0,1,0,1,0
37624,61147,22114,0,0,deny,66,66,0,1,0,1,0
37625,57777,445,0,0,drop,70,70,0,1,0,1,0
37626,57775,445,0,0,drop,70,70,0,1,0,1,0
37627,8536,37965,0,0,deny,62,62,0,1,0,1,0
37628,51300,64147,0,0,deny,66,66,0,1,0,1,0
37629,33908,48983,0,0,deny,145,145,0,1,0,1,0
37630,61744,11392,0,0,deny,66,66,0,1,0,1,0
37631,62668,445,0,0,drop,70,70,0,1,0,1,0
37632,49001,40108,0,0,deny,161,161,0,1,0,1,0
37633,62662,445,0,0,drop,70,70,0,1,0,1,0
37634,62658,445,0,0,drop,70,70,0,1,0,1,0
37635,62655,445,0,0,drop,70,70,0,1,0,1,0
37636,59985,57470,0,0,deny,66,66,0,1,0,1,0
37637,61278,56205,0,0,deny,66,66,0,1,0,1,0
37638,58068,445,0,0,drop,66,66,0,1,0,1,0
37639,57771,445,0,0,drop,70,70,0,1,0,1,0
37640,51185,37965,0,0,deny,66,66,0,1,0,1,0
37641,45908,33330,0,0,deny,60,60,0,1,0,1,0
37642,58059,445,0,0,drop,66,66,0,1,0,1,0
37643,58060,445,0,0,drop,66,66,0,1,0,1,0
37644,58054,445,0,0,drop,66,66,0,1,0,1,0
37645,58058,445,0,0,drop,66,66,0,1,0,1,0
37646,58057,445,0,0,drop,66,66,0,1,0,1,0
37647,58056,445,0,0,drop,66,66,0,1,0,1,0
37648,58053,445,0,0,drop,66,66,0,1,0,1,0
37649,57770,445,0,0,drop,70,70,0,1,0,1,0
37650,62651,445,0,0,drop,70,70,0,1,0,1,0
37651,62649,445,0,0,drop,70,70,0,1,0,1,0
37652,62648,445,0,0,drop,70,70,0,1,0,1,0
37653,62645,445,0,0,drop,70,70,0,1,0,1,0
37654,57765,445,0,0,drop,70,70,0,1,0,1,0
37655,60335,443,9738,443,allow,1853,1214,639,18,77,11,7
37656,53137,35111,13746,35111,allow,70,70,0,2,8,2,0
37657,60241,80,52293,80,allow,29924,6743,23181,37,150,16,21
37658,60332,443,37835,443,allow,5413,3344,2069,32,87,16,16
37659,50574,443,63021,443,allow,7352,1023,6329,19,16,11,8
37660,47089,15000,57898,15000,allow,138,78,60,2,5,1,1
37661,57296,53,27311,53,allow,771,101,670,2,30,1,1
37662,58917,53,38602,53,allow,192,82,110,2,30,1,1
37663,59905,443,11259,443,allow,343,163,180,6,15,3,3
37664,57239,53,63537,53,allow,186,95,91,2,31,1,1
37665,55447,53,15473,53,allow,1449,108,1341,4,33,2,2
37666,60259,443,51277,443,allow,3285,2009,1276,26,150,16,10
37667,60244,443,61797,443,allow,17829,9658,8171,92,150,46,46
37668,60235,443,27735,443,allow,7990,1730,6260,25,151,13,12
37669,60242,80,7986,80,allow,1493,737,756,11,150,6,5
37670,64884,53,2199,53,allow,190,97,93,2,31,1,1
37671,63934,53,45085,53,allow,202,103,99,2,30,1,1
37672,65218,53,11039,53,allow,188,96,92,2,30,1,1
37673,6649,80,6649,80,allow,103631,2766,100865,110,39,38,72
37674,56942,443,55057,443,allow,8172,2656,5516,29,330,15,14
37675,51886,35965,55520,35965,allow,66,66,0,1,5,1,0
37676,50573,443,27732,443,allow,7282,953,6329,18,16,10,8
37677,60304,443,14746,443,allow,3982,2461,1521,28,144,14,14
37678,50576,443,29225,443,allow,7282,953,6329,18,16,10,8
37679,60262,443,35496,443,allow,6627,1780,4847,23,149,13,10
37680,19648,7000,19648,7000,allow,3610,2043,1567,16,15,9,7
37681,60300,80,12014,80,allow,1343,846,497,11,145,6,5
37682,60208,80,42230,80,allow,1313,738,575,10,152,6,4
37683,60263,443,35248,443,allow,5889,2893,2996,45,149,24,21
37684,60225,443,43705,443,allow,8989,3335,5654,65,152,31,34
37685,59993,80,25071,80,allow,1883,1263,620,11,83,6,5
37686,65028,53,18830,53,allow,182,93,89,2,30,1,1
37687,64583,53,25231,53,allow,174,89,85,2,30,1,1
37688,49611,53,14294,53,allow,184,94,90,2,30,1,1
37689,63910,53,63969,53,allow,178,75,103,2,30,1,1
37690,49456,53,39013,53,allow,198,101,97,2,31,1,1
37691,54990,53,8264,53,allow,168,86,82,2,31,1,1
37692,65315,53,47241,53,allow,767,102,665,2,31,1,1
37693,56115,53,48441,53,allow,278,96,182,4,54,2,2
37694,49543,80,13855,80,allow,1548,847,701,10,15,5,5
37695,64989,53,11063,53,allow,578,286,292,9,15,5,4
37696,65382,53,48645,53,allow,301,108,193,4,55,2,2
37697,53133,34853,20354,34853,allow,758,320,438,11,16,6,5
37698,46327,25903,54070,25903,allow,134,64,70,2,10,1,1
37699,51908,38446,5874,38446,allow,316,136,180,6,6,3,3
37700,60258,80,44486,80,allow,3348,2437,911,12,150,7,5
37701,60331,443,58220,443,allow,1867,1228,639,18,87,11,7
37702,60224,443,54670,443,allow,9079,3570,5509,68,152,34,34
37703,60209,443,58823,443,allow,26423,2338,24085,50,152,24,26
37704,60305,80,11406,80,allow,4419,3852,567,15,144,8,7
37705,60270,80,22290,80,allow,1528,946,582,11,149,6,5
37706,52010,53,28769,53,allow,218,85,133,2,30,1,1
37707,55929,53,16714,53,allow,760,97,663,2,30,1,1
37708,55742,53,3708,53,allow,780,93,687,2,30,1,1
37709,50938,53,64544,53,allow,209,81,128,2,30,1,1
37710,52501,53,50653,53,allow,201,80,121,2,30,1,1
37711,49952,53,50731,53,allow,190,97,93,2,30,1,1
37712,52648,443,16992,443,allow,64748,15327,49421,87,273,39,48
37713,55395,53,45676,53,allow,767,102,665,2,31,1,1
37714,55748,53,59262,53,allow,188,96,92,2,31,1,1
37715,56587,53,5530,53,allow,184,94,90,2,31,1,1
37716,55605,53,8091,53,allow,190,97,93,2,31,1,1
37717,48817,6889,48817,6889,allow,1283,666,617,6,1200,3,3
37718,45980,443,15108,443,allow,9611,2412,7199,44,20,22,22
37719,57912,53,13801,53,allow,295,77,218,2,30,1,1
37720,55294,53,48651,53,allow,295,101,194,4,30,2,2
37721,64811,53,5466,53,allow,190,97,93,2,31,1,1
37722,49999,53,5056,53,allow,178,91,87,2,31,1,1
37723,65496,53,42568,53,allow,96,96,0,1,31,1,0
37724,38892,443,57044,443,allow,83444,15305,68139,121,148,51,70
37725,55451,53,63000,53,allow,751,95,656,2,30,1,1
37726,63950,53,13148,53,allow,200,102,98,2,31,1,1
37727,55619,53,10755,53,allow,182,93,89,2,31,1,1
37728,64707,53,28396,53,allow,757,98,659,2,31,1,1
37729,55950,53,65022,53,allow,752,93,659,2,31,1,1
37730,65209,53,6472,53,allow,164,84,80,2,31,1,1
37731,56813,53,41752,53,allow,753,96,657,2,31,1,1
37732,55310,53,30986,53,allow,176,90,86,2,31,1,1
37733,55076,53,45529,53,allow,182,93,89,2,31,1,1
37734,50516,53,48548,53,allow,772,100,672,2,31,1,1
37735,53259,123,17557,123,allow,184,94,90,2,31,1,1
37736,63930,443,21272,443,allow,2940,669,2271,13,122,6,7
37737,51221,49683,21900,49683,allow,870,330,540,12,1316,6,6
37738,30960,45731,48545,45731,allow,330,330,0,6,3610,6,0
37739,55354,53,26809,53,allow,212,108,104,2,31,1,1
37740,64428,53,57120,53,allow,190,97,93,2,31,1,1
37741,55531,53,35408,53,allow,772,100,672,2,31,1,1
37742,30960,45730,17923,45730,allow,330,330,0,6,3610,6,0
37743,57020,36237,0,0,deny,66,66,0,1,0,1,0
37744,22300,51505,0,0,deny,66,66,0,1,0,1,0
37745,52036,5900,0,0,deny,60,60,0,1,0,1,0
37746,21502,44847,0,0,deny,66,66,0,1,0,1,0
37747,62643,445,0,0,drop,70,70,0,1,0,1,0
37748,62640,445,0,0,drop,70,70,0,1,0,1,0
37749,54992,53,3265,53,allow,195,102,93,2,30,1,1
37750,58263,5223,22492,5223,allow,3721,1173,2548,18,20,11,7
37751,60210,80,21481,80,allow,5141,3706,1435,17,151,10,7
37752,64227,53,32450,53,allow,245,94,151,2,30,1,1
37753,55076,53,43465,53,allow,183,94,89,2,30,1,1
37754,49450,53,29878,53,allow,758,102,656,2,30,1,1
37755,56820,53,17754,53,allow,199,94,105,2,30,1,1
37756,50491,443,13045,443,allow,11995,3850,8145,44,120,23,21
37757,54373,53,8646,53,allow,200,86,114,2,30,1,1
37758,55221,443,65521,443,allow,10435,2860,7575,27,46,15,12
37759,44075,80,12675,80,allow,3560,1256,2304,22,86,10,12
37760,57432,53,35465,53,allow,193,102,91,2,29,1,1
37761,54990,53,17689,53,allow,168,86,82,2,29,1,1
37762,56137,53,49352,53,allow,199,102,97,2,29,1,1
37763,49456,53,3975,53,allow,199,102,97,2,30,1,1
37764,50063,443,44505,443,allow,39888,5010,34878,60,104,32,28
37765,56718,80,40668,80,allow,1462,703,759,8,15,5,3
37766,47262,443,28246,443,allow,4609,763,3846,14,14,8,6
37767,64048,53,63585,53,allow,326,92,234,4,31,2,2
37768,55804,53,21847,53,allow,193,102,91,2,30,1,1
37769,50263,53,23939,53,allow,172,94,78,2,30,1,1
37770,64070,53,45355,53,allow,337,89,248,4,38,2,2
37771,51881,17997,36769,17997,allow,414,136,278,6,16,3,3
37772,63888,6881,1639,6881,allow,66,66,0,2,7,2,0
37773,49593,53,57101,53,allow,212,94,118,2,29,1,1
37774,64583,53,3855,53,allow,179,94,85,2,29,1,1
37775,64167,53,3978,53,allow,211,102,109,2,29,1,1
37776,55165,53,51406,53,allow,193,102,91,2,30,1,1
37777,59666,53,55387,53,allow,497,118,379,2,30,1,1
37778,55165,53,23562,53,allow,193,102,91,2,29,1,1
37779,56803,53,49854,53,allow,195,102,93,2,29,1,1
37780,49501,53,7726,53,allow,734,94,640,2,29,1,1
37781,55865,53,59326,53,allow,196,102,94,2,29,1,1
37782,55745,53,9375,53,allow,199,102,97,2,29,1,1
37783,65349,53,5493,53,allow,284,94,190,2,29,1,1
37784,46949,53,11241,53,allow,168,78,90,2,29,1,1
37785,63934,53,38044,53,allow,209,110,99,2,30,1,1
37786,55865,53,56628,53,allow,196,102,94,2,30,1,1
37787,55313,53,12662,53,allow,168,78,90,2,29,1,1
37788,64428,53,56066,53,allow,195,102,93,2,30,1,1
37789,58034,443,56445,443,allow,4132,2158,1974,35,255,17,18
37790,60230,443,4763,443,allow,1868,1229,639,18,151,11,7
37791,60248,80,33298,80,allow,22768,6548,16220,31,149,14,17
37792,60214,80,20902,80,allow,8317,6126,2191,23,151,14,9
37793,60292,80,43938,80,allow,1462,864,598,11,144,6,5
37794,49761,443,53360,443,allow,36615,5107,31508,108,125,49,59
37795,56489,53,32825,53,allow,178,94,84,2,30,1,1
37796,58654,53,55637,53,allow,168,78,90,2,30,1,1
37797,64155,53,12235,53,allow,183,94,89,2,30,1,1
37798,55378,53,28719,53,allow,277,102,175,2,30,1,1
37799,56481,53,28182,53,allow,816,102,714,2,30,1,1
37800,58768,17,58768,17,allow,66,66,0,1,30,1,0
37801,50363,53,11154,53,allow,214,110,104,2,30,1,1
37802,60246,80,10832,80,allow,17231,6415,10816,26,149,12,14
37803,60256,80,21007,80,allow,3401,2157,1244,12,149,7,5
37804,37549,443,18373,443,allow,203299,6930,196369,231,16,92,139
37805,58379,443,57467,443,allow,24040,4851,19189,86,160,41,45
37806,60299,80,6795,80,allow,1557,778,779,11,144,6,5
37807,60223,80,32982,80,allow,17923,13519,4404,41,151,26,15
37808,47141,443,51949,443,allow,2011,1238,773,16,330,9,7
37809,56115,53,55783,53,allow,278,96,182,4,54,2,2
37810,37009,53,17382,53,allow,78,78,0,1,30,1,0
37811,56948,53,61880,53,allow,183,94,89,2,30,1,1
37812,33027,443,54809,443,allow,3723,2408,1315,28,376,15,13
37813,43222,443,24936,443,allow,2088188,38201,2049987,1829,84,404,1425
37814,58395,53,61283,53,allow,307,86,221,2,30,1,1
37815,55473,53,5965,53,allow,186,102,84,2,30,1,1
37816,55605,53,27341,53,allow,195,102,93,2,30,1,1
37817,56948,53,22387,53,allow,183,94,89,2,30,1,1
37818,60231,443,26634,443,allow,1868,1229,639,18,151,11,7
37819,64739,53,37126,53,allow,193,102,91,2,30,1,1
37820,42348,53,29230,53,allow,199,94,105,2,30,1,1
37821,60217,80,28538,80,allow,21163,16003,5160,47,151,30,17
37822,56489,53,51415,53,allow,178,94,84,2,30,1,1
37823,54302,53,4566,53,allow,168,78,90,2,30,1,1
37824,60207,80,10851,80,allow,3596,2562,1034,14,151,8,6
37825,56304,53,20690,53,allow,184,94,90,2,30,1,1
37826,65004,53,7635,53,allow,261,102,159,2,30,1,1
37827,60293,80,44550,80,allow,1462,864,598,11,144,6,5
37828,55804,53,9951,53,allow,816,102,714,2,30,1,1
37829,6973,80,6973,80,allow,132958,3923,129035,143,38,53,90
37830,56046,53,6511,53,allow,193,102,91,2,31,1,1
37831,60303,443,13935,443,allow,3928,2467,1461,27,144,14,13
37832,60229,443,63895,443,allow,19536,7593,11943,76,151,37,39
37833,60221,80,44120,80,allow,17981,13577,4404,41,151,26,15
37834,60298,443,32921,443,allow,9565,3317,6248,25,144,14,11
37835,60296,80,32377,80,allow,1463,865,598,11,144,6,5
37836,57418,53,56760,53,allow,209,102,107,2,30,1,1
37837,47918,123,27276,123,allow,184,94,90,2,30,1,1
37838,55748,53,60711,53,allow,194,102,92,2,30,1,1
37839,51843,45702,23719,45702,allow,1261,637,624,9,30,5,4
37840,50698,443,13372,443,allow,24575,6565,18010,86,275,32,54
37841,38118,443,46227,443,allow,70,70,0,1,5,1,0
37842,60247,80,40412,80,allow,21505,6581,14924,31,149,14,17
37843,60218,80,20948,80,allow,8268,6054,2214,23,151,14,9
37844,55906,53,30212,53,allow,264,110,154,2,30,1,1
37845,55473,53,63957,53,allow,186,102,84,2,30,1,1
37846,49999,53,61068,53,allow,181,94,87,2,30,1,1
37847,42224,123,27890,123,allow,184,94,90,2,30,1,1
37848,55294,53,35326,53,allow,199,102,97,2,30,1,1
37849,65218,53,38514,53,allow,194,102,92,2,31,1,1
37850,49755,443,49571,443,allow,447301,17016,430285,539,128,196,343
37851,65382,53,33350,53,allow,301,108,193,4,55,2,2
37852,46265,7700,48956,7700,allow,1440,956,484,15,35,8,7
37853,34163,443,6967,443,allow,5035,768,4267,14,15,8,6
37854,47261,443,56817,443,allow,4536,845,3691,16,15,9,7
37855,57595,80,64244,80,allow,2769,1396,1373,11,29,7,4
37856,26805,443,46763,443,allow,7697,2940,4757,25,18,13,12
37857,55226,443,46963,443,allow,8025,3048,4977,23,45,13,10
37858,59627,443,59627,443,allow,4401,1494,2907,19,29,11,8
37859,56496,80,21274,80,allow,458684,19849,438835,488,66,185,303
37860,49967,53,25418,53,allow,193,102,91,2,31,1,1
37861,50125,443,38569,443,allow,15687,3764,11923,32,34,18,14
37862,65340,53,2059,53,allow,313,110,203,4,32,2,2
37863,51904,51883,62551,51883,allow,70,70,0,2,8,2,0
37864,51887,16514,28256,16514,allow,70,70,0,1,5,1,0
37865,63876,5968,40554,5968,allow,70,70,0,1,4,1,0
37866,60238,80,26979,80,allow,1176,701,475,9,150,6,3
37867,60239,443,31265,443,allow,3149,1969,1180,19,150,11,8
37868,60250,443,56947,443,allow,12389,5180,7209,31,149,17,14
37869,60289,80,35170,80,allow,1928,906,1022,11,145,6,5
37870,60220,80,36816,80,allow,21108,15948,5160,47,151,30,17
37871,60301,443,3566,443,allow,7515,2022,5493,21,144,11,10
37872,8662,80,8662,80,allow,194259,7011,187248,211,39,80,131
37873,64583,53,5543,53,allow,426,89,337,4,58,2,2
37874,55786,53,25615,53,allow,816,102,714,2,29,1,1
37875,55448,53,23931,53,allow,184,94,90,2,29,1,1
37876,54635,53,0,0,allow,197,86,111,2,29,1,1
37877,6932,80,6932,80,allow,124405,3747,120658,131,38,46,85
37878,55570,53,24983,53,allow,168,86,82,2,29,1,1
37879,65382,53,24981,53,allow,301,108,193,4,54,2,2
37880,55010,53,35689,53,allow,195,102,93,2,29,1,1
37881,64043,53,22374,53,allow,320,94,226,2,29,1,1
37882,49567,53,36957,53,allow,184,102,82,2,29,1,1
37883,55365,53,10129,53,allow,184,94,90,2,29,1,1
37884,64352,53,14227,53,allow,213,102,111,2,29,1,1
37885,63934,53,32673,53,allow,209,110,99,2,29,1,1
37886,49212,53,34127,53,allow,1188,94,1094,2,29,1,1
37887,49611,53,47629,53,allow,184,94,90,2,29,1,1
37888,64255,53,54651,53,allow,211,102,109,2,30,1,1
37889,55448,53,34800,53,allow,184,94,90,2,29,1,1
37890,49952,53,48831,53,allow,195,102,93,2,30,1,1
37891,56542,53,53986,53,allow,183,94,89,2,29,1,1
37892,56739,53,42182,53,allow,195,102,93,2,30,1,1
37893,56015,53,39973,53,allow,195,102,93,2,30,1,1
37894,56739,53,65216,53,allow,195,102,93,2,30,1,1
37895,64502,53,56214,53,allow,199,102,97,2,30,1,1
37896,54560,53,54560,53,allow,832,106,726,2,30,1,1
37897,55556,53,12940,53,allow,302,78,224,2,30,1,1
37898,64739,53,1998,53,allow,816,102,714,2,30,1,1
37899,49742,53,40944,53,allow,790,110,680,2,30,1,1
37900,56434,53,28860,53,allow,316,94,222,2,30,1,1
37901,50363,53,62670,53,allow,214,110,104,2,30,1,1
37902,55294,53,55276,53,allow,199,102,97,2,30,1,1
37903,49518,53,16482,53,allow,193,102,91,2,30,1,1
37904,56332,443,3765,443,allow,6028,1958,4070,34,124,14,20
37905,38175,443,55489,443,allow,10208,2219,7989,37,125,19,18
37906,37965,51498,7708,51498,allow,158,158,0,1,1199,1,0
37907,55877,53546,37144,53546,allow,481,150,331,2,1200,1,1
37908,60290,80,20522,80,allow,1366,785,581,11,145,6,5
37909,60297,80,29320,80,allow,1463,865,598,11,144,6,5
37910,55650,18073,23998,18073,allow,504,318,186,8,15,5,3
37911,51966,443,48480,443,allow,130,70,60,2,15,1,1
37912,46155,443,27543,443,allow,206090,6478,199612,211,170,69,142
37913,47971,443,15056,443,allow,130,70,60,2,15,1,1
37914,63934,53,27798,53,allow,347,103,244,4,46,2,2
37915,56115,53,39416,53,allow,278,96,182,4,53,2,2
37916,64502,53,21170,53,allow,199,102,97,2,30,1,1
37917,49243,53,10757,53,allow,452,118,334,2,30,1,1
37918,55365,53,26447,53,allow,184,94,90,2,30,1,1
37919,64854,53,19682,53,allow,178,94,84,2,31,1,1
37920,65343,53,2539,53,allow,184,94,90,2,31,1,1
37921,56288,53,3353,53,allow,200,102,98,2,30,1,1
37922,56385,53,62602,53,allow,402,142,260,2,30,1,1
37923,48733,443,64638,443,allow,316457,19287,297170,382,80,157,225
37924,56365,80,15105,80,allow,1636,699,937,10,15,5,5
37925,51903,35904,6046,35904,allow,70,70,0,2,8,2,0
37926,60232,443,3016,443,allow,1868,1229,639,18,151,11,7
37927,60215,80,6497,80,allow,21073,15881,5192,47,151,30,17
37928,60219,80,48945,80,allow,1987,1593,394,10,151,6,4
37929,60245,80,28831,80,allow,14705,6415,8290,26,149,12,14
37930,60249,80,1265,80,allow,31138,6772,24366,40,149,17,23
37931,60294,80,59530,80,allow,1463,865,598,11,144,6,5
37932,49933,53,13874,53,allow,186,102,84,2,30,1,1
37933,54992,53,62120,53,allow,195,102,93,2,30,1,1
37934,63950,53,31406,53,allow,200,102,98,2,30,1,1
37935,57378,53,5726,53,allow,350,94,256,2,30,1,1
37936,49611,53,14406,53,allow,184,94,90,2,30,1,1
37937,56046,53,40264,53,allow,193,102,91,2,30,1,1
37938,37511,443,37511,443,allow,4673,1766,2907,19,26,11,8
37939,64502,53,7896,53,allow,374,101,273,4,42,2,2
37940,50123,443,58250,443,allow,15011,5619,9392,50,35,26,24
37941,60216,80,20321,80,allow,3606,2572,1034,14,151,8,6
37942,60222,80,61233,80,allow,1989,1365,624,11,151,6,5
37943,60284,80,50056,80,allow,1430,754,676,11,146,6,5
37944,7030,80,7030,80,allow,115811,3862,111949,123,38,44,79
37945,49791,53,47745,53,allow,226,94,132,2,30,1,1
37946,40755,123,40939,123,allow,184,94,90,2,30,1,1
37947,36307,53,54070,53,allow,200,86,114,2,30,1,1
37948,52804,443,52702,443,allow,70,70,0,2,154,2,0
37949,55505,53,30588,53,allow,199,102,97,2,31,1,1
37950,54990,53,35409,53,allow,168,86,82,2,31,1,1
37951,56369,53,3077,53,allow,193,102,91,2,31,1,1
37952,59630,443,48650,443,allow,3304,1468,1836,18,139,10,8
37953,56854,17067,53674,17067,allow,70,70,0,2,8,2,0
37954,53135,14297,49248,14297,allow,70,70,0,1,5,1,0
37955,34162,443,17948,443,allow,4897,850,4047,15,15,9,6
37956,60234,80,15861,80,allow,1131,772,359,10,151,6,4
37957,60295,80,60202,80,allow,8876,1061,7815,18,144,9,9
37958,52325,443,28114,443,allow,3188,1601,1587,34,48,18,16
37959,60213,80,54393,80,allow,47483,13980,33503,69,151,35,34
37960,60228,80,30633,80,allow,6854,6211,643,16,151,9,7
37961,9291,80,9291,80,allow,208056,7568,200488,227,39,88,139
37962,57528,53,37207,53,allow,585,192,393,6,54,3,3
37963,57382,53,15348,53,allow,969,86,883,2,30,1,1
37964,55146,53,34694,53,allow,181,94,87,2,30,1,1
37965,64884,53,3518,53,allow,195,102,93,2,30,1,1
37966,56754,53,65237,53,allow,183,94,89,2,30,1,1
37967,63951,53,30484,53,allow,193,102,91,2,30,1,1
37968,65209,53,36498,53,allow,166,86,80,2,30,1,1
37969,57432,53,25990,53,allow,193,102,91,2,30,1,1
37970,64385,53,43683,53,allow,179,94,85,2,30,1,1
37971,56587,53,37194,53,allow,184,94,90,2,30,1,1
37972,55310,53,16833,53,allow,180,94,86,2,30,1,1
37973,56481,53,4723,53,allow,193,102,91,2,30,1,1
37974,64762,53,50554,53,allow,194,102,92,2,30,1,1
37975,55310,53,54071,53,allow,180,94,86,2,30,1,1
37976,49767,53,22379,53,allow,177,94,83,2,31,1,1
37977,36126,53,44357,53,allow,326,78,248,2,31,1,1
37978,50779,443,59788,443,allow,16067,4838,11229,43,121,21,22
37979,60794,443,17248,443,allow,796772,27151,769621,878,137,302,576
37980,46337,443,56368,443,allow,10379011,159069,10219942,8727,252,1321,7406
37981,37965,50321,10306,50321,allow,158,158,0,1,1199,1,0
37982,63950,53,19633,53,allow,200,102,98,2,30,1,1
37983,51607,53,31322,53,allow,296,94,202,2,30,1,1
37984,55619,53,46483,53,allow,183,94,89,2,30,1,1
37985,64132,53,11636,53,allow,179,94,85,2,30,1,1
37986,55866,53,0,0,allow,86,86,0,1,30,1,0
37987,64884,53,55819,53,allow,195,102,93,2,31,1,1
37988,55076,53,14239,53,allow,183,94,89,2,30,1,1
37989,55373,53,47253,53,allow,164,86,78,2,31,1,1
37990,55373,53,29623,53,allow,164,86,78,2,30,1,1
37991,50002,53,11892,53,allow,196,102,94,2,31,1,1
37992,62458,53,43371,53,allow,429,102,327,2,31,1,1
37993,56587,53,64159,53,allow,184,94,90,2,31,1,1
37994,64762,53,20987,53,allow,194,102,92,2,31,1,1
37995,56560,53,21034,53,allow,198,102,96,2,31,1,1
37996,56975,53,65042,53,allow,197,102,95,2,31,1,1
37997,57239,53,14403,53,allow,193,102,91,2,31,1,1
37998,50967,443,6506,443,allow,612314,25589,586725,676,127,234,442
37999,50969,443,44036,443,allow,7221,2265,4956,16,127,7,9
38000,37965,23215,60797,23215,allow,537,158,379,2,1199,1,1
38001,45409,53,56925,53,allow,307,86,221,2,31,1,1
38002,65224,53,24023,53,allow,994,86,908,2,31,1,1
38003,58476,443,24063,443,allow,25370,5607,19763,40,138,18,22
38004,64569,53,2461,53,allow,214,102,112,2,31,1,1
38005,61191,443,24135,443,allow,569471,20976,548495,666,333,273,393
38006,51634,443,38565,443,allow,3174,346,2828,12,121,5,7
38007,42820,443,40301,443,allow,20255,5440,14815,32,122,16,16
38008,37965,51413,17500,51413,allow,848,252,596,4,1199,2,2
38009,43904,443,27046,443,allow,7552,2611,4941,24,360,13,11
38010,40214,443,5611,443,allow,3910,2223,1687,24,3676,8,16
38011,56288,53,26260,53,allow,200,102,98,2,31,1,1
38012,55748,53,57713,53,allow,194,102,92,2,31,1,1
38013,51843,80,51843,80,allow,35384,3225,32159,49,26,20,29
38014,38290,443,29490,443,allow,6978,1169,5809,22,163,12,10
38015,49942,53,42847,53,allow,264,94,170,2,31,1,1
38016,64132,53,36663,53,allow,179,94,85,2,31,1,1
38017,51444,3027,51444,3027,allow,156,156,0,3,8,3,0
38018,65209,53,37823,53,allow,166,86,80,2,31,1,1
38019,51616,443,56570,443,allow,62241,4598,57643,82,170,35,47
38020,51845,80,51845,80,allow,28037,2069,25968,40,26,16,24
38021,63580,443,12197,443,allow,5759,1721,4038,20,78,11,9
38022,62639,445,0,0,drop,70,70,0,1,0,1,0
38023,33627,36237,0,0,deny,66,66,0,1,0,1,0
38024,58043,445,0,0,drop,66,66,0,1,0,1,0
38025,23900,64147,0,0,deny,62,62,0,1,0,1,0
38026,62636,445,0,0,drop,70,70,0,1,0,1,0
38027,33651,36237,0,0,deny,146,146,0,1,0,1,0
38028,4760,44847,0,0,deny,62,62,0,1,0,1,0
38029,32051,37965,0,0,deny,62,62,0,1,0,1,0
38030,58042,445,0,0,drop,66,66,0,1,0,1,0
38031,21179,44847,0,0,deny,146,146,0,1,0,1,0
38032,58040,445,0,0,drop,66,66,0,1,0,1,0
38033,6224,37965,0,0,deny,62,62,0,1,0,1,0
38034,58039,445,0,0,drop,66,66,0,1,0,1,0
38035,27402,37965,0,0,deny,66,66,0,1,0,1,0
38036,58036,445,0,0,drop,66,66,0,1,0,1,0
38037,57752,445,0,0,drop,70,70,0,1,0,1,0
38038,26229,21247,0,0,deny,66,66,0,1,0,1,0
38039,57151,39004,0,0,deny,66,66,0,1,0,1,0
38040,57749,445,0,0,drop,70,70,0,1,0,1,0
38041,62635,445,0,0,drop,70,70,0,1,0,1,0
38042,62625,445,0,0,drop,70,70,0,1,0,1,0
38043,62624,445,0,0,drop,70,70,0,1,0,1,0
38044,31136,50584,0,0,deny,146,146,0,1,0,1,0
38045,61522,64147,0,0,deny,66,66,0,1,0,1,0
38046,37121,21247,0,0,deny,66,66,0,1,0,1,0
38047,26048,21,0,0,deny,60,60,0,1,0,1,0
38048,58026,445,0,0,drop,66,66,0,1,0,1,0
38049,42044,60043,0,0,deny,66,66,0,1,0,1,0
38050,57745,445,0,0,drop,70,70,0,1,0,1,0
38051,43868,23,0,0,deny,60,60,0,1,0,1,0
38052,15333,44847,0,0,deny,62,62,0,1,0,1,0
38053,57743,445,0,0,drop,70,70,0,1,0,1,0
38054,57741,445,0,0,drop,70,70,0,1,0,1,0
38055,58018,445,0,0,drop,66,66,0,1,0,1,0
38056,62608,445,0,0,drop,70,70,0,1,0,1,0
38057,62849,62413,0,0,deny,62,62,0,1,0,1,0
38058,65529,35440,0,0,deny,62,62,0,1,0,1,0
38059,58016,445,0,0,drop,66,66,0,1,0,1,0
38060,57734,445,0,0,drop,70,70,0,1,0,1,0
38061,57732,445,0,0,drop,70,70,0,1,0,1,0
38062,27528,35440,0,0,deny,66,66,0,1,0,1,0
38063,60361,57470,0,0,deny,66,66,0,1,0,1,0
38064,58007,445,0,0,drop,66,66,0,1,0,1,0
38065,56381,51505,0,0,deny,62,62,0,1,0,1,0
38066,5462,21247,0,0,deny,66,66,0,1,0,1,0
38067,57998,445,0,0,drop,66,66,0,1,0,1,0
38068,51401,6881,0,0,deny,66,66,0,1,0,1,0
38069,57731,445,0,0,drop,70,70,0,1,0,1,0
38070,57730,445,0,0,drop,70,70,0,1,0,1,0
38071,57729,445,0,0,drop,70,70,0,1,0,1,0
38072,57726,445,0,0,drop,70,70,0,1,0,1,0
38073,57723,445,0,0,drop,70,70,0,1,0,1,0
38074,31748,56205,0,0,deny,62,62,0,1,0,1,0
38075,30303,30303,0,0,deny,181,181,0,1,0,1,0
38076,49329,443,27397,443,allow,460,394,66,4,0,3,1
38077,57711,445,0,0,drop,70,70,0,1,0,1,0
38078,57710,445,0,0,drop,70,70,0,1,0,1,0
38079,62599,445,0,0,drop,70,70,0,1,0,1,0
38080,62597,445,0,0,drop,70,70,0,1,0,1,0
38081,62596,445,0,0,drop,70,70,0,1,0,1,0
38082,57706,445,0,0,drop,70,70,0,1,0,1,0
38083,48676,53395,0,0,deny,60,60,0,1,0,1,0
38084,64891,22,0,0,deny,60,60,0,1,0,1,0
38085,57993,445,0,0,drop,66,66,0,1,0,1,0
38086,57987,445,0,0,drop,66,66,0,1,0,1,0
38087,57992,445,0,0,drop,66,66,0,1,0,1,0
38088,57988,445,0,0,drop,66,66,0,1,0,1,0
38089,57986,445,0,0,drop,66,66,0,1,0,1,0
38090,57989,445,0,0,drop,66,66,0,1,0,1,0
38091,57985,445,0,0,drop,66,66,0,1,0,1,0
38092,57990,445,0,0,drop,66,66,0,1,0,1,0
38093,57700,445,0,0,drop,70,70,0,1,0,1,0
38094,57701,445,0,0,drop,70,70,0,1,0,1,0
38095,47105,64147,0,0,deny,62,62,0,1,0,1,0
38096,27537,25198,0,0,deny,148,148,0,1,0,1,0
38097,63171,2323,0,0,deny,60,60,0,1,0,1,0
38098,59626,22114,0,0,deny,66,66,0,1,0,1,0
38099,22130,61248,0,0,reset-both,159,159,0,1,0,1,0
38100,56794,46824,0,0,deny,66,66,0,1,0,1,0
38101,48488,50584,0,0,deny,62,62,0,1,0,1,0
38102,58664,64147,0,0,deny,62,62,0,1,0,1,0
38103,19617,39004,0,0,deny,145,145,0,1,0,1,0
38104,50644,35440,0,0,deny,66,66,0,1,0,1,0
38105,61135,50265,0,0,deny,62,62,0,1,0,1,0
38106,57689,445,0,0,drop,70,70,0,1,0,1,0
38107,16760,10214,0,0,deny,62,62,0,1,0,1,0
38108,62595,445,0,0,drop,70,70,0,1,0,1,0
38109,62591,445,0,0,drop,70,70,0,1,0,1,0
38110,62579,445,0,0,drop,70,70,0,1,0,1,0
38111,62581,445,0,0,drop,70,70,0,1,0,1,0
38112,65317,51221,0,0,deny,78,78,0,1,0,1,0
38113,63341,53,0,0,deny,77,77,0,1,0,1,0
38114,41429,50584,0,0,deny,66,66,0,1,0,1,0
38115,57972,445,0,0,drop,66,66,0,1,0,1,0
38116,57973,445,0,0,drop,66,66,0,1,0,1,0
38117,57970,445,0,0,drop,66,66,0,1,0,1,0
38118,46286,21247,0,0,deny,62,62,0,1,0,1,0
38119,38538,22,0,0,deny,60,60,0,1,0,1,0
38120,62577,445,0,0,drop,70,70,0,1,0,1,0
38121,57685,445,0,0,drop,70,70,0,1,0,1,0
38122,47682,64147,0,0,deny,66,66,0,1,0,1,0
38123,62568,445,0,0,drop,70,70,0,1,0,1,0
38124,62570,445,0,0,drop,70,70,0,1,0,1,0
38125,62571,445,0,0,drop,70,70,0,1,0,1,0
38126,14844,37965,0,0,deny,62,62,0,1,0,1,0
38127,12465,11392,0,0,deny,62,62,0,1,0,1,0
38128,57676,445,0,0,drop,70,70,0,1,0,1,0
38129,57673,445,0,0,drop,70,70,0,1,0,1,0
38130,57675,445,0,0,drop,70,70,0,1,0,1,0
38131,6014,37965,0,0,deny,62,62,0,1,0,1,0
38132,57672,445,0,0,drop,70,70,0,1,0,1,0
38133,57669,445,0,0,drop,70,70,0,1,0,1,0
38134,13285,29892,0,0,deny,145,145,0,1,0,1,0
38135,13285,29892,0,0,deny,145,145,0,1,0,1,0
38136,1373,22114,0,0,deny,62,62,0,1,0,1,0
38137,62089,8604,0,0,deny,66,66,0,1,0,1,0
38138,14343,6881,0,0,deny,146,146,0,1,0,1,0
38139,51592,51505,0,0,deny,66,66,0,1,0,1,0
38140,43724,35440,0,0,deny,62,62,0,1,0,1,0
38141,65085,22114,0,0,deny,66,66,0,1,0,1,0
38142,62559,445,0,0,drop,70,70,0,1,0,1,0
38143,62556,445,0,0,drop,70,70,0,1,0,1,0
38144,62552,445,0,0,drop,70,70,0,1,0,1,0
38145,43723,5900,0,0,deny,60,60,0,1,0,1,0
38146,57662,445,0,0,drop,70,70,0,1,0,1,0
38147,30274,23,0,0,deny,60,60,0,1,0,1,0
38148,23126,35440,0,0,deny,62,62,0,1,0,1,0
38149,993,4543,0,0,deny,66,66,0,1,0,1,0
38150,57387,70,0,0,deny,60,60,0,1,0,1,0
38151,49001,40108,0,0,deny,161,161,0,1,0,1,0
38152,57655,445,0,0,drop,70,70,0,1,0,1,0
38153,57653,445,0,0,drop,70,70,0,1,0,1,0
38154,57949,445,0,0,drop,66,66,0,1,0,1,0
38155,5617,64147,0,0,deny,62,62,0,1,0,1,0
38156,62549,445,0,0,drop,70,70,0,1,0,1,0
38157,62548,445,0,0,drop,70,70,0,1,0,1,0
38158,57649,445,0,0,drop,70,70,0,1,0,1,0
38159,57942,445,0,0,drop,66,66,0,1,0,1,0
38160,57941,445,0,0,drop,66,66,0,1,0,1,0
38161,57647,445,0,0,drop,70,70,0,1,0,1,0
38162,12242,51221,0,0,deny,62,62,0,1,0,1,0
38163,993,18732,0,0,deny,129,129,0,1,0,1,0
38164,51581,17546,0,0,deny,66,66,0,1,0,1,0
38165,64762,53,32990,53,allow,188,96,92,2,30,1,1
38166,65343,53,10337,53,allow,184,94,90,2,30,1,1
38167,64132,53,9025,53,allow,174,89,85,2,30,1,1
38168,56369,53,8270,53,allow,186,95,91,2,31,1,1
38169,64327,53,33651,53,allow,204,104,100,2,31,1,1
38170,56288,53,45590,53,allow,200,102,98,2,31,1,1
38171,49558,53,59753,53,allow,186,95,91,2,30,1,1
38172,65386,53,20616,53,allow,762,101,661,2,30,1,1
38173,64385,53,34139,53,allow,174,89,85,2,30,1,1
38174,51885,64546,12386,64546,allow,66,66,0,1,5,1,0
38175,60378,443,48147,443,allow,22073,10774,11299,48,107,26,22
38176,55660,53,37547,53,allow,757,98,659,2,30,1,1
38177,51840,80,51840,80,allow,525257,17273,507984,531,26,183,348
38178,51839,80,51839,80,allow,951054,20747,930307,902,26,276,626
38179,55005,443,32809,443,allow,134,60,74,3,11,2,1
38180,56219,53,32903,53,allow,762,101,661,2,31,1,1
38181,49518,53,63252,53,allow,186,95,91,2,30,1,1
38182,55396,53,1903,53,allow,778,103,675,2,30,1,1
38183,51830,443,51830,443,allow,17899,5015,12884,33,36,14,19
38184,62453,443,7833,443,allow,8698,3272,5426,22,26,11,11
38185,58370,443,50234,443,allow,6277528,124223,6153305,5970,160,1890,4080
38186,55649,42266,57482,42266,allow,70,70,0,1,5,1,0
38187,53134,42369,37708,42369,allow,70,70,0,1,5,1,0
38188,65264,53,54273,53,allow,88,88,0,1,30,1,0
38189,64122,53,44861,53,allow,212,108,104,2,31,1,1
38190,55175,80,55175,80,allow,7452,1052,6400,20,22,11,9
38191,40545,443,53543,443,allow,8691,6945,1746,25,80,14,11
38192,52787,443,46630,443,allow,352,218,134,6,28,4,2
38193,39513,443,6930,443,allow,16012,10450,5562,33,80,18,15
38194,56268,443,24537,443,allow,10226,4435,5791,50,256,24,26
38195,50474,80,50474,80,allow,4994,855,4139,14,21,7,7
38196,51899,47537,54934,47537,allow,70,70,0,2,8,2,0
38197,49273,7000,49273,7000,allow,2163,676,1487,14,15,7,7
38198,49512,443,62361,443,allow,12472,1628,10844,35,195,16,19
38199,65422,53,10168,53,allow,753,96,657,2,30,1,1
38200,64854,53,42024,53,allow,172,88,84,2,30,1,1
38201,64595,53,56793,53,allow,182,93,89,2,30,1,1
38202,49174,53,58915,53,allow,198,101,97,2,30,1,1
38203,64888,60038,0,0,allow,66,66,0,1,91,1,0
38204,51221,63128,42268,63128,allow,480,149,331,2,1201,1,1
38205,56046,53,4218,53,allow,186,95,91,2,31,1,1
38206,49160,50321,21626,50321,allow,150,150,0,2,1200,2,0
38207,56975,53,53582,53,allow,194,99,95,2,30,1,1
38208,50002,53,33820,53,allow,192,98,94,2,31,1,1
38209,56560,53,34693,53,allow,196,100,96,2,31,1,1
38210,49800,53,22865,53,allow,182,93,89,2,31,1,1
38211,49967,53,41633,53,allow,186,95,91,2,31,1,1
38212,55125,53,57418,53,allow,170,87,83,2,31,1,1
38213,49767,53,46615,53,allow,200,102,98,2,31,1,1
38214,57083,53,25967,53,allow,196,100,96,2,31,1,1
38215,56561,53,4757,53,allow,166,85,81,2,31,1,1
38216,49262,53,27998,53,allow,168,86,82,2,31,1,1
38217,65307,53,2186,53,allow,184,94,90,2,31,1,1
38218,55265,53,19057,53,allow,740,93,647,2,31,1,1
38219,49531,53,21298,53,allow,740,93,647,2,31,1,1
38220,15503,42286,2173,42286,allow,480,149,331,2,1200,1,1
38221,58988,443,31183,443,allow,4330,1777,2553,18,122,9,9
38222,56955,53,2081,53,allow,182,93,89,2,31,1,1
38223,55760,53,53617,53,allow,180,92,88,2,31,1,1
38224,49752,53,46099,53,allow,180,92,88,2,31,1,1
38225,54351,443,26403,443,allow,7900,2042,5858,27,36,15,12
38226,50557,53,32584,53,allow,758,93,665,2,31,1,1
38227,56589,53,29325,53,allow,198,101,97,2,31,1,1
38228,35608,443,39608,443,allow,5007,3053,1954,24,394,8,16
38229,62670,443,51023,443,allow,6179,3326,2853,26,186,12,14
38230,44884,443,19838,443,allow,36435,28844,7591,65,396,35,30
38231,59242,443,7294,443,allow,7192,2002,5190,24,360,11,13
38232,57643,445,0,0,drop,70,70,0,1,0,1,0
38233,6889,48817,0,0,deny,143,143,0,1,0,1,0
38234,62528,445,0,0,drop,70,70,0,1,0,1,0
38235,62530,445,0,0,drop,70,70,0,1,0,1,0
38236,62527,445,0,0,drop,70,70,0,1,0,1,0
38237,32342,62413,0,0,deny,66,66,0,1,0,1,0
38238,55733,51505,0,0,deny,66,66,0,1,0,1,0
38239,57937,445,0,0,drop,66,66,0,1,0,1,0
38240,53971,50265,0,0,deny,66,66,0,1,0,1,0
38241,57642,445,0,0,drop,70,70,0,1,0,1,0
38242,59511,21247,0,0,deny,62,62,0,1,0,1,0
38243,57926,445,0,0,drop,66,66,0,1,0,1,0
38244,57929,445,0,0,drop,66,66,0,1,0,1,0
38245,57927,445,0,0,drop,66,66,0,1,0,1,0
38246,57934,445,0,0,drop,66,66,0,1,0,1,0
38247,57933,445,0,0,drop,66,66,0,1,0,1,0
38248,57928,445,0,0,drop,66,66,0,1,0,1,0
38249,57924,445,0,0,drop,66,66,0,1,0,1,0
38250,64122,53,29748,53,allow,214,110,104,2,30,1,1
38251,65343,53,12113,53,allow,184,94,90,2,30,1,1
38252,62524,445,0,0,drop,70,70,0,1,0,1,0
38253,62521,445,0,0,drop,70,70,0,1,0,1,0
38254,62517,445,0,0,drop,70,70,0,1,0,1,0
38255,62519,445,0,0,drop,70,70,0,1,0,1,0
38256,63589,44847,0,0,deny,66,66,0,1,0,1,0
38257,57637,445,0,0,drop,70,70,0,1,0,1,0
38258,56418,41615,0,0,deny,143,143,0,1,0,1,0
38259,51259,1433,0,0,deny,60,60,0,1,0,1,0
38260,27869,51221,0,0,deny,66,66,0,1,0,1,0
38261,6546,37965,0,0,deny,62,62,0,1,0,1,0
38262,26448,41864,0,0,deny,145,145,0,1,0,1,0
38263,11066,50584,0,0,deny,66,66,0,1,0,1,0
38264,50292,22114,0,0,deny,66,66,0,1,0,1,0
38265,44821,64147,0,0,deny,62,62,0,1,0,1,0
38266,13968,29376,0,0,reset-both,62,62,0,1,0,1,0
38267,54778,22114,0,0,deny,62,62,0,1,0,1,0
38268,8486,56205,0,0,deny,62,62,0,1,0,1,0
38269,62516,445,0,0,drop,70,70,0,1,0,1,0
38270,62512,445,0,0,drop,70,70,0,1,0,1,0
38271,62509,445,0,0,drop,70,70,0,1,0,1,0
38272,32156,51505,0,0,deny,146,146,0,1,0,1,0
38273,57918,445,0,0,drop,66,66,0,1,0,1,0
38274,62508,445,0,0,drop,70,70,0,1,0,1,0
38275,7181,64147,0,0,deny,66,66,0,1,0,1,0
38276,64603,53,6564,53,allow,258,102,156,2,30,1,1
38277,36531,443,53488,443,allow,123782,10685,113097,157,180,65,92
38278,54982,53,55508,53,allow,282,96,186,4,48,2,2
38279,45525,53,45525,53,allow,469,165,304,4,30,2,2
38280,49406,53,22949,53,allow,215,102,113,2,30,1,1
38281,64982,53,55675,53,allow,215,102,113,2,30,1,1
38282,65172,53,25157,53,allow,306,110,196,2,30,1,1
38283,49262,53,60170,53,allow,168,86,82,2,30,1,1
38284,49603,53,29581,53,allow,199,102,97,2,30,1,1
38285,53248,443,60652,443,allow,532222,22112,510110,645,232,259,386
38286,38370,443,49097,443,allow,9194,5026,4168,24,32,11,13
38287,55625,443,33412,443,allow,96323,4044,92279,113,139,44,69
38288,55165,53,3036,53,allow,193,102,91,2,29,1,1
38289,55605,53,24748,53,allow,195,102,93,2,29,1,1
38290,50339,53,28610,53,allow,498,204,294,6,29,3,3
38291,64811,53,22274,53,allow,195,102,93,2,29,1,1
38292,64233,53,2922,53,allow,257,126,131,2,29,1,1
38293,50289,443,30139,443,allow,9571,2811,6760,45,87,24,21
38294,54989,443,3314,443,allow,7745,2583,5162,27,100,15,12
38295,65382,53,20387,53,allow,301,108,193,4,54,2,2
38296,50578,123,63477,123,allow,184,94,90,2,30,1,1
38297,50258,443,57201,443,allow,7975,1974,6001,31,210,15,16
38298,43220,443,18756,443,allow,3178535,62767,3115768,2800,83,626,2174
38299,47817,443,22532,443,allow,190,70,120,4,14,2,2
38300,38291,443,42711,443,allow,6737,1006,5731,20,162,11,9
38301,42980,80,62897,80,allow,944,529,415,11,315,6,5
38302,58363,443,44841,443,allow,46992,4773,42219,89,160,36,53
38303,36325,443,45107,443,allow,2930,1614,1316,16,249,9,7
38304,55220,80,9309,80,allow,1146,606,540,8,45,5,3
38305,53710,27935,28057,27935,allow,70,70,0,2,7,2,0
38306,55222,443,38278,443,allow,5312,1510,3802,18,45,11,7
38307,55219,443,55870,443,allow,6528,1918,4610,23,45,13,10
38308,60772,40010,29000,40010,allow,316,136,180,6,5,3,3
38309,38368,443,41740,443,allow,4392,1164,3228,17,34,9,8
38310,51907,47518,40645,47518,allow,316,136,180,6,5,3,3
38311,53713,26085,43109,26085,allow,70,70,0,2,7,2,0
38312,33069,80,38685,80,allow,1899,1172,727,17,284,10,7
38313,64275,53,47631,53,allow,324,90,234,4,35,2,2
38314,39208,5900,39208,5900,allow,152,66,86,2,10,1,1
38315,51500,993,4543,993,allow,14747,5073,9674,109,45,51,58
38316,42385,443,44650,443,allow,26481,1832,24649,40,330,18,22
38317,36108,8245,12106,8245,allow,280,214,66,2,29,1,1
38318,64132,53,49481,53,allow,179,94,85,2,29,1,1
38319,65343,53,41692,53,allow,184,94,90,2,29,1,1
38320,55599,53,39999,53,allow,258,94,164,2,29,1,1
38321,50263,53,56865,53,allow,164,86,78,2,29,1,1
38322,49381,53,64109,53,allow,230,102,128,2,29,1,1
38323,64276,53,39382,53,allow,197,102,95,2,29,1,1
38324,55354,53,62421,53,allow,214,110,104,2,30,1,1
38325,49548,53,36556,53,allow,198,94,104,2,29,1,1
38326,49952,53,64431,53,allow,195,102,93,2,29,1,1
38327,51979,80,28537,80,allow,6083,699,5384,14,46,7,7
38328,51965,80,35850,80,allow,106904,5958,100946,139,66,62,77
38329,55821,53,65311,53,allow,196,102,94,2,31,1,1
38330,64304,53,40913,53,allow,1054,293,761,8,94,4,4
38331,62456,443,40302,443,allow,8678,3253,5425,22,25,11,11
38332,49948,80,2205,80,allow,19740,993,18747,28,15,12,16
38333,49862,53,51904,53,allow,194,102,92,2,30,1,1
38334,64935,53,3553,53,allow,198,102,96,2,30,1,1
38335,55076,53,24944,53,allow,183,94,89,2,30,1,1
38336,65251,53,19717,53,allow,819,102,717,2,30,1,1
38337,35824,443,2741,443,allow,7237,2204,5033,15,120,7,8
38338,42289,443,63031,443,allow,6827,1776,5051,26,121,13,13
38339,55052,53,42687,53,allow,198,102,96,2,30,1,1
38340,65307,53,63090,53,allow,184,94,90,2,30,1,1
38341,49174,53,59747,53,allow,199,102,97,2,33,1,1
38342,55748,443,39721,443,allow,21446,1599,19847,35,154,16,19
38343,49904,53,21659,53,allow,749,94,655,2,30,1,1
38344,55354,53,63415,53,allow,214,110,104,2,30,1,1
38345,49947,80,44031,80,allow,362232,10443,351789,387,15,147,240
38346,50305,53,38735,53,allow,209,110,99,2,30,1,1
38347,42904,53,51732,53,allow,308,118,190,2,30,1,1
38348,55114,443,11994,443,allow,14680,6119,8561,35,152,16,19
38349,54953,443,55555,443,allow,9996,2043,7953,42,271,20,22
38350,56786,53,1954,53,allow,194,102,92,2,30,1,1
38351,37067,443,4326,443,allow,21446,1599,19847,35,155,16,19
38352,59834,80,63639,80,allow,943291,17238,926053,869,72,249,620
38353,64854,53,27051,53,allow,178,94,84,2,30,1,1
38354,55236,53,57748,53,allow,216,102,114,2,30,1,1
38355,57315,443,45136,443,allow,77504,4494,73010,112,200,54,58
38356,59773,53,31376,53,allow,193,94,99,2,30,1,1
38357,55036,53,3360,53,allow,177,94,83,2,30,1,1
38358,49999,53,62191,53,allow,316,91,225,4,46,2,2
38359,49198,53,53619,53,allow,308,118,190,2,30,1,1
38360,60381,443,9520,443,allow,24271,17315,6956,53,107,34,19
38361,35201,53,32554,53,allow,308,118,190,2,30,1,1
38362,56786,53,65502,53,allow,817,102,715,2,30,1,1
38363,65251,53,30637,53,allow,196,102,94,2,30,1,1
38364,50615,53,31516,53,allow,785,110,675,2,30,1,1
38365,49360,53,51221,53,allow,321,102,219,2,30,1,1
38366,55619,53,64151,53,allow,183,94,89,2,30,1,1
38367,64684,53,23170,53,allow,199,94,105,2,30,1,1
38368,64385,53,23181,53,allow,179,94,85,2,30,1,1
38369,41641,443,28317,443,allow,13106,6413,6693,24,121,12,12
38370,51973,80,59636,80,allow,21570,1613,19957,33,54,16,17
38371,51966,80,56206,80,allow,83302,3780,79522,105,66,47,58
38372,59874,443,18993,443,allow,1066,545,521,11,28,5,6
38373,56637,80,52477,80,allow,234,234,0,4,12,4,0
38374,56846,26665,43590,26665,allow,70,70,0,1,5,1,0
38375,47258,443,16882,443,allow,50898,2733,48165,73,218,33,40
38376,49946,80,45099,80,allow,31517,1203,30314,38,15,15,23
38377,49943,80,26149,80,allow,10767,783,9984,19,15,9,10
38378,57007,5333,59200,5333,allow,7194101,1949033,5245068,50585,1008,24913,25672
38379,45525,53,45525,53,allow,86,86,0,1,30,1,0
38380,55354,53,21132,53,allow,214,110,104,2,30,1,1
38381,56955,53,1466,53,allow,183,94,89,2,30,1,1
38382,50305,53,8454,53,allow,209,110,99,2,30,1,1
38383,49514,443,28704,443,allow,28361,1861,26500,49,195,19,30
38384,40527,443,2355,443,allow,21750,1903,19847,39,154,20,19
38385,56687,443,11163,443,allow,21086,2515,18571,42,25,21,21
38386,62454,443,55667,443,allow,18884,4117,14767,37,25,16,21
38387,51929,80,26646,80,allow,1213,821,392,8,15,6,2
38388,45300,443,4696,443,allow,11748,7422,4326,59,113,31,28
38389,55564,80,32717,80,allow,944,529,415,11,315,6,5
38390,64854,53,60425,53,allow,178,94,84,2,30,1,1
38391,65486,53,61924,53,allow,216,102,114,2,30,1,1
38392,64327,53,41700,53,allow,210,110,100,2,30,1,1
38393,55605,53,6586,53,allow,195,102,93,2,30,1,1
38394,57008,123,60959,123,allow,184,94,90,2,30,1,1
38395,33706,80,48762,80,allow,1265,473,792,8,15,5,3
38396,38700,443,49227,443,allow,130,70,60,2,14,1,1
38397,50711,443,57174,443,allow,7240,2265,4975,24,351,13,11
38398,42595,443,30091,443,allow,190565,9979,180586,272,244,140,132
38399,49456,53,22820,53,allow,308,101,207,4,32,2,2
38400,55740,8060,29494,8060,allow,70,70,0,2,7,2,0
38401,51884,22828,1526,22828,allow,70,70,0,1,5,1,0
38402,53249,443,17659,443,allow,3292049,87705,3204344,3470,232,1188,2282
38403,36471,443,15597,443,allow,83203,3599,79604,101,138,41,60
38404,62455,443,9859,443,allow,8302,2895,5407,22,25,11,11
38405,49952,80,46004,80,allow,4023,620,3403,14,15,7,7
38406,35991,443,26374,443,allow,190,70,120,4,14,2,2
38407,51844,80,51844,80,allow,72734,3432,69302,83,25,31,52
38408,51842,80,51842,80,allow,407760,15074,392686,424,25,154,270
38409,50172,443,57262,443,allow,130,70,60,2,14,1,1
38410,63863,34678,27822,34678,allow,504,382,122,8,15,6,2
38411,51974,80,47213,80,allow,38272,2881,35391,54,54,26,28
38412,53714,6882,37422,6882,allow,70,70,0,2,7,2,0
38413,56369,53,59261,53,allow,193,102,91,2,29,1,1
38414,55865,53,14766,53,allow,325,98,227,4,40,2,2
38415,65447,53,50068,53,allow,277,102,175,2,29,1,1
38416,49951,80,47463,80,allow,38898,1623,37275,49,15,21,28
38417,29677,53,29677,53,allow,218,90,128,2,29,1,1
38418,55294,53,64912,53,allow,199,102,97,2,29,1,1
38419,56292,53,0,0,allow,238,94,144,2,29,1,1
38420,64621,53,52780,53,allow,387,134,253,2,29,1,1
38421,64428,53,23839,53,allow,621,196,425,6,59,3,3
38422,49767,53,20343,53,allow,177,94,83,2,29,1,1
38423,55619,53,44719,53,allow,183,94,89,2,29,1,1
38424,65007,53,49517,53,allow,330,94,236,4,55,2,2
38425,64595,53,56897,53,allow,183,94,89,2,29,1,1
38426,64327,53,51961,53,allow,210,110,100,2,30,1,1
38427,54992,53,53080,53,allow,195,102,93,2,29,1,1
38428,49558,53,38507,53,allow,193,102,91,2,29,1,1
38429,56489,53,35362,53,allow,178,94,84,2,29,1,1
38430,55365,53,11222,53,allow,214,110,104,2,29,1,1
38431,65221,53,38871,53,allow,258,102,156,2,29,1,1
38432,64852,53,7184,53,allow,248,102,146,2,29,1,1
38433,49999,53,13553,53,allow,181,94,87,2,29,1,1
38434,55365,53,5213,53,allow,214,110,104,2,29,1,1
38435,55505,53,4978,53,allow,199,102,97,2,29,1,1
38436,56399,53,36148,53,allow,498,204,294,6,29,3,3
38437,56975,53,38883,53,allow,197,102,95,2,29,1,1
38438,55052,53,1245,53,allow,198,102,96,2,30,1,1
38439,65411,53,34611,53,allow,354,102,252,2,30,1,1
38440,64962,53,10417,53,allow,196,94,102,2,30,1,1
38441,57005,53,13005,53,allow,199,94,105,2,30,1,1
38442,49848,53,31476,53,allow,167,86,81,2,30,1,1
38443,55760,53,12734,53,allow,182,94,88,2,30,1,1
38444,64122,53,40984,53,allow,214,110,104,2,30,1,1
38445,52566,443,55072,443,allow,8594,1042,7552,16,120,7,9
38446,51629,443,13664,443,allow,19743,2133,17610,32,187,11,21
38447,52100,443,14481,443,allow,7711,1717,5994,26,361,13,13
38448,49301,53,26968,53,allow,353,118,235,2,31,1,1
38449,44721,443,28122,443,allow,24317,1518,22799,38,218,16,22
38450,63950,53,3217,53,allow,348,102,246,4,39,2,2
38451,49950,80,54747,80,allow,3991,620,3371,14,15,7,7
38452,49944,80,31108,80,allow,3695,550,3145,12,15,6,6
38453,55036,53,7624,53,allow,177,94,83,2,30,1,1
38454,55125,53,47085,53,allow,177,94,83,2,30,1,1
38455,55872,53,55193,53,allow,819,102,717,2,30,1,1
38456,50425,53,24348,53,allow,199,102,97,2,30,1,1
38457,55405,53,55361,53,allow,199,102,97,2,30,1,1
38458,49928,443,36059,443,allow,11646,4774,6872,29,32,18,11
38459,56688,443,28124,443,allow,19185,2445,16740,40,25,20,20
38460,49183,443,49342,443,allow,473744,13158,460586,495,20,183,312
38461,63885,6969,1755,6969,allow,66,66,0,2,8,2,0
38462,47828,443,4397,443,allow,512466,48982,463484,912,124,446,466
38463,57240,443,57240,443,allow,4623,1716,2907,19,26,11,8
38464,59873,443,3851,443,allow,1066,545,521,11,28,5,6
38465,35212,443,35212,443,allow,4700,1793,2907,19,27,11,8
38466,64811,53,57822,53,allow,314,97,217,4,47,2,2
38467,65436,53,49533,53,allow,286,90,196,4,55,2,2
38468,49862,53,59363,53,allow,817,102,715,2,30,1,1
38469,50002,53,25520,53,allow,196,102,94,2,30,1,1
38470,64935,53,55369,53,allow,198,102,96,2,30,1,1
38471,64122,53,11077,53,allow,214,110,104,2,30,1,1
38472,49800,53,14799,53,allow,183,94,89,2,30,1,1
38473,49949,80,34072,80,allow,16663,923,15740,25,15,11,14
38474,50477,80,50477,80,allow,20873,1203,19670,30,21,13,17
38475,34746,443,4348,443,allow,284320,14149,270171,398,244,203,195
38476,53675,29970,54968,29970,allow,612,426,186,10,22,7,3
38477,49945,80,12569,80,allow,4215,620,3595,14,15,7,7
38478,51980,80,55042,80,allow,4247,699,3548,13,46,7,6
38479,51977,80,44699,80,allow,4305,699,3606,13,46,7,6
38480,65497,53,19517,53,allow,490,111,379,4,54,2,2
38481,57185,53,50357,53,allow,784,94,690,2,30,1,1
38482,52780,53,38802,53,allow,338,94,244,2,30,1,1
38483,49425,53,61081,53,allow,772,102,670,2,30,1,1
38484,55821,53,40795,53,allow,196,102,94,2,30,1,1
38485,56955,53,34703,53,allow,183,94,89,2,30,1,1
38486,64945,53,35387,53,allow,240,86,154,2,30,1,1
38487,64605,53,20190,53,allow,183,94,89,2,31,1,1
38488,33313,443,29395,443,allow,9675,2389,7286,43,143,21,22
38489,49657,80,55424,80,allow,1278,774,504,12,361,7,5
38490,49781,53,21515,53,allow,194,102,92,2,30,1,1
38491,55872,53,6785,53,allow,196,102,94,2,30,1,1
38492,59283,53,37048,53,allow,359,86,273,2,30,1,1
38493,49319,53,45899,53,allow,166,86,80,2,30,1,1
38494,56979,53,50230,53,allow,209,110,99,2,30,1,1
38495,50520,53,46734,53,allow,732,86,646,2,30,1,1
38496,64762,53,37992,53,allow,194,102,92,2,30,1,1
38497,49767,53,43872,53,allow,200,102,98,2,31,1,1
38498,55310,53,54905,53,allow,180,94,86,2,31,1,1
38499,49703,53,23224,53,allow,288,102,186,2,31,1,1
38500,60796,443,14652,443,allow,69973,4662,65311,108,135,43,65
38501,49573,443,42644,443,allow,111881,6152,105729,137,139,51,86
38502,56288,53,47353,53,allow,200,102,98,2,30,1,1
38503,49848,53,25784,53,allow,167,86,81,2,30,1,1
38504,56430,53,26813,53,allow,199,102,97,2,30,1,1
38505,50002,53,41135,53,allow,196,102,94,2,30,1,1
38506,49800,53,2151,53,allow,183,94,89,2,31,1,1
38507,56589,53,43560,53,allow,166,86,80,2,31,1,1
38508,49518,53,53885,53,allow,193,102,91,2,30,1,1
38509,57058,53,2739,53,allow,167,86,81,2,31,1,1
38510,50523,53,46429,53,allow,376,78,298,2,31,1,1
38511,55760,53,35277,53,allow,182,94,88,2,31,1,1
38512,64022,53,48680,53,allow,197,102,95,2,31,1,1
38513,49898,443,38870,443,allow,8191,2343,5848,33,394,11,22
38514,6881,48608,12608,48608,allow,228,118,110,2,1199,1,1
38515,46838,443,19080,443,allow,10876,3774,7102,12,145,5,7
38516,43791,443,3031,443,allow,6933,1677,5256,22,305,12,10
38517,56369,53,59110,53,allow,193,102,91,2,31,1,1
38518,49973,53,27114,53,allow,261,94,167,2,30,1,1
38519,57083,53,27580,53,allow,198,102,96,2,30,1,1
38520,55405,53,37369,53,allow,199,102,97,2,30,1,1
38521,56975,53,33537,53,allow,197,102,95,2,30,1,1
38522,56743,53,62302,53,allow,209,110,99,2,31,1,1
38523,55505,53,51745,53,allow,199,102,97,2,31,1,1
38524,49820,53,29495,53,allow,193,102,91,2,31,1,1
38525,55125,53,32465,53,allow,177,94,83,2,31,1,1
38526,64327,53,41348,53,allow,210,110,100,2,31,1,1
38527,56743,53,46707,53,allow,209,110,99,2,30,1,1
38528,49809,53,6008,53,allow,386,134,252,2,30,1,1
38529,57083,53,19689,53,allow,198,102,96,2,30,1,1
38530,56589,53,12890,53,allow,199,102,97,2,31,1,1
38531,56869,53,8171,53,allow,198,94,104,2,31,1,1
38532,53709,15000,7812,15000,allow,320,140,180,6,7,3,3
38533,50726,443,17287,443,allow,6464,2707,3757,39,151,18,21
38534,49558,53,10290,53,allow,193,102,91,2,30,1,1
38535,56589,53,14177,53,allow,166,86,80,2,30,1,1
38536,49615,53,30558,53,allow,413,170,243,6,31,3,3
38537,50291,443,61794,443,allow,11617,4358,7259,48,86,26,22
38538,49967,53,25573,53,allow,445,95,350,4,50,2,2
38539,5588,5588,0,0,allow,3562,1936,1626,48,193,24,24
38540,57914,445,0,0,drop,66,66,0,1,0,1,0
38541,23537,35253,0,0,deny,66,66,0,1,0,1,0
38542,57624,445,0,0,drop,70,70,0,1,0,1,0
38543,57911,445,0,0,drop,66,66,0,1,0,1,0
38544,57910,445,0,0,drop,66,66,0,1,0,1,0
38545,33543,44847,0,0,deny,66,66,0,1,0,1,0
38546,57908,445,0,0,drop,66,66,0,1,0,1,0
38547,9017,6881,0,0,deny,66,66,0,1,0,1,0
38548,65179,44847,0,0,deny,66,66,0,1,0,1,0
38549,9687,57470,0,0,deny,78,78,0,1,0,1,0
38550,57621,445,0,0,drop,70,70,0,1,0,1,0
38551,12128,37965,0,0,deny,62,62,0,1,0,1,0
38552,50222,42873,0,0,deny,66,66,0,1,0,1,0
38553,62504,445,0,0,drop,70,70,0,1,0,1,0
38554,62498,445,0,0,drop,70,70,0,1,0,1,0
38555,62497,445,0,0,drop,70,70,0,1,0,1,0
38556,16883,22,0,0,deny,60,60,0,1,0,1,0
38557,57617,445,0,0,drop,70,70,0,1,0,1,0
38558,64115,2767,0,0,deny,66,66,0,1,0,1,0
38559,39244,36829,0,0,deny,62,62,0,1,0,1,0
38560,57987,56125,0,0,deny,90,90,0,1,0,1,0
38561,57615,445,0,0,drop,70,70,0,1,0,1,0
38562,39742,62413,0,0,deny,66,66,0,1,0,1,0
38563,57898,445,0,0,drop,66,66,0,1,0,1,0
38564,30039,7363,0,0,deny,145,145,0,1,0,1,0
38565,57613,445,0,0,drop,70,70,0,1,0,1,0
38566,5894,44847,0,0,deny,66,66,0,1,0,1,0
38567,55874,64147,0,0,deny,66,66,0,1,0,1,0
38568,61527,51050,0,0,deny,66,66,0,1,0,1,0
38569,54458,64147,0,0,deny,62,62,0,1,0,1,0
38570,54300,22114,0,0,deny,66,66,0,1,0,1,0
38571,51262,35440,0,0,deny,66,66,0,1,0,1,0
38572,58888,23718,0,0,deny,62,62,0,1,0,1,0
38573,57890,445,0,0,drop,66,66,0,1,0,1,0
38574,62484,445,0,0,drop,70,70,0,1,0,1,0
38575,50470,61463,0,0,deny,86,86,0,1,0,1,0
38576,48079,43227,0,0,deny,66,66,0,1,0,1,0
38577,50283,49169,0,0,deny,66,66,0,1,0,1,0
38578,57606,445,0,0,drop,70,70,0,1,0,1,0
38579,57887,445,0,0,drop,66,66,0,1,0,1,0
38580,57604,445,0,0,drop,70,70,0,1,0,1,0
38581,39531,19473,0,0,deny,62,62,0,1,0,1,0
38582,59227,11392,0,0,deny,62,62,0,1,0,1,0
38583,61563,37807,0,0,deny,62,62,0,1,0,1,0
38584,40216,50265,0,0,deny,62,62,0,1,0,1,0
38585,57698,64147,0,0,deny,66,66,0,1,0,1,0
38586,57603,445,0,0,drop,70,70,0,1,0,1,0
38587,57879,445,0,0,drop,66,66,0,1,0,1,0
38588,57602,445,0,0,drop,70,70,0,1,0,1,0
38589,58085,57470,0,0,deny,66,66,0,1,0,1,0
38590,49426,57470,0,0,deny,66,66,0,1,0,1,0
38591,57601,445,0,0,drop,70,70,0,1,0,1,0
38592,65096,37807,0,0,deny,62,62,0,1,0,1,0
38593,57870,445,0,0,drop,66,66,0,1,0,1,0
38594,57596,445,0,0,drop,70,70,0,1,0,1,0
38595,57595,445,0,0,drop,70,70,0,1,0,1,0
38596,1038,37965,0,0,deny,62,62,0,1,0,1,0
38597,22346,51505,0,0,deny,62,62,0,1,0,1,0
38598,57583,445,0,0,drop,70,70,0,1,0,1,0
38599,57576,445,0,0,drop,70,70,0,1,0,1,0
38600,58338,3363,0,0,deny,60,60,0,1,0,1,0
38601,57572,445,0,0,drop,70,70,0,1,0,1,0
38602,57573,445,0,0,drop,70,70,0,1,0,1,0
38603,60962,64147,0,0,deny,66,66,0,1,0,1,0
38604,47910,7454,0,0,deny,60,60,0,1,0,1,0
38605,49001,40108,0,0,deny,161,161,0,1,0,1,0
38606,62473,445,0,0,drop,70,70,0,1,0,1,0
38607,62469,445,0,0,drop,70,70,0,1,0,1,0
38608,62468,445,0,0,drop,70,70,0,1,0,1,0
38609,30782,36237,0,0,deny,62,62,0,1,0,1,0
38610,57863,445,0,0,drop,66,66,0,1,0,1,0
38611,57864,445,0,0,drop,66,66,0,1,0,1,0
38612,57859,445,0,0,drop,66,66,0,1,0,1,0
38613,57862,445,0,0,drop,66,66,0,1,0,1,0
38614,57861,445,0,0,drop,66,66,0,1,0,1,0
38615,57858,445,0,0,drop,66,66,0,1,0,1,0
38616,57860,445,0,0,drop,66,66,0,1,0,1,0
38617,57857,445,0,0,drop,66,66,0,1,0,1,0
38618,62051,11392,0,0,deny,66,66,0,1,0,1,0
38619,42968,56205,0,0,deny,62,62,0,1,0,1,0
38620,62388,39004,0,0,deny,62,62,0,1,0,1,0
38621,62150,23718,0,0,deny,66,66,0,1,0,1,0
38622,19068,37965,0,0,deny,62,62,0,1,0,1,0
38623,57561,445,0,0,drop,70,70,0,1,0,1,0
38624,39981,57470,0,0,deny,62,62,0,1,0,1,0
38625,43584,24748,0,0,deny,156,156,0,1,0,1,0
38626,43584,24748,0,0,deny,156,156,0,1,0,1,0
38627,43584,24748,0,0,deny,156,156,0,1,0,1,0
38628,64962,64147,0,0,deny,66,66,0,1,0,1,0
38629,36738,123,0,0,deny,234,234,0,1,0,1,0
38630,62463,445,0,0,drop,70,70,0,1,0,1,0
38631,62461,445,0,0,drop,70,70,0,1,0,1,0
38632,62453,445,0,0,drop,70,70,0,1,0,1,0
38633,37927,50265,0,0,deny,66,66,0,1,0,1,0
38634,15581,46713,0,0,deny,66,66,0,1,0,1,0
38635,53465,57470,0,0,deny,62,62,0,1,0,1,0
38636,46600,443,0,0,deny,1097,1097,0,1,0,1,0
38637,2740,22,0,0,deny,60,60,0,1,0,1,0
38638,57845,445,0,0,drop,66,66,0,1,0,1,0
38639,57843,445,0,0,drop,66,66,0,1,0,1,0
38640,57842,445,0,0,drop,66,66,0,1,0,1,0
38641,59509,64147,0,0,deny,62,62,0,1,0,1,0
38642,62451,445,0,0,drop,70,70,0,1,0,1,0
38643,46409,35440,0,0,deny,66,66,0,1,0,1,0
38644,57557,445,0,0,drop,70,70,0,1,0,1,0
38645,63196,445,0,0,deny,66,66,0,1,0,1,0
38646,57987,56125,0,0,deny,90,90,0,1,0,1,0
38647,50298,37965,0,0,deny,66,66,0,1,0,1,0
38648,62448,445,0,0,drop,70,70,0,1,0,1,0
38649,60052,37965,0,0,deny,66,66,0,1,0,1,0
38650,62443,445,0,0,drop,70,70,0,1,0,1,0
38651,62444,445,0,0,drop,70,70,0,1,0,1,0
38652,62438,445,0,0,drop,70,70,0,1,0,1,0
38653,51505,17372,0,0,deny,66,66,0,1,0,1,0
38654,57545,445,0,0,drop,70,70,0,1,0,1,0
38655,57548,445,0,0,drop,70,70,0,1,0,1,0
38656,57547,445,0,0,drop,70,70,0,1,0,1,0
38657,60969,48637,0,0,deny,78,78,0,1,0,1,0
38658,57543,445,0,0,drop,70,70,0,1,0,1,0
38659,57541,445,0,0,drop,70,70,0,1,0,1,0
38660,40642,23889,0,0,deny,146,146,0,1,0,1,0
38661,9393,51505,0,0,deny,66,66,0,1,0,1,0
38662,26750,57470,0,0,deny,66,66,0,1,0,1,0
38663,51374,30317,0,0,deny,66,66,0,1,0,1,0
38664,22390,19473,0,0,deny,66,66,0,1,0,1,0
38665,34301,21247,0,0,deny,62,62,0,1,0,1,0
38666,6661,23,0,0,deny,60,60,0,1,0,1,0
38667,62431,445,0,0,drop,70,70,0,1,0,1,0
38668,62430,445,0,0,drop,70,70,0,1,0,1,0
38669,62424,445,0,0,drop,70,70,0,1,0,1,0
38670,57535,445,0,0,drop,70,70,0,1,0,1,0
38671,15955,48817,0,0,deny,140,140,0,1,0,1,0
38672,57527,445,0,0,drop,70,70,0,1,0,1,0
38673,56495,53,29192,53,allow,198,101,97,2,30,1,1
38674,48757,80,48757,80,allow,560,264,296,9,44,5,4
38675,41098,80,34310,80,allow,1937,1193,744,12,16,7,5
38676,64605,53,39152,53,allow,182,93,89,2,30,1,1
38677,56623,53,18777,53,allow,771,101,670,2,30,1,1
38678,55934,53,51844,53,allow,731,85,646,2,30,1,1
38679,64312,53,26634,53,allow,202,103,99,2,31,1,1
38680,64485,53,38773,53,allow,182,93,89,2,30,1,1
38681,49781,53,57974,53,allow,188,96,92,2,30,1,1
38682,55581,53,6182,53,allow,166,85,81,2,30,1,1
38683,56855,64607,58491,64607,allow,316,136,180,6,6,3,3
38684,38660,15000,20760,15000,allow,138,78,60,2,5,1,1
38685,13371,2323,13371,2323,allow,124,60,64,2,5,1,1
38686,54958,53,54115,53,allow,1413,85,1328,4,47,2,2
38687,24624,443,24624,443,allow,5198,2221,2977,19,16,10,9
38688,54612,443,39989,443,allow,6110,857,5253,17,16,9,8
38689,10216,80,10216,80,allow,7548,1586,5962,18,21,8,10
38690,56824,3389,56824,3389,allow,3910,1805,2105,20,18,12,8
38691,55028,443,52319,443,allow,6791,1415,5376,19,51,12,7
38692,46986,443,11457,443,allow,2809,1884,925,19,27,11,8
38693,64087,443,64087,443,allow,150808,48110,102698,173,173,82,91
38694,51839,80,34402,80,allow,3240,1194,2046,14,20,9,5
38695,56389,53,50951,53,allow,279,93,186,4,32,2,2
38696,54982,53,63300,53,allow,282,96,186,4,48,2,2
38697,46475,80,46475,80,allow,8300,966,7334,14,20,6,8
38698,53897,443,3893,443,allow,10781,3635,7146,27,221,15,12
38699,3234,80,3234,80,allow,12425,835,11590,19,17,8,11
38700,56743,53,16205,53,allow,202,103,99,2,30,1,1
38701,55966,53,62624,53,allow,747,92,655,2,30,1,1
38702,6881,6881,56597,6881,allow,231,111,120,2,1200,1,1
38703,55560,53,1916,53,allow,164,84,80,2,31,1,1
38704,57028,53,32039,53,allow,776,102,674,2,31,1,1
38705,6881,6889,18694,6889,allow,221,111,110,2,1200,1,1
38706,30188,15370,58525,15370,allow,10190,4774,5416,64,1490,32,32
38707,64127,53,29234,53,allow,170,87,83,2,31,1,1
38708,65140,53,5924,53,allow,774,101,673,2,31,1,1
38709,30960,45722,27416,45722,allow,396,396,0,7,3616,7,0
38710,55859,53,35635,53,allow,778,103,675,2,31,1,1
38711,49820,53,12064,53,allow,186,95,91,2,31,1,1
38712,56946,53,14578,53,allow,732,89,643,2,31,1,1
38713,46445,443,57162,443,allow,13942,8293,5649,59,172,31,28
38714,50408,53,64657,53,allow,755,94,661,2,31,1,1
38715,64525,53,31849,53,allow,198,101,97,2,31,1,1
38716,49780,53,7446,53,allow,182,93,89,2,31,1,1
38717,50273,443,63017,443,allow,13363,4645,8718,54,241,32,22
38718,38059,443,31779,443,allow,25214,14000,11214,66,99,34,32
38719,56674,53,43592,53,allow,182,93,89,2,31,1,1
38720,55706,53,9914,53,allow,202,103,99,2,31,1,1
38721,51229,443,49748,443,allow,8590,1038,7552,16,120,7,9
38722,59658,443,33900,443,allow,5433,925,4508,19,360,10,9
38723,6881,49001,20436,49001,allow,210,111,99,2,1201,1,1
38724,55720,53,40889,53,allow,774,101,673,2,31,1,1
38725,30960,45727,32973,45727,allow,330,330,0,6,3610,6,0
38726,56876,30188,0,0,deny,66,66,0,1,0,1,0
38727,57524,445,0,0,drop,70,70,0,1,0,1,0
38728,25222,37965,0,0,deny,62,62,0,1,0,1,0
38729,32609,64097,0,0,deny,66,66,0,1,0,1,0
38730,57821,445,0,0,drop,66,66,0,1,0,1,0
38731,62421,445,0,0,drop,70,70,0,1,0,1,0
38732,62420,445,0,0,drop,70,70,0,1,0,1,0
38733,65265,55067,0,0,deny,62,62,0,1,0,1,0
38734,50470,61463,0,0,deny,86,86,0,1,0,1,0
38735,57521,445,0,0,drop,70,70,0,1,0,1,0
38736,13840,37965,0,0,deny,146,146,0,1,0,1,0
38737,57585,19750,0,0,deny,66,66,0,1,0,1,0
38738,57519,445,0,0,drop,70,70,0,1,0,1,0
38739,35494,22114,0,0,deny,66,66,0,1,0,1,0
38740,58976,43890,0,0,deny,66,66,0,1,0,1,0
38741,57816,445,0,0,drop,66,66,0,1,0,1,0
38742,57817,445,0,0,drop,66,66,0,1,0,1,0
38743,64546,57470,0,0,deny,66,66,0,1,0,1,0
38744,36301,443,2134,443,allow,7316,1933,5383,27,15,15,12
38745,59675,80,26404,80,allow,3437462,77916,3359546,3384,134,1140,2244
38746,57241,443,46273,443,allow,1167125,49170,1117955,1459,92,635,824
38747,45964,3111,0,0,deny,60,60,0,1,0,1,0
38748,57515,445,0,0,drop,70,70,0,1,0,1,0
38749,62412,445,0,0,drop,70,70,0,1,0,1,0
38750,57514,445,0,0,drop,70,70,0,1,0,1,0
38751,35261,15503,0,0,deny,74,74,0,1,0,1,0
38752,55565,64147,0,0,deny,62,62,0,1,0,1,0
38753,62406,445,0,0,drop,70,70,0,1,0,1,0
38754,62405,445,0,0,drop,70,70,0,1,0,1,0
38755,62401,445,0,0,drop,70,70,0,1,0,1,0
38756,57810,445,0,0,drop,66,66,0,1,0,1,0
38757,52714,64147,0,0,deny,66,66,0,1,0,1,0
38758,57806,445,0,0,drop,66,66,0,1,0,1,0
38759,57805,445,0,0,drop,66,66,0,1,0,1,0
38760,57804,445,0,0,drop,66,66,0,1,0,1,0
38761,57803,445,0,0,drop,66,66,0,1,0,1,0
38762,57800,445,0,0,drop,66,66,0,1,0,1,0
38763,57799,445,0,0,drop,66,66,0,1,0,1,0
38764,57795,445,0,0,drop,66,66,0,1,0,1,0
38765,62396,445,0,0,drop,70,70,0,1,0,1,0
38766,53656,31573,0,0,deny,66,66,0,1,0,1,0
38767,57509,445,0,0,drop,70,70,0,1,0,1,0
38768,62393,445,0,0,drop,70,70,0,1,0,1,0
38769,62392,445,0,0,drop,70,70,0,1,0,1,0
38770,62389,445,0,0,drop,70,70,0,1,0,1,0
38771,29159,39004,0,0,deny,62,62,0,1,0,1,0
38772,43350,58414,0,0,deny,66,66,0,1,0,1,0
38773,53608,39004,0,0,deny,66,66,0,1,0,1,0
38774,45051,23,0,0,deny,60,60,0,1,0,1,0
38775,56794,46824,0,0,deny,66,66,0,1,0,1,0
38776,60136,56205,0,0,deny,66,66,0,1,0,1,0
38777,41165,23,0,0,deny,60,60,0,1,0,1,0
38778,59668,51505,0,0,deny,62,62,0,1,0,1,0
38779,49160,34068,0,0,deny,146,146,0,1,0,1,0
38780,45908,3383,0,0,deny,60,60,0,1,0,1,0
38781,443,64347,0,0,deny,131,131,0,1,0,1,0
38782,9687,57470,0,0,deny,78,78,0,1,0,1,0
38783,62387,445,0,0,drop,70,70,0,1,0,1,0
38784,62386,445,0,0,drop,70,70,0,1,0,1,0
38785,62384,445,0,0,drop,70,70,0,1,0,1,0
38786,54742,37965,0,0,deny,66,66,0,1,0,1,0
38787,58255,50584,0,0,deny,62,62,0,1,0,1,0
38788,57789,445,0,0,drop,66,66,0,1,0,1,0
38789,56743,53,5034,53,allow,209,110,99,2,30,1,1
38790,57066,53,30352,53,allow,197,94,103,2,30,1,1
38791,49752,53,61999,53,allow,182,94,88,2,30,1,1
38792,49752,53,1168,53,allow,182,94,88,2,30,1,1
38793,65067,53,22984,53,allow,327,102,225,2,30,1,1
38794,48755,80,48755,80,allow,630,264,366,10,44,5,5
38795,56697,443,50660,443,allow,3593,2749,844,18,22,11,7
38796,53679,24300,62271,24300,allow,1656,914,742,13,21,9,4
38797,35292,8100,19734,8100,allow,234,234,0,4,11,4,0
38798,53693,26515,57249,26515,allow,70,70,0,1,4,1,0
38799,49666,53,61369,53,allow,392,124,268,4,35,2,2
38800,53145,27067,38874,27067,allow,1231702,397859,833843,10382,185,4780,5602
38801,59703,443,2631,443,allow,8867,2701,6166,21,105,9,12
38802,38779,80,43301,80,allow,540,540,0,10,186,10,0
38803,38676,443,23921,443,allow,101056,3737,97319,107,15,35,72
38804,64086,443,64086,443,allow,79107,10743,68364,96,172,42,54
38805,52079,443,42023,443,allow,4735,3589,1146,18,15,10,8
38806,42485,443,17248,443,allow,130,70,60,3,5,2,1
38807,58865,443,1630,443,allow,505070,16437,488633,543,45,187,356
38808,53690,42301,12821,42301,allow,1821,1088,733,17,15,9,8
38809,64595,53,13089,53,allow,299,93,206,4,35,2,2
38810,39818,443,44736,443,allow,2211,1181,1030,23,40,11,12
38811,58293,443,58293,443,allow,7134,2478,4656,18,75,10,8
38812,49319,53,1935,53,allow,166,86,80,2,29,1,1
38813,64605,53,57757,53,allow,183,94,89,2,29,1,1
38814,55125,53,57865,53,allow,177,94,83,2,29,1,1
38815,55119,53,12117,53,allow,994,86,908,2,29,1,1
38816,55943,53,30420,53,allow,448,184,264,6,29,3,3
38817,56979,53,46725,53,allow,209,110,99,2,29,1,1
38818,49253,53,38638,53,allow,727,86,641,2,29,1,1
38819,49781,53,14753,53,allow,194,102,92,2,30,1,1
38820,56533,53,7408,53,allow,199,102,97,2,29,1,1
38821,49847,53,33024,53,allow,448,184,264,6,29,3,3
38822,50216,443,60442,443,allow,6320,1382,4938,24,167,13,11
38823,57598,443,59383,443,allow,3323,2398,925,18,21,10,8
38824,56561,53,63189,53,allow,167,86,81,2,30,1,1
38825,56589,53,29602,53,allow,199,102,97,2,30,1,1
38826,54448,53,29193,53,allow,70,70,0,1,30,1,0
38827,49820,53,34423,53,allow,193,102,91,2,30,1,1
38828,56389,53,30370,53,allow,279,93,186,4,31,2,2
38829,36717,443,50144,443,allow,232,172,60,3,5,2,1
38830,56292,443,36478,443,allow,10839,2145,8694,32,140,14,18
38831,55715,443,55715,443,allow,4575,1668,2907,19,30,11,8
38832,38673,443,39946,443,allow,379440,8281,371159,362,16,106,256
38833,59320,443,31815,443,allow,4573,2614,1959,25,80,13,12
38834,64095,443,63841,443,allow,9895,2094,7801,52,262,23,29
38835,60796,53,60796,53,allow,248,106,142,2,30,1,1
38836,37993,49152,8346,49152,allow,156,156,0,3,8,3,0
38837,64022,53,64185,53,allow,197,102,95,2,30,1,1
38838,55581,53,26872,53,allow,167,86,81,2,30,1,1
38839,37994,49152,32893,49152,allow,156,156,0,3,8,3,0
38840,56094,443,60801,443,allow,5616,3106,2510,22,223,13,9
38841,56955,53,43873,53,allow,183,94,89,2,30,1,1
38842,38675,443,44099,443,allow,90810,3417,87393,94,16,30,64
38843,60901,443,55846,443,allow,622058,33681,588377,765,65,327,438
38844,56535,53,61823,53,allow,200,94,106,2,30,1,1
38845,56782,53,51399,53,allow,197,94,103,2,30,1,1
38846,59840,80,40850,80,allow,469946,11862,458084,482,68,173,309
38847,56922,53,56922,53,allow,219,98,121,2,30,1,1
38848,57083,53,55638,53,allow,198,102,96,2,30,1,1
38849,56871,53,27631,53,allow,198,86,112,2,30,1,1
38850,64813,16385,22226,16385,allow,432,192,240,8,30,4,4
38851,35515,53,35515,53,allow,235,98,137,2,30,1,1
38852,64525,53,63463,53,allow,199,102,97,2,30,1,1
38853,50803,443,13145,443,allow,98472,44922,53550,491,658,181,310
38854,56560,53,48488,53,allow,198,102,96,2,30,1,1
38855,42408,443,51647,443,allow,13108,2630,10478,26,120,12,14
38856,64485,53,11274,53,allow,183,94,89,2,30,1,1
38857,56389,53,40774,53,allow,279,93,186,4,32,2,2
38858,51882,15733,3672,15733,allow,70,70,0,1,5,1,0
38859,34657,443,31367,443,allow,448,78,370,6,25,1,5
38860,50985,80,61422,80,allow,613,539,74,7,15,6,1
38861,39690,443,65323,443,allow,5806,3167,2639,29,221,16,13
38862,65437,53,59504,53,allow,488,111,377,4,53,2,2
38863,55524,53,46955,53,allow,413,170,243,6,30,3,3
38864,55560,53,36102,53,allow,166,86,80,2,30,1,1
38865,63068,443,30672,443,allow,2928239,68426,2859813,2888,37,955,1933
38866,55029,443,56750,443,allow,35270,2782,32488,48,51,22,26
38867,38677,443,24014,443,allow,89883,3417,86466,94,15,30,64
38868,34135,443,33569,443,allow,9932,1987,7945,22,16,12,10
38869,65307,53,33704,53,allow,365,94,271,4,58,2,2
38870,56561,53,36683,53,allow,167,86,81,2,30,1,1
38871,57027,53,20222,53,allow,198,94,104,2,30,1,1
38872,55581,53,16064,53,allow,167,86,81,2,30,1,1
38873,64485,53,10635,53,allow,183,94,89,2,30,1,1
38874,60048,443,33885,443,allow,12254,3186,9068,27,171,13,14
38875,58862,443,37549,443,allow,1068717,27931,1040786,1093,45,351,742
38876,58864,443,26989,443,allow,312852,8845,304007,317,45,99,218
38877,56588,443,28580,443,allow,10615,5909,4706,28,42,14,14
38878,55625,80,27507,80,allow,389326,9849,379477,391,21,138,253
38879,9109,443,23310,443,allow,4400,433,3967,12,15,6,6
38880,47053,80,59078,80,allow,1188,463,725,8,15,5,3
38881,49951,80,39870,80,allow,1706,505,1201,8,14,5,3
38882,45074,443,48285,443,allow,4493,2566,1927,40,130,21,19
38883,53706,59208,33732,59208,allow,258,70,188,4,8,2,2
38884,48756,80,48756,80,allow,560,264,296,9,44,5,4
38885,49531,53,39343,53,allow,289,94,195,4,31,2,2
38886,49569,53,55862,53,allow,181,94,87,2,31,1,1
38887,64144,53,27291,53,allow,193,102,91,2,31,1,1
38888,64461,53,32838,53,allow,350,89,261,4,53,2,2
38889,56046,53,55070,53,allow,193,102,91,2,31,1,1
38890,65307,53,59322,53,allow,184,94,90,2,29,1,1
38891,45052,443,37093,443,allow,131573,4926,126647,152,152,55,97
38892,54982,53,58418,53,allow,282,96,186,4,47,2,2
38893,60432,54312,22904,54312,allow,701,455,246,8,15,4,4
38894,65532,53,6977,53,allow,255,102,153,2,29,1,1
38895,48754,80,48754,80,allow,560,264,296,9,44,5,4
38896,56611,443,56611,443,allow,4530,1623,2907,19,26,11,8
38897,56495,53,8652,53,allow,199,102,97,2,30,1,1
38898,33115,443,15120,443,allow,75816,2178,73638,72,16,20,52
38899,54982,53,26204,53,allow,282,96,186,4,48,2,2
38900,49429,53,3365,53,allow,199,102,97,2,29,1,1
38901,55760,53,9967,53,allow,182,94,88,2,30,1,1
38902,49863,8100,50615,8100,allow,234,234,0,4,11,4,0
38903,56842,24233,45791,24233,allow,70,70,0,1,5,1,0
38904,56495,53,46439,53,allow,199,102,97,2,30,1,1
38905,49331,53,38875,53,allow,200,94,106,2,29,1,1
38906,49262,53,13310,53,allow,168,86,82,2,29,1,1
38907,49429,53,51638,53,allow,199,102,97,2,29,1,1
38908,45589,53,45589,53,allow,225,106,119,2,30,1,1
38909,64485,53,6047,53,allow,183,94,89,2,30,1,1
38910,50405,53,35754,53,allow,200,102,98,2,30,1,1
38911,55560,53,7666,53,allow,166,86,80,2,30,1,1
38912,64334,53,44519,53,allow,200,94,106,2,31,1,1
38913,55560,53,43077,53,allow,166,86,80,2,30,1,1
38914,35868,123,20404,123,allow,184,94,90,2,30,1,1
38915,56561,53,4933,53,allow,167,86,81,2,30,1,1
38916,35099,53,35099,53,allow,225,106,119,2,30,1,1
38917,65410,53,40006,53,allow,229,110,119,2,31,1,1
38918,49780,53,9183,53,allow,183,94,89,2,31,1,1
38919,57470,1337,6563,1337,allow,330,330,0,6,1200,6,0
38920,49673,5223,52043,5223,allow,4266,1448,2818,22,3088,13,9
38921,55086,53,37200,53,allow,328,90,238,4,37,2,2
38922,56691,443,56691,443,allow,4378,1471,2907,19,29,11,8
38923,44983,443,63267,443,allow,4991,3096,1895,22,220,13,9
38924,60902,443,20935,443,allow,924886,40519,884367,1075,65,442,633
38925,49831,53,63335,53,allow,198,94,104,2,30,1,1
38926,55581,53,6275,53,allow,167,86,81,2,30,1,1
38927,53443,123,34007,123,allow,184,94,90,2,30,1,1
38928,64312,53,19518,53,allow,209,110,99,2,30,1,1
38929,55622,53,55622,53,allow,235,98,137,2,30,1,1
38930,64312,53,39914,53,allow,209,110,99,2,30,1,1
38931,53864,53,0,0,allow,181,86,95,2,30,1,1
38932,64567,53,38980,53,allow,199,102,97,2,30,1,1
38933,65367,53,6408,53,allow,251,94,157,2,30,1,1
38934,64257,53,61085,53,allow,211,78,133,2,30,1,1
38935,48480,443,23315,443,allow,10409,2670,7739,94,5805,17,77
38936,54349,443,33751,443,allow,14063,6328,7735,33,37,16,17
38937,56389,53,5155,53,allow,279,93,186,4,32,2,2
38938,65075,53,3072,53,allow,278,100,178,4,31,2,2
38939,36368,80,28918,80,allow,78,78,0,2,8,2,0
38940,49767,53,48677,53,allow,200,102,98,2,30,1,1
38941,36003,123,29238,123,allow,184,94,90,2,30,1,1
38942,56495,53,40690,53,allow,199,102,97,2,30,1,1
38943,53771,53,15804,53,allow,168,78,90,2,30,1,1
38944,50436,53,50436,53,allow,248,106,142,2,30,1,1
38945,49767,53,59870,53,allow,200,102,98,2,30,1,1
38946,64127,53,25934,53,allow,177,94,83,2,30,1,1
38947,64814,16386,26637,16386,allow,432,192,240,8,30,4,4
38948,64812,16384,57833,16384,allow,556,256,300,10,30,5,5
38949,56589,53,35173,53,allow,199,102,97,2,30,1,1
38950,64605,53,37496,53,allow,183,94,89,2,30,1,1
38951,56913,53,26881,53,allow,193,102,91,2,30,1,1
38952,46087,123,1853,123,allow,184,94,90,2,30,1,1
38953,43224,443,58496,443,allow,2027060,31188,1995872,1708,77,321,1387
38954,62984,8920,64791,8920,allow,829,583,246,9,15,5,4
38955,51898,50677,11184,50677,allow,70,70,0,2,8,2,0
38956,39691,443,19471,443,allow,6219,4130,2089,29,221,16,13
38957,51594,443,50600,443,allow,5854,1148,4706,18,23,10,8
38958,57058,53,29046,53,allow,167,86,81,2,30,1,1
38959,47749,53,47749,53,allow,248,106,142,2,30,1,1
38960,49212,53,2222,53,allow,183,94,89,2,30,1,1
38961,54590,443,20540,443,allow,12094,4159,7935,21,135,10,11
38962,64567,53,24261,53,allow,199,102,97,2,30,1,1
38963,49262,53,46554,53,allow,168,86,82,2,30,1,1
38964,50759,53,50759,53,allow,225,106,119,2,30,1,1
38965,65468,53,8938,53,allow,200,94,106,2,30,1,1
38966,57027,123,48138,123,allow,184,94,90,2,30,1,1
38967,55261,53,52795,53,allow,183,94,89,2,30,1,1
38968,65080,53,25627,53,allow,209,110,99,2,30,1,1
38969,50686,443,65474,443,allow,6586,1807,4779,23,360,12,11
38970,10151,54168,22661,54168,allow,479,150,329,2,1200,1,1
38971,57265,53,29608,53,allow,200,102,98,2,31,1,1
38972,41027,80,63019,80,allow,540,540,0,10,186,10,0
38973,61229,443,47952,443,allow,12708,2798,9910,36,258,13,23
38974,50802,443,32989,443,allow,207859,77557,130302,849,753,312,537
38975,57470,20433,47061,20433,allow,726,726,0,12,1200,12,0
38976,65080,53,11923,53,allow,209,110,99,2,30,1,1
38977,50477,443,26806,443,allow,55388,4069,51319,94,240,46,48
38978,57470,59208,35897,59208,allow,1367,664,703,16,1199,9,7
38979,56674,53,17434,53,allow,183,94,89,2,31,1,1
38980,65354,53,35359,53,allow,272,94,178,2,31,1,1
38981,57470,10154,49581,10154,allow,924,924,0,15,1200,15,0
38982,64085,53,40904,53,allow,195,94,101,2,31,1,1
38983,49740,53,60867,53,allow,341,85,256,4,42,2,2
38984,62021,443,62021,443,allow,4625,1718,2907,19,27,11,8
38985,53272,80,30742,80,allow,11060,3925,7135,24,108,13,11
38986,56950,443,41087,443,allow,5601,1203,4398,14,60,9,5
38987,39880,80,44153,80,allow,1779,793,986,17,58,6,11
38988,50825,443,14787,443,allow,6601,1120,5481,17,116,9,8
38989,56260,80,50522,80,allow,72600,58760,13840,186,1232,107,79
38990,56951,443,11252,443,allow,5601,1203,4398,14,60,9,5
38991,43412,443,47585,443,allow,2423,1465,958,18,171,10,8
38992,39743,80,10677,80,allow,1563,570,993,10,16,6,4
38993,49415,53,12077,53,allow,313,83,230,4,54,2,2
38994,63870,6881,25073,6881,allow,70,70,0,1,5,1,0
38995,63864,44139,53899,44139,allow,70,70,0,1,5,1,0
38996,56947,443,19771,443,allow,5601,1203,4398,14,60,9,5
38997,56952,443,36539,443,allow,5601,1203,4398,14,60,9,5
38998,49740,53,35003,53,allow,167,86,81,2,30,1,1
38999,62068,64147,0,0,deny,66,66,0,1,0,1,0
39000,57496,445,0,0,drop,70,70,0,1,0,1,0
39001,62380,445,0,0,drop,70,70,0,1,0,1,0
39002,57786,445,0,0,drop,66,66,0,1,0,1,0
39003,57784,445,0,0,drop,66,66,0,1,0,1,0
39004,57782,445,0,0,drop,66,66,0,1,0,1,0
39005,28176,35440,0,0,deny,146,146,0,1,0,1,0
39006,57493,445,0,0,drop,70,70,0,1,0,1,0
39007,57780,445,0,0,drop,66,66,0,1,0,1,0
39008,56646,48817,0,0,deny,62,62,0,1,0,1,0
39009,53543,44847,0,0,deny,146,146,0,1,0,1,0
39010,41840,50584,0,0,deny,66,66,0,1,0,1,0
39011,40731,2323,0,0,deny,60,60,0,1,0,1,0
39012,52472,51221,0,0,deny,74,74,0,1,0,1,0
39013,62375,445,0,0,drop,70,70,0,1,0,1,0
39014,26085,51221,0,0,deny,72,72,0,1,0,1,0
39015,62371,445,0,0,drop,70,70,0,1,0,1,0
39016,62369,445,0,0,drop,70,70,0,1,0,1,0
39017,57488,445,0,0,drop,70,70,0,1,0,1,0
39018,5688,44847,0,0,deny,66,66,0,1,0,1,0
39019,63096,44847,0,0,deny,66,66,0,1,0,1,0
39020,57487,445,0,0,drop,70,70,0,1,0,1,0
39021,29017,2222,0,0,deny,60,60,0,1,0,1,0
39022,28754,50584,0,0,deny,62,62,0,1,0,1,0
39023,6666,50070,0,0,deny,60,60,0,1,0,1,0
39024,46829,64147,0,0,deny,146,146,0,1,0,1,0
39025,54280,3398,0,0,deny,60,60,0,1,0,1,0
39026,57485,445,0,0,drop,70,70,0,1,0,1,0
39027,53667,56205,0,0,deny,62,62,0,1,0,1,0
39028,6721,37965,0,0,deny,66,66,0,1,0,1,0
39029,17800,3389,17800,3389,reset-both,293,223,70,4,0,3,1
39030,22285,3389,22285,3389,reset-both,293,223,70,4,0,3,1
39031,19626,3389,19626,3389,reset-both,293,223,70,4,0,3,1
39032,57769,445,0,0,drop,66,66,0,1,0,1,0
39033,61945,48817,0,0,deny,62,62,0,1,0,1,0
39034,12226,37965,0,0,deny,62,62,0,1,0,1,0
39035,44529,6881,0,0,deny,146,146,0,1,0,1,0
39036,57762,445,0,0,drop,66,66,0,1,0,1,0
39037,62352,445,0,0,drop,70,70,0,1,0,1,0
39038,57478,445,0,0,drop,70,70,0,1,0,1,0
39039,57476,445,0,0,drop,70,70,0,1,0,1,0
39040,52537,37965,0,0,deny,66,66,0,1,0,1,0
39041,57760,445,0,0,drop,66,66,0,1,0,1,0
39042,23969,57470,0,0,deny,62,62,0,1,0,1,0
39043,57475,445,0,0,drop,70,70,0,1,0,1,0
39044,54552,64147,0,0,deny,62,62,0,1,0,1,0
39045,58973,57470,0,0,deny,66,66,0,1,0,1,0
39046,16134,45680,0,0,deny,148,148,0,1,0,1,0
39047,57474,445,0,0,drop,70,70,0,1,0,1,0
39048,57473,445,0,0,drop,70,70,0,1,0,1,0
39049,57987,56125,0,0,deny,90,90,0,1,0,1,0
39050,57467,445,0,0,drop,70,70,0,1,0,1,0
39051,57470,445,0,0,drop,70,70,0,1,0,1,0
39052,57752,445,0,0,drop,66,66,0,1,0,1,0
39053,57750,445,0,0,drop,66,66,0,1,0,1,0
39054,58226,52848,0,0,deny,62,62,0,1,0,1,0
39055,50470,61463,0,0,deny,86,86,0,1,0,1,0
39056,57455,445,0,0,drop,70,70,0,1,0,1,0
39057,57454,445,0,0,drop,70,70,0,1,0,1,0
39058,60426,57470,0,0,deny,62,62,0,1,0,1,0
39059,57450,445,0,0,drop,70,70,0,1,0,1,0
39060,57445,445,0,0,drop,70,70,0,1,0,1,0
39061,57444,445,0,0,drop,70,70,0,1,0,1,0
39062,26937,23,0,0,deny,60,60,0,1,0,1,0
39063,29011,32468,0,0,deny,62,62,0,1,0,1,0
39064,49001,40108,0,0,deny,161,161,0,1,0,1,0
39065,26048,21,0,0,deny,60,60,0,1,0,1,0
39066,49305,57470,0,0,deny,66,66,0,1,0,1,0
39067,62343,445,0,0,drop,70,70,0,1,0,1,0
39068,50156,53,2104,53,allow,777,87,690,2,0,1,1
39069,62341,445,0,0,drop,70,70,0,1,0,1,0
39070,62340,445,0,0,drop,70,70,0,1,0,1,0
39071,57729,445,0,0,drop,66,66,0,1,0,1,0
39072,57732,445,0,0,drop,66,66,0,1,0,1,0
39073,57736,445,0,0,drop,66,66,0,1,0,1,0
39074,57737,445,0,0,drop,66,66,0,1,0,1,0
39075,57733,445,0,0,drop,66,66,0,1,0,1,0
39076,57734,445,0,0,drop,66,66,0,1,0,1,0
39077,57730,445,0,0,drop,66,66,0,1,0,1,0
39078,57731,445,0,0,drop,66,66,0,1,0,1,0
39079,63027,35440,0,0,deny,66,66,0,1,0,1,0
39080,1038,37965,0,0,deny,62,62,0,1,0,1,0
39081,9529,26467,0,0,deny,62,62,0,1,0,1,0
39082,52459,33890,0,0,deny,60,60,0,1,0,1,0
39083,57433,445,0,0,drop,70,70,0,1,0,1,0
39084,63288,52848,0,0,deny,66,66,0,1,0,1,0
39085,59147,51505,0,0,deny,66,66,0,1,0,1,0
39086,52459,33890,0,0,deny,60,60,0,1,0,1,0
39087,62347,25,62347,25,deny,291,126,165,4,0,2,2
39088,61147,22114,0,0,deny,66,66,0,1,0,1,0
39089,59095,57470,0,0,deny,66,66,0,1,0,1,0
39090,62336,445,0,0,drop,70,70,0,1,0,1,0
39091,62329,445,0,0,drop,70,70,0,1,0,1,0
39092,2691,64147,0,0,deny,62,62,0,1,0,1,0
39093,62324,445,0,0,drop,70,70,0,1,0,1,0
39094,55386,37965,0,0,deny,66,66,0,1,0,1,0
39095,68,67,0,0,deny,594,594,0,1,0,1,0
39096,2705,37,0,0,deny,60,60,0,1,0,1,0
39097,51300,64147,0,0,deny,66,66,0,1,0,1,0
39098,57717,445,0,0,drop,66,66,0,1,0,1,0
39099,57716,445,0,0,drop,66,66,0,1,0,1,0
39100,57714,445,0,0,drop,66,66,0,1,0,1,0
39101,49159,23,0,0,deny,60,60,0,1,0,1,0
39102,61744,11392,0,0,deny,66,66,0,1,0,1,0
39103,57429,445,0,0,drop,70,70,0,1,0,1,0
39104,52711,37965,0,0,deny,62,62,0,1,0,1,0
39105,44569,3389,0,0,deny,60,60,0,1,0,1,0
39106,62322,445,0,0,drop,70,70,0,1,0,1,0
39107,57148,23,0,0,deny,60,60,0,1,0,1,0
39108,41197,30188,0,0,deny,146,146,0,1,0,1,0
39109,26351,22114,0,0,deny,62,62,0,1,0,1,0
39110,51185,37965,0,0,deny,66,66,0,1,0,1,0
39111,59563,30188,0,0,deny,66,66,0,1,0,1,0
39112,59985,57470,0,0,deny,66,66,0,1,0,1,0
39113,56186,57470,0,0,deny,62,62,0,1,0,1,0
39114,6881,33156,0,0,deny,146,146,0,1,0,1,0
39115,57419,445,0,0,drop,70,70,0,1,0,1,0
39116,57417,445,0,0,drop,70,70,0,1,0,1,0
39117,57420,445,0,0,drop,70,70,0,1,0,1,0
39118,62320,445,0,0,drop,70,70,0,1,0,1,0
39119,19875,30170,0,0,deny,145,145,0,1,0,1,0
39120,57415,445,0,0,drop,70,70,0,1,0,1,0
39121,62316,445,0,0,drop,70,70,0,1,0,1,0
39122,62315,445,0,0,drop,70,70,0,1,0,1,0
39123,62310,445,0,0,drop,70,70,0,1,0,1,0
39124,57412,445,0,0,drop,70,70,0,1,0,1,0
39125,60857,61689,0,0,deny,146,146,0,1,0,1,0
39126,34983,26543,0,0,deny,145,145,0,1,0,1,0
39127,63765,51221,0,0,deny,62,62,0,1,0,1,0
39128,27898,52700,0,0,deny,62,62,0,1,0,1,0
39129,58207,51505,0,0,deny,62,62,0,1,0,1,0
39130,42044,60043,0,0,deny,66,66,0,1,0,1,0
39131,17781,50265,0,0,deny,62,62,0,1,0,1,0
39132,64614,53,3667,53,allow,186,95,91,2,30,1,1
39133,8883,443,24361,443,allow,9742,2044,7698,30,391,12,18
39134,56745,443,56745,443,allow,101899,20048,81851,132,62,67,65
39135,60433,6881,35052,6881,allow,70,70,0,1,5,1,0
39136,36417,443,45000,443,allow,3579,1914,1665,23,291,8,15
39137,56552,443,10361,443,allow,9518,3057,6461,21,43,12,9
39138,65315,53,25956,53,allow,172,88,84,2,30,1,1
39139,52781,443,23345,443,allow,1581,924,657,15,125,7,8
39140,55784,53,41751,53,allow,184,94,90,2,30,1,1
39141,50082,53,42387,53,allow,774,101,673,2,30,1,1
39142,50318,53,63172,53,allow,732,89,643,2,30,1,1
39143,38065,443,63899,443,allow,15799,7457,8342,42,98,22,20
39144,56746,443,56746,443,allow,68504,9909,58595,93,62,46,47
39145,56957,443,26018,443,allow,4359,924,3435,15,59,9,6
39146,56956,443,35896,443,allow,4359,924,3435,15,59,9,6
39147,50906,443,11737,443,allow,124,64,60,2,15,1,1
39148,52056,80,60936,80,allow,3641,846,2795,18,44,7,11
39149,10047,443,65295,443,allow,25316,10344,14972,84,170,48,36
39150,64567,53,15933,53,allow,198,101,97,2,30,1,1
39151,50905,443,13622,443,allow,124,64,60,2,15,1,1
39152,52783,443,32956,443,allow,1581,924,657,15,125,7,8
39153,55018,53,31411,53,allow,174,89,85,2,30,1,1
39154,53718,443,33767,443,allow,318,192,126,6,16,4,2
39155,64144,53,48969,53,allow,186,95,91,2,30,1,1
39156,63866,17623,15201,17623,allow,66,66,0,1,5,1,0
39157,38058,443,33797,443,allow,22970,12439,10531,61,98,32,29
39158,51317,443,42808,443,allow,3565,640,2925,16,153,7,9
39159,51900,15755,25086,15755,allow,316,136,180,6,6,3,3
39160,56388,53,28613,53,allow,186,95,91,3,46,2,1
39161,55655,63670,23563,63670,allow,70,70,0,2,8,2,0
39162,47642,443,46910,443,allow,12735,10573,2162,33,316,16,17
39163,38545,443,54573,443,allow,4961,2148,2813,30,90,13,17
39164,57290,53,48036,53,allow,758,93,665,2,30,1,1
39165,49418,53,11471,53,allow,776,102,674,2,30,1,1
39166,62063,443,35010,443,allow,25511,1260,24251,34,121,13,21
39167,57308,443,38390,443,allow,36373,15248,21125,172,123,69,103
39168,56853,13203,65279,13203,allow,316,136,180,6,6,3,3
39169,52782,443,35099,443,allow,1581,924,657,15,125,7,8
39170,55658,45261,40194,45261,allow,70,70,0,2,8,2,0
39171,53465,80,64691,80,allow,1360,540,820,20,187,10,10
39172,47728,443,8590,443,allow,8404,3653,4751,25,256,14,11
39173,63865,48610,9039,48610,allow,66,66,0,1,5,1,0
39174,50999,443,32321,443,allow,3051,1801,1250,18,16,8,10
39175,11295,40002,5818,40002,allow,356,170,186,6,53,3,3
39176,5588,5588,0,0,allow,3562,1936,1626,48,195,24,24
39177,65321,53,29738,53,allow,166,85,81,2,30,1,1
39178,65175,53,9313,53,allow,778,103,675,2,30,1,1
39179,55821,53,64842,53,allow,192,98,94,2,30,1,1
39180,49740,53,20760,53,allow,166,85,81,2,30,1,1
39181,49573,443,16183,443,allow,7332,2197,5135,18,135,8,10
39182,51772,443,20083,443,allow,2320,327,1993,11,135,5,6
39183,56448,53,33079,53,allow,200,102,98,2,30,1,1
39184,64331,53,12876,53,allow,174,89,85,2,31,1,1
39185,56655,53,60599,53,allow,168,86,82,2,31,1,1
39186,58986,443,40709,443,allow,10624,6845,3779,50,123,25,25
39187,49351,53,12256,53,allow,164,84,80,2,30,1,1
39188,50534,53,37578,53,allow,168,86,82,2,31,1,1
39189,64967,53,49030,53,allow,184,94,90,2,31,1,1
39190,49350,80,49350,80,allow,450,246,204,8,142,5,3
39191,49346,80,49346,80,allow,450,246,204,8,142,5,3
39192,49345,80,49345,80,allow,450,246,204,8,142,5,3
39193,56331,443,61535,443,allow,1786,172,1614,7,121,3,4
39194,49531,53,3594,53,allow,182,93,89,2,31,1,1
39195,65341,53,36456,53,allow,200,102,98,2,31,1,1
39196,53284,443,5586,443,allow,4579,2245,2334,12,122,6,6
39197,48909,5228,27859,5228,allow,11007,2491,8516,44,4411,18,26
39198,57078,443,63821,443,allow,4730,2569,2161,16,135,8,8
39199,6882,6889,29221,6889,allow,221,111,110,2,1201,1,1
39200,9144,3389,9144,3389,reset-both,293,223,70,4,1,3,1
39201,38554,3389,38554,3389,reset-both,293,223,70,4,1,3,1
39202,24041,55783,0,0,deny,62,62,0,1,0,1,0
39203,57406,445,0,0,drop,70,70,0,1,0,1,0
39204,38126,3389,38126,3389,reset-both,293,223,70,4,1,3,1
39205,57020,36237,0,0,deny,66,66,0,1,0,1,0
39206,58922,57470,0,0,deny,66,66,0,1,0,1,0
39207,62301,445,0,0,drop,70,70,0,1,0,1,0
39208,62297,445,0,0,drop,70,70,0,1,0,1,0
39209,62296,445,0,0,drop,70,70,0,1,0,1,0
39210,37075,3389,37075,3389,reset-both,293,223,70,4,1,3,1
39211,10967,3389,10967,3389,reset-both,293,223,70,4,1,3,1
39212,55706,53,61735,53,allow,209,110,99,2,30,1,1
39213,64144,53,47875,53,allow,193,102,91,2,30,1,1
39214,59728,80,65227,80,allow,821011,16040,804971,778,100,238,540
39215,64373,53,26971,53,allow,554,96,458,4,60,2,2
39216,54435,443,54824,443,allow,18802,3386,15416,54,293,28,26
39217,57163,53,34170,53,allow,209,110,99,2,30,1,1
39218,58049,443,10248,443,allow,8242,1641,6601,22,360,12,10
39219,49435,443,28726,443,allow,8602,1050,7552,16,120,7,9
39220,54763,443,60297,443,allow,7136,5777,1359,22,200,13,9
39221,38671,443,56566,443,allow,90139,3545,86594,96,15,32,64
39222,56948,443,19472,443,allow,5601,1203,4398,14,59,9,5
39223,53712,44822,45976,44822,allow,320,140,180,6,5,3,3
39224,63868,60392,13062,60392,allow,70,70,0,1,4,1,0
39225,64519,53,14591,53,allow,195,102,93,2,29,1,1
39226,49740,53,58621,53,allow,167,86,81,2,29,1,1
39227,60520,53,60520,53,allow,248,106,142,2,29,1,1
39228,51822,80,12401,80,allow,3709,1390,2319,17,19,10,7
39229,54489,53,0,0,allow,418,154,264,4,33,2,2
39230,38670,443,55536,443,allow,501559,13849,487710,527,15,193,334
39231,8380,80,8380,80,allow,25613,1592,24021,32,22,9,23
39232,64604,53,45485,53,allow,429,109,320,4,37,2,2
39233,10011,443,63236,443,allow,14565,3464,11101,59,151,31,28
39234,56497,80,9145,80,allow,410119,16112,394007,424,63,155,269
39235,56949,443,2703,443,allow,5601,1203,4398,14,59,9,5
39236,53711,30355,27778,30355,allow,320,140,180,6,5,3,3
39237,53703,16426,15322,16426,allow,70,70,0,2,7,2,0
39238,49752,53,44269,53,allow,182,94,88,2,29,1,1
39239,65321,53,58472,53,allow,167,86,81,2,29,1,1
39240,63867,43618,49838,43618,allow,70,70,0,1,4,1,0
39241,64312,53,28741,53,allow,209,110,99,2,29,1,1
39242,64127,53,58268,53,allow,177,94,83,2,30,1,1
39243,56388,53,20730,53,allow,275,95,180,4,44,2,2
39244,53704,15000,2505,15000,allow,70,70,0,2,7,2,0
39245,55018,53,64174,53,allow,312,89,223,4,36,2,2
39246,49781,53,31272,53,allow,194,102,92,2,29,1,1
39247,56747,443,56747,443,allow,33901,9598,24303,56,61,32,24
39248,56913,53,31255,53,allow,193,102,91,2,29,1,1
39249,65321,53,36858,53,allow,167,86,81,2,29,1,1
39250,49351,53,13338,53,allow,166,86,80,2,30,1,1
39251,54463,53,52007,53,allow,164,78,86,2,30,1,1
39252,51295,443,51295,443,allow,4334,1427,2907,19,27,11,8
39253,51902,443,16953,443,allow,6155,888,5267,17,15,8,9
39254,63859,80,37247,80,allow,314,192,122,6,15,4,2
39255,56674,53,20676,53,allow,183,94,89,2,30,1,1
39256,55706,53,23729,53,allow,209,110,99,2,30,1,1
39257,50707,53,59770,53,allow,181,86,95,2,30,1,1
39258,20746,53,43830,53,allow,191,86,105,2,30,1,1
39259,57282,53,14101,53,allow,199,102,97,2,30,1,1
39260,56491,443,52771,443,allow,6066,1016,5050,20,26,11,9
39261,65136,53,56790,53,allow,335,84,251,4,32,2,2
39262,51879,38564,56529,38564,allow,70,70,0,1,5,1,0
39263,56636,80,30803,80,allow,234,234,0,4,12,4,0
39264,40512,80,26257,80,allow,2543,691,1852,13,17,8,5
39265,56499,80,63072,80,allow,277848,13775,264073,301,63,118,183
39266,46778,53,46778,53,allow,214,82,132,2,30,1,1
39267,56492,443,53818,443,allow,6066,1016,5050,20,26,11,9
39268,56734,443,56734,443,allow,373876,52153,321723,424,87,185,239
39269,34001,53,36189,53,allow,225,78,147,2,30,1,1
39270,49627,443,59623,443,allow,20583,3435,17148,54,95,27,27
39271,49806,53,63116,53,allow,242,118,124,2,30,1,1
39272,54375,443,15828,443,allow,5642,3872,1770,32,81,17,15
39273,64744,3389,64744,3389,allow,3428,1714,1714,16,33,8,8
39274,55784,53,32669,53,allow,184,94,90,2,30,1,1
39275,55706,53,42379,53,allow,209,110,99,2,30,1,1
39276,56674,53,8365,53,allow,183,94,89,2,30,1,1
39277,56448,53,9031,53,allow,200,102,98,2,30,1,1
39278,55784,53,2771,53,allow,184,94,90,2,30,1,1
39279,56500,80,50985,80,allow,177736,11174,166562,198,63,77,121
39280,38666,443,18669,443,allow,94827,3328,91499,97,16,30,67
39281,65445,53,54616,53,allow,199,102,97,2,30,1,1
39282,56448,53,7304,53,allow,200,102,98,2,30,1,1
39283,64614,53,56180,53,allow,193,102,91,2,30,1,1
39284,56498,53,39557,53,allow,199,102,97,2,30,1,1
39285,21147,53,21147,53,allow,1413,688,725,3,30,2,1
39286,19473,13315,3345,13315,allow,460,150,310,2,1200,1,1
39287,53328,53,0,0,allow,418,154,264,4,33,2,2
39288,60766,28080,32813,28080,allow,70,70,0,1,5,1,0
39289,36230,443,36230,443,allow,4681,1774,2907,19,30,11,8
39290,35584,80,52820,80,allow,1507,454,1053,10,15,5,5
39291,56498,80,33330,80,allow,174021,11443,162578,197,63,81,116
39292,47161,443,37026,443,allow,11342,3715,7627,28,92,17,11
39293,47045,53,20106,53,allow,225,78,147,2,30,1,1
39294,65162,53,50444,53,allow,328,102,226,2,30,1,1
39295,50542,53,12388,53,allow,782,110,672,2,30,1,1
39296,53238,443,11082,443,allow,27650,12347,15303,47,53,24,23
39297,50483,443,61825,443,allow,12462,2612,9850,37,80,19,18
39298,51957,443,52201,443,allow,3516,1732,1784,34,42,19,15
39299,50232,28356,48349,28356,allow,4728691,2246710,2481981,40252,1121,19716,20536
39300,60111,443,2026,443,allow,11519,3163,8356,51,25,26,25
39301,60770,40010,17084,40010,allow,316,136,180,6,6,3,3
39302,51902,55933,35723,55933,allow,316,136,180,6,5,3,3
39303,64420,53,3288,53,allow,194,102,92,2,31,1,1
39304,51880,18468,34831,18468,allow,70,70,0,1,5,1,0
39305,53702,51413,14183,51413,allow,70,70,0,2,7,2,0
39306,51894,26116,38290,26116,allow,70,70,0,2,8,2,0
39307,63869,34368,37141,34368,allow,70,70,0,1,4,1,0
39308,51901,443,44241,443,allow,6215,948,5267,18,15,9,9
39309,55648,80,35736,80,allow,70,70,0,1,5,1,0
39310,51903,443,13827,443,allow,1612,1089,523,12,15,7,5
39311,53402,443,53402,443,allow,4582,1675,2907,19,29,11,8
39312,65382,443,15464,443,allow,15607,5238,10369,36,126,19,17
39313,53623,50093,42211,50093,allow,552,306,246,9,38,5,4
39314,9100,443,50468,443,allow,4945,431,4514,12,15,6,6
39315,49212,53,38007,53,allow,183,94,89,2,29,1,1
39316,56501,80,5186,80,allow,300370,14101,286269,313,63,116,197
39317,55261,53,52324,53,allow,183,94,89,2,29,1,1
39318,64525,53,5631,53,allow,199,102,97,2,29,1,1
39319,57265,53,15033,53,allow,200,102,98,2,30,1,1
39320,49780,53,34638,53,allow,183,94,89,2,29,1,1
39321,56498,53,6287,53,allow,199,102,97,2,30,1,1
39322,49800,53,33373,53,allow,183,94,89,2,29,1,1
39323,55018,53,37429,53,allow,179,94,85,2,30,1,1
39324,56388,53,28849,53,allow,193,102,91,2,29,1,1
39325,50405,53,20541,53,allow,200,102,98,2,29,1,1
39326,56305,53,56939,53,allow,242,118,124,2,30,1,1
39327,64022,53,2782,53,allow,197,102,95,2,30,1,1
39328,52361,53,7907,53,allow,186,78,108,2,29,1,1
39329,49979,53,49459,53,allow,197,94,103,2,30,1,1
39330,50013,53,7317,53,allow,199,102,97,2,30,1,1
39331,60166,53,7820,53,allow,258,94,164,2,30,1,1
39332,64567,53,19362,53,allow,199,102,97,2,30,1,1
39333,57163,53,45195,53,allow,209,110,99,2,30,1,1
39334,27327,53,27327,53,allow,823,98,725,2,30,1,1
39335,56655,53,60035,53,allow,168,86,82,2,30,1,1
39336,44913,80,22574,80,allow,1270,387,883,16,393,4,12
39337,57470,6881,33137,6881,allow,792,792,0,13,1200,13,0
39338,64525,53,61457,53,allow,199,102,97,2,30,1,1
39339,49384,53,48199,53,allow,193,102,91,2,31,1,1
39340,49632,53,3027,53,allow,199,102,97,2,31,1,1
39341,51909,80,5336,80,allow,6057,4543,1514,16,15,9,7
39342,11295,40033,3453,40033,allow,213,89,124,4,32,2,2
39343,55656,31165,21172,31165,allow,70,70,0,2,8,2,0
39344,51893,63924,11081,63924,allow,70,70,0,2,8,2,0
39345,51896,43357,29923,43357,allow,70,70,0,2,8,2,0
39346,26943,443,22865,443,allow,21275,16156,5119,41,22,23,18
39347,52624,443,65468,443,allow,5837,1982,3855,19,19,11,8
39348,64425,53,23618,53,allow,289,134,155,2,30,1,1
39349,49351,53,27652,53,allow,166,86,80,2,30,1,1
39350,57047,53,31984,53,allow,198,94,104,2,31,1,1
39351,49516,53,42173,53,allow,183,94,89,2,30,1,1
39352,55657,37273,33354,37273,allow,70,70,0,2,8,2,0
39353,51895,17172,52457,17172,allow,70,70,0,2,8,2,0
39354,51897,57057,49158,57057,allow,70,70,0,2,8,2,0
39355,48371,443,24225,443,allow,3908,630,3278,12,17,7,5
39356,9105,443,49589,443,allow,4077,438,3639,12,15,6,6
39357,37236,53,35776,53,allow,223,78,145,2,30,1,1
39358,50013,53,8187,53,allow,199,102,97,2,30,1,1
39359,65315,53,36625,53,allow,94,94,0,1,30,1,0
39360,38667,443,44334,443,allow,496852,12216,484636,499,16,167,332
39361,53504,443,31592,443,allow,2291912,60511,2231401,2353,196,863,1490
39362,60431,52867,18137,52867,allow,70,70,0,1,5,1,0
39363,55784,53,64875,53,allow,330,94,236,4,48,2,2
39364,56388,53,34689,53,allow,275,95,180,4,49,2,2
39365,49460,53,64925,53,allow,458,188,270,6,30,3,3
39366,65445,53,31304,53,allow,199,102,97,2,30,1,1
39367,56432,53,34927,53,allow,458,188,270,6,30,3,3
39368,52501,443,44230,443,allow,163226,10147,153079,233,101,101,132
39369,55018,53,50628,53,allow,179,94,85,2,30,1,1
39370,49531,53,34898,53,allow,183,94,89,2,30,1,1
39371,65228,53,53617,53,allow,212,86,126,2,30,1,1
39372,49997,53,1711,53,allow,209,110,99,2,30,1,1
39373,64967,53,49368,53,allow,184,94,90,2,31,1,1
39374,65365,53,42836,53,allow,196,102,94,2,31,1,1
39375,41876,80,9169,80,allow,1740,708,1032,19,396,6,13
39376,34548,443,60764,443,allow,11549,3378,8171,33,196,16,17
39377,49348,80,49348,80,allow,450,246,204,8,142,5,3
39378,45780,443,35080,443,allow,7847,1591,6256,23,186,13,10
39379,57470,6881,47770,6881,allow,330,330,0,6,1200,6,0
39380,21133,18719,1173,18719,allow,150,150,0,1,1200,1,0
39381,57018,53,4073,53,allow,209,110,99,2,30,1,1
39382,65341,53,7483,53,allow,200,102,98,2,30,1,1
39383,49737,53,3736,53,allow,338,110,228,2,30,1,1
39384,64331,53,26878,53,allow,324,89,235,4,31,2,2
39385,51208,443,14745,443,allow,3477,1216,2261,16,136,8,8
39386,52201,443,3597,443,allow,5681,1441,4240,21,51,11,10
39387,63861,37832,64694,37832,allow,70,70,0,1,5,1,0
39388,51089,80,45189,80,allow,6240,4510,1730,40,131,22,18
39389,50286,443,30253,443,allow,10203,2365,7838,40,86,22,18
39390,33150,53,60040,53,allow,816,228,588,8,30,4,4
39391,63959,53,54075,53,allow,246,102,144,2,31,1,1
39392,59851,80,45085,80,allow,307815,6418,301397,285,63,84,201
39393,57593,80,6872,80,allow,486,280,206,8,26,5,3
39394,65155,53,63407,53,allow,295,103,192,4,49,2,2
39395,50021,53,58776,53,allow,963,391,572,10,83,5,5
39396,51901,15860,21103,15860,allow,316,136,180,6,6,3,3
39397,52327,443,53473,443,allow,134,60,74,3,6,2,1
39398,51092,80,39250,80,allow,3974,2713,1261,34,131,19,15
39399,49278,80,32439,80,allow,991,525,466,10,136,6,4
39400,64331,53,61619,53,allow,179,94,85,2,30,1,1
39401,56636,53,19411,53,allow,302,86,216,2,30,1,1
39402,50534,53,27625,53,allow,168,86,82,2,30,1,1
39403,64933,53,11327,53,allow,349,94,255,2,30,1,1
39404,21502,44847,0,0,deny,66,66,0,1,0,1,0
39405,57399,445,0,0,drop,70,70,0,1,0,1,0
39406,443,36576,0,0,deny,60,60,0,1,0,1,0
39407,57398,445,0,0,drop,70,70,0,1,0,1,0
39408,62115,57470,0,0,deny,66,66,0,1,0,1,0
39409,26793,3389,26793,3389,reset-both,293,223,70,4,1,3,1
39410,64605,35993,0,0,deny,62,62,0,1,0,1,0
39411,12604,3389,12604,3389,reset-both,293,223,70,4,1,3,1
39412,57392,445,0,0,drop,70,70,0,1,0,1,0
39413,57692,445,0,0,drop,66,66,0,1,0,1,0
39414,32707,11392,0,0,deny,146,146,0,1,0,1,0
39415,62292,445,0,0,drop,70,70,0,1,0,1,0
39416,62294,445,0,0,drop,70,70,0,1,0,1,0
39417,57389,445,0,0,drop,70,70,0,1,0,1,0
39418,56413,51221,0,0,deny,66,66,0,1,0,1,0
39419,1030,44847,0,0,deny,146,146,0,1,0,1,0
39420,57151,39004,0,0,deny,66,66,0,1,0,1,0
39421,45908,3383,0,0,deny,60,60,0,1,0,1,0
39422,6881,6881,0,0,deny,146,146,0,1,0,1,0
39423,44568,3389,0,0,deny,60,60,0,1,0,1,0
39424,28809,50584,0,0,deny,66,66,0,1,0,1,0
39425,57689,445,0,0,drop,66,66,0,1,0,1,0
39426,57687,445,0,0,drop,66,66,0,1,0,1,0
39427,61522,64147,0,0,deny,66,66,0,1,0,1,0
39428,23900,64147,0,0,deny,62,62,0,1,0,1,0
39429,57385,445,0,0,drop,70,70,0,1,0,1,0
39430,37121,21247,0,0,deny,66,66,0,1,0,1,0
39431,49622,50584,0,0,deny,62,62,0,1,0,1,0
39432,61788,20000,0,0,deny,60,60,0,1,0,1,0
39433,57384,445,0,0,drop,70,70,0,1,0,1,0
39434,15333,44847,0,0,deny,62,62,0,1,0,1,0
39435,62284,445,0,0,drop,70,70,0,1,0,1,0
39436,62278,445,0,0,drop,70,70,0,1,0,1,0
39437,62277,445,0,0,drop,70,70,0,1,0,1,0
39438,62276,445,0,0,drop,70,70,0,1,0,1,0
39439,57987,56125,0,0,deny,90,90,0,1,0,1,0
39440,57684,445,0,0,drop,66,66,0,1,0,1,0
39441,56693,1900,0,0,deny,139,139,0,1,0,1,0
39442,57673,445,0,0,drop,66,66,0,1,0,1,0
39443,57668,445,0,0,drop,66,66,0,1,0,1,0
39444,57670,445,0,0,drop,66,66,0,1,0,1,0
39445,57676,445,0,0,drop,66,66,0,1,0,1,0
39446,57667,445,0,0,drop,66,66,0,1,0,1,0
39447,57672,445,0,0,drop,66,66,0,1,0,1,0
39448,57678,445,0,0,drop,66,66,0,1,0,1,0
39449,14997,57470,0,0,deny,72,72,0,1,0,1,0
39450,57379,445,0,0,drop,70,70,0,1,0,1,0
39451,9687,57470,0,0,deny,78,78,0,1,0,1,0
39452,50470,61463,0,0,deny,86,86,0,1,0,1,0
39453,62267,445,0,0,drop,70,70,0,1,0,1,0
39454,17344,62413,0,0,deny,66,66,0,1,0,1,0
39455,33786,23,0,0,deny,60,60,0,1,0,1,0
39456,62265,445,0,0,drop,70,70,0,1,0,1,0
39457,62261,445,0,0,drop,70,70,0,1,0,1,0
39458,62263,445,0,0,drop,70,70,0,1,0,1,0
39459,56944,35894,0,0,deny,62,62,0,1,0,1,0
39460,26953,30317,0,0,deny,62,62,0,1,0,1,0
39461,65388,55783,0,0,deny,66,66,0,1,0,1,0
39462,27528,35440,0,0,deny,66,66,0,1,0,1,0
39463,60361,57470,0,0,deny,66,66,0,1,0,1,0
39464,51401,6881,0,0,deny,66,66,0,1,0,1,0
39465,57366,445,0,0,drop,70,70,0,1,0,1,0
39466,65494,53,0,0,deny,88,88,0,1,0,1,0
39467,62259,445,0,0,drop,70,70,0,1,0,1,0
39468,62257,445,0,0,drop,70,70,0,1,0,1,0
39469,62255,445,0,0,drop,70,70,0,1,0,1,0
39470,57662,445,0,0,drop,66,66,0,1,0,1,0
39471,62252,445,0,0,drop,70,70,0,1,0,1,0
39472,61336,61689,0,0,deny,62,62,0,1,0,1,0
39473,57657,445,0,0,drop,66,66,0,1,0,1,0
39474,31748,56205,0,0,deny,62,62,0,1,0,1,0
39475,57363,445,0,0,drop,70,70,0,1,0,1,0
39476,57656,445,0,0,drop,66,66,0,1,0,1,0
39477,57655,445,0,0,drop,66,66,0,1,0,1,0
39478,57652,445,0,0,drop,66,66,0,1,0,1,0
39479,40369,57470,0,0,deny,62,62,0,1,0,1,0
39480,29300,35440,0,0,deny,146,146,0,1,0,1,0
39481,45690,60038,0,0,reset-both,62,62,0,1,0,1,0
39482,55505,53,61786,53,allow,198,101,97,2,1,1,1
39483,57665,52700,0,0,deny,66,66,0,1,0,1,0
39484,58743,35894,0,0,deny,62,62,0,1,0,1,0
39485,57358,445,0,0,drop,70,70,0,1,0,1,0
39486,62247,445,0,0,drop,70,70,0,1,0,1,0
39487,57357,445,0,0,drop,70,70,0,1,0,1,0
39488,62243,445,0,0,drop,70,70,0,1,0,1,0
39489,62235,445,0,0,drop,70,70,0,1,0,1,0
39490,57355,445,0,0,drop,70,70,0,1,0,1,0
39491,38400,51505,0,0,deny,146,146,0,1,0,1,0
39492,47515,5900,0,0,deny,60,60,0,1,0,1,0
39493,57641,445,0,0,drop,66,66,0,1,0,1,0
39494,27209,30170,0,0,deny,145,145,0,1,0,1,0
39495,37420,44847,0,0,deny,62,62,0,1,0,1,0
39496,1024,62609,0,0,deny,148,148,0,1,0,1,0
39497,47134,37965,0,0,deny,62,62,0,1,0,1,0
39498,57348,445,0,0,drop,70,70,0,1,0,1,0
39499,11574,51505,0,0,deny,66,66,0,1,0,1,0
39500,57634,445,0,0,drop,66,66,0,1,0,1,0
39501,16654,50265,0,0,deny,62,62,0,1,0,1,0
39502,28899,37965,0,0,deny,62,62,0,1,0,1,0
39503,62225,445,0,0,drop,70,70,0,1,0,1,0
39504,64681,35993,0,0,deny,62,62,0,1,0,1,0
39505,57346,445,0,0,drop,70,70,0,1,0,1,0
39506,57987,56125,0,0,deny,90,90,0,1,0,1,0
39507,48841,51221,0,0,deny,62,62,0,1,0,1,0
39508,57345,445,0,0,drop,70,70,0,1,0,1,0
39509,57632,445,0,0,drop,66,66,0,1,0,1,0
39510,57344,445,0,0,drop,70,70,0,1,0,1,0
39511,57343,445,0,0,drop,70,70,0,1,0,1,0
39512,57340,445,0,0,drop,70,70,0,1,0,1,0
39513,57339,445,0,0,drop,70,70,0,1,0,1,0
39514,28824,44847,0,0,deny,62,62,0,1,0,1,0
39515,48219,55442,0,0,deny,66,66,0,1,0,1,0
39516,44855,58414,0,0,deny,62,62,0,1,0,1,0
39517,52432,50265,0,0,deny,66,66,0,1,0,1,0
39518,57625,445,0,0,drop,66,66,0,1,0,1,0
39519,0,0,0,0,allow,320,320,0,5,0,5,0
39520,50767,57470,0,0,deny,66,66,0,1,0,1,0
39521,57620,445,0,0,drop,66,66,0,1,0,1,0
39522,57325,445,0,0,drop,70,70,0,1,0,1,0
39523,57324,445,0,0,drop,70,70,0,1,0,1,0
39524,57322,445,0,0,drop,70,70,0,1,0,1,0
39525,62089,8604,0,0,deny,66,66,0,1,0,1,0
39526,52614,44847,0,0,deny,66,66,0,1,0,1,0
39527,57314,445,0,0,drop,70,70,0,1,0,1,0
39528,57315,445,0,0,drop,70,70,0,1,0,1,0
39529,57849,50584,0,0,deny,66,66,0,1,0,1,0
39530,43724,35440,0,0,deny,62,62,0,1,0,1,0
39531,18876,44847,0,0,deny,66,66,0,1,0,1,0
39532,9522,51505,0,0,deny,66,66,0,1,0,1,0
39533,62307,8055,0,0,deny,159,159,0,1,0,1,0
39534,55553,37965,0,0,deny,66,66,0,1,0,1,0
39535,50292,22114,0,0,deny,66,66,0,1,0,1,0
39536,51015,64147,0,0,deny,145,145,0,1,0,1,0
39537,62215,445,0,0,drop,70,70,0,1,0,1,0
39538,62213,445,0,0,drop,70,70,0,1,0,1,0
39539,62212,445,0,0,drop,70,70,0,1,0,1,0
39540,57608,445,0,0,drop,66,66,0,1,0,1,0
39541,57606,445,0,0,drop,66,66,0,1,0,1,0
39542,57607,445,0,0,drop,66,66,0,1,0,1,0
39543,57602,445,0,0,drop,66,66,0,1,0,1,0
39544,57603,445,0,0,drop,66,66,0,1,0,1,0
39545,57601,445,0,0,drop,66,66,0,1,0,1,0
39546,20508,57470,0,0,deny,62,62,0,1,0,1,0
39547,40521,23117,0,0,deny,62,62,0,1,0,1,0
39548,51581,17546,0,0,deny,66,66,0,1,0,1,0
39549,10436,37965,0,0,deny,62,62,0,1,0,1,0
39550,57237,21247,0,0,deny,62,62,0,1,0,1,0
39551,57303,445,0,0,drop,70,70,0,1,0,1,0
39552,61150,11392,0,0,deny,66,66,0,1,0,1,0
39553,59008,51221,0,0,deny,62,62,0,1,0,1,0
39554,1078,30975,0,0,deny,143,143,0,1,0,1,0
39555,42429,22114,0,0,deny,146,146,0,1,0,1,0
39556,57500,23,0,0,deny,60,60,0,1,0,1,0
39557,50470,61463,0,0,deny,86,86,0,1,0,1,0
39558,61408,30188,0,0,deny,66,66,0,1,0,1,0
39559,53147,37965,0,0,deny,62,62,0,1,0,1,0
39560,15933,64147,0,0,deny,62,62,0,1,0,1,0
39561,62207,445,0,0,drop,70,70,0,1,0,1,0
39562,62211,445,0,0,drop,70,70,0,1,0,1,0
39563,62197,445,0,0,drop,70,70,0,1,0,1,0
39564,57299,445,0,0,drop,70,70,0,1,0,1,0
39565,57589,445,0,0,drop,66,66,0,1,0,1,0
39566,57588,445,0,0,drop,66,66,0,1,0,1,0
39567,57586,445,0,0,drop,66,66,0,1,0,1,0
39568,443,38385,0,0,allow,66,66,0,1,90,1,0
39569,59723,443,54726,443,allow,8380,1882,6498,29,396,9,20
39570,65075,53,1890,53,allow,278,100,178,4,31,2,2
39571,65365,53,19962,53,allow,192,98,94,2,30,1,1
39572,49384,53,2964,53,allow,186,95,91,2,30,1,1
39573,34924,443,1749,443,allow,2401,1149,1252,14,982,7,7
39574,61735,443,32889,443,allow,57467,4506,52961,86,30,42,44
39575,60384,443,14731,443,allow,130,70,60,2,15,1,1
39576,42602,443,64444,443,allow,2378,1126,1252,14,982,7,7
39577,35702,443,5840,443,allow,6751,1889,4862,24,316,13,11
39578,60187,443,37474,443,allow,5656,1936,3720,23,57,11,12
39579,48268,443,29893,443,allow,18462,11672,6790,47,63,26,21
39580,43415,443,53448,443,allow,130,70,60,2,15,1,1
39581,60362,443,18140,443,allow,130,70,60,2,15,1,1
39582,56852,49677,39171,49677,allow,130,70,60,2,5,1,1
39583,50998,443,19722,443,allow,3482,1985,1497,21,17,10,11
39584,50997,443,46270,443,allow,3772,2099,1673,22,18,11,11
39585,53131,44021,31517,44021,allow,698,320,378,10,16,6,4
39586,39572,443,3299,443,allow,2396,1144,1252,14,982,7,7
39587,45363,443,50809,443,allow,2396,1144,1252,14,982,7,7
39588,56772,53,9066,53,allow,168,86,82,2,30,1,1
39589,41632,443,56228,443,allow,8507,4462,4045,27,141,14,13
39590,47595,33439,0,0,allow,106,106,0,1,60,1,0
39591,39716,443,56404,443,allow,131171,10346,120825,183,150,93,90
39592,65155,53,8256,53,allow,295,103,192,4,48,2,2
39593,60378,443,38205,443,allow,130,70,60,2,15,1,1
39594,59835,53,53528,53,allow,168,78,90,2,30,1,1
39595,55644,45579,20057,45579,allow,70,70,0,1,5,1,0
39596,43423,443,64524,443,allow,130,70,60,2,15,1,1
39597,35178,8635,35178,8635,allow,138,78,60,2,5,1,1
39598,55000,5222,35744,5222,allow,32608,22014,10594,225,215,124,101
39599,48269,443,55381,443,allow,4800,3396,1404,19,60,10,9
39600,50996,443,8675,443,allow,3536,2039,1497,22,18,11,11
39601,50661,80,9944,80,allow,2693,461,2232,14,17,6,8
39602,56945,443,12296,443,allow,7818,2136,5682,31,322,14,17
39603,50990,443,22704,443,allow,6090,2628,3462,21,24,11,10
39604,49516,53,51751,53,allow,182,93,89,2,30,1,1
39605,55945,53,51093,53,allow,733,86,647,2,30,1,1
39606,56946,443,38559,443,allow,10408,4790,5618,34,322,16,18
39607,51142,80,61764,80,allow,1114,534,580,12,16,7,5
39608,44912,80,52893,80,allow,1602,1282,320,10,15,5,5
39609,50988,443,14910,443,allow,6938,2686,4252,25,27,12,13
39610,60374,443,9623,443,allow,130,70,60,2,15,1,1
39611,64245,53,8045,53,allow,198,101,97,2,31,1,1
39612,60167,5222,36653,5222,allow,908,650,258,11,20,7,4
39613,56948,53,35699,53,allow,93,93,0,1,30,1,0
39614,63882,49163,63411,49163,allow,66,66,0,2,8,2,0
39615,51878,9999,7906,9999,allow,66,66,0,1,5,1,0
39616,55169,53,64266,53,allow,775,103,672,2,30,1,1
39617,55272,53,11966,53,allow,285,103,182,4,51,2,2
39618,52414,80,51546,80,allow,9534,746,8788,18,49,9,9
39619,55821,53,40940,53,allow,168,86,82,2,30,1,1
39620,57282,53,60817,53,allow,198,101,97,2,30,1,1
39621,64420,53,14172,53,allow,188,96,92,2,30,1,1
39622,49632,53,30803,53,allow,198,101,97,2,30,1,1
39623,58279,443,21713,443,allow,3878,1156,2722,14,136,7,7
39624,52682,443,30711,443,allow,5406,922,4484,19,360,10,9
39625,30188,32873,43392,32873,allow,502,150,352,2,1200,1,1
39626,59772,443,48331,443,allow,181413,11493,169920,167,85,41,126
39627,64483,53,26683,53,allow,168,86,82,2,31,1,1
39628,55714,443,18718,443,allow,11626,4173,7453,25,121,12,13
39629,62616,443,35713,443,allow,32504,1730,30774,44,122,17,27
39630,53283,443,51039,443,allow,3369,1036,2333,11,121,5,6
39631,44858,5228,3088,5228,allow,6819,1586,5233,18,3603,9,9
39632,58080,443,57943,443,allow,646,358,288,10,133,6,4
39633,50303,443,16402,443,allow,13459,1604,11855,27,187,14,13
39634,62194,445,0,0,drop,70,70,0,1,0,1,0
39635,57287,445,0,0,drop,70,70,0,1,0,1,0
39636,57290,445,0,0,drop,70,70,0,1,0,1,0
39637,55733,51505,0,0,deny,66,66,0,1,0,1,0
39638,57289,445,0,0,drop,70,70,0,1,0,1,0
39639,53971,50265,0,0,deny,66,66,0,1,0,1,0
39640,57286,445,0,0,drop,70,70,0,1,0,1,0
39641,12060,37965,0,0,deny,66,66,0,1,0,1,0
39642,61135,50265,0,0,deny,62,62,0,1,0,1,0
39643,53971,55442,0,0,deny,66,66,0,1,0,1,0
39644,57282,445,0,0,drop,70,70,0,1,0,1,0
39645,54423,21247,0,0,deny,62,62,0,1,0,1,0
39646,62192,445,0,0,drop,70,70,0,1,0,1,0
39647,63589,44847,0,0,deny,66,66,0,1,0,1,0
39648,62188,445,0,0,drop,70,70,0,1,0,1,0
39649,62184,445,0,0,drop,70,70,0,1,0,1,0
39650,62180,445,0,0,drop,70,70,0,1,0,1,0
39651,24311,22617,0,0,deny,60,60,0,1,0,1,0
39652,64958,53,33266,53,allow,395,102,293,2,30,1,1
39653,55272,53,17246,53,allow,285,103,182,4,50,2,2
39654,50580,80,18240,80,allow,1513,694,819,10,15,5,5
39655,53815,44847,0,0,deny,62,62,0,1,0,1,0
39656,10396,62609,0,0,deny,148,148,0,1,0,1,0
39657,33896,57470,0,0,deny,74,74,0,1,0,1,0
39658,12074,10197,0,0,deny,72,72,0,1,0,1,0
39659,63080,37965,0,0,deny,66,66,0,1,0,1,0
39660,57276,445,0,0,drop,70,70,0,1,0,1,0
39661,50442,37807,0,0,deny,66,66,0,1,0,1,0
39662,12242,51221,0,0,deny,62,62,0,1,0,1,0
39663,11066,50584,0,0,deny,66,66,0,1,0,1,0
39664,27869,51221,0,0,deny,66,66,0,1,0,1,0
39665,62175,445,0,0,drop,70,70,0,1,0,1,0
39666,62172,445,0,0,drop,70,70,0,1,0,1,0
39667,49531,53,38676,53,allow,183,94,89,2,29,1,1
39668,64967,53,8909,53,allow,184,94,90,2,29,1,1
39669,63380,443,31712,443,allow,4704,2139,2565,13,119,7,6
39670,48265,443,35728,443,allow,7379,2268,5111,18,134,8,10
39671,56622,443,37505,443,allow,3575,1079,2496,15,155,7,8
39672,51087,80,58473,80,allow,6363,3093,3270,36,130,19,17
39673,57594,80,6266,80,allow,486,280,206,8,25,5,3
39674,51091,80,22433,80,allow,4033,2712,1321,35,130,19,16
39675,63457,443,6711,443,allow,606,300,306,11,60,6,5
39676,50669,443,15933,443,allow,8464,2256,6208,25,255,13,12
39677,46505,443,30509,443,allow,59700,5399,54301,109,32,57,52
39678,57282,53,4028,53,allow,199,102,97,2,29,1,1
39679,51086,80,8200,80,allow,6365,3093,3272,36,130,19,17
39680,49820,53,16935,53,allow,193,102,91,2,29,1,1
39681,65315,53,35548,53,allow,178,94,84,2,29,1,1
39682,65341,53,19741,53,allow,200,102,98,2,29,1,1
39683,57018,53,62434,53,allow,209,110,99,2,29,1,1
39684,56948,53,55604,53,allow,183,94,89,2,29,1,1
39685,49307,53,61453,53,allow,210,102,108,2,29,1,1
39686,57282,53,23204,53,allow,199,102,97,2,29,1,1
39687,64144,53,4671,53,allow,193,102,91,2,29,1,1
39688,55809,443,23452,443,allow,180,180,0,4,11,4,0
39689,49165,53,17672,53,allow,212,102,110,2,29,1,1
39690,65075,53,49710,53,allow,278,100,178,4,30,2,2
39691,51675,8245,24099,8245,allow,346,214,132,3,29,1,2
39692,49780,53,4418,53,allow,183,94,89,2,29,1,1
39693,52312,443,50036,443,allow,1574859,55851,1519008,1758,185,656,1102
39694,49312,53,8379,53,allow,216,94,122,2,29,1,1
39695,51890,31122,40957,31122,allow,70,70,0,2,8,2,0
39696,51892,46647,34851,46647,allow,70,70,0,2,8,2,0
39697,55272,53,42714,53,allow,285,103,182,4,50,2,2
39698,49884,53,44954,53,allow,232,110,122,2,30,1,1
39699,55646,14420,30714,14420,allow,70,70,0,1,5,1,0
39700,50552,80,61160,80,allow,2367,1240,1127,10,16,5,5
39701,65486,443,40088,443,allow,375786,11380,364406,388,16,137,251
39702,50594,80,12498,80,allow,1635,824,811,10,15,5,5
39703,56841,29753,13885,29753,allow,70,70,0,1,5,1,0
39704,49500,443,11255,443,allow,16888,2692,14196,42,150,22,20
39705,65319,53,47160,53,allow,285,103,182,4,44,2,2
39706,63458,443,33627,443,allow,7934,1372,6562,25,63,12,13
39707,42595,443,31051,443,allow,1093,606,487,11,15,7,4
39708,65485,443,65115,443,allow,92447,4519,87928,105,16,39,66
39709,53684,25933,35129,25933,allow,552,306,246,9,15,5,4
39710,65341,53,20700,53,allow,200,102,98,2,30,1,1
39711,49621,443,59596,443,allow,14888,3555,11333,58,256,23,35
39712,45891,443,41811,443,allow,5718,1527,4191,24,22,13,11
39713,56772,53,56028,53,allow,168,86,82,2,30,1,1
39714,49632,53,14328,53,allow,199,102,97,2,30,1,1
39715,64245,53,44468,53,allow,199,102,97,2,30,1,1
39716,56341,443,63475,443,allow,8325,1483,6842,24,47,13,11
39717,59065,443,57168,443,allow,25840,18434,7406,45,171,26,19
39718,38579,80,3885,80,allow,996,507,489,10,200,5,5
39719,50467,80,50467,80,allow,886702,38812,847890,1134,23,558,576
39720,52133,443,32677,443,allow,7601,1919,5682,24,76,13,11
39721,49632,53,26153,53,allow,199,102,97,2,30,1,1
39722,58209,53,58209,53,allow,645,90,555,2,30,1,1
39723,42050,53,28616,53,allow,168,78,90,2,30,1,1
39724,54063,443,37024,443,allow,1313,652,661,13,185,7,6
39725,65155,53,21805,53,allow,295,103,192,4,48,2,2
39726,53717,443,48427,443,allow,318,192,126,6,15,4,2
39727,39612,443,50624,443,allow,482030,16677,465353,539,28,207,332
39728,58506,443,5356,443,allow,2408,1399,1009,18,274,9,9
39729,49349,80,49349,80,allow,450,246,204,8,141,5,3
39730,63460,443,27370,443,allow,502,250,252,9,63,5,4
39731,49997,53,42691,53,allow,209,110,99,2,29,1,1
39732,50655,80,3910,80,allow,1507,682,825,13,20,8,5
39733,57584,443,57584,443,allow,8019,4063,3956,33,92,16,17
39734,51891,23238,33315,23238,allow,70,70,0,2,8,2,0
39735,43376,443,45691,443,allow,7123,1331,5792,22,81,11,11
39736,53719,443,60186,443,allow,70,70,0,1,5,1,0
39737,62776,443,62776,443,allow,4398,1491,2907,19,26,11,8
39738,60591,53,64106,53,allow,78,78,0,1,29,1,0
39739,64967,53,42572,53,allow,184,94,90,2,29,1,1
39740,56448,53,62354,53,allow,200,102,98,2,29,1,1
39741,41029,53,0,0,allow,86,86,0,1,29,1,0
39742,56655,53,54773,53,allow,86,86,0,1,29,1,0
39743,51582,5223,65291,5223,allow,4183,1283,2900,23,163,13,10
39744,49973,80,59362,80,allow,1352,364,988,13,15,6,7
39745,64331,53,48009,53,allow,179,94,85,2,29,1,1
39746,65194,53,28428,53,allow,196,94,102,2,29,1,1
39747,56655,53,28955,53,allow,168,86,82,2,29,1,1
39748,64844,53,45693,53,allow,733,86,647,2,29,1,1
39749,55821,53,13953,53,allow,196,102,94,2,29,1,1
39750,49516,53,31257,53,allow,183,94,89,2,29,1,1
39751,49351,53,56042,53,allow,166,86,80,2,29,1,1
39752,49516,53,60499,53,allow,183,94,89,2,29,1,1
39753,59902,53,0,0,allow,220,83,137,2,30,1,1
39754,57305,53,52868,53,allow,168,86,82,2,29,1,1
39755,65365,53,13159,53,allow,196,102,94,2,30,1,1
39756,64292,53,46657,53,allow,199,94,105,2,30,1,1
39757,42291,53,6078,53,allow,168,78,90,2,30,1,1
39758,49600,53,23356,53,allow,243,94,149,2,30,1,1
39759,44847,6881,3314,6881,allow,501,150,351,2,1200,1,1
39760,59560,443,54712,443,allow,4038,1219,2819,22,135,9,13
39761,65155,53,9340,53,allow,613,200,413,6,59,3,3
39762,57867,27019,59183,27019,allow,802,472,330,8,30,5,3
39763,56937,8200,16885,8200,allow,78,78,0,1,30,1,0
39764,63975,53,64486,53,allow,316,94,222,2,30,1,1
39765,55629,53,49009,53,allow,208,94,114,2,30,1,1
39766,9087,53,9087,53,allow,178,82,96,2,30,1,1
39767,65422,53,59464,53,allow,208,94,114,2,30,1,1
39768,64298,443,45877,443,allow,115035,5282,109753,128,120,44,84
39769,60434,11339,49665,11339,allow,70,70,0,2,8,2,0
39770,34158,443,8410,443,allow,130,70,60,2,15,1,1
39771,56772,53,47377,53,allow,168,86,82,2,30,1,1
39772,64348,53,23011,53,allow,321,102,219,2,30,1,1
39773,49724,53,34584,53,allow,210,102,108,2,30,1,1
39774,64245,53,47905,53,allow,199,102,97,2,30,1,1
39775,56772,53,27354,53,allow,168,86,82,2,30,1,1
39776,65292,53,10766,53,allow,385,106,279,4,33,2,2
39777,51889,44348,63585,44348,allow,70,70,0,2,8,2,0
39778,55272,53,40097,53,allow,599,198,401,6,50,3,3
39779,58017,53,58017,53,allow,832,106,726,2,30,1,1
39780,64420,53,3880,53,allow,194,102,92,2,30,1,1
39781,55258,443,6481,443,allow,1786,172,1614,7,120,3,4
39782,46334,443,50617,443,allow,9759,2304,7455,28,138,14,14
39783,65075,53,30736,53,allow,278,100,178,4,30,2,2
39784,49347,80,49347,80,allow,450,246,204,8,141,5,3
39785,56524,443,14904,443,allow,344632,9074,335558,354,121,122,232
39786,57470,58125,57009,58125,allow,1572,664,908,14,1200,9,5
39787,54121,443,19391,443,allow,26357358,863775,25493583,27347,208,8650,18697
39788,55345,53,38199,53,allow,255,102,153,2,30,1,1
39789,39208,53,0,0,allow,86,86,0,1,30,1,0
39790,50407,8080,50407,8080,allow,378,180,198,7,33,4,3
39791,53697,6224,21795,6224,allow,70,70,0,2,8,2,0
39792,53683,30218,33662,30218,allow,492,306,186,8,15,5,3
39793,38654,443,36804,443,allow,9144,1783,7361,19,16,10,9
39794,53698,8120,50996,8120,allow,70,70,0,2,8,2,0
39795,55026,53,55024,53,allow,196,94,102,2,30,1,1
39796,64245,53,26898,53,allow,199,102,97,2,30,1,1
39797,64726,53,58493,53,allow,352,94,258,2,30,1,1
39798,56947,53,11234,53,allow,239,102,137,2,30,1,1
39799,62169,445,0,0,drop,70,70,0,1,0,1,0
39800,56636,43890,0,0,deny,66,66,0,1,0,1,0
39801,57269,445,0,0,drop,70,70,0,1,0,1,0
39802,28009,36237,0,0,deny,146,146,0,1,0,1,0
39803,57268,445,0,0,drop,70,70,0,1,0,1,0
39804,47910,7461,0,0,deny,60,60,0,1,0,1,0
39805,23537,35253,0,0,deny,66,66,0,1,0,1,0
39806,57263,445,0,0,drop,70,70,0,1,0,1,0
39807,6666,138,0,0,deny,60,60,0,1,0,1,0
39808,1972,57470,0,0,deny,78,78,0,1,0,1,0
39809,6881,6881,0,0,deny,62,62,0,1,0,1,0
39810,65179,44847,0,0,deny,66,66,0,1,0,1,0
39811,57261,445,0,0,drop,70,70,0,1,0,1,0
39812,57566,445,0,0,drop,66,66,0,1,0,1,0
39813,52569,30188,0,0,deny,66,66,0,1,0,1,0
39814,62167,445,0,0,drop,70,70,0,1,0,1,0
39815,62164,445,0,0,drop,70,70,0,1,0,1,0
39816,22922,35440,0,0,deny,66,66,0,1,0,1,0
39817,27272,64147,0,0,deny,66,66,0,1,0,1,0
39818,18754,30188,0,0,deny,62,62,0,1,0,1,0
39819,57257,445,0,0,drop,70,70,0,1,0,1,0
39820,50529,44847,0,0,deny,66,66,0,1,0,1,0
39821,61925,51505,0,0,deny,62,62,0,1,0,1,0
39822,41381,23,0,0,deny,60,60,0,1,0,1,0
39823,57558,445,0,0,drop,66,66,0,1,0,1,0
39824,57557,445,0,0,drop,66,66,0,1,0,1,0
39825,58501,44847,0,0,deny,66,66,0,1,0,1,0
39826,52626,44847,0,0,deny,66,66,0,1,0,1,0
39827,57256,445,0,0,drop,70,70,0,1,0,1,0
39828,64115,2767,0,0,deny,66,66,0,1,0,1,0
39829,9687,57470,0,0,deny,78,78,0,1,0,1,0
39830,443,7387,0,0,deny,60,60,0,1,0,1,0
39831,52472,51221,0,0,deny,74,74,0,1,0,1,0
39832,61559,23,0,0,deny,60,60,0,1,0,1,0
39833,62155,445,0,0,drop,70,70,0,1,0,1,0
39834,35120,26467,0,0,deny,62,62,0,1,0,1,0
39835,62150,445,0,0,drop,70,70,0,1,0,1,0
39836,62149,445,0,0,drop,70,70,0,1,0,1,0
39837,62147,445,0,0,drop,70,70,0,1,0,1,0
39838,61527,51050,0,0,deny,66,66,0,1,0,1,0
39839,45941,23386,0,0,deny,60,60,0,1,0,1,0
39840,57554,445,0,0,drop,66,66,0,1,0,1,0
39841,49367,51505,0,0,deny,62,62,0,1,0,1,0
39842,57251,445,0,0,drop,70,70,0,1,0,1,0
39843,41954,2323,0,0,deny,60,60,0,1,0,1,0
39844,51222,35440,0,0,deny,62,62,0,1,0,1,0
39845,48676,53395,0,0,deny,60,60,0,1,0,1,0
39846,57550,445,0,0,drop,66,66,0,1,0,1,0
39847,57546,445,0,0,drop,66,66,0,1,0,1,0
39848,57541,445,0,0,drop,66,66,0,1,0,1,0
39849,57542,445,0,0,drop,66,66,0,1,0,1,0
39850,57547,445,0,0,drop,66,66,0,1,0,1,0
39851,57545,445,0,0,drop,66,66,0,1,0,1,0
39852,57539,445,0,0,drop,66,66,0,1,0,1,0
39853,38852,37965,0,0,deny,62,62,0,1,0,1,0
39854,62140,445,0,0,drop,70,70,0,1,0,1,0
39855,57987,56125,0,0,deny,90,90,0,1,0,1,0
39856,2705,37,0,0,deny,60,60,0,1,0,1,0
39857,62137,445,0,0,drop,70,70,0,1,0,1,0
39858,62136,445,0,0,drop,70,70,0,1,0,1,0
39859,62133,445,0,0,drop,70,70,0,1,0,1,0
39860,57698,64147,0,0,deny,66,66,0,1,0,1,0
39861,44821,64147,0,0,deny,62,62,0,1,0,1,0
39862,13727,13751,0,0,deny,148,148,0,1,0,1,0
39863,59227,11392,0,0,deny,62,62,0,1,0,1,0
39864,16994,57866,0,0,deny,146,146,0,1,0,1,0
39865,49426,57470,0,0,deny,66,66,0,1,0,1,0
39866,16001,48817,0,0,deny,143,143,0,1,0,1,0
39867,48079,43227,0,0,deny,66,66,0,1,0,1,0
39868,2170,43227,0,0,deny,62,62,0,1,0,1,0
39869,57238,445,0,0,drop,70,70,0,1,0,1,0
39870,30797,23,0,0,deny,60,60,0,1,0,1,0
39871,64022,53,20960,53,allow,194,99,95,2,1,1,1
39872,17010,57470,0,0,deny,62,62,0,1,0,1,0
39873,62130,445,0,0,drop,70,70,0,1,0,1,0
39874,62129,445,0,0,drop,70,70,0,1,0,1,0
39875,62126,445,0,0,drop,70,70,0,1,0,1,0
39876,57235,445,0,0,drop,70,70,0,1,0,1,0
39877,57533,445,0,0,drop,66,66,0,1,0,1,0
39878,22346,51505,0,0,deny,62,62,0,1,0,1,0
39879,19004,51505,0,0,deny,62,62,0,1,0,1,0
39880,62124,445,0,0,drop,70,70,0,1,0,1,0
39881,50470,61463,0,0,deny,86,86,0,1,0,1,0
39882,57529,445,0,0,drop,66,66,0,1,0,1,0
39883,60962,64147,0,0,deny,66,66,0,1,0,1,0
39884,57526,445,0,0,drop,66,66,0,1,0,1,0
39885,57528,445,0,0,drop,66,66,0,1,0,1,0
39886,57525,445,0,0,drop,66,66,0,1,0,1,0
39887,57231,445,0,0,drop,70,70,0,1,0,1,0
39888,50298,37965,0,0,deny,66,66,0,1,0,1,0
39889,57229,445,0,0,drop,70,70,0,1,0,1,0
39890,19068,37965,0,0,deny,62,62,0,1,0,1,0
39891,50066,30188,0,0,deny,62,62,0,1,0,1,0
39892,57227,445,0,0,drop,70,70,0,1,0,1,0
39893,62119,445,0,0,drop,70,70,0,1,0,1,0
39894,65285,50584,0,0,deny,66,66,0,1,0,1,0
39895,49644,30188,0,0,deny,66,66,0,1,0,1,0
39896,62107,445,0,0,drop,70,70,0,1,0,1,0
39897,62110,445,0,0,drop,70,70,0,1,0,1,0
39898,59611,56205,0,0,deny,66,66,0,1,0,1,0
39899,54167,50584,0,0,deny,62,62,0,1,0,1,0
39900,40216,50265,0,0,deny,62,62,0,1,0,1,0
39901,37927,50265,0,0,deny,66,66,0,1,0,1,0
39902,37343,21247,0,0,deny,62,62,0,1,0,1,0
39903,57513,445,0,0,drop,66,66,0,1,0,1,0
39904,65317,51221,0,0,deny,78,78,0,1,0,1,0
39905,63927,50265,0,0,deny,62,62,0,1,0,1,0
39906,39244,36829,0,0,deny,62,62,0,1,0,1,0
39907,57220,445,0,0,drop,70,70,0,1,0,1,0
39908,0,0,0,0,deny,82,82,0,1,0,1,0
39909,0,0,0,0,allow,480,244,236,4,0,2,2
39910,60674,8055,0,0,deny,145,145,0,1,0,1,0
39911,52658,64147,0,0,deny,145,145,0,1,0,1,0
39912,63196,445,0,0,deny,66,66,0,1,0,1,0
39913,57218,445,0,0,drop,70,70,0,1,0,1,0
39914,63098,35440,0,0,deny,66,66,0,1,0,1,0
39915,46409,35440,0,0,deny,66,66,0,1,0,1,0
39916,57633,50584,0,0,deny,146,146,0,1,0,1,0
39917,57506,445,0,0,drop,66,66,0,1,0,1,0
39918,5222,18733,0,0,deny,66,66,0,1,0,1,0
39919,10427,32480,0,0,deny,66,66,0,1,0,1,0
39920,62096,445,0,0,drop,70,70,0,1,0,1,0
39921,29951,34021,0,0,reset-both,62,62,0,1,0,1,0
39922,6546,37965,0,0,deny,62,62,0,1,0,1,0
39923,57217,445,0,0,drop,70,70,0,1,0,1,0
39924,57216,445,0,0,drop,70,70,0,1,0,1,0
39925,39390,15503,0,0,deny,74,74,0,1,0,1,0
39926,57215,445,0,0,drop,70,70,0,1,0,1,0
39927,57212,445,0,0,drop,70,70,0,1,0,1,0
39928,57211,445,0,0,drop,70,70,0,1,0,1,0
39929,51505,17372,0,0,deny,66,66,0,1,0,1,0
39930,57503,445,0,0,drop,66,66,0,1,0,1,0
39931,57987,56125,0,0,deny,90,90,0,1,0,1,0
39932,57131,35776,0,0,deny,145,145,0,1,0,1,0
39933,2828,35253,0,0,deny,66,66,0,1,0,1,0
39934,39981,57470,0,0,deny,62,62,0,1,0,1,0
39935,61404,52700,0,0,deny,72,72,0,1,0,1,0
39936,58424,52700,0,0,deny,66,66,0,1,0,1,0
39937,57497,445,0,0,drop,66,66,0,1,0,1,0
39938,57197,445,0,0,drop,70,70,0,1,0,1,0
39939,57196,445,0,0,drop,70,70,0,1,0,1,0
39940,57192,445,0,0,drop,70,70,0,1,0,1,0
39941,19161,26296,0,0,deny,159,159,0,1,0,1,0
39942,34301,21247,0,0,deny,62,62,0,1,0,1,0
39943,51320,44847,0,0,deny,66,66,0,1,0,1,0
39944,57491,445,0,0,drop,66,66,0,1,0,1,0
39945,57186,445,0,0,drop,70,70,0,1,0,1,0
39946,57187,445,0,0,drop,70,70,0,1,0,1,0
39947,22390,19473,0,0,deny,66,66,0,1,0,1,0
39948,39531,19473,0,0,deny,62,62,0,1,0,1,0
39949,5222,1504,0,0,deny,66,66,0,1,0,1,0
39950,50090,50265,0,0,deny,62,62,0,1,0,1,0
39951,62089,445,0,0,drop,70,70,0,1,0,1,0
39952,62085,445,0,0,drop,70,70,0,1,0,1,0
39953,62084,445,0,0,drop,70,70,0,1,0,1,0
39954,26448,9192,0,0,deny,145,145,0,1,0,1,0
39955,57475,445,0,0,drop,66,66,0,1,0,1,0
39956,57476,445,0,0,drop,66,66,0,1,0,1,0
39957,57478,445,0,0,drop,66,66,0,1,0,1,0
39958,57477,445,0,0,drop,66,66,0,1,0,1,0
39959,57479,445,0,0,drop,66,66,0,1,0,1,0
39960,57480,445,0,0,drop,66,66,0,1,0,1,0
39961,57474,445,0,0,drop,66,66,0,1,0,1,0
39962,57473,445,0,0,drop,66,66,0,1,0,1,0
39963,57175,445,0,0,drop,70,70,0,1,0,1,0
39964,23277,53733,0,0,deny,62,62,0,1,0,1,0
39965,58574,21247,0,0,deny,66,66,0,1,0,1,0
39966,62132,42873,0,0,deny,66,66,0,1,0,1,0
39967,46662,36237,0,0,deny,62,62,0,1,0,1,0
39968,35494,22114,0,0,deny,66,66,0,1,0,1,0
39969,63037,443,11934,443,allow,303,85,218,2,31,1,1
39970,63038,53,49856,53,allow,303,85,218,2,31,1,1
39971,53216,443,34085,443,allow,14933,1671,13262,31,66,15,16
39972,50523,443,44131,443,allow,1389,868,521,12,25,6,6
39973,53676,80,62250,80,allow,154478,6934,147544,194,24,86,108
39974,65319,53,30506,53,allow,285,103,182,4,44,2,2
39975,59867,443,26148,443,allow,6197,843,5354,21,27,10,11
39976,45346,443,29212,443,allow,2438,1442,996,21,20,12,9
39977,56848,19556,62974,19556,allow,70,70,0,2,8,2,0
39978,53052,443,55345,443,allow,214,140,74,4,15,3,1
39979,52009,443,21173,443,allow,10339,2028,8311,28,46,16,12
39980,50546,80,2878,80,allow,1990,812,1178,9,15,5,4
39981,63045,443,61231,443,allow,510,164,346,2,30,1,1
39982,63046,53,33586,53,allow,510,164,346,2,30,1,1
39983,50521,80,1574,80,allow,454,262,192,8,25,5,3
39984,50468,80,50468,80,allow,90393,7684,82709,132,22,69,63
39985,49555,53,60187,53,allow,578,286,292,9,15,5,4
39986,61714,443,1566,443,allow,2484,330,2154,12,135,5,7
39987,53253,443,34431,443,allow,36393,27741,8652,147,210,76,71
39988,47289,443,7853,443,allow,16114,7882,8232,37,104,15,22
39989,53217,443,21683,443,allow,6058,1038,5020,20,66,11,9
39990,28755,80,28755,80,allow,21270,2178,19092,35,29,15,20
39991,50466,80,50466,80,allow,78335,7114,71221,114,22,60,54
39992,49655,80,18992,80,allow,1056,682,374,10,15,6,4
39993,55654,18251,23263,18251,allow,70,70,0,2,8,2,0
39994,51877,13472,45197,13472,allow,66,66,0,1,5,1,0
39995,38634,443,16123,443,allow,9096,1676,7420,20,18,10,10
39996,49292,443,18411,443,allow,80199,66182,14017,134,163,87,47
39997,50408,8080,50408,8080,allow,378,180,198,7,32,4,3
39998,46383,443,46383,443,allow,4661,1754,2907,19,30,11,8
39999,44638,443,36875,443,allow,20062,11233,8829,48,94,29,19
40000,49525,443,29311,443,allow,14786,2845,11941,32,121,17,15
40001,59787,443,61520,443,allow,20036,2088,17948,51,334,21,30
40002,58854,443,61370,443,allow,19134,6811,12323,39,83,18,21
40003,50524,443,21568,443,allow,1389,868,521,12,25,6,6
40004,56849,23745,4233,23745,allow,70,70,0,2,8,2,0
40005,41247,80,52056,80,allow,234,234,0,4,12,4,0
40006,63461,443,13278,443,allow,622,310,312,11,59,6,5
40007,33383,443,13969,443,allow,24440,2215,22225,46,316,20,26
40008,53223,443,54102,443,allow,7457,1726,5731,25,65,13,12
40009,45019,53,52189,53,allow,168,78,90,2,30,1,1
40010,53224,443,28053,443,allow,6001,982,5019,19,65,10,9
40011,47196,443,63403,443,allow,2701330,44089,2657241,2230,134,296,1934
40012,33775,80,33775,80,allow,424,198,226,7,142,4,3
40013,57170,445,0,0,drop,70,70,0,1,0,1,0
40014,62081,445,0,0,drop,70,70,0,1,0,1,0
40015,62075,445,0,0,drop,70,70,0,1,0,1,0
40016,62068,445,0,0,drop,70,70,0,1,0,1,0
40017,30782,36237,0,0,deny,62,62,0,1,0,1,0
40018,64546,57470,0,0,deny,66,66,0,1,0,1,0
40019,53465,57470,0,0,deny,62,62,0,1,0,1,0
40020,57461,445,0,0,drop,66,66,0,1,0,1,0
40021,57460,445,0,0,drop,66,66,0,1,0,1,0
40022,57458,445,0,0,drop,66,66,0,1,0,1,0
40023,57159,445,0,0,drop,70,70,0,1,0,1,0
40024,57162,445,0,0,drop,70,70,0,1,0,1,0
40025,57161,445,0,0,drop,70,70,0,1,0,1,0
40026,57157,445,0,0,drop,70,70,0,1,0,1,0
40027,62067,445,0,0,drop,70,70,0,1,0,1,0
40028,57154,445,0,0,drop,70,70,0,1,0,1,0
40029,36963,23,0,0,deny,60,60,0,1,0,1,0
40030,52714,64147,0,0,deny,66,66,0,1,0,1,0
40031,62064,445,0,0,drop,70,70,0,1,0,1,0
40032,19885,64147,0,0,deny,62,62,0,1,0,1,0
40033,61981,9000,0,0,deny,60,60,0,1,0,1,0
40034,61242,35253,0,0,deny,66,66,0,1,0,1,0
40035,62059,445,0,0,drop,70,70,0,1,0,1,0
40036,50470,61463,0,0,deny,86,86,0,1,0,1,0
40037,62060,445,0,0,drop,70,70,0,1,0,1,0
40038,62055,445,0,0,drop,70,70,0,1,0,1,0
40039,48706,23393,0,0,deny,60,60,0,1,0,1,0
40040,1441,51221,0,0,deny,62,62,0,1,0,1,0
40041,59364,44847,0,0,deny,66,66,0,1,0,1,0
40042,1171,18375,0,0,deny,146,146,0,1,0,1,0
40043,56653,22114,0,0,deny,66,66,0,1,0,1,0
40044,57148,445,0,0,drop,70,70,0,1,0,1,0
40045,53608,39004,0,0,deny,66,66,0,1,0,1,0
40046,29159,39004,0,0,deny,62,62,0,1,0,1,0
40047,2705,37,0,0,deny,60,60,0,1,0,1,0
40048,45007,22114,0,0,deny,146,146,0,1,0,1,0
40049,57141,445,0,0,drop,70,70,0,1,0,1,0
40050,62045,445,0,0,drop,70,70,0,1,0,1,0
40051,62044,445,0,0,drop,70,70,0,1,0,1,0
40052,62041,445,0,0,drop,70,70,0,1,0,1,0
40053,57140,445,0,0,drop,70,70,0,1,0,1,0
40054,25222,37965,0,0,deny,62,62,0,1,0,1,0
40055,54742,37965,0,0,deny,66,66,0,1,0,1,0
40056,60136,56205,0,0,deny,66,66,0,1,0,1,0
40057,16001,48817,0,0,deny,143,143,0,1,0,1,0
40058,8194,21247,0,0,deny,146,146,0,1,0,1,0
40059,49977,57470,0,0,deny,62,62,0,1,0,1,0
40060,57134,445,0,0,drop,70,70,0,1,0,1,0
40061,53132,29384,35704,29384,allow,70,70,0,1,5,1,0
40062,64255,53,15083,53,allow,260,86,174,2,30,1,1
40063,64516,53,21568,53,allow,215,94,121,2,30,1,1
40064,48658,53,48919,53,allow,368,80,288,4,30,2,2
40065,52997,443,53080,443,allow,17380,7747,9633,52,121,23,29
40066,55421,53,63396,53,allow,168,78,90,2,30,1,1
40067,39385,443,14896,443,allow,89229,6918,82311,131,33,63,68
40068,50531,80,35066,80,allow,21782,2162,19620,28,20,11,17
40069,65029,53,39227,53,allow,214,102,112,2,29,1,1
40070,64020,53,46952,53,allow,302,118,184,2,29,1,1
40071,60232,53,0,0,allow,202,86,116,2,29,1,1
40072,59537,80,26442,80,allow,3892,1824,2068,21,187,12,9
40073,57470,47099,22688,47099,allow,330,330,0,6,1199,6,0
40074,45624,443,55280,443,allow,6697,1606,5091,23,17,13,10
40075,59350,443,59350,443,allow,4401,1494,2907,19,27,11,8
40076,60014,443,21323,443,allow,10021,3035,6986,30,46,17,13
40077,65528,53,22092,53,allow,199,86,113,2,29,1,1
40078,65108,53,46911,53,allow,195,94,101,2,29,1,1
40079,59928,53,57258,53,allow,320,94,226,2,29,1,1
40080,53696,50321,25044,50321,allow,70,70,0,2,7,2,0
40081,64537,53,43379,53,allow,251,102,149,2,30,1,1
40082,53236,443,39010,443,allow,41247,1363,39884,51,37,13,38
40083,65055,53,62687,53,allow,225,86,139,2,30,1,1
40084,53282,443,30859,443,allow,1786,172,1614,7,119,3,4
40085,53232,443,62934,443,allow,102629,3555,99074,114,58,40,74
40086,51876,35624,49210,35624,allow,70,70,0,1,5,1,0
40087,63050,53,33894,53,allow,384,166,218,2,30,1,1
40088,65018,53,20967,53,allow,310,102,208,2,30,1,1
40089,50265,18659,34655,18659,allow,481,150,331,2,1200,1,1
40090,53212,443,62292,443,allow,81114,4708,76406,108,66,39,69
40091,64734,53,19737,53,allow,383,90,293,4,43,2,2
40092,49944,80,49944,80,allow,220279,13007,207272,266,22,115,151
40093,63041,53,42776,53,allow,448,166,282,2,30,1,1
40094,12477,80,12477,80,allow,6835,961,5874,17,27,9,8
40095,53219,443,33001,443,allow,6058,1038,5020,20,66,11,9
40096,53228,443,43258,443,allow,5026,973,4053,19,59,10,9
40097,53231,443,2130,443,allow,8906,1533,7373,32,58,16,16
40098,53230,443,3800,443,allow,6177,1038,5139,22,58,11,11
40099,49941,80,49941,80,allow,493003,23995,469008,578,22,246,332
40100,60770,443,16135,443,allow,4239,2026,2213,15,120,7,8
40101,65276,53,33888,53,allow,226,86,140,2,30,1,1
40102,44911,443,42749,443,allow,10194,2176,8018,25,186,14,11
40103,31956,53,16501,53,allow,268,94,174,2,30,1,1
40104,63047,443,26730,443,allow,304,86,218,2,30,1,1
40105,53234,443,53501,443,allow,6059,1040,5019,20,58,11,9
40106,62464,41090,36975,41090,allow,454923,271912,183011,516,549,295,221
40107,8449,80,8449,80,allow,48320,1685,46635,57,126,22,35
40108,53136,41442,29017,41442,allow,70,70,0,2,8,2,0
40109,57432,66,52808,66,allow,70,70,0,1,5,1,0
40110,49943,80,49943,80,allow,254742,14106,240636,305,22,131,174
40111,49942,80,49942,80,allow,323714,18296,305418,384,22,165,219
40112,60387,80,36861,80,allow,214,140,74,4,15,3,1
40113,52119,443,11235,443,allow,10583,3353,7230,32,83,16,16
40114,63048,53,53568,53,allow,304,86,218,2,30,1,1
40115,64109,53,30318,53,allow,225,102,123,2,30,1,1
40116,64004,53,17770,53,allow,247,94,153,2,30,1,1
40117,14697,8000,59482,8000,allow,212,150,62,2,30,1,1
40118,37857,443,49755,443,allow,7051,5086,1965,32,100,18,14
40119,56635,80,4559,80,allow,234,234,0,4,12,4,0
40120,55974,80,55609,80,allow,613,539,74,7,15,6,1
40121,50463,80,50463,80,allow,210639,12949,197690,287,23,147,140
40122,63042,443,30142,443,allow,512,166,346,2,30,1,1
40123,17750,25326,52113,25326,allow,491,150,341,2,1200,1,1
40124,56521,443,40583,443,allow,11375,1770,9605,27,55,15,12
40125,49218,5222,44351,5222,allow,85080,31769,53311,661,1172,305,356
40126,48191,5223,34035,5223,allow,4164,1264,2900,23,1140,13,10
40127,65319,53,38266,53,allow,285,103,182,4,43,2,2
40128,38653,443,4233,443,allow,9664,1703,7961,22,15,11,11
40129,53685,53,0,0,allow,547,97,450,4,40,2,2
40130,53328,53,0,0,allow,232,77,155,2,32,1,1
40131,50464,80,50464,80,allow,218570,13559,205011,291,22,146,145
40132,55032,5222,63875,5222,allow,138,64,74,3,5,2,1
40133,65319,53,28841,53,allow,285,103,182,4,43,2,2
40134,50465,80,50465,80,allow,202622,12371,190251,264,22,132,132
40135,60386,80,35408,80,allow,214,140,74,4,15,3,1
40136,59837,80,33837,80,allow,830733,17622,813111,789,66,245,544
40137,65021,53,29449,53,allow,589,91,498,4,54,2,2
40138,65365,53,10909,53,allow,196,102,94,2,29,1,1
40139,49384,53,22527,53,allow,193,102,91,2,29,1,1
40140,64483,53,53474,53,allow,168,86,82,2,29,1,1
40141,64256,53,36499,53,allow,211,78,133,2,29,1,1
40142,56738,53,53123,53,allow,242,110,132,2,29,1,1
40143,38629,443,15765,443,allow,9198,2279,6919,18,18,9,9
40144,64483,53,39103,53,allow,168,86,82,2,29,1,1
40145,31201,53,38511,53,allow,197,78,119,2,30,1,1
40146,49385,53,9929,53,allow,843,285,558,8,56,4,4
40147,26690,53,55791,53,allow,197,94,103,2,29,1,1
40148,49742,53,9539,53,allow,213,102,111,2,29,1,1
40149,49208,53,8830,53,allow,216,94,122,2,29,1,1
40150,53229,443,57933,443,allow,91414,11700,79714,174,59,65,109
40151,64089,53,20449,53,allow,197,94,103,2,30,1,1
40152,63049,443,56063,443,allow,384,166,218,2,30,1,1
40153,57174,53,49148,53,allow,210,94,116,2,30,1,1
40154,53221,443,43184,443,allow,57706,2486,55220,67,65,23,44
40155,53227,443,7377,443,allow,16336,3219,13117,46,59,21,25
40156,64483,53,3911,53,allow,168,86,82,2,30,1,1
40157,50820,443,50820,443,allow,37757,4416,33341,44,32,17,27
40158,65216,53,59898,53,allow,244,94,150,2,30,1,1
40159,56891,53,21983,53,allow,200,94,106,2,30,1,1
40160,39758,53,26339,53,allow,86,86,0,1,30,1,0
40161,53233,443,34879,443,allow,6059,1040,5019,20,58,11,9
40162,64753,53,4084,53,allow,287,102,185,2,30,1,1
40163,36387,443,45505,443,allow,7139,1751,5388,32,1372,10,22
40164,37827,443,64403,443,allow,424,210,214,7,131,4,3
40165,60388,80,19317,80,allow,214,140,74,4,15,3,1
40166,38633,443,44108,443,allow,3448,1619,1829,18,18,8,10
40167,19874,3389,19874,3389,allow,4145,1976,2169,22,18,13,9
40168,53235,443,2490,443,allow,11111,1014,10097,24,37,10,14
40169,53226,443,20634,443,allow,5993,974,5019,19,59,10,9
40170,53222,443,42780,443,allow,4531,974,3557,18,65,10,8
40171,53218,443,1969,443,allow,245772,8639,237133,291,66,103,188
40172,56350,53,30997,53,allow,287,102,185,2,30,1,1
40173,33497,53,21271,53,allow,168,78,90,2,30,1,1
40174,63043,53,52366,53,allow,448,166,282,2,30,1,1
40175,38174,443,51209,443,allow,7034,1885,5149,28,95,15,13
40176,62896,993,16279,993,allow,9831,4069,5762,88,192,40,48
40177,50028,53,16611,53,allow,210,102,108,2,30,1,1
40178,63044,443,58831,443,allow,512,166,346,2,30,1,1
40179,61465,443,63826,443,allow,9619,879,8740,19,135,8,11
40180,59538,80,24164,80,allow,3835,1767,2068,21,187,12,9
40181,25,63566,25,63566,allow,102,102,0,1,5,1,0
40182,46286,443,2203,443,allow,1053,566,487,10,41,6,4
40183,28509,80,28509,80,allow,10145,1446,8699,23,29,11,12
40184,49476,53,2698,53,allow,200,94,106,2,30,1,1
40185,49257,80,49257,80,allow,19393,1504,17889,30,32,12,18
40186,63876,5968,28223,5968,allow,66,66,0,2,8,2,0
40187,53687,51471,5153,51471,allow,70,70,0,1,5,1,0
40188,63034,443,35751,443,allow,304,86,218,2,30,1,1
40189,47010,53,59094,53,allow,294,94,200,2,30,1,1
40190,59166,443,40050,443,allow,130458,7920,122538,199,359,94,105
40191,63033,53,19877,53,allow,304,86,218,2,30,1,1
40192,49977,53,37356,53,allow,212,94,118,2,30,1,1
40193,9067,443,32087,443,allow,11768028,275478,11492550,12305,77,4158,8147
40194,63878,50829,45177,50829,allow,66,66,0,2,8,2,0
40195,63032,53,34881,53,allow,304,86,218,2,30,1,1
40196,56702,53,49433,53,allow,168,78,90,2,30,1,1
40197,9055,443,33529,443,allow,6594797,175738,6419059,6398,123,1755,4643
40198,55770,443,27394,443,allow,40169,4646,35523,61,122,24,37
40199,28897,35440,0,0,deny,62,62,0,1,0,1,0
40200,57133,445,0,0,drop,70,70,0,1,0,1,0
40201,62029,22114,0,0,deny,66,66,0,1,0,1,0
40202,11478,51221,0,0,deny,66,66,0,1,0,1,0
40203,9743,23,0,0,deny,60,60,0,1,0,1,0
40204,9687,57470,0,0,deny,78,78,0,1,0,1,0
40205,60126,35440,0,0,deny,62,62,0,1,0,1,0
40206,58128,44847,0,0,deny,146,146,0,1,0,1,0
40207,57439,445,0,0,drop,66,66,0,1,0,1,0
40208,62037,445,0,0,drop,70,70,0,1,0,1,0
40209,62035,445,0,0,drop,70,70,0,1,0,1,0
40210,57129,445,0,0,drop,70,70,0,1,0,1,0
40211,58672,43890,0,0,deny,66,66,0,1,0,1,0
40212,7274,64147,0,0,deny,62,62,0,1,0,1,0
40213,52472,51221,0,0,deny,74,74,0,1,0,1,0
40214,60646,11392,0,0,deny,66,66,0,1,0,1,0
40215,65494,53,0,0,deny,88,88,0,1,0,1,0
40216,57128,445,0,0,drop,70,70,0,1,0,1,0
40217,19245,64147,0,0,deny,66,66,0,1,0,1,0
40218,57432,445,0,0,drop,66,66,0,1,0,1,0
40219,57429,445,0,0,drop,66,66,0,1,0,1,0
40220,37701,23,0,0,deny,60,60,0,1,0,1,0
40221,41220,59356,0,0,deny,62,62,0,1,0,1,0
40222,2705,37,0,0,deny,60,60,0,1,0,1,0
40223,63096,44847,0,0,deny,66,66,0,1,0,1,0
40224,6721,37965,0,0,deny,66,66,0,1,0,1,0
40225,65515,22114,0,0,deny,66,66,0,1,0,1,0
40226,62026,445,0,0,drop,70,70,0,1,0,1,0
40227,52989,51505,0,0,deny,66,66,0,1,0,1,0
40228,34306,37965,0,0,deny,62,62,0,1,0,1,0
40229,48576,443,26108,443,allow,476,410,66,4,0,3,1
40230,9522,51505,0,0,deny,66,66,0,1,0,1,0
40231,57123,445,0,0,drop,70,70,0,1,0,1,0
40232,62019,445,0,0,drop,70,70,0,1,0,1,0
40233,62018,445,0,0,drop,70,70,0,1,0,1,0
40234,62015,445,0,0,drop,70,70,0,1,0,1,0
40235,57987,56125,0,0,deny,90,90,0,1,0,1,0
40236,55174,53,1640,53,allow,774,101,673,2,0,1,1
40237,57428,445,0,0,drop,66,66,0,1,0,1,0
40238,43611,1879,0,0,deny,145,145,0,1,0,1,0
40239,50877,35776,0,0,deny,159,159,0,1,0,1,0
40240,57412,445,0,0,drop,66,66,0,1,0,1,0
40241,57419,445,0,0,drop,66,66,0,1,0,1,0
40242,57413,445,0,0,drop,66,66,0,1,0,1,0
40243,57418,445,0,0,drop,66,66,0,1,0,1,0
40244,57417,445,0,0,drop,66,66,0,1,0,1,0
40245,57414,445,0,0,drop,66,66,0,1,0,1,0
40246,57411,445,0,0,drop,66,66,0,1,0,1,0
40247,57874,26467,0,0,deny,62,62,0,1,0,1,0
40248,62012,445,0,0,drop,70,70,0,1,0,1,0
40249,10775,35440,0,0,deny,62,62,0,1,0,1,0
40250,62007,445,0,0,drop,70,70,0,1,0,1,0
40251,62005,445,0,0,drop,70,70,0,1,0,1,0
40252,62004,445,0,0,drop,70,70,0,1,0,1,0
40253,43129,15503,0,0,deny,62,62,0,1,0,1,0
40254,55766,36237,0,0,deny,146,146,0,1,0,1,0
40255,53090,59356,0,0,deny,66,66,0,1,0,1,0
40256,63340,53,0,0,deny,84,84,0,1,0,1,0
40257,40185,64147,0,0,deny,62,62,0,1,0,1,0
40258,57110,445,0,0,drop,70,70,0,1,0,1,0
40259,65526,28793,0,0,deny,62,62,0,1,0,1,0
40260,25565,44521,0,0,deny,60,60,0,1,0,1,0
40261,57107,445,0,0,drop,70,70,0,1,0,1,0
40262,15875,50584,0,0,deny,62,62,0,1,0,1,0
40263,62003,445,0,0,drop,70,70,0,1,0,1,0
40264,62002,445,0,0,drop,70,70,0,1,0,1,0
40265,61999,445,0,0,drop,70,70,0,1,0,1,0
40266,443,41545,0,0,deny,60,60,0,1,0,1,0
40267,57403,445,0,0,drop,66,66,0,1,0,1,0
40268,61995,445,0,0,drop,70,70,0,1,0,1,0
40269,57402,445,0,0,drop,66,66,0,1,0,1,0
40270,57400,445,0,0,drop,66,66,0,1,0,1,0
40271,57399,445,0,0,drop,66,66,0,1,0,1,0
40272,47381,8305,0,0,deny,159,159,0,1,0,1,0
40273,57103,445,0,0,drop,70,70,0,1,0,1,0
40274,57396,445,0,0,drop,66,66,0,1,0,1,0
40275,45682,37965,0,0,deny,62,62,0,1,0,1,0
40276,15641,26467,0,0,deny,62,62,0,1,0,1,0
40277,57101,445,0,0,drop,70,70,0,1,0,1,0
40278,57612,28793,0,0,deny,66,66,0,1,0,1,0
40279,57099,445,0,0,drop,70,70,0,1,0,1,0
40280,61085,37965,0,0,deny,62,62,0,1,0,1,0
40281,53966,57470,0,0,deny,62,62,0,1,0,1,0
40282,61990,445,0,0,drop,70,70,0,1,0,1,0
40283,59435,37807,0,0,deny,62,62,0,1,0,1,0
40284,1040,37965,0,0,deny,62,62,0,1,0,1,0
40285,52976,31573,0,0,deny,66,66,0,1,0,1,0
40286,61984,445,0,0,drop,70,70,0,1,0,1,0
40287,61981,445,0,0,drop,70,70,0,1,0,1,0
40288,35558,15503,0,0,deny,66,66,0,1,0,1,0
40289,60060,443,0,0,deny,1097,1097,0,1,0,1,0
40290,50470,61463,0,0,deny,86,86,0,1,0,1,0
40291,10036,44847,0,0,deny,66,66,0,1,0,1,0
40292,55375,44847,0,0,deny,66,66,0,1,0,1,0
40293,57385,445,0,0,drop,66,66,0,1,0,1,0
40294,57092,445,0,0,drop,70,70,0,1,0,1,0
40295,27018,61508,0,0,deny,753,753,0,1,0,1,0
40296,27018,61508,0,0,deny,753,753,0,1,0,1,0
40297,50901,26467,0,0,deny,66,66,0,1,0,1,0
40298,57090,445,0,0,drop,70,70,0,1,0,1,0
40299,61510,37965,0,0,deny,66,66,0,1,0,1,0
40300,59563,30188,0,0,deny,66,66,0,1,0,1,0
40301,57089,445,0,0,drop,70,70,0,1,0,1,0
40302,57378,445,0,0,drop,66,66,0,1,0,1,0
40303,61968,445,0,0,drop,70,70,0,1,0,1,0
40304,57088,445,0,0,drop,70,70,0,1,0,1,0
40305,8536,37965,0,0,deny,62,62,0,1,0,1,0
40306,57087,445,0,0,drop,70,70,0,1,0,1,0
40307,47910,7464,0,0,deny,60,60,0,1,0,1,0
40308,56752,44847,0,0,deny,62,62,0,1,0,1,0
40309,59352,37965,0,0,deny,66,66,0,1,0,1,0
40310,57082,445,0,0,drop,70,70,0,1,0,1,0
40311,57083,445,0,0,drop,70,70,0,1,0,1,0
40312,57376,445,0,0,drop,66,66,0,1,0,1,0
40313,48681,11392,0,0,deny,62,62,0,1,0,1,0
40314,57069,445,0,0,drop,70,70,0,1,0,1,0
40315,57068,445,0,0,drop,70,70,0,1,0,1,0
40316,57066,445,0,0,drop,70,70,0,1,0,1,0
40317,8080,37965,0,0,deny,62,62,0,1,0,1,0
40318,47091,5228,39353,5228,allow,3113,1395,1718,20,3608,8,12
40319,52064,443,64308,443,allow,9003,2598,6405,33,345,15,18
40320,57470,41024,3847,41024,allow,330,330,0,6,1200,6,0
40321,55172,80,55172,80,allow,268230,8528,259702,292,231,106,186
40322,47293,443,64269,443,allow,6318,1025,5293,17,31,9,8
40323,59866,443,32010,443,allow,6135,843,5292,20,26,10,10
40324,57470,58973,26085,58973,allow,330,330,0,6,1200,6,0
40325,33795,80,33795,80,allow,490,264,226,8,142,5,3
40326,40866,8434,40866,8434,allow,156,156,0,3,8,3,0
40327,53685,38978,33015,38978,allow,70,70,0,1,5,1,0
40328,50542,80,60343,80,allow,1607,970,637,8,16,5,3
40329,51209,443,64337,443,allow,84768,21103,63665,136,133,58,78
40330,49941,443,34505,443,allow,8754,2895,5859,26,16,15,11
40331,51886,35965,10726,35965,allow,70,70,0,2,8,2,0
40332,51874,43161,26415,43161,allow,66,66,0,1,5,1,0
40333,64335,443,56064,443,allow,230615,48569,182046,379,176,157,222
40334,57470,6881,6226,6881,allow,453,251,202,4,1200,2,2
40335,59868,443,32881,443,allow,502,250,252,9,26,5,4
40336,42473,80,36510,80,allow,1737,796,941,12,16,7,5
40337,45345,443,9986,443,allow,2438,1442,996,21,27,12,9
40338,53681,31466,20007,31466,allow,70,70,0,1,5,1,0
40339,56840,20413,2836,20413,allow,66,66,0,1,5,1,0
40340,8282,40200,5762,40200,allow,133,64,69,3,30,2,1
40341,57470,6881,28610,6881,allow,396,396,0,7,1200,7,0
40342,57470,24260,9692,24260,allow,806,163,643,2,1201,1,1
40343,57058,445,0,0,drop,70,70,0,1,0,1,0
40344,57059,445,0,0,drop,70,70,0,1,0,1,0
40345,57369,445,0,0,drop,66,66,0,1,0,1,0
40346,25565,58771,0,0,deny,60,60,0,1,0,1,0
40347,60854,42873,0,0,deny,66,66,0,1,0,1,0
40348,57361,445,0,0,drop,66,66,0,1,0,1,0
40349,26351,22114,0,0,deny,62,62,0,1,0,1,0
40350,48020,7484,0,0,deny,60,60,0,1,0,1,0
40351,57987,56125,0,0,deny,90,90,0,1,0,1,0
40352,58922,57470,0,0,deny,66,66,0,1,0,1,0
40353,54028,37965,0,0,deny,62,62,0,1,0,1,0
40354,29787,37965,0,0,deny,62,62,0,1,0,1,0
40355,50325,80,28914,80,allow,19438,12019,7419,53,312,30,23
40356,59974,443,38243,443,allow,354,140,214,6,130,3,3
40357,57047,445,0,0,drop,70,70,0,1,0,1,0
40358,61960,445,0,0,drop,70,70,0,1,0,1,0
40359,61956,445,0,0,drop,70,70,0,1,0,1,0
40360,15403,51505,0,0,deny,66,66,0,1,0,1,0
40361,57347,445,0,0,drop,66,66,0,1,0,1,0
40362,57352,445,0,0,drop,66,66,0,1,0,1,0
40363,57349,445,0,0,drop,66,66,0,1,0,1,0
40364,57350,445,0,0,drop,66,66,0,1,0,1,0
40365,57353,445,0,0,drop,66,66,0,1,0,1,0
40366,57348,445,0,0,drop,66,66,0,1,0,1,0
40367,57346,445,0,0,drop,66,66,0,1,0,1,0
40368,57345,445,0,0,drop,66,66,0,1,0,1,0
40369,40260,44610,0,0,deny,145,145,0,1,0,1,0
40370,26058,1433,0,0,deny,60,60,0,1,0,1,0
40371,60405,5900,0,0,deny,60,60,0,1,0,1,0
40372,56413,51221,0,0,deny,66,66,0,1,0,1,0
40373,63765,51221,0,0,deny,62,62,0,1,0,1,0
40374,27401,37965,0,0,deny,66,66,0,1,0,1,0
40375,45964,2666,0,0,deny,60,60,0,1,0,1,0
40376,57042,445,0,0,drop,70,70,0,1,0,1,0
40377,31613,23,0,0,deny,60,60,0,1,0,1,0
40378,28809,50584,0,0,deny,66,66,0,1,0,1,0
40379,55459,50584,0,0,deny,62,62,0,1,0,1,0
40380,61953,445,0,0,drop,70,70,0,1,0,1,0
40381,57470,3800,54639,3800,allow,150,150,0,1,1199,1,0
40382,33538,80,33538,80,allow,424,198,226,7,141,4,3
40383,47918,443,24262,443,allow,7936,2847,5089,15,120,7,8
40384,53689,42719,50216,42719,allow,70,70,0,1,4,1,0
40385,51956,443,47122,443,allow,8256,3157,5099,28,46,16,12
40386,63039,443,48295,443,allow,448,166,282,2,29,1,1
40387,63031,443,4313,443,allow,304,86,218,2,29,1,1
40388,50083,80,45276,80,allow,38045,26409,11636,105,476,68,37
40389,59744,80,14710,80,allow,699554,16426,683128,701,95,244,457
40390,58707,80,41124,80,allow,2542,1879,663,12,14,6,6
40391,56850,64932,41419,64932,allow,70,70,0,1,5,1,0
40392,63036,53,45835,53,allow,304,86,218,2,29,1,1
40393,50608,443,53757,443,allow,8058,2722,5336,17,31,10,7
40394,40342,53,32234,53,allow,168,78,90,2,29,1,1
40395,57593,443,14217,443,allow,7037,1786,5251,23,200,13,10
40396,59865,443,51225,443,allow,502,250,252,9,26,5,4
40397,54768,25,54768,25,allow,194,66,128,3,15,1,2
40398,41945,443,44467,443,allow,12146,2681,9465,63,4156,25,38
40399,60782,3389,60782,3389,allow,3504,1790,1714,17,33,9,8
40400,61571,53,17660,53,allow,211,78,133,2,30,1,1
40401,51887,16514,22575,16514,allow,70,70,0,2,8,2,0
40402,51875,25072,3449,25072,allow,70,70,0,1,5,1,0
40403,33871,443,48273,443,allow,11277,2233,9044,43,215,20,23
40404,34739,5222,35050,5222,allow,26914,4119,22795,85,539,41,44
40405,59559,443,17669,443,allow,6328,1536,4792,23,17,12,11
40406,53452,443,10617,443,allow,15368,8643,6725,36,49,19,17
40407,49708,80,56764,80,allow,179277,5324,173953,171,108,49,122
40408,49707,80,15833,80,allow,196092,6387,189705,189,108,57,132
40409,49704,80,31664,80,allow,217502,6597,210905,211,109,62,149
40410,55665,443,34619,443,allow,6291,1499,4792,22,17,11,11
40411,64484,53,32900,53,allow,732,239,493,6,51,3,3
40412,49454,443,27908,443,allow,7212,1757,5455,20,17,10,10
40413,49221,80,26224,80,allow,214,140,74,4,15,3,1
40414,51776,8000,6250,8000,allow,328,142,186,6,90,3,3
40415,65298,53,43096,53,allow,246,102,144,2,30,1,1
40416,56438,3389,56438,3389,allow,3425,1470,1955,16,17,8,8
40417,44521,443,14957,443,allow,6502,1347,5155,31,1195,10,21
40418,36712,53,0,0,allow,139,70,69,2,30,1,1
40419,42770,443,4955,443,allow,8820,2996,5824,27,95,14,13
40420,56800,443,21923,443,allow,79399,4048,75351,90,120,32,58
40421,57470,5254,14927,5254,allow,453,251,202,4,1200,2,2
40422,43346,443,33396,443,allow,3691281,56325,3634956,3201,138,570,2631
40423,49705,80,59166,80,allow,132198,5466,126732,140,109,45,95
40424,9074,443,22062,443,allow,318,192,126,6,29,4,2
40425,45042,443,17332,443,allow,8445,2120,6325,27,107,15,12
40426,44509,80,44509,80,allow,84030,4287,79743,107,145,47,60
40427,62453,53,64784,53,allow,441,162,279,6,32,3,3
40428,53135,14297,19034,14297,allow,70,70,0,2,8,2,0
40429,36367,443,61564,443,allow,1209,709,500,14,26,8,6
40430,37390,443,2795,443,allow,4859,964,3895,17,26,10,7
40431,59713,3389,59713,3389,allow,4213,2429,1784,18,32,9,9
40432,64698,53,34866,53,allow,211,102,109,2,30,1,1
40433,50012,53,31232,53,allow,209,102,107,2,30,1,1
40434,65164,53,35312,53,allow,262,94,168,2,30,1,1
40435,56995,53,19045,53,allow,196,94,102,2,30,1,1
40436,57470,6885,1463,6885,allow,616,414,202,5,1200,3,2
40437,57470,32251,57534,32251,allow,132,132,0,3,1199,3,0
40438,59862,443,40236,443,allow,5301,953,4348,17,28,9,8
40439,57402,443,10569,443,allow,6649,1556,5093,23,21,13,10
40440,51712,443,2406,443,allow,66148,6145,60003,116,80,60,56
40441,53686,8999,26730,8999,allow,70,70,0,1,4,1,0
40442,53682,20884,50647,20884,allow,70,70,0,1,4,1,0
40443,60060,22,60060,22,allow,7974,3469,4505,57,40,28,29
40444,53688,17106,13403,17106,allow,70,70,0,1,4,1,0
40445,57266,443,13002,443,allow,16452,7129,9323,44,47,25,19
40446,63040,53,20975,53,allow,512,166,346,2,29,1,1
40447,49839,53,59644,53,allow,258,110,148,2,29,1,1
40448,63035,443,45890,443,allow,304,86,218,2,29,1,1
40449,49230,53,36534,53,allow,351,94,257,2,30,1,1
40450,50265,37449,54760,37449,allow,925,594,331,11,2335,10,1
40451,56992,53,30426,53,allow,355,102,253,2,30,1,1
40452,58771,443,41397,443,allow,4726,2487,2239,19,305,9,10
40453,33367,80,33367,80,allow,424,198,226,7,141,4,3
40454,34285,80,34285,80,allow,424,198,226,7,141,4,3
40455,9064,443,8179,443,allow,11738,6980,4758,34,81,19,15
40456,47245,443,62935,443,allow,1989,1183,806,16,94,9,7
40457,51873,19311,22096,19311,allow,70,70,0,1,5,1,0
40458,49709,80,35500,80,allow,128214,4961,123253,134,108,43,91
40459,63995,53,52864,53,allow,212,94,118,2,30,1,1
40460,49213,53,44755,53,allow,211,102,109,2,30,1,1
40461,53719,443,54352,443,allow,3225,1939,1286,26,139,14,12
40462,35954,443,60270,443,allow,6406,1614,4792,24,17,13,11
40463,64801,7000,64801,7000,allow,2269,815,1454,14,15,7,7
40464,56679,443,4543,443,allow,7941,1952,5989,20,15,11,9
40465,59595,80,6644,80,allow,1052,612,440,10,15,5,5
40466,64925,53,10435,53,allow,338,110,228,2,30,1,1
40467,57470,6881,57710,6881,allow,453,251,202,4,1200,2,2
40468,56523,443,56096,443,allow,28479,3138,25341,42,42,17,25
40469,44850,443,60943,443,allow,4502,895,3607,15,25,9,6
40470,56680,443,53449,443,allow,7889,1900,5989,20,15,11,9
40471,59864,443,10819,443,allow,6066,833,5233,19,26,10,9
40472,59863,443,41870,443,allow,622,310,312,11,28,6,5
40473,40175,80,8302,80,allow,130,70,60,2,15,1,1
40474,49706,80,39061,80,allow,118813,4128,114685,122,108,38,84
40475,49667,53,38974,53,allow,261,94,167,2,30,1,1
40476,53895,443,14973,443,allow,390740,13639,377101,441,132,152,289
40477,65219,443,28202,443,allow,4748,2193,2555,14,135,7,7
40478,6881,45711,37473,45711,allow,228,118,110,2,1199,1,1
40479,49160,38552,12049,38552,allow,868,150,718,4,1200,2,2
40480,57470,6881,64620,6881,allow,577,251,326,4,1200,2,2
40481,37965,15509,12475,15509,allow,481,150,331,2,1199,1,1
40482,27005,1301,24545,1301,allow,860,126,734,2,30,1,1
40483,27005,1303,22373,1303,allow,868,126,742,2,30,1,1
40484,41891,443,2286,443,allow,235626,4546,231080,232,339,53,179
40485,60768,40010,23273,40010,allow,316,136,180,6,7,3,3
40486,50985,80,32837,80,allow,5823,1570,4253,17,20,10,7
40487,53233,443,40528,443,allow,47830,23388,24442,74,51,37,37
40488,49206,443,6191,443,allow,15982,9199,6783,95,160,40,55
40489,37026,80,28562,80,allow,2849,1631,1218,9,721,5,4
40490,80,13743,80,13743,allow,70,70,0,1,5,1,0
40491,27005,1201,20493,1201,allow,867,126,741,2,30,1,1
40492,33443,443,53620,443,allow,14402,2801,11601,28,205,11,17
40493,50983,80,17764,80,allow,7765,2215,5550,20,20,12,8
40494,13375,53,13375,53,allow,213,82,131,2,30,1,1
40495,61949,445,0,0,drop,70,70,0,1,0,1,0
40496,61939,445,0,0,drop,70,70,0,1,0,1,0
40497,57034,445,0,0,drop,70,70,0,1,0,1,0
40498,57031,445,0,0,drop,70,70,0,1,0,1,0
40499,57032,445,0,0,drop,70,70,0,1,0,1,0
40500,57029,445,0,0,drop,70,70,0,1,0,1,0
40501,57026,445,0,0,drop,70,70,0,1,0,1,0
40502,57333,445,0,0,drop,66,66,0,1,0,1,0
40503,57331,445,0,0,drop,66,66,0,1,0,1,0
40504,57330,445,0,0,drop,66,66,0,1,0,1,0
40505,61937,445,0,0,drop,70,70,0,1,0,1,0
40506,61935,445,0,0,drop,70,70,0,1,0,1,0
40507,51313,64147,0,0,deny,62,62,0,1,0,1,0
40508,61933,445,0,0,drop,70,70,0,1,0,1,0
40509,61929,445,0,0,drop,70,70,0,1,0,1,0
40510,61927,445,0,0,drop,70,70,0,1,0,1,0
40511,62849,62413,0,0,deny,66,66,0,1,0,1,0
40512,34809,57470,0,0,deny,66,66,0,1,0,1,0
40513,17344,62413,0,0,deny,66,66,0,1,0,1,0
40514,40500,25356,0,0,deny,146,146,0,1,0,1,0
40515,57020,445,0,0,drop,70,70,0,1,0,1,0
40516,46365,53413,0,0,deny,71,71,0,1,0,1,0
40517,6224,37965,0,0,deny,62,62,0,1,0,1,0
40518,26921,57470,0,0,deny,62,62,0,1,0,1,0
40519,10028,25604,0,0,deny,62,62,0,1,0,1,0
40520,56463,17,0,0,deny,60,60,0,1,0,1,0
40521,14997,57470,0,0,deny,72,72,0,1,0,1,0
40522,9687,57470,0,0,deny,78,78,0,1,0,1,0
40523,62625,37965,0,0,deny,62,62,0,1,0,1,0
40524,57013,445,0,0,drop,70,70,0,1,0,1,0
40525,35261,15503,0,0,deny,74,74,0,1,0,1,0
40526,57010,445,0,0,drop,70,70,0,1,0,1,0
40527,51163,23,0,0,deny,60,60,0,1,0,1,0
40528,6881,6881,0,0,deny,62,62,0,1,0,1,0
40529,61916,445,0,0,drop,70,70,0,1,0,1,0
40530,61918,445,0,0,drop,70,70,0,1,0,1,0
40531,61915,445,0,0,drop,70,70,0,1,0,1,0
40532,443,62451,0,0,deny,60,60,0,1,0,1,0
40533,65494,53,0,0,deny,88,88,0,1,0,1,0
40534,47910,7461,0,0,deny,60,60,0,1,0,1,0
40535,57007,445,0,0,drop,70,70,0,1,0,1,0
40536,50470,61463,0,0,deny,86,86,0,1,0,1,0
40537,22528,48817,0,0,deny,148,148,0,1,0,1,0
40538,65494,53,0,0,deny,88,88,0,1,0,1,0
40539,57005,445,0,0,drop,70,70,0,1,0,1,0
40540,61195,56205,0,0,deny,62,62,0,1,0,1,0
40541,53781,37965,0,0,deny,62,62,0,1,0,1,0
40542,57001,445,0,0,drop,70,70,0,1,0,1,0
40543,49293,22,0,0,deny,60,60,0,1,0,1,0
40544,57310,445,0,0,drop,66,66,0,1,0,1,0
40545,61908,445,0,0,drop,70,70,0,1,0,1,0
40546,61907,445,0,0,drop,70,70,0,1,0,1,0
40547,59889,30188,0,0,deny,62,62,0,1,0,1,0
40548,47105,64147,0,0,deny,62,62,0,1,0,1,0
40549,57000,445,0,0,drop,70,70,0,1,0,1,0
40550,61681,23,0,0,deny,60,60,0,1,0,1,0
40551,58664,64147,0,0,deny,66,66,0,1,0,1,0
40552,57305,445,0,0,drop,66,66,0,1,0,1,0
40553,57302,445,0,0,drop,66,66,0,1,0,1,0
40554,45941,23384,0,0,deny,60,60,0,1,0,1,0
40555,52410,8604,0,0,deny,66,66,0,1,0,1,0
40556,1024,64147,0,0,deny,62,62,0,1,0,1,0
40557,58884,23,0,0,deny,60,60,0,1,0,1,0
40558,16687,10214,0,0,deny,66,66,0,1,0,1,0
40559,56995,445,0,0,drop,70,70,0,1,0,1,0
40560,61897,445,0,0,drop,70,70,0,1,0,1,0
40561,41429,50584,0,0,deny,66,66,0,1,0,1,0
40562,5222,32859,0,0,deny,66,66,0,1,0,1,0
40563,61891,445,0,0,drop,70,70,0,1,0,1,0
40564,61892,445,0,0,drop,70,70,0,1,0,1,0
40565,61887,445,0,0,drop,70,70,0,1,0,1,0
40566,57298,445,0,0,drop,66,66,0,1,0,1,0
40567,57287,445,0,0,drop,66,66,0,1,0,1,0
40568,57292,445,0,0,drop,66,66,0,1,0,1,0
40569,57281,445,0,0,drop,66,66,0,1,0,1,0
40570,57284,445,0,0,drop,66,66,0,1,0,1,0
40571,57280,445,0,0,drop,66,66,0,1,0,1,0
40572,57285,445,0,0,drop,66,66,0,1,0,1,0
40573,57279,445,0,0,drop,66,66,0,1,0,1,0
40574,49248,35993,0,0,deny,66,66,0,1,0,1,0
40575,57987,56125,0,0,deny,90,90,0,1,0,1,0
40576,11574,51505,0,0,deny,66,66,0,1,0,1,0
40577,50644,35440,0,0,deny,66,66,0,1,0,1,0
40578,47682,64147,0,0,deny,66,66,0,1,0,1,0
40579,61884,445,0,0,drop,70,70,0,1,0,1,0
40580,33931,50584,0,0,deny,146,146,0,1,0,1,0
40581,50327,1433,0,0,deny,60,60,0,1,0,1,0
40582,59965,36237,0,0,deny,62,62,0,1,0,1,0
40583,6014,37965,0,0,deny,66,66,0,1,0,1,0
40584,61880,445,0,0,drop,70,70,0,1,0,1,0
40585,61879,445,0,0,drop,70,70,0,1,0,1,0
40586,61876,445,0,0,drop,70,70,0,1,0,1,0
40587,45908,3383,0,0,deny,60,60,0,1,0,1,0
40588,56982,445,0,0,drop,70,70,0,1,0,1,0
40589,44855,58414,0,0,deny,62,62,0,1,0,1,0
40590,55022,23,0,0,deny,60,60,0,1,0,1,0
40591,48219,55442,0,0,deny,66,66,0,1,0,1,0
40592,16654,50265,0,0,deny,62,62,0,1,0,1,0
40593,1373,22114,0,0,deny,66,66,0,1,0,1,0
40594,52432,50265,0,0,deny,66,66,0,1,0,1,0
40595,56376,44847,0,0,deny,62,62,0,1,0,1,0
40596,56979,445,0,0,drop,70,70,0,1,0,1,0
40597,51093,57470,0,0,deny,66,66,0,1,0,1,0
40598,40369,57470,0,0,deny,62,62,0,1,0,1,0
40599,50783,23,0,0,deny,60,60,0,1,0,1,0
40600,65317,51221,0,0,deny,78,78,0,1,0,1,0
40601,52614,44847,0,0,deny,66,66,0,1,0,1,0
40602,10348,25604,0,0,deny,62,62,0,1,0,1,0
40603,61875,445,0,0,drop,70,70,0,1,0,1,0
40604,61872,445,0,0,drop,70,70,0,1,0,1,0
40605,61868,445,0,0,drop,70,70,0,1,0,1,0
40606,27621,50584,0,0,deny,146,146,0,1,0,1,0
40607,57849,50584,0,0,deny,66,66,0,1,0,1,0
40608,57277,445,0,0,drop,66,66,0,1,0,1,0
40609,18876,44847,0,0,deny,66,66,0,1,0,1,0
40610,61867,445,0,0,drop,70,70,0,1,0,1,0
40611,26953,30317,0,0,deny,62,62,0,1,0,1,0
40612,6824,26467,0,0,deny,62,62,0,1,0,1,0
40613,57273,445,0,0,drop,66,66,0,1,0,1,0
40614,56975,445,0,0,drop,70,70,0,1,0,1,0
40615,28899,37965,0,0,deny,62,62,0,1,0,1,0
40616,50767,57470,0,0,deny,66,66,0,1,0,1,0
40617,57272,445,0,0,drop,66,66,0,1,0,1,0
40618,57271,445,0,0,drop,66,66,0,1,0,1,0
40619,56973,445,0,0,drop,70,70,0,1,0,1,0
40620,57268,445,0,0,drop,66,66,0,1,0,1,0
40621,42389,42873,0,0,deny,74,74,0,1,0,1,0
40622,56971,445,0,0,drop,70,70,0,1,0,1,0
40623,47134,37965,0,0,deny,62,62,0,1,0,1,0
40624,20939,60461,0,0,deny,60,60,0,1,0,1,0
40625,40834,50584,0,0,deny,146,146,0,1,0,1,0
40626,53513,56205,0,0,deny,62,62,0,1,0,1,0
40627,55553,37965,0,0,deny,66,66,0,1,0,1,0
40628,27323,23117,0,0,deny,146,146,0,1,0,1,0
40629,61862,445,0,0,drop,70,70,0,1,0,1,0
40630,23126,35440,0,0,deny,66,66,0,1,0,1,0
40631,61855,445,0,0,drop,70,70,0,1,0,1,0
40632,61858,445,0,0,drop,70,70,0,1,0,1,0
40633,19875,30170,0,0,deny,145,145,0,1,0,1,0
40634,61408,30188,0,0,deny,66,66,0,1,0,1,0
40635,56964,445,0,0,drop,70,70,0,1,0,1,0
40636,57258,445,0,0,drop,66,66,0,1,0,1,0
40637,56962,445,0,0,drop,70,70,0,1,0,1,0
40638,39351,23,0,0,deny,60,60,0,1,0,1,0
40639,60222,22114,0,0,deny,62,62,0,1,0,1,0
40640,56961,445,0,0,drop,70,70,0,1,0,1,0
40641,56960,445,0,0,drop,70,70,0,1,0,1,0
40642,56959,445,0,0,drop,70,70,0,1,0,1,0
40643,56957,445,0,0,drop,70,70,0,1,0,1,0
40644,26900,27017,16696,27017,allow,168,82,86,2,30,1,1
40645,5237,30128,2836,30128,allow,621281,256,621025,881,49,5,876
40646,26900,27017,64848,27017,allow,422,164,258,6,30,3,3
40647,37390,80,53231,80,allow,78,78,0,1,5,1,0
40648,63855,29799,41914,29799,allow,66,66,0,1,5,1,0
40649,26900,27017,27524,27017,allow,422,164,258,6,30,3,3
40650,57255,443,56046,443,allow,36865,3692,33173,61,47,30,31
40651,50613,80,39114,80,allow,85306,4735,80571,120,22,55,65
40652,50660,80,5489,80,allow,875,327,548,9,15,5,4
40653,26900,27017,46103,27017,allow,422,164,258,6,30,3,3
40654,52669,443,6202,443,allow,18814,2623,16191,54,25,26,28
40655,26900,27017,33807,27017,allow,422,164,258,6,30,3,3
40656,60174,80,16526,80,allow,1564,990,574,15,24,8,7
40657,51885,64546,64002,64546,allow,70,70,0,2,8,2,0
40658,55649,42266,41427,42266,allow,70,70,0,2,8,2,0
40659,53134,42369,45499,42369,allow,70,70,0,2,8,2,0
40660,63856,6881,31846,6881,allow,66,66,0,1,5,1,0
40661,56558,443,2694,443,allow,7702,2155,5547,19,39,11,8
40662,42388,161,0,0,allow,109,109,0,2,35,2,0
40663,50814,53,0,0,allow,82,82,0,1,30,1,0
40664,54346,443,54346,443,allow,4651,1744,2907,19,27,11,8
40665,49869,80,36356,80,allow,43386,3876,39510,79,22,42,37
40666,57275,53,57275,53,allow,217,86,131,2,30,1,1
40667,50968,443,5698,443,allow,7532,3051,4481,13,120,6,7
40668,42460,443,50577,443,allow,2907,1719,1188,17,361,9,8
40669,38611,443,14308,443,allow,22215289,662818,21552471,25924,349,8862,17062
40670,58702,80,13752,80,allow,2424,529,1895,11,75,6,5
40671,45523,443,20387,443,allow,8636,1914,6722,31,95,16,15
40672,43028,443,42197,443,allow,6748,1643,5105,26,138,14,12
40673,57843,443,8573,443,allow,25053,19627,5426,38,76,23,15
40674,57894,443,47420,443,allow,85263,3763,81500,115,216,46,69
40675,61489,443,14014,443,allow,7299,4561,2738,32,193,16,16
40676,9061,80,4144,80,allow,639,279,360,8,121,4,4
40677,51442,443,61245,443,allow,4591,3237,1354,18,271,10,8
40678,41852,443,11364,443,allow,22648,14673,7975,96,245,45,51
40679,56210,5228,6603,5228,allow,7061,1730,5331,21,3600,11,10
40680,26900,27017,2558,27017,allow,422,164,258,6,30,3,3
40681,55594,53,15652,53,allow,202,83,119,2,31,1,1
40682,55767,443,58129,443,allow,1786,172,1614,7,122,3,4
40683,57470,14435,56762,14435,allow,1035,253,782,4,1200,2,2
40684,50265,45682,46008,45682,allow,402,132,270,6,1209,3,3
40685,64085,443,64085,443,allow,140818,8751,132067,156,168,57,99
40686,59278,443,45402,443,allow,10495,9044,1451,29,35,18,11
40687,27005,27216,53096,27216,allow,883,126,757,2,31,1,1
40688,49097,80,63676,80,allow,1739,740,999,17,235,5,12
40689,45155,443,55125,443,allow,4000,1726,2274,13,135,6,7
40690,59275,443,56019,443,allow,242735602,5306961,237428641,238334,3604,81340,156994
40691,56954,445,0,0,drop,70,70,0,1,0,1,0
40692,53971,55442,0,0,deny,66,66,0,1,0,1,0
40693,59511,21247,0,0,deny,66,66,0,1,0,1,0
40694,57250,445,0,0,drop,66,66,0,1,0,1,0
40695,61839,445,0,0,drop,70,70,0,1,0,1,0
40696,993,54748,0,0,deny,66,66,0,1,0,1,0
40697,54000,53,0,0,allow,202,86,116,2,30,1,1
40698,49453,443,59315,443,allow,8251,2124,6127,21,16,11,10
40699,58831,443,5275,443,allow,8004,2236,5768,41,18,23,18
40700,51884,22828,5463,22828,allow,70,70,0,2,8,2,0
40701,50470,61463,0,0,deny,86,86,0,1,0,1,0
40702,57247,445,0,0,drop,66,66,0,1,0,1,0
40703,56941,445,0,0,drop,70,70,0,1,0,1,0
40704,56940,445,0,0,drop,70,70,0,1,0,1,0
40705,56938,445,0,0,drop,70,70,0,1,0,1,0
40706,19096,64147,0,0,deny,62,62,0,1,0,1,0
40707,56930,445,0,0,drop,70,70,0,1,0,1,0
40708,56931,445,0,0,drop,70,70,0,1,0,1,0
40709,57240,445,0,0,drop,66,66,0,1,0,1,0
40710,51164,64147,0,0,deny,62,62,0,1,0,1,0
40711,57235,445,0,0,drop,66,66,0,1,0,1,0
40712,50442,37807,0,0,deny,66,66,0,1,0,1,0
40713,8486,56205,0,0,deny,66,66,0,1,0,1,0
40714,56919,445,0,0,drop,70,70,0,1,0,1,0
40715,54778,22114,0,0,deny,66,66,0,1,0,1,0
40716,49242,22114,0,0,deny,62,62,0,1,0,1,0
40717,50137,1433,0,0,deny,60,60,0,1,0,1,0
40718,61830,445,0,0,drop,70,70,0,1,0,1,0
40719,61827,445,0,0,drop,70,70,0,1,0,1,0
40720,61828,445,0,0,drop,70,70,0,1,0,1,0
40721,56636,43890,0,0,deny,66,66,0,1,0,1,0
40722,57222,445,0,0,drop,66,66,0,1,0,1,0
40723,57217,445,0,0,drop,66,66,0,1,0,1,0
40724,57221,445,0,0,drop,66,66,0,1,0,1,0
40725,57223,445,0,0,drop,66,66,0,1,0,1,0
40726,57225,445,0,0,drop,66,66,0,1,0,1,0
40727,57220,445,0,0,drop,66,66,0,1,0,1,0
40728,57218,445,0,0,drop,66,66,0,1,0,1,0
40729,57224,445,0,0,drop,66,66,0,1,0,1,0
40730,50470,61463,0,0,deny,86,86,0,1,0,1,0
40731,15933,64147,0,0,deny,62,62,0,1,0,1,0
40732,27272,64147,0,0,deny,66,66,0,1,0,1,0
40733,59699,55783,0,0,deny,62,62,0,1,0,1,0
40734,51745,57470,0,0,deny,62,62,0,1,0,1,0
40735,56915,445,0,0,drop,70,70,0,1,0,1,0
40736,50222,42873,0,0,deny,66,66,0,1,0,1,0
40737,22922,35440,0,0,deny,66,66,0,1,0,1,0
40738,58131,15503,0,0,deny,146,146,0,1,0,1,0
40739,5617,64147,0,0,deny,62,62,0,1,0,1,0
40740,65285,44847,0,0,deny,146,146,0,1,0,1,0
40741,50529,44847,0,0,deny,66,66,0,1,0,1,0
40742,61925,51505,0,0,deny,62,62,0,1,0,1,0
40743,56906,445,0,0,drop,70,70,0,1,0,1,0
40744,56904,445,0,0,drop,70,70,0,1,0,1,0
40745,56903,445,0,0,drop,70,70,0,1,0,1,0
40746,58501,44847,0,0,deny,66,66,0,1,0,1,0
40747,56901,445,0,0,drop,70,70,0,1,0,1,0
40748,52626,44847,0,0,deny,66,66,0,1,0,1,0
40749,63938,3389,63938,3389,allow,3364,1714,1650,15,32,8,7
40750,50988,80,43692,80,allow,5956,1595,4361,17,19,10,7
40751,55747,53,47798,53,allow,199,94,105,2,29,1,1
40752,58058,53,63439,53,allow,168,78,90,2,29,1,1
40753,55760,443,60909,443,allow,12723734,404530,12319204,13539,134,4494,9045
40754,34085,80,34085,80,allow,490,264,226,8,140,5,3
40755,26900,27017,2675,27017,allow,422,164,258,6,30,3,3
40756,42119,443,42119,443,allow,9299,1697,7602,21,146,12,9
40757,36505,443,41059,443,allow,6293,1501,4792,22,16,11,11
40758,56678,443,56425,443,allow,7889,1900,5989,20,15,11,9
40759,26900,27017,59495,27017,allow,422,164,258,6,30,3,3
40760,50986,80,14169,80,allow,8074,2261,5813,22,19,13,9
40761,54437,80,15743,80,allow,95298,61941,33357,182,929,95,87
40762,37780,443,60477,443,allow,134,60,74,3,5,2,1
40763,44300,443,36814,443,allow,7746,2015,5731,29,15,16,13
40764,50530,80,18434,80,allow,3561,1337,2224,13,20,7,6
40765,63853,10659,8048,10659,allow,70,70,0,1,4,1,0
40766,33922,443,8890,443,allow,6084,1842,4242,26,329,14,12
40767,63854,16437,6082,16437,allow,70,70,0,1,4,1,0
40768,27005,1107,18135,1107,allow,824,126,698,2,29,1,1
40769,49937,80,61073,80,allow,1130,613,517,11,15,6,5
40770,26900,27017,17453,27017,allow,172,86,86,2,29,1,1
40771,27005,1304,58771,1304,allow,859,126,733,2,29,1,1
40772,51880,8001,53470,8001,allow,86,86,0,1,29,1,0
40773,52925,53,48232,53,allow,168,78,90,2,29,1,1
40774,26900,27017,4107,27017,allow,422,164,258,6,29,3,3
40775,51880,8000,3169,8000,allow,172,94,78,2,29,1,1
40776,8358,80,8358,80,allow,1875,567,1308,11,31,6,5
40777,7197,80,7197,80,allow,450,246,204,8,31,5,3
40778,54797,80,8308,80,allow,8957,4075,4882,32,416,17,15
40779,56634,80,24022,80,allow,234,234,0,4,12,4,0
40780,60429,46854,20959,46854,allow,70,70,0,1,5,1,0
40781,54828,443,1359,443,allow,150,150,0,1,5,1,0
40782,51692,993,54748,993,allow,11462,4282,7180,61,37,28,33
40783,60037,443,12655,443,allow,6194,1289,4905,23,66,12,11
40784,46278,443,29099,443,allow,6685,4843,1842,29,17,18,11
40785,63847,45598,22596,45598,allow,376,254,122,6,15,4,2
40786,49943,53,23345,53,allow,596,90,506,4,59,2,2
40787,26900,27017,44727,27017,allow,422,164,258,6,30,3,3
40788,26900,27017,63917,27017,allow,422,164,258,6,30,3,3
40789,33564,443,54838,443,allow,314376,14130,300246,399,246,169,230
40790,56675,443,33305,443,allow,7941,1952,5989,20,15,11,9
40791,49568,443,30225,443,allow,6408,2531,3877,21,16,11,10
40792,49875,53,45365,53,allow,445,94,351,2,30,1,1
40793,64577,443,50601,443,allow,24686,1935,22751,36,16,17,19
40794,63875,43485,59709,43485,allow,312,132,180,6,6,3,3
40795,50089,443,20398,443,allow,292,172,120,4,15,2,2
40796,26900,27017,11839,27017,allow,422,164,258,6,30,3,3
40797,49294,53,7678,53,allow,287,94,193,2,30,1,1
40798,64505,53,32135,53,allow,214,102,112,2,30,1,1
40799,51872,48108,27950,48108,allow,70,70,0,1,5,1,0
40800,40980,443,52078,443,allow,567854,22650,545204,713,158,311,402
40801,53375,53,19528,53,allow,298,86,212,2,30,1,1
40802,46964,80,54750,80,allow,1687,951,736,10,93,6,4
40803,55894,53,40691,53,allow,216,102,114,2,30,1,1
40804,65169,53,4248,53,allow,211,102,109,2,30,1,1
40805,55161,53,36813,53,allow,197,94,103,2,30,1,1
40806,26900,27017,46394,27017,allow,422,164,258,6,30,3,3
40807,56846,26665,12553,26665,allow,70,70,0,2,8,2,0
40808,51870,40490,51955,40490,allow,70,70,0,1,5,1,0
40809,53403,443,55979,443,allow,38342,14090,24252,83,159,40,43
40810,50517,80,5050,80,allow,502,256,246,9,25,5,4
40811,51548,80,13460,80,allow,1861,1219,642,10,15,5,5
40812,49940,80,46739,80,allow,1130,613,517,11,15,6,5
40813,56254,80,61838,80,allow,1196,682,514,12,15,6,6
40814,26900,27017,28688,27017,allow,422,164,258,6,30,3,3
40815,57731,53,26408,53,allow,237,86,151,2,30,1,1
40816,26900,27017,53527,27017,allow,254,82,172,4,30,2,2
40817,50394,443,24134,443,allow,60424,4482,55942,101,686,39,62
40818,56677,443,24316,443,allow,7941,1952,5989,20,15,11,9
40819,57804,443,57804,443,allow,4378,1471,2907,19,26,11,8
40820,50984,80,27335,80,allow,8706,2289,6417,22,19,13,9
40821,50987,80,34293,80,allow,8047,2291,5756,22,19,13,9
40822,65278,53,33473,53,allow,403,91,312,4,34,2,2
40823,38369,443,64342,443,allow,434,226,208,7,28,4,3
40824,56676,443,53618,443,allow,7889,1900,5989,20,15,11,9
40825,53132,443,46008,443,allow,6515,1516,4999,23,16,12,11
40826,58547,53,0,0,allow,86,86,0,1,29,1,0
40827,26900,27017,49129,27017,allow,422,164,258,6,30,3,3
40828,50817,53,0,0,allow,182,73,109,2,30,1,1
40829,36949,443,20544,443,allow,7474,1298,6176,25,81,11,14
40830,61862,80,50297,80,allow,9747,537,9210,14,16,6,8
40831,49205,443,49232,443,allow,512444,20822,491622,555,159,191,364
40832,61049,53,17729,53,allow,525,150,375,6,33,3,3
40833,60430,51413,49908,51413,allow,70,70,0,1,5,1,0
40834,54347,443,29019,443,allow,9976,3230,6746,22,58,13,9
40835,54279,443,54279,443,allow,4699,1792,2907,19,28,11,8
40836,50516,80,41134,80,allow,502,256,246,9,25,5,4
40837,26900,27017,30872,27017,allow,422,164,258,6,29,3,3
40838,63578,5228,10061,5228,allow,8544,2633,5911,51,154,28,23
40839,50512,80,4579,80,allow,318,192,126,6,25,4,2
40840,26900,27017,12522,27017,allow,422,164,258,6,30,3,3
40841,54000,53,38105,53,allow,294,86,208,2,30,1,1
40842,26900,27017,60227,27017,allow,422,164,258,6,30,3,3
40843,46189,443,46189,443,allow,4398,1491,2907,19,30,11,8
40844,64817,53,59265,53,allow,199,94,105,2,29,1,1
40845,58427,53,30619,53,allow,197,94,103,2,30,1,1
40846,26900,27017,22476,27017,allow,422,164,258,6,30,3,3
40847,57470,6881,12266,6881,allow,453,251,202,4,1199,2,2
40848,55877,6380,28997,6380,allow,149,149,0,2,1200,2,0
40849,52660,443,21035,443,allow,5042,2002,3040,14,119,7,7
40850,19412,53,19412,53,allow,229,98,131,2,30,1,1
40851,26900,27017,5951,27017,allow,422,164,258,6,30,3,3
40852,26900,27017,3690,27017,allow,422,164,258,6,30,3,3
40853,54978,53,3492,53,allow,198,94,104,2,30,1,1
40854,49976,53,44388,53,allow,245,110,135,2,30,1,1
40855,27005,1302,11338,1302,allow,862,126,736,2,30,1,1
40856,27005,27015,49083,27015,allow,872,126,746,2,30,1,1
40857,27005,1401,26580,1401,allow,864,126,738,2,30,1,1
40858,49932,53,19133,53,allow,237,86,151,2,30,1,1
40859,51091,53,0,0,allow,325,75,250,2,30,1,1
40860,56224,53,54618,53,allow,221,102,119,2,30,1,1
40861,56972,53,60729,53,allow,301,126,175,2,30,1,1
40862,65145,53,64400,53,allow,338,110,228,2,30,1,1
40863,42433,443,64701,443,allow,6381,3801,2580,19,135,10,9
40864,62073,443,18581,443,allow,7989,4098,3891,34,136,15,19
40865,41498,443,27057,443,allow,2733,1555,1178,22,275,11,11
40866,57470,6881,1701,6881,allow,453,251,202,4,1199,2,2
40867,27005,27272,38443,27272,allow,887,126,761,2,30,1,1
40868,57430,80,9392,80,allow,4509,2976,1533,13,15,6,7
40869,53378,443,65278,443,allow,5090,1692,3398,19,82,11,8
40870,50510,80,5594,80,allow,378,192,186,7,25,4,3
40871,17046,53,17046,53,allow,220,90,130,2,30,1,1
40872,26900,27017,1204,27017,allow,422,164,258,6,30,3,3
40873,49597,53,64001,53,allow,216,102,114,2,30,1,1
40874,64975,53,43514,53,allow,198,94,104,2,30,1,1
40875,54656,443,58488,443,allow,6509,1635,4874,21,186,11,10
40876,37653,5223,42431,5223,allow,142,142,0,1,5,1,0
40877,50513,80,33823,80,allow,318,192,126,6,25,4,2
40878,49939,80,14388,80,allow,1130,613,517,11,15,6,5
40879,49938,80,5232,80,allow,1130,613,517,11,15,6,5
40880,50511,80,14463,80,allow,318,192,126,6,25,4,2
40881,34313,53,0,0,allow,184,86,98,2,30,1,1
40882,11236,53,11236,53,allow,197,90,107,2,30,1,1
40883,36942,53,36942,53,allow,197,90,107,2,30,1,1
40884,49903,443,11070,443,allow,355761,14847,340914,423,33,183,240
40885,54846,53,32938,53,allow,168,78,90,2,30,1,1
40886,64888,53,40321,53,allow,767,102,665,2,30,1,1
40887,26900,27017,39625,27017,allow,422,164,258,6,30,3,3
40888,61700,53,61700,53,allow,221,90,131,2,30,1,1
40889,37748,80,57196,80,allow,1090,609,481,13,329,7,6
40890,51437,443,45199,443,allow,6286,1494,4792,22,16,11,11
40891,60277,443,60277,443,allow,7428,729,6699,19,80,7,12
40892,58439,443,16787,443,allow,232,172,60,3,5,2,1
40893,48462,80,48462,80,allow,19738,890,18848,25,20,9,16
40894,50131,443,16533,443,allow,12716,2575,10141,55,141,27,28
40895,56610,80,6975,80,allow,1604,700,904,15,116,7,8
40896,64243,53,51060,53,allow,258,102,156,2,30,1,1
40897,6881,13929,23344,13929,allow,502,150,352,2,1200,1,1
40898,6881,25243,30519,25243,allow,498,150,348,4,1273,2,2
40899,55732,53,56337,53,allow,280,126,154,2,30,1,1
40900,60597,53,0,0,allow,344,94,250,2,30,1,1
40901,64784,53,44632,53,allow,195,102,93,2,30,1,1
40902,27005,1403,18731,1403,allow,857,126,731,2,30,1,1
40903,56901,53,16725,53,allow,264,94,170,2,31,1,1
40904,49583,443,53752,443,allow,10877,2925,7952,56,285,23,33
40905,54970,443,62898,443,allow,251620,16028,235592,353,371,159,194
40906,27005,1307,27385,1307,allow,857,126,731,2,30,1,1
40907,64558,53,57812,53,allow,321,102,219,2,31,1,1
40908,9057,443,55377,443,allow,7769,3958,3811,17,121,9,8
40909,60206,443,52179,443,allow,4706,2475,2231,13,120,7,6
40910,41787,443,37748,443,allow,34237,22442,11795,86,131,41,45
40911,61113,443,60052,443,allow,23915,14776,9139,66,136,35,31
40912,6881,31026,35308,31026,allow,509,150,359,2,1199,1,1
40913,48817,11373,48817,11373,allow,481,150,331,2,1200,1,1
40914,27005,1101,40896,1101,allow,902,126,776,2,30,1,1
40915,63616,443,48346,443,allow,1296,612,684,18,120,9,9
40916,60026,443,38651,443,allow,3643,607,3036,13,120,6,7
40917,64510,443,61997,443,allow,18370,2434,15936,26,120,11,15
40918,33654,443,14790,443,allow,8628,2898,5730,20,144,9,11
40919,63992,443,1306,443,allow,4360,2142,2218,15,120,7,8
40920,37965,39108,36972,39108,allow,1056,1056,0,17,1550,17,0
40921,57470,6969,61511,6969,allow,37677,7875,29802,115,3342,58,57
40922,54961,443,45503,443,allow,25572,2605,22967,56,133,29,27
40923,51888,42529,42090,42529,allow,316,136,180,6,6,3,3
40924,56691,443,48234,443,allow,3986,2645,1341,18,18,10,8
40925,56692,443,32743,443,allow,3932,2581,1351,18,18,10,8
40926,37570,443,52731,443,allow,130,64,66,3,6,2,1
40927,40231,443,30990,443,allow,10401,3375,7026,33,22,17,16
40928,56694,443,2147,443,allow,3723,2372,1351,18,18,10,8
40929,56690,443,32613,443,allow,3936,2585,1351,18,18,10,8
40930,50257,3389,50257,3389,allow,3473,1518,1955,17,18,9,8
40931,56693,443,44446,443,allow,3886,2545,1341,18,18,10,8
40932,50688,5222,59884,5222,allow,402,342,60,2,15,1,1
40933,34170,80,4419,80,allow,2865,2000,865,12,16,7,5
40934,55214,443,10396,443,allow,10048,2128,7920,44,118,24,20
40935,53816,22114,0,0,deny,146,146,0,1,0,1,0
40936,61818,445,0,0,drop,70,70,0,1,0,1,0
40937,61813,445,0,0,drop,70,70,0,1,0,1,0
40938,61811,445,0,0,drop,70,70,0,1,0,1,0
40939,56898,445,0,0,drop,70,70,0,1,0,1,0
40940,57205,445,0,0,drop,66,66,0,1,0,1,0
40941,57203,445,0,0,drop,66,66,0,1,0,1,0
40942,57202,445,0,0,drop,66,66,0,1,0,1,0
40943,61810,445,0,0,drop,70,70,0,1,0,1,0
40944,58888,23718,0,0,deny,66,66,0,1,0,1,0
40945,61808,445,0,0,drop,70,70,0,1,0,1,0
40946,443,48346,0,0,deny,81,81,0,1,0,1,0
40947,56892,445,0,0,drop,70,70,0,1,0,1,0
40948,61803,445,0,0,drop,70,70,0,1,0,1,0
40949,61800,445,0,0,drop,70,70,0,1,0,1,0
40950,61802,445,0,0,drop,70,70,0,1,0,1,0
40951,9528,44847,0,0,deny,146,146,0,1,0,1,0
40952,61563,37807,0,0,deny,66,66,0,1,0,1,0
40953,56885,445,0,0,drop,70,70,0,1,0,1,0
40954,13911,57470,0,0,deny,60,60,0,1,0,1,0
40955,12128,37965,0,0,deny,62,62,0,1,0,1,0
40956,56882,445,0,0,drop,70,70,0,1,0,1,0
40957,56127,35440,0,0,deny,62,62,0,1,0,1,0
40958,65096,37807,0,0,deny,66,66,0,1,0,1,0
40959,54489,53,0,0,allow,232,77,155,2,2,1,1
40960,61787,445,0,0,drop,70,70,0,1,0,1,0
40961,61788,445,0,0,drop,70,70,0,1,0,1,0
40962,61784,445,0,0,drop,70,70,0,1,0,1,0
40963,9327,57470,0,0,deny,62,62,0,1,0,1,0
40964,56879,445,0,0,drop,70,70,0,1,0,1,0
40965,56877,445,0,0,drop,70,70,0,1,0,1,0
40966,60462,47967,0,0,deny,148,148,0,1,0,1,0
40967,56873,445,0,0,drop,70,70,0,1,0,1,0
40968,60248,30188,0,0,deny,62,62,0,1,0,1,0
40969,52672,22114,0,0,deny,146,146,0,1,0,1,0
40970,50713,57470,0,0,deny,62,62,0,1,0,1,0
40971,57649,6881,0,0,deny,62,62,0,1,0,1,0
40972,56872,445,0,0,drop,70,70,0,1,0,1,0
40973,57182,445,0,0,drop,66,66,0,1,0,1,0
40974,61781,445,0,0,drop,70,70,0,1,0,1,0
40975,61779,445,0,0,drop,70,70,0,1,0,1,0
40976,59611,56205,0,0,deny,66,66,0,1,0,1,0
40977,62150,23718,0,0,deny,66,66,0,1,0,1,0
40978,15854,50584,0,0,deny,62,62,0,1,0,1,0
40979,56867,445,0,0,drop,70,70,0,1,0,1,0
40980,12074,10197,0,0,deny,72,72,0,1,0,1,0
40981,57176,445,0,0,drop,66,66,0,1,0,1,0
40982,58341,10197,0,0,deny,78,78,0,1,0,1,0
40983,57173,445,0,0,drop,66,66,0,1,0,1,0
40984,40161,443,23210,443,allow,13459,1604,11855,27,66,14,13
40985,61769,445,0,0,drop,70,70,0,1,0,1,0
40986,49644,30188,0,0,deny,66,66,0,1,0,1,0
40987,1038,37965,0,0,deny,62,62,0,1,0,1,0
40988,61764,445,0,0,drop,70,70,0,1,0,1,0
40989,61761,445,0,0,drop,70,70,0,1,0,1,0
40990,61760,445,0,0,drop,70,70,0,1,0,1,0
40991,57169,445,0,0,drop,66,66,0,1,0,1,0
40992,65285,50584,0,0,deny,66,66,0,1,0,1,0
40993,63098,35440,0,0,deny,66,66,0,1,0,1,0
40994,10427,32480,0,0,deny,66,66,0,1,0,1,0
40995,65317,51221,0,0,deny,78,78,0,1,0,1,0
40996,26969,29434,0,0,deny,146,146,0,1,0,1,0
40997,61755,445,0,0,drop,70,70,0,1,0,1,0
40998,56854,445,0,0,drop,70,70,0,1,0,1,0
40999,61751,445,0,0,drop,70,70,0,1,0,1,0
41000,61750,445,0,0,drop,70,70,0,1,0,1,0
41001,61748,445,0,0,drop,70,70,0,1,0,1,0
41002,57162,445,0,0,drop,66,66,0,1,0,1,0
41003,30169,35776,0,0,deny,159,159,0,1,0,1,0
41004,57158,445,0,0,drop,66,66,0,1,0,1,0
41005,57157,445,0,0,drop,66,66,0,1,0,1,0
41006,57156,445,0,0,drop,66,66,0,1,0,1,0
41007,56851,445,0,0,drop,70,70,0,1,0,1,0
41008,26729,57470,0,0,deny,66,66,0,1,0,1,0
41009,57153,445,0,0,drop,66,66,0,1,0,1,0
41010,57152,445,0,0,drop,66,66,0,1,0,1,0
41011,57151,445,0,0,drop,66,66,0,1,0,1,0
41012,61404,52700,0,0,deny,72,72,0,1,0,1,0
41013,58424,52700,0,0,deny,66,66,0,1,0,1,0
41014,51320,44847,0,0,deny,66,66,0,1,0,1,0
41015,64276,26467,0,0,deny,66,66,0,1,0,1,0
41016,61743,445,0,0,drop,70,70,0,1,0,1,0
41017,61742,445,0,0,drop,70,70,0,1,0,1,0
41018,61741,445,0,0,drop,70,70,0,1,0,1,0
41019,59509,64147,0,0,deny,62,62,0,1,0,1,0
41020,56846,445,0,0,drop,70,70,0,1,0,1,0
41021,57148,445,0,0,drop,66,66,0,1,0,1,0
41022,61739,445,0,0,drop,70,70,0,1,0,1,0
41023,30016,36237,0,0,deny,62,62,0,1,0,1,0
41024,56845,445,0,0,drop,70,70,0,1,0,1,0
41025,57146,445,0,0,drop,66,66,0,1,0,1,0
41026,60052,37965,0,0,deny,66,66,0,1,0,1,0
41027,56843,445,0,0,drop,70,70,0,1,0,1,0
41028,57142,445,0,0,drop,66,66,0,1,0,1,0
41029,57143,445,0,0,drop,66,66,0,1,0,1,0
41030,48840,50584,0,0,deny,146,146,0,1,0,1,0
41031,57140,445,0,0,drop,66,66,0,1,0,1,0
41032,2681,48817,0,0,deny,146,146,0,1,0,1,0
41033,65265,55067,0,0,deny,66,66,0,1,0,1,0
41034,61738,445,0,0,drop,70,70,0,1,0,1,0
41035,34311,5900,0,0,deny,60,60,0,1,0,1,0
41036,49807,443,23954,443,allow,2796,1730,1066,15,126,9,6
41037,49911,80,3385,80,allow,1519,787,732,10,110,6,4
41038,62325,443,62325,443,allow,1210,637,573,14,51,7,7
41039,49761,80,17829,80,allow,2113,1181,932,10,127,6,4
41040,49712,443,1489,443,allow,11365,1278,10087,23,131,10,13
41041,49750,443,8728,443,allow,7370,1474,5896,19,128,10,9
41042,59219,80,51900,80,allow,1658,1344,314,10,15,5,5
41043,49639,443,37506,443,allow,7521,2117,5404,22,89,12,10
41044,49765,443,44439,443,allow,17982,2337,15645,34,127,16,18
41045,49760,80,15959,80,allow,2113,1181,932,10,127,6,4
41046,49805,443,42807,443,allow,2839,1654,1185,15,126,9,6
41047,49808,443,22176,443,allow,1101,654,447,12,126,7,5
41048,43184,80,44137,80,allow,1972,1464,508,15,16,7,8
41049,55177,80,55177,80,allow,374,240,134,7,15,5,2
41050,57911,443,43527,443,allow,9662,4079,5583,66,194,30,36
41051,49706,443,36455,443,allow,32941,1850,31091,46,131,19,27
41052,49803,80,1813,80,allow,2553,1621,932,13,126,8,5
41053,49746,443,2591,443,allow,54014,2565,51449,65,128,24,41
41054,48837,53,7815,53,allow,198,93,105,2,30,1,1
41055,57078,3389,57078,3389,allow,3407,1518,1889,16,17,9,7
41056,62328,443,62328,443,allow,1210,637,573,14,51,7,7
41057,43309,80,55504,80,allow,805,665,140,6,32,4,2
41058,49813,443,15951,443,allow,10103,3140,6963,29,126,16,13
41059,55176,80,55176,80,allow,374,240,134,7,15,5,2
41060,49769,443,60646,443,allow,14166,2015,12151,27,127,11,16
41061,49277,80,55324,80,allow,254,128,126,5,16,3,2
41062,49762,80,8921,80,allow,2114,1182,932,10,127,6,4
41063,51145,80,51145,80,allow,33072,3959,29113,40,46,14,26
41064,49774,443,35552,443,allow,26623,5756,20867,42,126,18,24
41065,55178,80,55178,80,allow,374,240,134,7,15,5,2
41066,49749,443,40981,443,allow,7398,1597,5801,20,128,10,10
41067,49246,443,11384,443,allow,29705,9203,20502,41,18,21,20
41068,51760,443,1508,443,allow,1569,1044,525,14,94,9,5
41069,57913,443,36692,443,allow,10457,4216,6241,70,194,31,39
41070,49718,80,57630,80,allow,11291,1348,9943,17,131,6,11
41071,49811,443,7864,443,allow,7551,2453,5098,22,126,12,10
41072,62329,443,62329,443,allow,1210,637,573,14,51,7,7
41073,49912,80,32939,80,allow,1590,858,732,10,110,6,4
41074,57596,80,43063,80,allow,1231,726,505,10,18,6,4
41075,62327,443,62327,443,allow,1210,637,573,14,51,7,7
41076,60681,443,60681,443,allow,5667,1393,4274,19,16,9,10
41077,35894,53,14493,53,allow,198,93,105,2,30,1,1
41078,57597,443,32556,443,allow,12528,7238,5290,26,91,15,11
41079,62962,443,7055,443,allow,5036,2564,2472,15,125,8,7
41080,30960,45724,8617,45724,allow,330,330,0,6,3609,6,0
41081,65415,443,12568,443,allow,2494,1643,851,17,26,9,8
41082,56527,53,0,0,allow,206,83,123,2,31,1,1
41083,42601,443,30864,443,allow,10845900,123386,10722514,8862,139,1081,7781
41084,45941,23386,0,0,deny,60,60,0,1,0,1,0
41085,61729,445,0,0,drop,70,70,0,1,0,1,0
41086,61723,445,0,0,drop,70,70,0,1,0,1,0
41087,56836,445,0,0,drop,70,70,0,1,0,1,0
41088,56834,445,0,0,drop,70,70,0,1,0,1,0
41089,9283,57470,0,0,deny,66,66,0,1,0,1,0
41090,54099,80,63919,80,allow,214,140,74,4,15,3,1
41091,37780,443,37780,443,allow,4294,695,3599,15,20,8,7
41092,49748,443,24833,443,allow,7084,1703,5381,19,128,10,9
41093,50338,443,61638,443,allow,6441,1651,4790,22,53,12,10
41094,49782,443,2557,443,allow,7757,1997,5760,23,126,13,10
41095,57129,445,0,0,drop,66,66,0,1,0,1,0
41096,57987,56125,0,0,deny,90,90,0,1,0,1,0
41097,56833,445,0,0,drop,70,70,0,1,0,1,0
41098,56832,445,0,0,drop,70,70,0,1,0,1,0
41099,56831,445,0,0,drop,70,70,0,1,0,1,0
41100,56825,445,0,0,drop,70,70,0,1,0,1,0
41101,56828,445,0,0,drop,70,70,0,1,0,1,0
41102,33896,57470,0,0,deny,74,74,0,1,0,1,0
41103,57131,26296,0,0,deny,145,145,0,1,0,1,0
41104,55565,64147,0,0,deny,66,66,0,1,0,1,0
41105,13281,51050,0,0,deny,62,62,0,1,0,1,0
41106,51324,11392,0,0,deny,66,66,0,1,0,1,0
41107,54210,36237,0,0,deny,62,62,0,1,0,1,0
41108,57122,445,0,0,drop,66,66,0,1,0,1,0
41109,61711,445,0,0,drop,70,70,0,1,0,1,0
41110,63447,44847,0,0,deny,62,62,0,1,0,1,0
41111,56256,62413,0,0,deny,62,62,0,1,0,1,0
41112,61242,35253,0,0,deny,66,66,0,1,0,1,0
41113,13462,35440,0,0,deny,62,62,0,1,0,1,0
41114,56811,445,0,0,drop,70,70,0,1,0,1,0
41115,56810,445,0,0,drop,70,70,0,1,0,1,0
41116,443,21255,0,0,deny,66,66,0,1,0,1,0
41117,45964,55559,0,0,deny,60,60,0,1,0,1,0
41118,56806,445,0,0,drop,70,70,0,1,0,1,0
41119,59364,44847,0,0,deny,66,66,0,1,0,1,0
41120,56800,445,0,0,drop,70,70,0,1,0,1,0
41121,56801,445,0,0,drop,70,70,0,1,0,1,0
41122,56646,48817,0,0,deny,62,62,0,1,0,1,0
41123,61945,48817,0,0,deny,66,66,0,1,0,1,0
41124,57120,445,0,0,drop,66,66,0,1,0,1,0
41125,41282,53,19391,53,allow,168,78,90,2,30,1,1
41126,56744,53,53021,53,allow,274,110,164,2,30,1,1
41127,49951,53,52674,53,allow,525,110,415,2,30,1,1
41128,57470,41813,46944,41813,allow,519,166,353,2,1200,1,1
41129,15503,48319,24114,48319,allow,481,150,331,2,1199,1,1
41130,49816,443,49816,443,allow,4682,1775,2907,19,28,11,8
41131,61407,443,61407,443,allow,4552,1645,2907,19,26,11,8
41132,56695,443,49657,443,allow,3874,2523,1351,18,17,10,8
41133,49777,443,39129,443,allow,8638,2215,6423,24,126,14,10
41134,64784,53,28832,53,allow,195,102,93,2,29,1,1
41135,57470,18634,6347,18634,allow,594,594,0,10,1199,10,0
41136,49828,443,43122,443,allow,7284,1353,5931,26,186,14,12
41137,53237,443,24814,443,allow,33472,16066,17406,57,48,29,28
41138,42156,80,29548,80,allow,891,536,355,10,255,6,4
41139,51612,443,45282,443,allow,6777,3431,3346,27,15,14,13
41140,53693,26515,52761,26515,allow,70,70,0,2,7,2,0
41141,63846,80,10554,80,allow,314,192,122,6,15,4,2
41142,51465,443,37534,443,allow,318,70,248,5,17,1,4
41143,51443,443,10966,443,allow,1048,1048,0,9,16,9,0
41144,48187,443,22685,443,allow,1515,568,947,14,82,6,8
41145,51690,993,38356,993,allow,15022,5202,9820,113,36,53,60
41146,55179,80,55179,80,allow,374,240,134,7,15,5,2
41147,49747,443,22101,443,allow,7087,1705,5382,19,128,10,9
41148,49714,80,42166,80,allow,2096,1011,1085,11,130,6,5
41149,65173,53,61112,53,allow,508,186,322,6,51,3,3
41150,49527,53,42526,53,allow,268,94,174,2,29,1,1
41151,27005,27015,16145,27015,allow,879,126,753,2,29,1,1
41152,50509,80,1536,80,allow,49872,11098,38774,65,24,27,38
41153,49775,80,20586,80,allow,1302,849,453,10,126,6,4
41154,49711,443,12474,443,allow,18088,1844,16244,34,130,14,20
41155,49779,443,29819,443,allow,10057,1887,8170,23,126,12,11
41156,49838,443,6189,443,allow,8555,1821,6734,24,123,13,11
41157,54654,6881,17557,6881,allow,470,348,122,6,26,4,2
41158,59001,80,22174,80,allow,1266,383,883,16,393,4,12
41159,36513,443,42006,443,allow,4216,2615,1601,26,80,13,13
41160,62326,443,62326,443,allow,1210,637,573,14,51,7,7
41161,51461,443,45147,443,allow,318,70,248,5,17,1,4
41162,55733,53,46441,53,allow,463,128,335,4,41,2,2
41163,51867,48059,47188,48059,allow,160,70,90,2,5,1,1
41164,49740,443,61794,443,allow,7554,2281,5273,22,129,13,9
41165,49766,443,21804,443,allow,12026,1450,10576,27,127,12,15
41166,49741,443,56871,443,allow,6060,1553,4507,18,129,10,8
41167,49738,443,60730,443,allow,5572,1446,4126,17,129,10,7
41168,49786,443,41630,443,allow,10079,2855,7224,23,126,12,11
41169,49715,443,3770,443,allow,7681,1658,6023,21,130,11,10
41170,49716,443,11903,443,allow,9323,3144,6179,24,130,14,10
41171,49809,443,59332,443,allow,83683,2747,80936,92,125,32,60
41172,49700,80,32872,80,allow,56411,2447,53964,58,130,19,39
41173,49801,443,19605,443,allow,44380,1589,42791,48,126,14,34
41174,49743,443,63725,443,allow,157156,3872,153284,160,128,48,112
41175,49736,443,65019,443,allow,52574,2783,49791,61,129,19,42
41176,49745,443,54598,443,allow,4043,1781,2262,19,128,11,8
41177,49791,443,8451,443,allow,6057,767,5290,16,126,8,8
41178,62732,443,28854,443,allow,50000,36438,13562,98,336,61,37
41179,49719,443,9783,443,allow,40332,2476,37856,57,130,26,31
41180,35452,443,39555,443,allow,5120,3761,1359,21,49,12,9
41181,49710,443,57720,443,allow,9772,1954,7818,23,130,12,11
41182,54926,6789,33904,6789,allow,124239,48650,75589,1342,84,628,714
41183,64772,53,64772,53,allow,241,98,143,2,30,1,1
41184,49834,443,28335,443,allow,9890,4516,5374,26,124,14,12
41185,49835,443,4788,443,allow,10066,4676,5390,27,123,15,12
41186,65232,53,42020,53,allow,311,94,217,2,30,1,1
41187,55411,53,35188,53,allow,200,94,106,2,30,1,1
41188,49183,53,43011,53,allow,592,198,394,6,78,3,3
41189,48189,443,41896,443,allow,1343,616,727,14,82,7,7
41190,51868,30305,17475,30305,allow,70,70,0,1,5,1,0
41191,33858,443,46476,443,allow,12017,2031,9986,38,216,18,20
41192,49778,443,56574,443,allow,10105,1951,8154,24,126,13,11
41193,49727,443,62181,443,allow,1461,761,700,15,130,8,7
41194,65052,53,65052,53,allow,240,98,142,2,30,1,1
41195,41321,443,40754,443,allow,6989232,188564,6800668,7110,288,2412,4698
41196,56076,53,58265,53,allow,311,94,217,2,30,1,1
41197,34306,53,34306,53,allow,241,98,143,2,30,1,1
41198,49981,53,18517,53,allow,200,94,106,2,30,1,1
41199,50288,443,59061,443,allow,8207,2558,5649,41,80,23,18
41200,49702,80,20428,80,allow,2014,1216,798,13,130,8,5
41201,49780,80,65003,80,allow,1429,931,498,10,126,6,4
41202,49783,443,33987,443,allow,10095,2871,7224,23,126,12,11
41203,49836,443,16827,443,allow,6611,2169,4442,20,123,12,8
41204,49812,443,57189,443,allow,6503,2037,4466,24,125,13,11
41205,49763,443,64834,443,allow,8439,1840,6599,21,127,11,10
41206,55142,443,55142,443,allow,4480,555,3925,11,20,6,5
41207,64272,53,63528,53,allow,626,190,436,6,60,3,3
41208,57167,53,41895,53,allow,195,102,93,2,30,1,1
41209,56659,53,34690,53,allow,199,94,105,2,30,1,1
41210,9047,443,22557,443,allow,3645,609,3036,13,120,6,7
41211,57150,53,63337,53,allow,286,97,189,4,47,2,2
41212,49810,80,21965,80,allow,1469,979,490,10,125,6,4
41213,41133,443,38649,443,allow,6964782,246690,6718092,7203,184,2494,4709
41214,49815,443,20999,443,allow,3964,780,3184,14,125,8,6
41215,42186,443,43705,443,allow,10165,2433,7732,19,49,10,9
41216,63590,443,25710,443,allow,6187,933,5254,18,147,10,8
41217,53912,443,53912,443,allow,4447,1540,2907,19,30,11,8
41218,44890,443,40961,443,allow,2134,1397,737,18,1162,10,8
41219,56674,443,42391,443,allow,7889,1900,5989,20,15,11,9
41220,52077,443,25258,443,allow,6317,2196,4121,19,15,10,9
41221,56842,24233,12414,24233,allow,70,70,0,2,8,2,0
41222,49795,443,22996,443,allow,7243,777,6466,17,126,8,9
41223,10165,80,10165,80,allow,6714,929,5785,17,33,8,9
41224,49826,443,35074,443,allow,5635,1599,4036,19,125,11,8
41225,56696,443,27730,443,allow,3140,1782,1358,18,17,10,8
41226,48509,443,53083,443,allow,4922,950,3972,17,34,10,7
41227,41685,161,0,0,allow,109,109,0,2,34,2,0
41228,55174,80,55174,80,allow,374,240,134,7,15,5,2
41229,49701,80,18933,80,allow,6132,634,5498,13,130,6,7
41230,58682,443,48693,443,allow,5061,876,4185,16,70,8,8
41231,49490,53,6765,53,allow,364,92,272,4,38,2,2
41232,14394,443,16776,443,allow,4649,2928,1721,40,415,21,19
41233,49806,443,11715,443,allow,37255,2202,35053,46,125,17,29
41234,41487,443,27679,443,allow,7112,5916,1196,20,30,10,10
41235,49717,443,12194,443,allow,20576,8959,11617,42,130,24,18
41236,62730,443,41025,443,allow,12539,6472,6067,81,406,37,44
41237,49790,80,49818,80,allow,1769,1271,498,10,126,6,4
41238,49731,80,40624,80,allow,318,192,126,6,130,4,2
41239,34767,443,6327,443,allow,6313,1368,4945,21,846,11,10
41240,49788,443,22621,443,allow,74171,1888,72283,72,126,18,54
41241,49734,80,8310,80,allow,88983,2379,86604,92,129,30,62
41242,60425,60425,17270,60425,allow,1728,1031,697,14,17,8,6
41243,27005,1402,23160,1402,allow,870,126,744,2,29,1,1
41244,49817,443,20632,443,allow,4504,839,3665,16,125,8,8
41245,48186,443,28155,443,allow,1947,688,1259,18,82,8,10
41246,37462,53,30454,53,allow,207,86,121,2,30,1,1
41247,46384,443,46384,443,allow,4594,1687,2907,19,30,11,8
41248,56306,53,41144,53,allow,228,94,134,2,30,1,1
41249,34995,443,34995,443,allow,1542,489,1053,8,20,5,3
41250,60597,53,0,0,allow,344,94,250,2,29,1,1
41251,57470,22646,6893,22646,allow,353,166,187,2,1200,1,1
41252,64944,53,42030,53,allow,228,94,134,2,30,1,1
41253,50975,53,27923,53,allow,199,94,105,2,30,1,1
41254,22583,53,22583,53,allow,213,82,131,2,30,1,1
41255,55638,53,61828,53,allow,184,86,98,2,30,1,1
41256,57167,53,27604,53,allow,195,102,93,2,30,1,1
41257,46385,53,10375,53,allow,199,94,105,2,30,1,1
41258,54320,27016,15570,27016,allow,924,924,0,3,30,3,0
41259,52883,53,22567,53,allow,339,94,245,2,30,1,1
41260,47037,80,10159,80,allow,613,539,74,7,15,6,1
41261,38897,443,50921,443,allow,11019,4204,6815,23,49,13,10
41262,51869,25355,56016,25355,allow,70,70,0,1,5,1,0
41263,49767,443,22404,443,allow,11883,1419,10464,26,127,11,15
41264,49735,443,18914,443,allow,1143,672,471,12,129,7,5
41265,49792,443,3776,443,allow,6089,799,5290,16,126,8,8
41266,49781,443,43148,443,allow,7877,1949,5928,24,126,12,12
41267,49794,443,25276,443,allow,7307,841,6466,18,126,9,9
41268,39762,443,10128,443,allow,9264,2848,6416,31,100,16,15
41269,49804,443,24644,443,allow,5938,1521,4417,20,125,10,10
41270,49837,443,60962,443,allow,9634,2232,7402,24,123,12,12
41271,49764,443,53395,443,allow,7128,865,6263,19,127,9,10
41272,58536,53,40631,53,allow,522,162,360,6,64,3,3
41273,55595,443,57179,443,allow,448,166,282,2,30,1,1
41274,58302,443,57426,443,allow,4568,2059,2509,17,33,9,8
41275,56673,443,15225,443,allow,7941,1952,5989,20,15,11,9
41276,39820,443,46872,443,allow,2190,1249,941,23,26,12,11
41277,51882,15733,38796,15733,allow,70,70,0,2,8,2,0
41278,49742,443,32248,443,allow,4490,750,3740,16,128,8,8
41279,49785,443,35177,443,allow,7757,1949,5808,22,126,12,10
41280,49732,80,4505,80,allow,2052,711,1341,10,130,6,4
41281,49787,443,47487,443,allow,34175,1680,32495,42,126,15,27
41282,49713,80,27859,80,allow,5029,1986,3043,16,130,8,8
41283,56672,443,28399,443,allow,7888,1899,5989,20,15,11,9
41284,39814,443,9384,443,allow,5761,3561,2200,45,51,23,22
41285,54685,53,54685,53,allow,832,106,726,2,30,1,1
41286,55768,443,42706,443,allow,5263,2534,2729,16,120,8,8
41287,27005,27212,63313,27212,allow,889,126,763,2,30,1,1
41288,56615,443,28312,443,allow,4425,2899,1526,24,34,14,10
41289,49768,443,40344,443,allow,12934,1419,11515,27,127,11,16
41290,50999,443,48896,443,allow,33716,17750,15966,134,329,72,62
41291,57948,443,51203,443,allow,6885,3239,3646,53,190,24,29
41292,59480,443,64952,443,allow,5058,2667,2391,25,92,13,12
41293,49737,443,56529,443,allow,5566,1444,4122,17,129,10,7
41294,49784,443,6049,443,allow,7805,1949,5856,22,126,12,10
41295,64335,53,51507,53,allow,293,95,198,4,46,2,2
41296,64222,53,1206,53,allow,264,94,170,2,30,1,1
41297,6881,35045,1586,35045,allow,475,150,325,2,1200,1,1
41298,61569,53,2254,53,allow,211,78,133,2,30,1,1
41299,55829,53,23534,53,allow,168,78,90,2,30,1,1
41300,64706,27065,4529,27065,allow,924,924,0,3,30,3,0
41301,56707,443,58509,443,allow,40263,17490,22773,75,403,35,40
41302,15503,7750,61935,7750,allow,858,858,0,14,1200,14,0
41303,34878,53,44059,53,allow,339,94,245,2,30,1,1
41304,53260,53,10585,53,allow,199,94,105,2,30,1,1
41305,57008,53,37986,53,allow,255,110,145,2,30,1,1
41306,27005,27237,36473,27237,allow,876,126,750,2,30,1,1
41307,49737,53,34228,53,allow,184,86,98,2,31,1,1
41308,55312,53,28336,53,allow,195,102,93,2,31,1,1
41309,55766,443,53751,443,allow,1864,250,1614,8,120,4,4
41310,37580,443,41939,443,allow,24810,10597,14213,51,123,22,29
41311,57470,13551,21268,13551,allow,761,166,595,2,1200,1,1
41312,57470,21178,29997,21178,allow,166,166,0,1,1200,1,0
41313,27005,27268,57130,27268,allow,884,126,758,2,30,1,1
41314,57470,6889,19938,6889,allow,546,166,380,2,1200,1,1
41315,8979,443,54799,443,allow,62149740,2002795,60146945,62894,211,19380,43514
41316,56845,27201,52716,27201,allow,316,136,180,6,7,3,3
41317,57582,443,57582,443,allow,2506,1461,1045,21,88,10,11
41318,48188,443,44045,443,allow,1263,536,727,13,82,6,7
41319,11296,443,11296,443,allow,1311,782,529,12,23,7,5
41320,53666,50321,61664,50321,allow,736,490,246,8,17,4,4
41321,9073,443,37513,443,allow,4187235,99258,4087977,4375,28,1464,2911
41322,38087,443,27935,443,allow,6147,910,5237,18,100,10,8
41323,56671,443,59090,443,allow,7940,1951,5989,20,16,11,9
41324,57641,80,57641,80,allow,35197,3040,32157,40,32,14,26
41325,63869,34368,47992,34368,allow,66,66,0,2,8,2,0
41326,11319,443,11319,443,allow,179461,16904,162557,220,36,105,115
41327,11992,443,11992,443,allow,12020,5977,6043,38,30,23,15
41328,11028,443,11028,443,allow,6671,3244,3427,26,30,16,10
41329,10886,51505,0,0,deny,62,62,0,1,0,1,0
41330,37343,21247,0,0,deny,62,62,0,1,0,1,0
41331,443,48346,0,0,deny,81,81,0,1,0,1,0
41332,993,38356,0,0,deny,66,66,0,1,0,1,0
41333,27785,37965,0,0,deny,66,66,0,1,0,1,0
41334,57111,445,0,0,drop,66,66,0,1,0,1,0
41335,59668,51505,0,0,deny,66,66,0,1,0,1,0
41336,57109,445,0,0,drop,66,66,0,1,0,1,0
41337,51413,48637,0,0,deny,72,72,0,1,0,1,0
41338,50674,35440,0,0,deny,146,146,0,1,0,1,0
41339,50637,44847,0,0,deny,62,62,0,1,0,1,0
41340,46662,36237,0,0,deny,62,62,0,1,0,1,0
41341,56789,445,0,0,drop,70,70,0,1,0,1,0
41342,65285,44847,0,0,deny,62,62,0,1,0,1,0
41343,52720,35894,0,0,deny,62,62,0,1,0,1,0
41344,50470,61463,0,0,deny,86,86,0,1,0,1,0
41345,50716,50584,0,0,deny,70,70,0,1,0,1,0
41346,61701,445,0,0,drop,70,70,0,1,0,1,0
41347,61702,445,0,0,drop,70,70,0,1,0,1,0
41348,61700,445,0,0,drop,70,70,0,1,0,1,0
41349,40474,23117,0,0,deny,146,146,0,1,0,1,0
41350,1441,51221,0,0,deny,62,62,0,1,0,1,0
41351,11478,51221,0,0,deny,66,66,0,1,0,1,0
41352,57092,445,0,0,drop,66,66,0,1,0,1,0
41353,62029,22114,0,0,deny,66,66,0,1,0,1,0
41354,57090,445,0,0,drop,66,66,0,1,0,1,0
41355,57097,445,0,0,drop,66,66,0,1,0,1,0
41356,57094,445,0,0,drop,66,66,0,1,0,1,0
41357,57095,445,0,0,drop,66,66,0,1,0,1,0
41358,57096,445,0,0,drop,66,66,0,1,0,1,0
41359,57093,445,0,0,drop,66,66,0,1,0,1,0
41360,57091,445,0,0,drop,66,66,0,1,0,1,0
41361,56835,35894,0,0,deny,66,66,0,1,0,1,0
41362,56785,445,0,0,drop,70,70,0,1,0,1,0
41363,27783,57470,0,0,deny,62,62,0,1,0,1,0
41364,35261,15503,0,0,deny,74,74,0,1,0,1,0
41365,58672,43890,0,0,deny,66,66,0,1,0,1,0
41366,56773,445,0,0,drop,70,70,0,1,0,1,0
41367,56775,445,0,0,drop,70,70,0,1,0,1,0
41368,56776,445,0,0,drop,70,70,0,1,0,1,0
41369,56772,445,0,0,drop,70,70,0,1,0,1,0
41370,56768,445,0,0,drop,70,70,0,1,0,1,0
41371,28754,50584,0,0,deny,66,66,0,1,0,1,0
41372,61696,445,0,0,drop,70,70,0,1,0,1,0
41373,61691,445,0,0,drop,70,70,0,1,0,1,0
41374,61683,445,0,0,drop,70,70,0,1,0,1,0
41375,62068,64147,0,0,deny,66,66,0,1,0,1,0
41376,59564,57470,0,0,deny,66,66,0,1,0,1,0
41377,42379,443,23985,443,allow,499,425,74,4,0,3,1
41378,20400,64147,0,0,deny,62,62,0,1,0,1,0
41379,57074,445,0,0,drop,66,66,0,1,0,1,0
41380,57076,445,0,0,drop,66,66,0,1,0,1,0
41381,57075,445,0,0,drop,66,66,0,1,0,1,0
41382,65515,22114,0,0,deny,66,66,0,1,0,1,0
41383,13911,57470,0,0,deny,60,60,0,1,0,1,0
41384,3996,57470,0,0,deny,62,62,0,1,0,1,0
41385,52989,51505,0,0,deny,66,66,0,1,0,1,0
41386,61682,445,0,0,drop,70,70,0,1,0,1,0
41387,25348,23,0,0,deny,60,60,0,1,0,1,0
41388,64903,51050,0,0,deny,62,62,0,1,0,1,0
41389,23770,50584,0,0,deny,62,62,0,1,0,1,0
41390,48706,23393,0,0,deny,60,60,0,1,0,1,0
41391,19245,64147,0,0,deny,66,66,0,1,0,1,0
41392,56763,445,0,0,drop,70,70,0,1,0,1,0
41393,59874,22114,0,0,deny,146,146,0,1,0,1,0
41394,61679,445,0,0,drop,70,70,0,1,0,1,0
41395,34193,17,0,0,deny,60,60,0,1,0,1,0
41396,45344,443,7513,443,allow,2593,1394,1199,20,13,11,9
41397,48230,57866,0,0,deny,146,146,0,1,0,1,0
41398,61669,445,0,0,drop,70,70,0,1,0,1,0
41399,61672,445,0,0,drop,70,70,0,1,0,1,0
41400,61671,445,0,0,drop,70,70,0,1,0,1,0
41401,63867,64147,0,0,deny,62,62,0,1,0,1,0
41402,57987,56125,0,0,deny,90,90,0,1,0,1,0
41403,56755,445,0,0,drop,70,70,0,1,0,1,0
41404,56754,445,0,0,drop,70,70,0,1,0,1,0
41405,23969,57470,0,0,deny,62,62,0,1,0,1,0
41406,443,48346,0,0,deny,81,81,0,1,0,1,0
41407,15875,50584,0,0,deny,62,62,0,1,0,1,0
41408,56748,445,0,0,drop,70,70,0,1,0,1,0
41409,8889,33698,0,0,deny,60,60,0,1,0,1,0
41410,56747,445,0,0,drop,70,70,0,1,0,1,0
41411,58226,52848,0,0,deny,62,62,0,1,0,1,0
41412,61662,445,0,0,drop,70,70,0,1,0,1,0
41413,61661,445,0,0,drop,70,70,0,1,0,1,0
41414,61659,445,0,0,drop,70,70,0,1,0,1,0
41415,1972,57470,0,0,deny,78,78,0,1,0,1,0
41416,60426,57470,0,0,deny,62,62,0,1,0,1,0
41417,8297,37965,0,0,deny,62,62,0,1,0,1,0
41418,26085,51221,0,0,deny,72,72,0,1,0,1,0
41419,48258,37965,0,0,deny,62,62,0,1,0,1,0
41420,56743,445,0,0,drop,70,70,0,1,0,1,0
41421,49305,57470,0,0,deny,66,66,0,1,0,1,0
41422,56742,445,0,0,drop,70,70,0,1,0,1,0
41423,57874,26467,0,0,deny,62,62,0,1,0,1,0
41424,13285,29892,0,0,deny,145,145,0,1,0,1,0
41425,57054,445,0,0,drop,66,66,0,1,0,1,0
41426,13285,29892,0,0,deny,145,145,0,1,0,1,0
41427,61653,445,0,0,drop,70,70,0,1,0,1,0
41428,61652,445,0,0,drop,70,70,0,1,0,1,0
41429,12226,37965,0,0,deny,62,62,0,1,0,1,0
41430,53966,57470,0,0,deny,62,62,0,1,0,1,0
41431,49977,57470,0,0,deny,62,62,0,1,0,1,0
41432,45099,57470,0,0,deny,62,62,0,1,0,1,0
41433,60423,35440,0,0,deny,62,62,0,1,0,1,0
41434,443,32698,0,0,deny,89,89,0,1,0,1,0
41435,56737,445,0,0,drop,70,70,0,1,0,1,0
41436,52976,31573,0,0,deny,66,66,0,1,0,1,0
41437,63288,52848,0,0,deny,66,66,0,1,0,1,0
41438,55386,37965,0,0,deny,66,66,0,1,0,1,0
41439,35558,15503,0,0,deny,66,66,0,1,0,1,0
41440,65317,51221,0,0,deny,78,78,0,1,0,1,0
41441,443,48346,0,0,deny,81,81,0,1,0,1,0
41442,46518,44847,0,0,deny,62,62,0,1,0,1,0
41443,10036,44847,0,0,deny,66,66,0,1,0,1,0
41444,55375,44847,0,0,deny,66,66,0,1,0,1,0
41445,57049,445,0,0,drop,66,66,0,1,0,1,0
41446,43129,15503,0,0,deny,62,62,0,1,0,1,0
41447,57045,445,0,0,drop,66,66,0,1,0,1,0
41448,80,37649,0,0,deny,60,60,0,1,0,1,0
41449,61642,445,0,0,drop,70,70,0,1,0,1,0
41450,55394,123,0,0,deny,234,234,0,1,0,1,0
41451,61638,445,0,0,drop,70,70,0,1,0,1,0
41452,61637,445,0,0,drop,70,70,0,1,0,1,0
41453,61630,445,0,0,drop,70,70,0,1,0,1,0
41454,57044,445,0,0,drop,66,66,0,1,0,1,0
41455,50470,61463,0,0,deny,86,86,0,1,0,1,0
41456,56724,445,0,0,drop,70,70,0,1,0,1,0
41457,58381,57470,0,0,deny,66,66,0,1,0,1,0
41458,61626,445,0,0,drop,70,70,0,1,0,1,0
41459,60192,35440,0,0,deny,146,146,0,1,0,1,0
41460,443,48346,0,0,deny,81,81,0,1,0,1,0
41461,61624,445,0,0,drop,70,70,0,1,0,1,0
41462,61622,445,0,0,drop,70,70,0,1,0,1,0
41463,61620,445,0,0,drop,70,70,0,1,0,1,0
41464,56721,445,0,0,drop,70,70,0,1,0,1,0
41465,58207,51505,0,0,deny,66,66,0,1,0,1,0
41466,57034,445,0,0,drop,66,66,0,1,0,1,0
41467,57987,56125,0,0,deny,90,90,0,1,0,1,0
41468,25254,5555,0,0,deny,60,60,0,1,0,1,0
41469,50052,65008,0,0,deny,60,60,0,1,0,1,0
41470,57033,445,0,0,drop,66,66,0,1,0,1,0
41471,57030,445,0,0,drop,66,66,0,1,0,1,0
41472,57027,445,0,0,drop,66,66,0,1,0,1,0
41473,48706,23393,0,0,deny,60,60,0,1,0,1,0
41474,48681,11392,0,0,deny,62,62,0,1,0,1,0
41475,53625,64147,0,0,deny,62,62,0,1,0,1,0
41476,48681,11392,0,0,deny,146,146,0,1,0,1,0
41477,57026,445,0,0,drop,66,66,0,1,0,1,0
41478,57025,445,0,0,drop,66,66,0,1,0,1,0
41479,57023,445,0,0,drop,66,66,0,1,0,1,0
41480,30960,45723,17261,45723,allow,330,330,0,6,3608,6,0
41481,55312,53,10081,53,allow,190,97,93,2,30,1,1
41482,56684,443,25036,443,allow,8737,1821,6916,23,23,14,9
41483,59930,80,22245,80,allow,1638,1324,314,10,15,5,5
41484,63849,16632,40129,16632,allow,66,66,0,1,5,1,0
41485,51104,13011,33495,13011,allow,948,473,475,13,15,7,6
41486,14272,53,14272,53,allow,1415,689,726,3,31,2,1
41487,58478,443,30017,443,allow,19356,2148,17208,34,112,17,17
41488,45343,443,52570,443,allow,2312,1382,930,19,26,11,8
41489,53508,80,33768,80,allow,16965052,382638,16582414,16619,61,5458,11161
41490,60113,443,5252,443,allow,704,280,424,11,19,5,6
41491,54448,443,65424,443,allow,1786,172,1614,7,120,3,4
41492,57470,6881,39218,6881,allow,517,163,354,2,1200,1,1
41493,11761,443,11761,443,allow,5626,2487,3139,23,29,14,9
41494,51412,443,11649,443,allow,8933,1958,6975,25,81,14,11
41495,56683,443,10179,443,allow,8735,1819,6916,23,23,14,9
41496,63865,48610,16202,48610,allow,66,66,0,2,8,2,0
41497,52829,80,23872,80,allow,2078,726,1352,10,15,5,5
41498,57830,7635,57830,7635,allow,138,78,60,2,5,1,1
41499,57639,80,57639,80,allow,104868,1493,103375,90,31,17,73
41500,49131,443,28166,443,allow,6150,914,5236,18,97,10,8
41501,57636,80,57636,80,allow,147506,3521,143985,125,32,23,102
41502,32899,443,18208,443,allow,47948,40338,7610,82,17,43,39
41503,35078,443,18726,443,allow,78,78,0,1,5,1,0
41504,57638,80,57638,80,allow,29263,2432,26831,36,31,13,23
41505,37561,80,40884,80,allow,1630,918,712,12,16,7,5
41506,57642,80,57642,80,allow,220515,3488,217027,180,31,31,149
41507,47471,80,60446,80,allow,1114,534,580,12,16,7,5
41508,38502,443,34798,443,allow,2378,1126,1252,14,978,7,7
41509,57581,443,57581,443,allow,2512,1465,1047,21,87,10,11
41510,48726,80,33900,80,allow,1794,1480,314,13,15,8,5
41511,59809,443,46540,443,allow,35140,3700,31440,67,76,30,37
41512,51501,993,18732,993,allow,12667,4060,8607,87,32,39,48
41513,47947,80,61494,80,allow,2917,870,2047,14,16,8,6
41514,54693,443,58435,443,allow,5220,922,4298,17,100,10,7
41515,27452,5222,13129,5222,allow,3751,1007,2744,35,425,11,24
41516,50995,443,19177,443,allow,3115,1849,1266,18,16,8,10
41517,36276,7000,36276,7000,allow,3638,2027,1611,17,15,9,8
41518,41151,80,58286,80,allow,1711,786,925,12,16,7,5
41519,63866,17623,35380,17623,allow,66,66,0,2,8,2,0
41520,38433,443,38484,443,allow,33344,25806,7538,105,130,56,49
41521,40909,443,25631,443,allow,1062,724,338,16,41,11,5
41522,60433,6881,42209,6881,allow,70,70,0,2,8,2,0
41523,37716,443,28375,443,allow,14009,10561,3448,30,135,16,14
41524,27005,27241,34573,27241,allow,885,126,759,2,30,1,1
41525,50265,50262,19967,50262,allow,3758,2456,1302,52,2355,31,21
41526,51221,55497,56542,55497,allow,528,528,0,9,1200,9,0
41527,61192,35440,0,0,deny,146,146,0,1,0,1,0
41528,60854,42873,0,0,deny,66,66,0,1,0,1,0
41529,1138,42873,0,0,deny,62,62,0,1,0,1,0
41530,24041,55783,0,0,deny,62,62,0,1,0,1,0
41531,56717,445,0,0,drop,70,70,0,1,0,1,0
41532,56715,445,0,0,drop,70,70,0,1,0,1,0
41533,29011,32468,0,0,deny,66,66,0,1,0,1,0
41534,61619,445,0,0,drop,70,70,0,1,0,1,0
41535,61616,445,0,0,drop,70,70,0,1,0,1,0
41536,61614,445,0,0,drop,70,70,0,1,0,1,0
41537,33801,62413,0,0,deny,62,62,0,1,0,1,0
41538,46945,64147,0,0,deny,62,62,0,1,0,1,0
41539,57020,445,0,0,drop,66,66,0,1,0,1,0
41540,26180,35440,0,0,deny,62,62,0,1,0,1,0
41541,61611,445,0,0,drop,70,70,0,1,0,1,0
41542,56713,445,0,0,drop,70,70,0,1,0,1,0
41543,57017,445,0,0,drop,66,66,0,1,0,1,0
41544,57016,445,0,0,drop,66,66,0,1,0,1,0
41545,52281,161,0,0,allow,550,550,0,6,35,6,0
41546,54974,443,56766,443,allow,8670,2248,6422,36,90,21,15
41547,52313,443,33219,443,allow,52235,4973,47262,81,179,39,42
41548,56361,80,32552,80,allow,9997,1306,8691,17,25,8,9
41549,11901,443,11901,443,allow,5599,2459,3140,23,29,14,9
41550,11801,443,11801,443,allow,19187,5127,14060,38,22,23,15
41551,63850,6881,4556,6881,allow,70,70,0,1,4,1,0
41552,50460,443,12819,443,allow,1346,918,428,10,31,6,4
41553,53912,443,35610,443,allow,1346,918,428,10,33,6,4
41554,47600,53,23679,53,allow,168,78,90,2,29,1,1
41555,27005,27015,28770,27015,allow,879,126,753,2,29,1,1
41556,27005,27207,59346,27207,allow,875,126,749,2,29,1,1
41557,54322,27015,26816,27015,allow,924,924,0,3,29,3,0
41558,42587,53,63043,53,allow,199,94,105,2,30,1,1
41559,65455,3389,65455,3389,allow,4350,2261,2089,21,17,11,10
41560,57470,50321,46751,50321,allow,538,166,372,2,1199,1,1
41561,12157,80,12157,80,allow,2144,1519,625,9,29,6,3
41562,49567,443,55321,443,allow,6408,2531,3877,21,15,11,10
41563,46409,80,63158,80,allow,1053,613,440,10,15,5,5
41564,63848,48560,32430,48560,allow,70,70,0,1,4,1,0
41565,60973,443,19022,443,allow,398300,18473,379827,492,72,222,270
41566,51880,18468,1087,18468,allow,70,70,0,2,8,2,0
41567,60977,443,59690,443,allow,275026,15030,259996,353,72,167,186
41568,56970,53,57331,53,allow,428,103,325,4,34,2,2
41569,63867,43618,62706,43618,allow,66,66,0,2,7,2,0
41570,64900,53,36772,53,allow,314,102,212,2,29,1,1
41571,56081,53,45307,53,allow,237,94,143,2,29,1,1
41572,56314,53,21778,53,allow,211,102,109,2,29,1,1
41573,61568,53,62912,53,allow,260,86,174,2,29,1,1
41574,54321,27015,42449,27015,allow,924,924,0,3,29,3,0
41575,64998,27037,18339,27037,allow,3287,2072,1215,12,30,6,6
41576,27005,27203,54242,27203,allow,871,126,745,2,29,1,1
41577,37611,53,57023,53,allow,199,94,105,2,30,1,1
41578,57298,53,55060,53,allow,323,110,213,2,30,1,1
41579,49663,53,0,0,allow,86,86,0,1,30,1,0
41580,51455,443,21298,443,allow,8618,3110,5508,34,1695,18,16
41581,60766,28080,64298,28080,allow,70,70,0,2,8,2,0
41582,33243,443,33380,443,allow,1067,650,417,10,31,6,4
41583,56669,443,61657,443,allow,8058,2038,6020,20,15,11,9
41584,56100,53,62385,53,allow,211,102,109,2,30,1,1
41585,56637,443,17039,443,allow,8865,1819,7046,24,30,14,10
41586,33231,443,11220,443,allow,1067,650,417,10,35,6,4
41587,41547,80,41547,80,allow,120443,1965,118478,108,20,21,87
41588,49424,53,53979,53,allow,228,110,118,2,30,1,1
41589,43391,80,44561,80,allow,1560,684,876,10,15,5,5
41590,33834,443,55526,443,allow,1178,820,358,9,15,6,3
41591,37893,53,0,0,allow,86,86,0,1,30,1,0
41592,6189,53,29429,53,allow,229,86,143,2,30,1,1
41593,35106,53,20275,53,allow,271,102,169,2,30,1,1
41594,51221,15886,64989,15886,allow,481,150,331,2,1200,1,1
41595,64573,53,28615,53,allow,380,110,270,2,30,1,1
41596,64566,53,50358,53,allow,347,107,240,4,42,2,2
41597,50448,443,19311,443,allow,1346,918,428,10,35,6,4
41598,60425,80,53766,80,allow,186,64,122,4,28,2,2
41599,58676,443,61726,443,allow,6144,939,5205,18,70,9,9
41600,37846,443,26954,443,allow,30620,20855,9765,91,112,45,46
41601,41914,123,34175,123,allow,184,94,90,2,30,1,1
41602,37923,443,39242,443,allow,2593394,70243,2523151,2678,303,908,1770
41603,51221,55497,24312,55497,allow,330,330,0,6,1200,6,0
41604,50968,443,1299,443,allow,10759,3158,7601,29,75,16,13
41605,56670,443,11392,443,allow,8006,1986,6020,20,15,11,9
41606,65483,443,48950,443,allow,92479,4869,87610,109,16,44,65
41607,56431,80,21703,80,allow,17248,1619,15629,26,25,11,15
41608,49540,53,16812,53,allow,279,94,185,2,30,1,1
41609,33539,53,23280,53,allow,336,231,105,3,30,2,1
41610,43680,53,64871,53,allow,271,102,169,2,30,1,1
41611,10151,60419,62503,60419,allow,479,150,329,2,1200,1,1
41612,53911,443,57422,443,allow,1346,918,428,10,33,6,4
41613,60974,443,22731,443,allow,166465,9498,156967,220,72,100,120
41614,60975,443,27000,443,allow,333131,17461,315670,435,72,211,224
41615,53958,80,17834,80,allow,23134,15926,7208,53,541,32,21
41616,50750,443,64318,443,allow,70,70,0,2,171,2,0
41617,50749,443,31608,443,allow,70,70,0,2,171,2,0
41618,57586,443,57586,443,allow,13517,1521,11996,32,87,11,21
41619,63870,6881,42274,6881,allow,66,66,0,2,7,2,0
41620,54657,443,15364,443,allow,7070,1030,6040,19,33,11,8
41621,34308,3389,34308,3389,allow,4930,2691,2239,24,19,14,10
41622,60409,80,41783,80,allow,10970,7709,3261,24,29,13,11
41623,60427,80,8033,80,allow,186,64,122,4,28,2,2
41624,57583,443,57583,443,allow,2512,1466,1046,21,87,10,11
41625,46256,443,26728,443,allow,15090,9197,5893,33,97,19,14
41626,56633,80,19210,80,allow,234,234,0,4,12,4,0
41627,11897,443,11897,443,allow,1452,817,635,16,29,9,7
41628,60431,52867,31778,52867,allow,70,70,0,2,8,2,0
41629,63864,44139,1189,44139,allow,66,66,0,2,7,2,0
41630,12266,443,12266,443,allow,18634,3895,14739,48,29,27,21
41631,60741,443,38588,443,allow,2042,559,1483,20,89,6,14
41632,57640,80,57640,80,allow,64437,2630,61807,64,31,18,46
41633,57585,443,57585,443,allow,2504,1458,1046,21,87,10,11
41634,51879,38564,27585,38564,allow,70,70,0,2,8,2,0
41635,50016,53,35137,53,allow,275,94,181,2,29,1,1
41636,55312,53,37351,53,allow,195,102,93,2,29,1,1
41637,27005,27214,50051,27214,allow,876,126,750,2,29,1,1
41638,63868,60392,39941,60392,allow,66,66,0,2,7,2,0
41639,56639,443,6220,443,allow,10138,2213,7925,27,30,16,11
41640,55713,53,11593,53,allow,308,94,214,2,30,1,1
41641,57414,53,33094,53,allow,214,102,112,2,29,1,1
41642,50242,80,35975,80,allow,2793,1071,1722,14,105,7,7
41643,65484,443,29745,443,allow,148284,6200,142084,165,16,63,102
41644,56634,443,43198,443,allow,8865,1819,7046,24,30,14,10
41645,27005,27015,21869,27015,allow,877,126,751,2,29,1,1
41646,51550,443,50088,443,allow,13331,2421,10910,38,209,20,18
41647,27005,27202,9481,27202,allow,872,126,746,2,29,1,1
41648,55773,53,51846,53,allow,102,102,0,1,60,1,0
41649,65406,53,1627,53,allow,102,102,0,1,60,1,0
41650,40931,443,31983,443,allow,7399,3328,4071,76,4153,33,43
41651,32806,7275,35238,7275,allow,130,70,60,2,15,1,1
41652,54935,443,10103,443,allow,10198,3881,6317,46,146,26,20
41653,55648,80,53307,80,allow,70,70,0,2,8,2,0
41654,51865,14732,14153,14732,allow,70,70,0,1,5,1,0
41655,60556,28678,33348,28678,allow,1806,1806,0,22,224,22,0
41656,60583,443,60583,443,allow,1315,786,529,12,36,7,5
41657,56668,443,3930,443,allow,8005,1985,6020,20,15,11,9
41658,49128,53,21318,53,allow,199,94,105,2,30,1,1
41659,58890,53,58890,53,allow,198,90,108,2,30,1,1
41660,36851,53,52640,53,allow,404,261,143,3,30,2,1
41661,55281,53,41810,53,allow,236,94,142,2,30,1,1
41662,57015,53,23440,53,allow,363,102,261,2,30,1,1
41663,53565,443,13839,443,allow,12007,942,11065,19,120,8,11
41664,44847,12269,58091,12269,allow,502,150,352,2,1200,1,1
41665,39105,443,21624,443,allow,2853588,73973,2779615,2907,129,994,1913
41666,53692,16624,3177,16624,allow,320,140,180,6,6,3,3
41667,51866,23431,28853,23431,allow,70,70,0,1,5,1,0
41668,50476,80,25570,80,allow,5049,4344,705,11,30,6,5
41669,54453,443,45461,443,allow,4227,1086,3141,15,29,8,7
41670,56636,443,16823,443,allow,8865,1819,7046,24,30,14,10
41671,55887,53,35825,53,allow,339,98,241,4,47,2,2
41672,64265,53,25534,53,allow,550,133,417,4,47,2,2
41673,55470,53,60625,53,allow,310,94,216,2,30,1,1
41674,31602,53,0,0,allow,327,102,225,2,30,1,1
41675,50278,443,50420,443,allow,36958,2966,33992,48,120,18,30
41676,57097,443,3043,443,allow,3578432,133577,3444855,4291,426,1634,2657
41677,50584,51413,31327,51413,allow,498,150,348,4,2396,2,2
41678,56640,443,54047,443,allow,8735,1819,6916,23,30,14,9
41679,56682,443,39754,443,allow,8735,1819,6916,23,22,14,9
41680,33725,53,33725,53,allow,216,90,126,2,30,1,1
41681,56135,53,30728,53,allow,258,118,140,2,30,1,1
41682,64564,53,49143,53,allow,273,94,179,2,30,1,1
41683,46838,80,4801,80,allow,70,70,0,1,120,1,0
41684,51221,62348,26234,62348,allow,132,132,0,3,1200,3,0
41685,44871,53,64533,53,allow,164,78,86,2,31,1,1
41686,64516,443,9177,443,allow,2649258,1156086,1493172,7283,5215,3384,3899
41687,6882,40796,60379,40796,allow,228,118,110,2,1200,1,1
41688,57470,38871,35688,38871,allow,545,166,379,2,1199,1,1
41689,53678,31592,21651,31592,allow,70,70,0,1,5,1,0
41690,6666,21,6666,21,allow,66,66,0,1,5,1,0
41691,59626,443,63020,443,allow,5837,1982,3855,19,18,11,8
41692,56667,443,7226,443,allow,8057,2037,6020,20,16,11,9
41693,49911,53,3623,53,allow,200,94,106,2,30,1,1
41694,55144,53,47771,53,allow,209,102,107,2,30,1,1
41695,55312,53,24613,53,allow,195,102,93,2,30,1,1
41696,27005,27240,14670,27240,allow,868,126,742,2,31,1,1
41697,63123,443,2036,443,allow,5530,2343,3187,22,128,10,12
41698,50277,443,37349,443,allow,3182,1568,1614,8,120,4,4
41699,55105,53,24892,53,allow,194,94,100,2,30,1,1
41700,45035,80,33169,80,allow,3720,1663,2057,17,186,10,7
41701,56845,53,65473,53,allow,233,102,131,2,30,1,1
41702,49278,53,60636,53,allow,200,94,106,2,30,1,1
41703,65036,53,31003,53,allow,209,94,115,2,30,1,1
41704,27005,27016,20035,27016,allow,903,126,777,2,31,1,1
41705,51806,443,31513,443,allow,19093,3390,15703,26,126,10,16
41706,57470,52177,52924,52177,allow,1980,1980,0,31,2321,31,0
41707,57014,445,0,0,drop,66,66,0,1,0,1,0
41708,57433,21247,0,0,deny,66,66,0,1,0,1,0
41709,45941,23386,0,0,deny,60,60,0,1,0,1,0
41710,57012,445,0,0,drop,66,66,0,1,0,1,0
41711,64605,35993,0,0,deny,66,66,0,1,0,1,0
41712,62115,57470,0,0,deny,66,66,0,1,0,1,0
41713,8536,37965,0,0,deny,62,62,0,1,0,1,0
41714,27401,37965,0,0,deny,66,66,0,1,0,1,0
41715,56706,445,0,0,drop,70,70,0,1,0,1,0
41716,443,48346,0,0,deny,81,81,0,1,0,1,0
41717,61610,445,0,0,drop,70,70,0,1,0,1,0
41718,9529,26467,0,0,deny,62,62,0,1,0,1,0
41719,61599,445,0,0,drop,70,70,0,1,0,1,0
41720,61593,445,0,0,drop,70,70,0,1,0,1,0
41721,56704,445,0,0,drop,70,70,0,1,0,1,0
41722,56703,445,0,0,drop,70,70,0,1,0,1,0
41723,45964,55559,0,0,deny,60,60,0,1,0,1,0
41724,57002,445,0,0,drop,66,66,0,1,0,1,0
41725,56702,445,0,0,drop,70,70,0,1,0,1,0
41726,56701,445,0,0,drop,70,70,0,1,0,1,0
41727,56699,445,0,0,drop,70,70,0,1,0,1,0
41728,56697,445,0,0,drop,70,70,0,1,0,1,0
41729,28385,50584,0,0,deny,146,146,0,1,0,1,0
41730,80,53945,0,0,deny,60,60,0,1,0,1,0
41731,12107,22114,0,0,deny,62,62,0,1,0,1,0
41732,52318,17,0,0,deny,60,60,0,1,0,1,0
41733,56994,445,0,0,drop,66,66,0,1,0,1,0
41734,56683,445,0,0,drop,70,70,0,1,0,1,0
41735,56682,445,0,0,drop,70,70,0,1,0,1,0
41736,61585,445,0,0,drop,70,70,0,1,0,1,0
41737,56676,445,0,0,drop,70,70,0,1,0,1,0
41738,14165,51050,0,0,deny,146,146,0,1,0,1,0
41739,56672,445,0,0,drop,70,70,0,1,0,1,0
41740,56673,445,0,0,drop,70,70,0,1,0,1,0
41741,1026,30188,0,0,deny,62,62,0,1,0,1,0
41742,62849,62413,0,0,deny,66,66,0,1,0,1,0
41743,8239,37965,0,0,deny,146,146,0,1,0,1,0
41744,56991,445,0,0,drop,66,66,0,1,0,1,0
41745,65388,55783,0,0,deny,66,66,0,1,0,1,0
41746,28424,35440,0,0,deny,66,66,0,1,0,1,0
41747,443,22323,0,0,deny,61,61,0,1,0,1,0
41748,443,22323,0,0,deny,83,83,0,1,0,1,0
41749,56983,445,0,0,drop,66,66,0,1,0,1,0
41750,56980,445,0,0,drop,66,66,0,1,0,1,0
41751,56661,445,0,0,drop,70,70,0,1,0,1,0
41752,59772,62413,0,0,deny,62,62,0,1,0,1,0
41753,48125,7548,0,0,deny,60,60,0,1,0,1,0
41754,50470,61463,0,0,deny,86,86,0,1,0,1,0
41755,54118,6004,0,0,deny,66,66,0,1,0,1,0
41756,64693,26467,0,0,deny,62,62,0,1,0,1,0
41757,58743,35894,0,0,deny,66,66,0,1,0,1,0
41758,35261,15503,0,0,deny,74,74,0,1,0,1,0
41759,55600,22,0,0,deny,60,60,0,1,0,1,0
41760,61574,445,0,0,drop,70,70,0,1,0,1,0
41761,61571,445,0,0,drop,70,70,0,1,0,1,0
41762,56656,445,0,0,drop,70,70,0,1,0,1,0
41763,56969,445,0,0,drop,66,66,0,1,0,1,0
41764,56961,445,0,0,drop,66,66,0,1,0,1,0
41765,56965,445,0,0,drop,66,66,0,1,0,1,0
41766,56967,445,0,0,drop,66,66,0,1,0,1,0
41767,56968,445,0,0,drop,66,66,0,1,0,1,0
41768,56963,445,0,0,drop,66,66,0,1,0,1,0
41769,56962,445,0,0,drop,66,66,0,1,0,1,0
41770,56964,445,0,0,drop,66,66,0,1,0,1,0
41771,61336,61689,0,0,deny,66,66,0,1,0,1,0
41772,13911,57470,0,0,deny,60,60,0,1,0,1,0
41773,56648,445,0,0,drop,70,70,0,1,0,1,0
41774,56645,445,0,0,drop,70,70,0,1,0,1,0
41775,56646,445,0,0,drop,70,70,0,1,0,1,0
41776,56643,445,0,0,drop,70,70,0,1,0,1,0
41777,56640,445,0,0,drop,70,70,0,1,0,1,0
41778,6224,37965,0,0,deny,62,62,0,1,0,1,0
41779,58664,64147,0,0,deny,66,66,0,1,0,1,0
41780,59724,64147,0,0,deny,62,62,0,1,0,1,0
41781,61569,445,0,0,drop,70,70,0,1,0,1,0
41782,61560,445,0,0,drop,70,70,0,1,0,1,0
41783,61555,445,0,0,drop,70,70,0,1,0,1,0
41784,16687,10214,0,0,deny,66,66,0,1,0,1,0
41785,37420,44847,0,0,deny,66,66,0,1,0,1,0
41786,56948,445,0,0,drop,66,66,0,1,0,1,0
41787,56946,445,0,0,drop,66,66,0,1,0,1,0
41788,56947,445,0,0,drop,66,66,0,1,0,1,0
41789,7947,50584,0,0,deny,62,62,0,1,0,1,0
41790,65495,11392,0,0,deny,62,62,0,1,0,1,0
41791,41429,50584,0,0,deny,66,66,0,1,0,1,0
41792,45908,33330,0,0,deny,60,60,0,1,0,1,0
41793,56635,445,0,0,drop,70,70,0,1,0,1,0
41794,61554,445,0,0,drop,70,70,0,1,0,1,0
41795,17561,52700,0,0,deny,62,62,0,1,0,1,0
41796,33528,23,0,0,deny,60,60,0,1,0,1,0
41797,61057,31573,0,0,deny,146,146,0,1,0,1,0
41798,6014,37965,0,0,deny,66,66,0,1,0,1,0
41799,56026,51505,0,0,deny,146,146,0,1,0,1,0
41800,52870,22197,0,0,deny,62,62,0,1,0,1,0
41801,61551,445,0,0,drop,70,70,0,1,0,1,0
41802,64681,35993,0,0,deny,66,66,0,1,0,1,0
41803,61550,445,0,0,drop,70,70,0,1,0,1,0
41804,61548,445,0,0,drop,70,70,0,1,0,1,0
41805,61543,445,0,0,drop,70,70,0,1,0,1,0
41806,50470,61463,0,0,deny,86,86,0,1,0,1,0
41807,47682,64147,0,0,deny,66,66,0,1,0,1,0
41808,47105,64147,0,0,deny,62,62,0,1,0,1,0
41809,52724,64147,0,0,deny,62,62,0,1,0,1,0
41810,56627,445,0,0,drop,70,70,0,1,0,1,0
41811,50644,35440,0,0,deny,66,66,0,1,0,1,0
41812,56624,445,0,0,drop,70,70,0,1,0,1,0
41813,19698,502,0,0,deny,60,60,0,1,0,1,0
41814,28824,44847,0,0,deny,66,66,0,1,0,1,0
41815,54530,35440,0,0,deny,66,66,0,1,0,1,0
41816,56619,445,0,0,drop,70,70,0,1,0,1,0
41817,56618,445,0,0,drop,70,70,0,1,0,1,0
41818,1373,22114,0,0,deny,66,66,0,1,0,1,0
41819,28135,34021,0,0,reset-both,62,62,0,1,0,1,0
41820,57472,44847,0,0,deny,62,62,0,1,0,1,0
41821,0,0,0,0,allow,156,156,0,2,0,2,0
41822,0,0,0,0,allow,707,707,0,2,0,2,0
41823,0,0,0,0,allow,1188,1188,0,2,0,2,0
41824,0,0,0,0,allow,244,244,0,2,0,2,0
41825,57665,52700,0,0,deny,66,66,0,1,0,1,0
41826,61533,445,0,0,drop,70,70,0,1,0,1,0
41827,61532,445,0,0,drop,70,70,0,1,0,1,0
41828,61530,445,0,0,drop,70,70,0,1,0,1,0
41829,58131,3855,0,0,deny,146,146,0,1,0,1,0
41830,28124,37965,0,0,deny,62,62,0,1,0,1,0
41831,56614,445,0,0,drop,70,70,0,1,0,1,0
41832,65317,51221,0,0,deny,78,78,0,1,0,1,0
41833,56613,445,0,0,drop,70,70,0,1,0,1,0
41834,43657,50011,0,0,deny,62,62,0,1,0,1,0
41835,20170,23,0,0,deny,60,60,0,1,0,1,0
41836,48841,51221,0,0,deny,62,62,0,1,0,1,0
41837,40521,23117,0,0,deny,66,66,0,1,0,1,0
41838,10436,37965,0,0,deny,62,62,0,1,0,1,0
41839,56925,445,0,0,drop,66,66,0,1,0,1,0
41840,443,20995,0,0,deny,83,83,0,1,0,1,0
41841,20508,57470,0,0,deny,62,62,0,1,0,1,0
41842,61524,445,0,0,drop,70,70,0,1,0,1,0
41843,61522,445,0,0,drop,70,70,0,1,0,1,0
41844,26183,22114,0,0,deny,62,62,0,1,0,1,0
41845,57234,21247,0,0,deny,66,66,0,1,0,1,0
41846,56608,445,0,0,drop,70,70,0,1,0,1,0
41847,59008,51221,0,0,deny,66,66,0,1,0,1,0
41848,49367,51505,0,0,deny,66,66,0,1,0,1,0
41849,6881,33454,0,0,deny,100,100,0,1,0,1,0
41850,17719,49153,0,0,deny,145,145,0,1,0,1,0
41851,54047,50011,0,0,deny,62,62,0,1,0,1,0
41852,56919,445,0,0,drop,66,66,0,1,0,1,0
41853,49160,57470,0,0,deny,146,146,0,1,0,1,0
41854,56916,445,0,0,drop,66,66,0,1,0,1,0
41855,61514,445,0,0,drop,70,70,0,1,0,1,0
41856,47396,23,0,0,deny,60,60,0,1,0,1,0
41857,55644,45579,38445,45579,allow,70,70,0,2,8,2,0
41858,48440,53,22120,53,allow,198,93,105,2,30,1,1
41859,52993,443,64908,443,allow,16229,3316,12913,23,125,9,14
41860,61591,80,1732,80,allow,124,64,60,2,16,1,1
41861,5588,5588,0,0,allow,3562,1936,1626,48,194,24,24
41862,27005,27216,33781,27216,allow,872,126,746,2,30,1,1
41863,19473,12345,64156,12345,allow,478,149,329,2,1200,1,1
41864,54993,443,50582,443,allow,38985,4250,34735,58,19,27,31
41865,27005,27246,16977,27246,allow,865,126,739,2,30,1,1
41866,56330,53,24669,53,allow,711,87,624,2,30,1,1
41867,49858,443,3076,443,allow,16232,3319,12913,23,124,9,14
41868,54994,443,29516,443,allow,13580,3864,9716,40,18,23,17
41869,51411,443,6428,443,allow,5550,1177,4373,24,80,13,11
41870,57470,6346,6625,6346,allow,330,330,0,6,1200,6,0
41871,47595,33438,0,0,allow,106,106,0,1,60,1,0
41872,58496,53,58496,53,allow,204,92,112,2,30,1,1
41873,45341,443,7736,443,allow,2754,1394,1360,22,36,11,11
41874,46860,15000,54542,15000,allow,130,70,60,2,6,1,1
41875,54991,443,1653,443,allow,20604,3530,17074,40,19,21,19
41876,53662,443,56042,443,allow,7471,2800,4671,21,76,13,8
41877,50518,80,23907,80,allow,2864,1338,1526,17,21,9,8
41878,36631,443,36631,443,allow,4568,1661,2907,19,29,11,8
41879,44682,443,42842,443,allow,2750,1891,859,17,25,10,7
41880,51878,9999,48543,9999,allow,70,70,0,2,8,2,0
41881,56522,443,44815,443,allow,43823,7381,36442,84,38,42,42
41882,48483,443,20913,443,allow,60944,9555,51389,71,362,25,46
41883,64224,443,1301,443,allow,24320,6711,17609,45,122,20,25
41884,58911,443,49541,443,allow,23915,4341,19574,37,120,15,22
41885,54988,443,63071,443,allow,69664,6958,62706,98,23,46,52
41886,58705,5228,47511,5228,allow,4706,2850,1856,44,6872,25,19
41887,54995,443,42324,443,allow,13281,4753,8528,32,17,18,14
41888,59772,80,1176,80,allow,5558,3386,2172,29,36,15,14
41889,59276,443,40586,443,allow,16232,3319,12913,23,125,9,14
41890,50994,443,10248,443,allow,3137,1855,1282,19,16,9,10
41891,56125,80,28714,80,allow,891,536,355,10,255,6,4
41892,52261,53,8647,53,allow,578,286,292,9,15,5,4
41893,27005,27255,55228,27255,allow,879,126,753,2,30,1,1
41894,35644,53,9492,53,allow,198,93,105,2,30,1,1
41895,58642,443,2998,443,allow,7127,3015,4112,24,144,12,12
41896,44822,11848,0,0,reset-both,148,148,0,1,0,1,0
41897,61508,445,0,0,drop,70,70,0,1,0,1,0
41898,61509,445,0,0,drop,70,70,0,1,0,1,0
41899,61507,445,0,0,drop,70,70,0,1,0,1,0
41900,23126,35440,0,0,deny,66,66,0,1,0,1,0
41901,1821,64147,0,0,deny,66,66,0,1,0,1,0
41902,56914,445,0,0,drop,66,66,0,1,0,1,0
41903,56595,445,0,0,drop,70,70,0,1,0,1,0
41904,53147,37965,0,0,deny,62,62,0,1,0,1,0
41905,12060,37965,0,0,deny,66,66,0,1,0,1,0
41906,59511,21247,0,0,deny,66,66,0,1,0,1,0
41907,54423,21247,0,0,deny,66,66,0,1,0,1,0
41908,40100,17,0,0,deny,60,60,0,1,0,1,0
41909,61499,445,0,0,drop,70,70,0,1,0,1,0
41910,56592,445,0,0,drop,70,70,0,1,0,1,0
41911,6881,45711,0,0,deny,100,100,0,1,0,1,0
41912,6881,57470,0,0,deny,100,100,0,1,0,1,0
41913,53815,44847,0,0,deny,66,66,0,1,0,1,0
41914,49254,53,34045,53,allow,214,102,112,2,30,1,1
41915,39077,443,60900,443,allow,24631,1902,22729,37,215,17,20
41916,55646,14420,49852,14420,allow,70,70,0,2,8,2,0
41917,51861,23919,4159,23919,allow,70,70,0,1,5,1,0
41918,65297,53,52505,53,allow,241,118,123,2,30,1,1
41919,61496,445,0,0,drop,70,70,0,1,0,1,0
41920,61494,445,0,0,drop,70,70,0,1,0,1,0
41921,61492,445,0,0,drop,70,70,0,1,0,1,0
41922,56905,445,0,0,drop,66,66,0,1,0,1,0
41923,56900,445,0,0,drop,66,66,0,1,0,1,0
41924,56901,445,0,0,drop,66,66,0,1,0,1,0
41925,56899,445,0,0,drop,66,66,0,1,0,1,0
41926,56897,445,0,0,drop,66,66,0,1,0,1,0
41927,56896,445,0,0,drop,66,66,0,1,0,1,0
41928,56895,445,0,0,drop,66,66,0,1,0,1,0
41929,63080,37965,0,0,deny,66,66,0,1,0,1,0
41930,33896,57470,0,0,deny,74,74,0,1,0,1,0
41931,53513,56205,0,0,deny,62,62,0,1,0,1,0
41932,56587,445,0,0,drop,70,70,0,1,0,1,0
41933,8999,48817,0,0,deny,146,146,0,1,0,1,0
41934,57093,26467,0,0,deny,62,62,0,1,0,1,0
41935,24260,50584,0,0,deny,62,62,0,1,0,1,0
41936,52754,26467,0,0,deny,62,62,0,1,0,1,0
41937,56586,445,0,0,drop,70,70,0,1,0,1,0
41938,8486,56205,0,0,deny,66,66,0,1,0,1,0
41939,56584,445,0,0,drop,70,70,0,1,0,1,0
41940,33563,14037,0,0,deny,78,78,0,1,0,1,0
41941,61491,445,0,0,drop,70,70,0,1,0,1,0
41942,61488,445,0,0,drop,70,70,0,1,0,1,0
41943,63861,37832,6242,37832,allow,66,66,0,2,7,2,0
41944,53677,10657,55902,10657,allow,70,70,0,1,4,1,0
41945,51862,27758,53526,27758,allow,70,70,0,1,5,1,0
41946,64208,53,37921,53,allow,194,94,100,2,29,1,1
41947,56983,53,62235,53,allow,221,94,127,2,29,1,1
41948,52327,53,21249,53,allow,224,94,130,2,29,1,1
41949,49790,53,34832,53,allow,195,102,93,2,30,1,1
41950,57470,19641,64041,19641,allow,132,132,0,3,1199,3,0
41951,58183,443,49158,443,allow,841459,41656,799803,1083,141,389,694
41952,34344,443,5583,443,allow,9167,2205,6962,37,120,19,18
41953,53674,31724,6450,31724,allow,70,70,0,1,4,1,0
41954,60272,443,56856,443,allow,13199834,344312,12855522,13125,121,3739,9386
41955,32296,443,32296,443,allow,5421,2444,2977,20,15,11,9
41956,49917,53,46665,53,allow,168,78,90,2,29,1,1
41957,27005,27237,41184,27237,allow,891,126,765,2,30,1,1
41958,40808,53,41572,53,allow,168,78,90,2,29,1,1
41959,27005,27257,60876,27257,allow,883,126,757,2,30,1,1
41960,57048,53,62627,53,allow,512,95,417,4,34,2,2
41961,39488,53,45099,53,allow,199,94,105,2,29,1,1
41962,64330,53,63113,53,allow,200,94,106,2,29,1,1
41963,27005,27017,51500,27017,allow,901,126,775,2,30,1,1
41964,64394,443,20424,443,allow,3182,1568,1614,8,120,4,4
41965,27005,27269,13554,27269,allow,886,126,760,2,30,1,1
41966,37087,443,26551,443,allow,9710,2136,7574,26,363,11,15
41967,49542,443,22517,443,allow,9824,1839,7985,27,172,13,14
41968,64347,53,35603,53,allow,321,109,212,4,47,2,2
41969,35742,53,48792,53,allow,199,94,105,2,30,1,1
41970,46965,53,4424,53,allow,199,94,105,2,30,1,1
41971,56164,53,3250,53,allow,226,110,116,2,30,1,1
41972,39716,53,15462,53,allow,86,86,0,1,30,1,0
41973,33262,443,40811,443,allow,4067,2672,1395,23,23,14,9
41974,56841,29753,27881,29753,allow,70,70,0,2,8,2,0
41975,45551,443,60203,443,allow,6964,2091,4873,20,15,10,10
41976,55410,80,63972,80,allow,1250,472,778,13,46,3,10
41977,51863,22038,12301,22038,allow,70,70,0,1,5,1,0
41978,41472,53,41472,53,allow,218,90,128,2,30,1,1
41979,34366,443,52089,443,allow,520306,17622,502684,582,210,210,372
41980,35263,443,2697,443,allow,22457,12680,9777,65,20,34,31
41981,44047,443,38951,443,allow,6750,4410,2340,19,120,9,10
41982,56004,53,16480,53,allow,177,94,83,2,30,1,1
41983,41316,443,15056,443,allow,4997074,153969,4843105,5249,343,1861,3388
41984,37965,58909,50714,58909,allow,1577,594,983,20,1724,10,10
41985,56004,53,53891,53,allow,177,94,83,2,30,1,1
41986,58797,443,26512,443,allow,3311,1069,2242,13,135,6,7
41987,55930,443,56260,443,allow,6271,1354,4917,25,113,14,11
41988,53660,443,7808,443,allow,9028,3897,5131,24,83,15,9
41989,54992,443,45267,443,allow,31183,3879,27304,52,19,26,26
41990,40988,80,28753,80,allow,19112,2192,16920,46,90,23,23
41991,65236,53,36812,53,allow,215,102,113,2,30,1,1
41992,57073,53,17930,53,allow,197,102,95,2,35,1,1
41993,59609,443,2759,443,allow,7762,1777,5985,22,80,13,9
41994,64709,53,12288,53,allow,229,110,119,2,30,1,1
41995,55127,80,31027,80,allow,4239,2334,1905,17,187,10,7
41996,60921,443,34285,443,allow,9869,2448,7421,61,1253,24,37
41997,58848,443,23115,443,allow,1362,627,735,14,81,7,7
41998,51883,16325,58501,16325,allow,316,136,180,6,6,3,3
41999,41693,443,28921,443,allow,27069,3064,24005,44,178,19,25
42000,26865,443,22998,443,allow,21239,16302,4937,35,20,20,15
42001,60426,80,65008,80,allow,4515,3889,626,11,27,6,5
42002,53719,443,48486,443,allow,70,70,0,2,8,2,0
42003,56844,44445,50438,44445,allow,70,70,0,1,5,1,0
42004,64683,53,5338,53,allow,376,95,281,4,36,2,2
42005,41868,443,44888,443,allow,6204,1328,4876,21,139,12,9
42006,53676,3678,50673,3678,allow,70,70,0,1,4,1,0
42007,33259,443,58382,443,allow,4193,2689,1504,23,23,14,9
42008,57555,443,43596,443,allow,25519,7061,18458,37,16,20,17
42009,53444,443,53444,443,allow,960,539,421,9,30,5,4
42010,53445,443,53445,443,allow,960,539,421,9,30,5,4
42011,49668,53,59883,53,allow,200,94,106,2,29,1,1
42012,42089,53,62601,53,allow,199,94,105,2,29,1,1
42013,53127,30467,24380,30467,allow,314,128,186,6,18,3,3
42014,56665,443,40335,443,allow,8058,2038,6020,20,15,11,9
42015,24891,53,42889,53,allow,168,78,90,2,30,1,1
42016,57600,53,41878,53,allow,168,78,90,2,30,1,1
42017,54262,53,54262,53,allow,198,90,108,2,30,1,1
42018,27005,27015,15539,27015,allow,881,126,755,2,30,1,1
42019,44949,53,44949,53,allow,198,90,108,2,30,1,1
42020,34167,80,27156,80,allow,3643,1738,1905,17,187,10,7
42021,57360,53,29113,53,allow,231,110,121,2,30,1,1
42022,50279,443,56387,443,allow,1786,172,1614,7,119,3,4
42023,56666,443,25263,443,allow,8006,1986,6020,20,15,11,9
42024,33258,443,43741,443,allow,6958,4394,2564,30,28,17,13
42025,40203,80,61605,80,allow,28577,1878,26699,47,31,23,24
42026,57139,53,26096,53,allow,181,86,95,2,30,1,1
42027,64864,53,28778,53,allow,275,126,149,2,30,1,1
42028,65425,53,4149,53,allow,402,142,260,2,30,1,1
42029,42184,53,42184,53,allow,334,226,108,3,30,2,1
42030,40836,443,10613,443,allow,9524,3934,5590,20,135,10,10
42031,38083,443,10081,443,allow,2465,1356,1109,18,180,8,10
42032,50126,443,42712,443,allow,8464,2699,5765,48,147,26,22
42033,53447,443,53447,443,allow,960,539,421,9,30,5,4
42034,17176,443,17176,443,allow,6311,1229,5082,18,16,8,10
42035,35207,53,52779,53,allow,168,78,90,2,30,1,1
42036,65374,53,60025,53,allow,261,102,159,2,30,1,1
42037,59101,53,46129,53,allow,195,94,101,2,30,1,1
42038,50694,80,52061,80,allow,3481,1576,1905,17,187,10,7
42039,33260,443,40517,443,allow,4051,2618,1433,21,23,13,8
42040,54452,443,13624,443,allow,4227,1086,3141,15,28,8,7
42041,56843,64277,53228,64277,allow,70,70,0,1,5,1,0
42042,59828,443,59390,443,allow,7083,2786,4297,24,81,14,10
42043,53446,443,53446,443,allow,960,539,421,9,30,5,4
42044,56358,80,8330,80,allow,1569,1077,492,11,30,6,5
42045,37835,443,55999,443,allow,63724,45783,17941,171,123,85,86
42046,56952,53,53652,53,allow,487,136,351,4,46,2,2
42047,65182,53,61284,53,allow,634,199,435,6,79,3,3
42048,61838,53,61838,53,allow,216,90,126,2,30,1,1
42049,65270,53,38040,53,allow,226,110,116,2,30,1,1
42050,52361,443,27364,443,allow,7488,2474,5014,23,3600,12,11
42051,60767,40010,24332,40010,allow,316,136,180,6,6,3,3
42052,48743,443,24308,443,allow,26609,2444,24165,45,21,21,24
42053,36841,443,36841,443,allow,4401,1494,2907,19,27,11,8
42054,56486,443,16895,443,allow,2673671,30446,2643225,2145,125,234,1911
42055,49547,443,61463,443,allow,7817,1780,6037,26,172,13,13
42056,48744,443,35880,443,allow,2098,1239,859,22,20,12,10
42057,26499,80,26499,80,allow,168957,11365,157592,202,31,90,112
42058,26501,80,26501,80,allow,93644,8868,84776,131,31,64,67
42059,26504,80,26504,80,allow,13592,1419,12173,25,31,13,12
42060,49276,80,4660,80,allow,254,128,126,5,16,3,2
42061,46555,53,62486,53,allow,168,78,90,2,30,1,1
42062,27005,27015,37450,27015,allow,879,126,753,2,31,1,1
42063,61484,445,0,0,drop,70,70,0,1,0,1,0
42064,56893,445,0,0,drop,66,66,0,1,0,1,0
42065,61483,445,0,0,drop,70,70,0,1,0,1,0
42066,56888,445,0,0,drop,66,66,0,1,0,1,0
42067,54778,22114,0,0,deny,66,66,0,1,0,1,0
42068,45941,23388,0,0,deny,60,60,0,1,0,1,0
42069,56885,445,0,0,drop,66,66,0,1,0,1,0
42070,56887,445,0,0,drop,66,66,0,1,0,1,0
42071,6881,6881,0,0,deny,62,62,0,1,0,1,0
42072,56883,445,0,0,drop,66,66,0,1,0,1,0
42073,48676,53393,0,0,deny,60,60,0,1,0,1,0
42074,8889,47679,0,0,deny,60,60,0,1,0,1,0
42075,56577,445,0,0,drop,70,70,0,1,0,1,0
42076,11880,36829,0,0,deny,146,146,0,1,0,1,0
42077,57131,8055,0,0,deny,145,145,0,1,0,1,0
42078,443,15564,0,0,deny,85,85,0,1,0,1,0
42079,52569,30188,0,0,deny,66,66,0,1,0,1,0
42080,56575,445,0,0,drop,70,70,0,1,0,1,0
42081,11030,37965,0,0,deny,62,62,0,1,0,1,0
42082,61478,445,0,0,drop,70,70,0,1,0,1,0
42083,20198,17372,0,0,deny,62,62,0,1,0,1,0
42084,50222,42873,0,0,deny,66,66,0,1,0,1,0
42085,61467,445,0,0,drop,70,70,0,1,0,1,0
42086,61465,445,0,0,drop,70,70,0,1,0,1,0
42087,18754,30188,0,0,deny,66,66,0,1,0,1,0
42088,56574,445,0,0,drop,70,70,0,1,0,1,0
42089,16430,31573,0,0,deny,62,62,0,1,0,1,0
42090,56573,445,0,0,drop,70,70,0,1,0,1,0
42091,56572,445,0,0,drop,70,70,0,1,0,1,0
42092,56568,445,0,0,drop,70,70,0,1,0,1,0
42093,56569,445,0,0,drop,70,70,0,1,0,1,0
42094,57987,56125,0,0,deny,90,90,0,1,0,1,0
42095,22981,15503,0,0,deny,62,62,0,1,0,1,0
42096,56872,445,0,0,drop,66,66,0,1,0,1,0
42097,23197,44847,0,0,deny,62,62,0,1,0,1,0
42098,443,9986,0,0,deny,669,669,0,1,0,1,0
42099,63213,15503,0,0,deny,62,62,0,1,0,1,0
42100,56554,445,0,0,drop,70,70,0,1,0,1,0
42101,56552,445,0,0,drop,70,70,0,1,0,1,0
42102,56547,445,0,0,drop,70,70,0,1,0,1,0
42103,58550,21247,0,0,deny,62,62,0,1,0,1,0
42104,56543,445,0,0,drop,70,70,0,1,0,1,0
42105,56544,445,0,0,drop,70,70,0,1,0,1,0
42106,56148,37965,0,0,deny,66,66,0,1,0,1,0
42107,56865,445,0,0,drop,66,66,0,1,0,1,0
42108,38852,37965,0,0,deny,62,62,0,1,0,1,0
42109,61455,445,0,0,drop,70,70,0,1,0,1,0
42110,58888,23718,0,0,deny,66,66,0,1,0,1,0
42111,51222,35440,0,0,deny,66,66,0,1,0,1,0
42112,56862,445,0,0,drop,66,66,0,1,0,1,0
42113,53459,37807,0,0,deny,146,146,0,1,0,1,0
42114,3980,63710,0,0,deny,62,62,0,1,0,1,0
42115,61563,37807,0,0,deny,66,66,0,1,0,1,0
42116,13911,57470,0,0,deny,60,60,0,1,0,1,0
42117,56532,445,0,0,drop,70,70,0,1,0,1,0
42118,56855,445,0,0,drop,66,66,0,1,0,1,0
42119,47210,50584,0,0,deny,146,146,0,1,0,1,0
42120,56846,445,0,0,drop,66,66,0,1,0,1,0
42121,65096,37807,0,0,deny,66,66,0,1,0,1,0
42122,56380,36829,0,0,deny,66,66,0,1,0,1,0
42123,25067,50265,0,0,deny,145,145,0,1,0,1,0
42124,17010,57470,0,0,deny,62,62,0,1,0,1,0
42125,19004,51505,0,0,deny,66,66,0,1,0,1,0
42126,45941,23386,0,0,deny,60,60,0,1,0,1,0
42127,56528,445,0,0,drop,70,70,0,1,0,1,0
42128,61447,445,0,0,drop,70,70,0,1,0,1,0
42129,61444,445,0,0,drop,70,70,0,1,0,1,0
42130,61443,445,0,0,drop,70,70,0,1,0,1,0
42131,56840,445,0,0,drop,66,66,0,1,0,1,0
42132,56838,445,0,0,drop,66,66,0,1,0,1,0
42133,56839,445,0,0,drop,66,66,0,1,0,1,0
42134,56835,445,0,0,drop,66,66,0,1,0,1,0
42135,56834,445,0,0,drop,66,66,0,1,0,1,0
42136,56836,445,0,0,drop,66,66,0,1,0,1,0
42137,56837,445,0,0,drop,66,66,0,1,0,1,0
42138,56832,445,0,0,drop,66,66,0,1,0,1,0
42139,56519,445,0,0,drop,70,70,0,1,0,1,0
42140,56516,445,0,0,drop,70,70,0,1,0,1,0
42141,56517,445,0,0,drop,70,70,0,1,0,1,0
42142,56514,445,0,0,drop,70,70,0,1,0,1,0
42143,35120,26467,0,0,deny,62,62,0,1,0,1,0
42144,42465,57470,0,0,deny,60,60,0,1,0,1,0
42145,56511,445,0,0,drop,70,70,0,1,0,1,0
42146,21459,23,0,0,deny,60,60,0,1,0,1,0
42147,41586,1900,0,0,deny,139,139,0,1,0,1,0
42148,3730,37965,0,0,deny,62,62,0,1,0,1,0
42149,46108,48817,0,0,deny,145,145,0,1,0,1,0
42150,50066,30188,0,0,deny,66,66,0,1,0,1,0
42151,62150,23718,0,0,deny,66,66,0,1,0,1,0
42152,54167,50584,0,0,deny,66,66,0,1,0,1,0
42153,443,20995,0,0,deny,83,83,0,1,0,1,0
42154,1972,57470,0,0,deny,78,78,0,1,0,1,0
42155,51676,23718,0,0,deny,62,62,0,1,0,1,0
42156,61435,445,0,0,drop,70,70,0,1,0,1,0
42157,61428,445,0,0,drop,70,70,0,1,0,1,0
42158,56505,445,0,0,drop,70,70,0,1,0,1,0
42159,56817,445,0,0,drop,66,66,0,1,0,1,0
42160,56820,445,0,0,drop,66,66,0,1,0,1,0
42161,56819,445,0,0,drop,66,66,0,1,0,1,0
42162,53003,11392,0,0,deny,66,66,0,1,0,1,0
42163,5617,64147,0,0,deny,62,62,0,1,0,1,0
42164,61425,445,0,0,drop,70,70,0,1,0,1,0
42165,0,0,0,0,allow,320,320,0,5,0,5,0
42166,63927,50265,0,0,deny,62,62,0,1,0,1,0
42167,45832,51050,0,0,deny,62,62,0,1,0,1,0
42168,61423,445,0,0,drop,70,70,0,1,0,1,0
42169,56498,445,0,0,drop,70,70,0,1,0,1,0
42170,50881,50584,0,0,deny,66,66,0,1,0,1,0
42171,2828,35253,0,0,deny,66,66,0,1,0,1,0
42172,56496,445,0,0,drop,70,70,0,1,0,1,0
42173,61420,445,0,0,drop,70,70,0,1,0,1,0
42174,61417,445,0,0,drop,70,70,0,1,0,1,0
42175,61414,445,0,0,drop,70,70,0,1,0,1,0
42176,1038,37965,0,0,deny,62,62,0,1,0,1,0
42177,60052,37965,0,0,deny,66,66,0,1,0,1,0
42178,64362,35253,0,0,deny,146,146,0,1,0,1,0
42179,65317,51221,0,0,deny,78,78,0,1,0,1,0
42180,56491,445,0,0,drop,70,70,0,1,0,1,0
42181,26729,57470,0,0,deny,66,66,0,1,0,1,0
42182,56490,445,0,0,drop,70,70,0,1,0,1,0
42183,61406,445,0,0,drop,70,70,0,1,0,1,0
42184,61404,445,0,0,drop,70,70,0,1,0,1,0
42185,61403,445,0,0,drop,70,70,0,1,0,1,0
42186,56486,445,0,0,drop,70,70,0,1,0,1,0
42187,50470,61463,0,0,deny,86,86,0,1,0,1,0
42188,12128,37965,0,0,deny,62,62,0,1,0,1,0
42189,45941,23388,0,0,deny,60,60,0,1,0,1,0
42190,56485,445,0,0,drop,70,70,0,1,0,1,0
42191,19875,30170,0,0,deny,145,145,0,1,0,1,0
42192,80,9918,0,0,deny,60,60,0,1,0,1,0
42193,61945,48817,0,0,deny,66,66,0,1,0,1,0
42194,56646,48817,0,0,deny,62,62,0,1,0,1,0
42195,40294,28680,0,0,deny,145,145,0,1,0,1,0
42196,58574,21247,0,0,deny,66,66,0,1,0,1,0
42197,55642,26872,27323,26872,allow,70,70,0,1,5,1,0
42198,5588,5588,0,0,allow,3562,1936,1626,48,196,24,24
42199,43923,5222,15090,5222,allow,3007,1354,1653,28,83,15,13
42200,53129,38413,41585,38413,allow,70,70,0,1,5,1,0
42201,57335,443,6083,443,allow,4048,3089,959,24,15,13,11
42202,34837,80,34635,80,allow,7794,1470,6324,18,151,9,9
42203,55377,3389,55377,3389,allow,3343,1454,1889,15,16,8,7
42204,51858,44647,20973,44647,allow,66,66,0,1,5,1,0
42205,49258,80,49258,80,allow,17197,1551,15646,29,27,13,16
42206,26503,80,26503,80,allow,225609,13986,211623,285,31,134,151
42207,27005,30002,50231,30002,allow,1780,252,1528,5,44,3,2
42208,50987,443,24921,443,allow,3278,1962,1316,20,20,9,11
42209,53668,50678,10621,50678,allow,70,70,0,1,5,1,0
42210,26496,80,26496,80,allow,160989,10162,150827,189,31,81,108
42211,27992,443,34351,443,allow,7775,3104,4671,18,76,10,8
42212,50116,443,45796,443,allow,48255,4798,43457,100,149,47,53
42213,37309,53,0,0,allow,82,82,0,1,30,1,0
42214,53669,59056,20109,59056,allow,70,70,0,1,5,1,0
42215,55706,22,55706,22,allow,252,60,192,5,14,2,3
42216,51102,443,51987,443,allow,13990,9102,4888,28,15,16,12
42217,50124,443,10944,443,allow,48860,5749,43111,91,147,47,44
42218,51877,13472,10032,13472,allow,70,70,0,2,8,2,0
42219,56908,443,5972,443,allow,187104,26358,160746,205,190,58,147
42220,34814,80,10830,80,allow,9105,1930,7175,18,16,9,9
42221,49790,53,24988,53,allow,190,97,93,2,30,1,1
42222,43536,443,9827,443,allow,13710,4975,8735,22,121,9,13
42223,54660,443,15942,443,allow,7077,3245,3832,24,173,12,12
42224,38795,40032,51125,40032,allow,243,180,63,2,31,1,1
42225,57744,53,14767,53,allow,198,93,105,2,31,1,1
42226,53350,443,63189,443,allow,2950,679,2271,13,120,6,7
42227,57470,50321,43161,50321,allow,9414,7249,2165,91,3838,76,15
42228,61688,443,16509,443,allow,14462,3625,10837,31,63,16,15
42229,54586,161,0,0,allow,14172,5597,8575,50,31,25,25
42230,47355,161,0,0,allow,7809,3013,4796,28,31,14,14
42231,42162,53,42162,53,allow,227,88,139,2,31,1,1
42232,59371,161,59371,161,allow,2085,880,1205,10,31,5,5
42233,50719,443,22608,443,allow,17803069,497380,17305689,17583,219,5899,11684
42234,57807,443,2939,443,allow,9783,5855,3928,22,122,11,11
42235,49160,6889,21794,6889,allow,311,311,0,3,1200,3,0
42236,21133,54322,33050,54322,allow,480,149,331,2,1200,1,1
42237,47058,443,44896,443,allow,328838,76878,251960,449,243,185,264
42238,11988,48817,0,0,deny,66,66,0,1,0,1,0
42239,63271,52752,0,0,deny,78,78,0,1,0,1,0
42240,56480,445,0,0,drop,70,70,0,1,0,1,0
42241,56798,445,0,0,drop,66,66,0,1,0,1,0
42242,61398,445,0,0,drop,70,70,0,1,0,1,0
42243,61395,445,0,0,drop,70,70,0,1,0,1,0
42244,23277,53733,0,0,deny,66,66,0,1,0,1,0
42245,57987,56125,0,0,deny,90,90,0,1,0,1,0
42246,65265,55067,0,0,deny,66,66,0,1,0,1,0
42247,3818,37965,0,0,deny,66,66,0,1,0,1,0
42248,56790,445,0,0,drop,66,66,0,1,0,1,0
42249,443,20995,0,0,deny,83,83,0,1,0,1,0
42250,60426,25988,33152,25988,allow,70,70,0,1,5,1,0
42251,51859,35365,59521,35365,allow,70,70,0,1,5,1,0
42252,58442,123,61048,123,allow,184,94,90,2,30,1,1
42253,34367,443,31324,443,allow,25205,2243,22962,41,149,17,24
42254,53671,60416,30870,60416,allow,70,70,0,1,4,1,0
42255,27005,27016,31585,27016,allow,876,126,750,2,30,1,1
42256,61009,27065,32929,27065,allow,1582,1386,196,6,30,4,2
42257,49255,7000,49255,7000,allow,2163,676,1487,14,14,7,7
42258,41410,80,40896,80,allow,1484,877,607,11,34,6,5
42259,56909,443,38825,443,allow,31860,21778,10082,84,190,42,42
42260,41409,80,32220,80,allow,1484,877,607,11,34,6,5
42261,39483,443,14932,443,allow,3884,1859,2025,20,255,10,10
42262,26500,80,26500,80,allow,57276,6978,50298,77,30,34,43
42263,41484,443,11902,443,allow,10024,6237,3787,22,27,11,11
42264,53670,32016,15201,32016,allow,70,70,0,1,4,1,0
42265,64323,53,33071,53,allow,376,126,250,2,30,1,1
42266,27005,27015,15962,27015,allow,906,126,780,2,30,1,1
42267,27005,28115,50771,28115,allow,910,126,784,2,30,1,1
42268,27005,28315,51531,28315,allow,875,126,749,2,30,1,1
42269,27005,28015,54917,28015,allow,888,126,762,2,30,1,1
42270,40695,53,6681,53,allow,168,78,90,2,29,1,1
42271,27005,27015,43397,27015,allow,884,126,758,2,30,1,1
42272,52125,53,31811,53,allow,205,86,119,2,29,1,1
42273,9042,443,33866,443,allow,15177,5713,9464,37,120,17,20
42274,56661,443,32722,443,allow,8059,2039,6020,20,15,11,9
42275,27005,27019,20474,27019,allow,2024,504,1520,7,33,5,2
42276,56632,80,25180,80,allow,234,234,0,4,12,4,0
42277,28238,443,59283,443,allow,8456,3501,4955,20,90,11,9
42278,34373,28678,41304,28678,allow,1806,1806,0,22,224,22,0
42279,49549,443,52947,443,allow,7896,1770,6126,26,171,13,13
42280,37314,80,28984,80,allow,1348,844,504,13,255,8,5
42281,47650,443,47650,443,allow,4585,1678,2907,19,28,11,8
42282,38123,443,24032,443,allow,15449,1976,13473,32,16,16,16
42283,55367,53,25329,53,allow,215,102,113,2,30,1,1
42284,59597,443,2305,443,allow,10310,2469,7841,35,255,18,17
42285,53132,29384,28228,29384,allow,70,70,0,2,8,2,0
42286,65074,53,29931,53,allow,284,118,166,2,30,1,1
42287,56663,443,10408,443,allow,8057,2037,6020,20,15,11,9
42288,49180,443,17664,443,allow,888019,22655,865364,902,18,322,580
42289,49790,53,51287,53,allow,195,102,93,2,30,1,1
42290,41037,80,6510,80,allow,613,539,74,7,15,6,1
42291,38082,443,40503,443,allow,9037,1851,7186,26,180,14,12
42292,56925,443,10686,443,allow,33095,18485,14610,73,185,43,30
42293,50324,443,12034,443,allow,13002,1895,11107,31,202,17,14
42294,38121,443,50120,443,allow,1515436,54168,1461268,1689,16,687,1002
42295,57402,2258,57402,2258,allow,156,156,0,3,8,3,0
42296,51860,53854,59221,53854,allow,70,70,0,1,5,1,0
42297,60410,80,39027,80,allow,186,64,122,4,27,2,2
42298,65337,53,53258,53,allow,460,112,348,4,56,2,2
42299,58849,443,31441,443,allow,1366,631,735,14,81,7,7
42300,56664,443,21855,443,allow,8005,1985,6020,20,15,11,9
42301,60374,443,14239,443,allow,15475,7059,8416,33,97,18,15
42302,60380,443,36908,443,allow,24243,17180,7063,52,97,33,19
42303,49538,443,16302,443,allow,2926,1825,1101,22,171,11,11
42304,51876,35624,28526,35624,allow,70,70,0,2,8,2,0
42305,56830,17793,18491,17793,allow,564,318,246,9,15,5,4
42306,26502,80,26502,80,allow,184480,11115,173365,239,30,116,123
42307,57054,80,1820,80,allow,25138,16043,9095,79,2410,53,26
42308,57084,443,60490,443,allow,9905,4321,5584,27,315,13,14
42309,49219,443,60965,443,allow,70,70,0,2,4,2,0
42310,51857,40561,47310,40561,allow,70,70,0,1,5,1,0
42311,37712,443,12957,443,allow,7660,2239,5421,32,255,16,16
42312,53672,20380,47465,20380,allow,70,70,0,1,4,1,0
42313,49790,53,41551,53,allow,195,102,93,2,29,1,1
42314,55641,61762,29914,61762,allow,70,70,0,1,5,1,0
42315,53280,443,38767,443,allow,4228,1083,3145,15,31,8,7
42316,27005,27016,51239,27016,allow,888,126,762,2,30,1,1
42317,27005,27015,1608,27015,allow,888,126,762,2,30,1,1
42318,58648,443,61974,443,allow,7509,1262,6247,22,16,12,10
42319,51412,53,4036,53,allow,252,78,174,2,30,1,1
42320,57508,443,43486,443,allow,6749,2649,4100,19,142,9,10
42321,27005,28215,29356,28215,allow,879,126,753,2,30,1,1
42322,54417,53,12775,53,allow,259,86,173,2,30,1,1
42323,37965,33622,23125,33622,allow,132,132,0,3,1199,3,0
42324,60427,61137,28150,61137,allow,70,70,0,1,5,1,0
42325,59314,443,58564,443,allow,16862,7584,9278,97,8912,60,37
42326,42630,443,10044,443,allow,6039,1327,4712,19,121,11,8
42327,47387,443,50220,443,allow,3930,392,3538,9,15,4,5
42328,60428,80,55142,80,allow,20301,1264,19037,28,26,11,17
42329,57370,6969,42648,6969,allow,70,70,0,1,5,1,0
42330,56662,443,9856,443,allow,8007,1987,6020,20,15,11,9
42331,57507,7000,57507,7000,allow,3562,1995,1567,16,15,9,7
42332,54618,53,15831,53,allow,263,86,177,2,30,1,1
42333,62952,443,20995,443,allow,1304,612,692,18,120,9,9
42334,59912,443,31539,443,allow,7763,1354,6409,25,82,13,12
42335,57432,66,6875,66,allow,70,70,0,2,8,2,0
42336,53540,443,65354,443,allow,20948,4141,16807,76,616,37,39
42337,49699,443,3417,443,allow,9968,2106,7862,27,128,14,13
42338,42090,443,42090,443,allow,3509,1693,1816,21,96,10,11
42339,52955,443,44904,443,allow,3617,2035,1582,30,346,15,15
42340,64708,53,55981,53,allow,294,134,160,2,30,1,1
42341,64968,27030,53742,27030,allow,735,462,273,2,30,1,1
42342,46009,53,4263,53,allow,199,94,105,2,30,1,1
42343,50915,53,63317,53,allow,168,78,90,2,30,1,1
42344,49589,53,16073,53,allow,214,102,112,2,31,1,1
42345,62928,443,42185,443,allow,52219,4148,48071,75,125,33,42
42346,27005,27015,24637,27015,allow,1630,126,1504,4,31,2,2
42347,27005,27021,42135,27021,allow,1708,126,1582,4,31,2,2
42348,27005,30015,42725,30015,allow,1700,126,1574,4,31,2,2
42349,60295,53,27114,53,allow,224,94,130,2,30,1,1
42350,47969,53,59484,53,allow,199,94,105,2,30,1,1
42351,52258,443,2636,443,allow,3757,356,3401,12,120,5,7
42352,35205,53,35205,53,allow,240,98,142,2,30,1,1
42353,64185,53,32210,53,allow,403,110,293,2,31,1,1
42354,38544,161,0,0,allow,8977,3570,5407,30,31,15,15
42355,59424,443,28784,443,allow,2288,1131,1157,25,119,12,13
42356,35145,443,40787,443,allow,3542,1045,2497,13,120,6,7
42357,51765,443,19120,443,allow,3026,965,2061,14,135,7,7
42358,57626,443,3957,443,allow,3858,1277,2581,12,120,6,6
42359,53688,17106,21939,17106,allow,70,70,0,2,8,2,0
42360,54455,443,48160,443,allow,282,148,134,5,27,3,2
42361,56673,443,23897,443,allow,6693,1072,5621,18,26,10,8
42362,58209,53,48023,53,allow,259,86,173,2,30,1,1
42363,45325,53,64530,53,allow,168,78,90,2,30,1,1
42364,55647,61042,18333,61042,allow,320,140,180,6,7,3,3
42365,53687,51471,3936,51471,allow,70,70,0,2,8,2,0
42366,60281,80,39760,80,allow,1151,711,440,10,16,5,5
42367,64910,53,52147,53,allow,259,86,173,2,30,1,1
42368,27005,27016,48849,27016,allow,1688,126,1562,4,31,2,2
42369,27005,27016,24190,27016,allow,1696,126,1570,4,31,2,2
42370,41230,443,13536,443,allow,78,78,0,1,5,1,0
42371,35756,80,35756,80,allow,364170,17670,346500,412,31,170,242
42372,51240,443,5101,443,allow,9668,4688,4980,42,16,25,17
42373,39387,443,57166,443,allow,204,70,134,4,26,2,2
42374,51241,443,60698,443,allow,8083,2502,5581,40,16,22,18
42375,40358,443,63081,443,allow,626,352,274,10,16,6,4
42376,56788,445,0,0,drop,66,66,0,1,0,1,0
42377,61384,445,0,0,drop,70,70,0,1,0,1,0
42378,50090,50265,0,0,deny,66,66,0,1,0,1,0
42379,62872,50584,0,0,deny,62,62,0,1,0,1,0
42380,33896,57470,0,0,deny,74,74,0,1,0,1,0
42381,33193,50584,0,0,deny,62,62,0,1,0,1,0
42382,61381,445,0,0,drop,70,70,0,1,0,1,0
42383,61379,445,0,0,drop,70,70,0,1,0,1,0
42384,61375,445,0,0,drop,70,70,0,1,0,1,0
42385,56467,445,0,0,drop,70,70,0,1,0,1,0
42386,56784,445,0,0,drop,66,66,0,1,0,1,0
42387,10000,10214,0,0,deny,62,62,0,1,0,1,0
42388,55565,64147,0,0,deny,66,66,0,1,0,1,0
42389,59509,64147,0,0,deny,62,62,0,1,0,1,0
42390,61053,44847,0,0,deny,66,66,0,1,0,1,0
42391,42389,42873,0,0,deny,74,74,0,1,0,1,0
42392,56464,445,0,0,drop,70,70,0,1,0,1,0
42393,2422,50584,0,0,deny,62,62,0,1,0,1,0
42394,61370,445,0,0,drop,70,70,0,1,0,1,0
42395,443,20087,0,0,deny,83,83,0,1,0,1,0
42396,15854,50584,0,0,deny,62,62,0,1,0,1,0
42397,61368,445,0,0,drop,70,70,0,1,0,1,0
42398,61365,445,0,0,drop,70,70,0,1,0,1,0
42399,61366,445,0,0,drop,70,70,0,1,0,1,0
42400,56653,22114,0,0,deny,66,66,0,1,0,1,0
42401,52430,35440,0,0,deny,62,62,0,1,0,1,0
42402,56778,445,0,0,drop,66,66,0,1,0,1,0
42403,26333,23,0,0,deny,60,60,0,1,0,1,0
42404,56776,445,0,0,drop,66,66,0,1,0,1,0
42405,56774,445,0,0,drop,66,66,0,1,0,1,0
42406,56773,445,0,0,drop,66,66,0,1,0,1,0
42407,56460,445,0,0,drop,70,70,0,1,0,1,0
42408,33563,14037,0,0,deny,78,78,0,1,0,1,0
42409,56769,445,0,0,drop,66,66,0,1,0,1,0
42410,56768,445,0,0,drop,66,66,0,1,0,1,0
42411,56767,445,0,0,drop,66,66,0,1,0,1,0
42412,56458,445,0,0,drop,70,70,0,1,0,1,0
42413,59668,51505,0,0,deny,66,66,0,1,0,1,0
42414,39056,22114,0,0,deny,62,62,0,1,0,1,0
42415,56456,445,0,0,drop,70,70,0,1,0,1,0
42416,65285,44847,0,0,deny,62,62,0,1,0,1,0
42417,443,20995,0,0,deny,83,83,0,1,0,1,0
42418,61361,445,0,0,drop,70,70,0,1,0,1,0
42419,61360,445,0,0,drop,70,70,0,1,0,1,0
42420,61363,445,0,0,drop,70,70,0,1,0,1,0
42421,56764,445,0,0,drop,66,66,0,1,0,1,0
42422,45941,23386,0,0,deny,60,60,0,1,0,1,0
42423,42252,33303,0,0,deny,60,60,0,1,0,1,0
42424,61355,445,0,0,drop,70,70,0,1,0,1,0
42425,56761,445,0,0,drop,66,66,0,1,0,1,0
42426,45654,67,0,0,deny,60,60,0,1,0,1,0
42427,56759,445,0,0,drop,66,66,0,1,0,1,0
42428,56757,445,0,0,drop,66,66,0,1,0,1,0
42429,56755,445,0,0,drop,66,66,0,1,0,1,0
42430,31330,15503,0,0,deny,145,145,0,1,0,1,0
42431,56449,445,0,0,drop,70,70,0,1,0,1,0
42432,28897,35440,0,0,deny,66,66,0,1,0,1,0
42433,60168,35440,0,0,deny,66,66,0,1,0,1,0
42434,56447,445,0,0,drop,70,70,0,1,0,1,0
42435,65064,30188,0,0,deny,66,66,0,1,0,1,0
42436,61350,445,0,0,drop,70,70,0,1,0,1,0
42437,56446,445,0,0,drop,70,70,0,1,0,1,0
42438,51413,48637,0,0,deny,72,72,0,1,0,1,0
42439,56445,445,0,0,drop,70,70,0,1,0,1,0
42440,61341,445,0,0,drop,70,70,0,1,0,1,0
42441,61338,445,0,0,drop,70,70,0,1,0,1,0
42442,56444,445,0,0,drop,70,70,0,1,0,1,0
42443,443,20995,0,0,deny,83,83,0,1,0,1,0
42444,56442,445,0,0,drop,70,70,0,1,0,1,0
42445,56438,445,0,0,drop,70,70,0,1,0,1,0
42446,60646,11392,0,0,deny,66,66,0,1,0,1,0
42447,7273,64147,0,0,deny,66,66,0,1,0,1,0
42448,28754,50584,0,0,deny,66,66,0,1,0,1,0
42449,20005,37965,0,0,deny,62,62,0,1,0,1,0
42450,56456,1433,0,0,deny,60,60,0,1,0,1,0
42451,56745,445,0,0,drop,66,66,0,1,0,1,0
42452,62068,64147,0,0,deny,66,66,0,1,0,1,0
42453,56426,445,0,0,drop,70,70,0,1,0,1,0
42454,56425,445,0,0,drop,70,70,0,1,0,1,0
42455,56423,445,0,0,drop,70,70,0,1,0,1,0
42456,60126,35440,0,0,deny,66,66,0,1,0,1,0
42457,56415,445,0,0,drop,70,70,0,1,0,1,0
42458,56416,445,0,0,drop,70,70,0,1,0,1,0
42459,6881,21416,0,0,deny,146,146,0,1,0,1,0
42460,32727,23,0,0,deny,60,60,0,1,0,1,0
42461,56737,445,0,0,drop,66,66,0,1,0,1,0
42462,41220,59356,0,0,deny,62,62,0,1,0,1,0
42463,61327,445,0,0,drop,70,70,0,1,0,1,0
42464,52200,23,0,0,deny,60,60,0,1,0,1,0
42465,56734,445,0,0,drop,66,66,0,1,0,1,0
42466,45342,443,2921,443,allow,2378,1382,996,20,21,11,9
42467,10775,35440,0,0,deny,66,66,0,1,0,1,0
42468,28764,2323,0,0,deny,60,60,0,1,0,1,0
42469,56404,445,0,0,drop,70,70,0,1,0,1,0
42470,51910,37965,0,0,deny,62,62,0,1,0,1,0
42471,53090,59356,0,0,deny,66,66,0,1,0,1,0
42472,40185,64147,0,0,deny,66,66,0,1,0,1,0
42473,33012,50265,0,0,deny,145,145,0,1,0,1,0
42474,443,20995,0,0,deny,83,83,0,1,0,1,0
42475,65526,28793,0,0,deny,66,66,0,1,0,1,0
42476,14350,56205,0,0,deny,146,146,0,1,0,1,0
42477,42465,57470,0,0,deny,60,60,0,1,0,1,0
42478,56719,445,0,0,drop,66,66,0,1,0,1,0
42479,34306,37965,0,0,deny,62,62,0,1,0,1,0
42480,63779,26467,0,0,deny,62,62,0,1,0,1,0
42481,52282,37965,0,0,deny,66,66,0,1,0,1,0
42482,45941,23388,0,0,deny,60,60,0,1,0,1,0
42483,56399,445,0,0,drop,70,70,0,1,0,1,0
42484,38093,11392,0,0,deny,146,146,0,1,0,1,0
42485,23969,57470,0,0,deny,62,62,0,1,0,1,0
42486,10886,51505,0,0,deny,62,62,0,1,0,1,0
42487,61085,37965,0,0,deny,62,62,0,1,0,1,0
42488,49305,57470,0,0,deny,66,66,0,1,0,1,0
42489,1972,57470,0,0,deny,78,78,0,1,0,1,0
42490,56390,445,0,0,drop,70,70,0,1,0,1,0
42491,56391,445,0,0,drop,70,70,0,1,0,1,0
42492,56389,445,0,0,drop,70,70,0,1,0,1,0
42493,61318,445,0,0,drop,70,70,0,1,0,1,0
42494,61315,445,0,0,drop,70,70,0,1,0,1,0
42495,61316,445,0,0,drop,70,70,0,1,0,1,0
42496,56369,22114,0,0,deny,62,62,0,1,0,1,0
42497,1523,22,0,0,deny,60,60,0,1,0,1,0
42498,56387,445,0,0,drop,70,70,0,1,0,1,0
42499,56706,445,0,0,drop,66,66,0,1,0,1,0
42500,56710,445,0,0,drop,66,66,0,1,0,1,0
42501,56709,445,0,0,drop,66,66,0,1,0,1,0
42502,56707,445,0,0,drop,66,66,0,1,0,1,0
42503,56704,445,0,0,drop,66,66,0,1,0,1,0
42504,56712,445,0,0,drop,66,66,0,1,0,1,0
42505,56711,445,0,0,drop,66,66,0,1,0,1,0
42506,56705,445,0,0,drop,66,66,0,1,0,1,0
42507,56383,445,0,0,drop,70,70,0,1,0,1,0
42508,45682,1,0,0,deny,62,62,0,1,0,1,0
42509,57612,28793,0,0,deny,66,66,0,1,0,1,0
42510,41022,30975,0,0,deny,157,157,0,1,0,1,0
42511,52144,49344,0,0,deny,62,62,0,1,0,1,0
42512,1040,37965,0,0,deny,62,62,0,1,0,1,0
42513,59435,37807,0,0,deny,66,66,0,1,0,1,0
42514,65317,51221,0,0,deny,78,78,0,1,0,1,0
42515,26085,51221,0,0,deny,72,72,0,1,0,1,0
42516,57987,56125,0,0,deny,90,90,0,1,0,1,0
42517,15641,26467,0,0,deny,62,62,0,1,0,1,0
42518,60423,35440,0,0,deny,62,62,0,1,0,1,0
42519,31995,61689,0,0,deny,146,146,0,1,0,1,0
42520,61313,445,0,0,drop,70,70,0,1,0,1,0
42521,56377,445,0,0,drop,70,70,0,1,0,1,0
42522,61307,445,0,0,drop,70,70,0,1,0,1,0
42523,61301,445,0,0,drop,70,70,0,1,0,1,0
42524,63288,52848,0,0,deny,66,66,0,1,0,1,0
42525,58226,52848,0,0,deny,62,62,0,1,0,1,0
42526,9473,26467,0,0,deny,66,66,0,1,0,1,0
42527,56690,445,0,0,drop,66,66,0,1,0,1,0
42528,56691,445,0,0,drop,66,66,0,1,0,1,0
42529,56689,445,0,0,drop,66,66,0,1,0,1,0
42530,36227,23,0,0,deny,60,60,0,1,0,1,0
42531,50901,26467,0,0,deny,66,66,0,1,0,1,0
42532,61298,445,0,0,drop,70,70,0,1,0,1,0
42533,56370,445,0,0,drop,70,70,0,1,0,1,0
42534,52830,22114,0,0,deny,146,146,0,1,0,1,0
42535,56367,445,0,0,drop,70,70,0,1,0,1,0
42536,55386,37965,0,0,deny,66,66,0,1,0,1,0
42537,12226,37965,0,0,deny,62,62,0,1,0,1,0
42538,61295,445,0,0,drop,70,70,0,1,0,1,0
42539,61294,445,0,0,drop,70,70,0,1,0,1,0
42540,61292,445,0,0,drop,70,70,0,1,0,1,0
42541,61288,445,0,0,drop,70,70,0,1,0,1,0
42542,56752,44847,0,0,deny,66,66,0,1,0,1,0
42543,17532,23,0,0,deny,60,60,0,1,0,1,0
42544,56363,445,0,0,drop,70,70,0,1,0,1,0
42545,56362,445,0,0,drop,70,70,0,1,0,1,0
42546,33595,23,0,0,deny,60,60,0,1,0,1,0
42547,26799,6881,0,0,deny,146,146,0,1,0,1,0
42548,58207,51505,0,0,deny,66,66,0,1,0,1,0
42549,47910,7461,0,0,deny,60,60,0,1,0,1,0
42550,61510,37965,0,0,deny,66,66,0,1,0,1,0
42551,56358,445,0,0,drop,70,70,0,1,0,1,0
42552,59352,37965,0,0,deny,66,66,0,1,0,1,0
42553,63271,52752,0,0,deny,78,78,0,1,0,1,0
42554,51412,51505,0,0,deny,62,62,0,1,0,1,0
42555,45405,161,0,0,allow,5858,2302,3556,22,30,11,11
42556,32833,53,32833,53,allow,227,88,139,2,30,1,1
42557,22199,443,22199,443,allow,79787,12741,67046,117,31,65,52
42558,22773,443,22773,443,allow,6993,960,6033,17,31,10,7
42559,54553,443,44028,443,allow,68345,58488,9857,122,329,62,60
42560,56840,20413,10874,20413,allow,70,70,0,2,8,2,0
42561,35753,80,35753,80,allow,158890,11318,147572,182,30,74,108
42562,60374,80,60374,80,allow,118413,7486,110927,151,33,70,81
42563,27331,443,27331,443,allow,1251,722,529,11,147,6,5
42564,26961,443,26961,443,allow,1251,722,529,11,147,6,5
42565,5588,5588,0,0,allow,3562,1936,1626,48,193,24,24
42566,56680,161,0,0,allow,15721,6203,9518,50,30,25,25
42567,51385,161,51385,161,allow,2315,979,1336,10,30,5,5
42568,8069,80,8069,80,allow,638,306,332,11,84,6,5
42569,56976,80,37703,80,allow,214,140,74,4,35,3,1
42570,8389,80,8389,80,allow,1700,1073,627,15,84,8,7
42571,62440,443,45155,443,allow,28183,7016,21167,51,45,23,28
42572,26504,443,26504,443,allow,1251,722,529,11,147,6,5
42573,39287,53,1937,53,allow,198,93,105,2,30,1,1
42574,45000,443,43427,443,allow,2227,1018,1209,17,16,8,9
42575,56978,80,63683,80,allow,214,140,74,4,35,3,1
42576,49181,2710,52440,2710,allow,66,66,0,1,5,1,0
42577,27008,443,27008,443,allow,1251,722,529,11,147,6,5
42578,39915,443,44120,443,allow,6922156,117604,6804552,6122,50,1519,4603
42579,43310,443,13938,443,allow,60,60,0,1,5,1,0
42580,10344,80,10344,80,allow,6705,702,6003,13,16,6,7
42581,56975,80,23804,80,allow,214,140,74,4,35,3,1
42582,56988,80,5679,80,allow,214,140,74,4,35,3,1
42583,56624,443,46421,443,allow,12807,129,12678,13,147,2,11
42584,47748,161,0,0,allow,6387,2535,3852,22,30,11,11
42585,54234,80,54234,80,allow,2334,1575,759,11,148,6,5
42586,22678,443,22678,443,allow,18172,3573,14599,39,26,20,19
42587,35755,80,35755,80,allow,201552,13184,188368,245,30,111,134
42588,22939,443,22939,443,allow,6993,960,6033,17,31,10,7
42589,35752,80,35752,80,allow,871846,24071,847775,900,30,326,574
42590,22376,443,22376,443,allow,6620,3193,3427,23,26,13,10
42591,22404,443,22404,443,allow,5576,2436,3140,21,26,12,9
42592,38852,443,38852,443,allow,4747,1840,2907,19,28,11,8
42593,43309,443,32781,443,allow,60,60,0,1,5,1,0
42594,16262,80,16262,80,allow,14671,951,13720,23,16,10,13
42595,60112,443,25865,443,allow,572,280,292,9,16,5,4
42596,8160,80,8160,80,allow,1670,1044,626,15,84,8,7
42597,56828,53156,12395,53156,allow,66,66,0,1,5,1,0
42598,53660,18599,61340,18599,allow,492,306,186,8,16,5,3
42599,56979,80,46084,80,allow,214,140,74,4,35,3,1
42600,55645,18904,52547,18904,allow,320,140,180,6,6,3,3
42601,51077,13021,36103,13021,allow,154976,25739,129237,605,387,321,284
42602,51874,43161,58126,43161,allow,70,70,0,2,8,2,0
42603,27005,27016,32182,27016,allow,1648,126,1522,4,30,2,2
42604,57577,443,53525,443,allow,4752,2561,2191,32,256,16,16
42605,56977,80,20065,80,allow,214,140,74,4,35,3,1
42606,64216,53,64216,53,allow,220,100,120,2,30,1,1
42607,61053,443,61053,443,allow,40415,2911,37504,57,18,27,30
42608,8485,80,8485,80,allow,572,240,332,10,84,5,5
42609,41528,161,0,0,allow,14381,5620,8761,50,30,25,25
42610,53132,22448,0,0,allow,66,66,0,1,90,1,0
42611,50265,38203,29229,38203,allow,480,149,331,2,1200,1,1
42612,53685,38978,44279,38978,allow,70,70,0,2,8,2,0
42613,43308,443,4843,443,allow,120,120,0,2,5,2,0
42614,53681,31466,64750,31466,allow,70,70,0,2,8,2,0
42615,57878,80,49228,80,allow,5518,527,4991,13,75,6,7
42616,54028,443,7656,443,allow,11123,4258,6865,48,197,27,21
42617,27005,27015,49049,27015,allow,1610,126,1484,4,30,2,2
42618,64091,443,50015,443,allow,3258,1197,2061,14,136,7,7
42619,60306,443,16522,443,allow,2866,623,2243,13,136,6,7
42620,55288,443,7334,443,allow,15679,1532,14147,16,139,3,13
42621,27005,30002,14816,30002,allow,1652,126,1526,4,31,2,2
42622,61275,445,0,0,drop,70,70,0,1,0,1,0
42623,61276,445,0,0,drop,70,70,0,1,0,1,0
42624,61273,445,0,0,drop,70,70,0,1,0,1,0
42625,34273,36829,0,0,deny,146,146,0,1,0,1,0
42626,56357,445,0,0,drop,70,70,0,1,0,1,0
42627,50341,37965,0,0,deny,62,62,0,1,0,1,0
42628,54028,37965,0,0,deny,66,66,0,1,0,1,0
42629,49191,35440,0,0,deny,62,62,0,1,0,1,0
42630,29011,32468,0,0,deny,66,66,0,1,0,1,0
42631,15403,51505,0,0,deny,66,66,0,1,0,1,0
42632,54869,35440,0,0,deny,146,146,0,1,0,1,0
42633,62115,57470,0,0,deny,66,66,0,1,0,1,0
42634,53294,443,27871,443,allow,7740,4267,3473,39,97,21,18
42635,23066,443,23066,443,allow,5573,2434,3139,21,25,12,9
42636,56980,80,6065,80,allow,214,140,74,4,35,3,1
42637,7660,443,7660,443,allow,5640,2394,3246,25,82,13,12
42638,60426,57470,0,0,deny,62,62,0,1,0,1,0
42639,64605,35993,0,0,deny,66,66,0,1,0,1,0
42640,56670,445,0,0,drop,66,66,0,1,0,1,0
42641,61270,445,0,0,drop,70,70,0,1,0,1,0
42642,61268,445,0,0,drop,70,70,0,1,0,1,0
42643,37662,2323,0,0,deny,60,60,0,1,0,1,0
42644,6712,5632,0,0,deny,60,60,0,1,0,1,0
42645,50470,61463,0,0,deny,86,86,0,1,0,1,0
42646,29787,37965,0,0,deny,62,62,0,1,0,1,0
42647,55373,1,0,0,deny,66,66,0,1,0,1,0
42648,56662,445,0,0,drop,66,66,0,1,0,1,0
42649,56339,445,0,0,drop,70,70,0,1,0,1,0
42650,50025,53,43960,53,allow,536,120,416,4,59,2,2
42651,49760,1443,52471,1443,allow,626,352,274,10,15,6,4
42652,60375,80,60375,80,allow,172473,8713,163760,205,33,91,114
42653,35754,80,35754,80,allow,141193,10612,130581,165,30,69,96
42654,49928,443,22562,443,allow,9330,2410,6920,25,81,13,12
42655,7797,443,7797,443,allow,1474,697,777,18,82,8,10
42656,43156,53,17212,53,allow,168,78,90,2,29,1,1
42657,65001,53,54840,53,allow,224,78,146,2,30,1,1
42658,58278,443,51446,443,allow,7349712,213635,7136077,7600,192,2303,5297
42659,35094,53,9610,53,allow,371,94,277,2,30,1,1
42660,40941,443,61408,443,allow,9794,2178,7616,26,48,16,10
42661,38936,80,38936,80,allow,8429,1098,7331,16,20,8,8
42662,53278,443,21560,443,allow,38395,6930,31465,56,30,27,29
42663,2777,23,2777,23,allow,130,66,64,2,4,1,1
42664,56602,443,24699,443,allow,27035,4207,22828,43,31,21,22
42665,56799,443,31346,443,allow,6496,1340,5156,31,506,10,21
42666,53682,20884,39828,20884,allow,70,70,0,2,7,2,0
42667,60376,80,60376,80,allow,180425,10839,169586,213,33,93,120
42668,53686,8999,46759,8999,allow,70,70,0,2,7,2,0
42669,35751,80,35751,80,allow,336615,15190,321425,383,31,159,224
42670,27005,27015,42995,27015,allow,1758,252,1506,5,32,3,2
42671,49229,53,37715,53,allow,243,110,133,2,29,1,1
42672,59222,53,30617,53,allow,181,86,95,2,30,1,1
42673,53102,53,13819,53,allow,70,70,0,1,30,1,0
42674,57388,53,31918,53,allow,266,86,180,2,30,1,1
42675,42487,443,53584,443,allow,4887,895,3992,16,29,9,7
42676,49940,443,49940,443,allow,13342,2357,10985,25,18,14,11
42677,61040,443,61040,443,allow,4886,1530,3356,17,17,10,7
42678,57373,443,61209,443,allow,5620,927,4693,17,15,10,7
42679,56989,80,28425,80,allow,526,304,222,8,35,5,3
42680,6881,6881,56925,6881,allow,238,118,120,2,1200,1,1
42681,50494,80,52508,80,allow,18059,13615,4444,29,27,16,13
42682,56658,53,56658,53,allow,257,114,143,2,30,1,1
42683,59743,80,42514,80,allow,815748,15896,799852,777,90,244,533
42684,50508,443,58389,443,allow,7588,1850,5738,19,25,10,9
42685,51873,19311,58554,19311,allow,70,70,0,2,7,2,0
42686,54961,443,58980,443,allow,1015861,30762,985099,1147,257,421,726
42687,56659,443,54837,443,allow,8058,2038,6020,20,15,11,9
42688,49523,53,19380,53,allow,314,93,221,4,43,2,2
42689,7928,80,7928,80,allow,25909,3016,22893,40,83,15,25
42690,37941,443,61204,443,allow,69429,16478,52951,156,182,83,73
42691,50474,80,43879,80,allow,19357,10244,9113,36,27,19,17
42692,56987,80,45961,80,allow,214,140,74,4,35,3,1
42693,56986,80,18351,80,allow,214,140,74,4,35,3,1
42694,56984,80,27269,80,allow,214,140,74,4,35,3,1
42695,23023,80,23023,80,allow,2270,1645,625,9,26,6,3
42696,8167,443,8167,443,allow,1474,697,777,18,82,8,10
42697,40806,8000,49174,8000,allow,1259,639,620,20,300,10,10
42698,51481,53,20508,53,allow,168,78,90,2,30,1,1
42699,55952,443,28479,443,allow,24272,12428,11844,70,213,32,38
42700,51073,80,13586,80,allow,525373,237667,287706,1387,390,693,694
42701,50408,7000,50408,7000,allow,3132,815,2317,14,18,7,7
42702,48105,53,48105,53,allow,262,106,156,2,33,1,1
42703,51875,25072,31017,25072,allow,70,70,0,2,7,2,0
42704,4956,53,4956,53,allow,203,82,121,2,30,1,1
42705,60399,161,0,0,allow,18789,5169,13620,54,30,27,27
42706,53125,10693,11015,10693,allow,954,454,500,14,21,8,6
42707,51856,62841,45068,62841,allow,136,136,0,3,13,3,0
42708,51855,23268,16577,23268,allow,70,70,0,1,5,1,0
42709,62439,443,26291,443,allow,16246,11056,5190,37,45,21,16
42710,32967,80,37431,80,allow,21387,1482,19905,38,18,19,19
42711,22,15260,22,15260,allow,130,70,60,2,15,1,1
42712,8024,80,8024,80,allow,572,240,332,10,83,5,5
42713,64530,53,46090,53,allow,211,102,109,2,30,1,1
42714,38260,443,50232,443,allow,7173,1419,5754,32,383,11,21
42715,58847,443,24312,443,allow,3143,1064,2079,18,82,8,10
42716,35915,443,57098,443,allow,1786,172,1614,7,120,3,4
42717,60369,80,60369,80,allow,266818,12375,254443,285,34,107,178
42718,57066,443,13444,443,allow,556770,88286,468484,777,202,314,463
42719,27005,27016,56355,27016,allow,1646,126,1520,4,31,2,2
42720,43087,443,6969,443,allow,4909,1007,3902,14,35,8,6
42721,56660,443,63035,443,allow,8006,1986,6020,20,15,11,9
42722,13743,80,13743,80,allow,724,366,358,11,142,6,5
42723,27563,443,27563,443,allow,1181,722,459,10,147,6,4
42724,53689,42719,61267,42719,allow,70,70,0,2,7,2,0
42725,57790,443,8937,443,allow,117653,21783,95870,251,556,93,158
42726,10038,443,58313,443,allow,7481,2070,5411,25,315,12,13
42727,47120,443,47120,443,allow,4604,1697,2907,19,29,11,8
42728,62441,443,36404,443,allow,4651,3116,1535,19,44,10,9
42729,22592,443,22592,443,allow,29021,6752,22269,48,30,29,19
42730,7934,443,7934,443,allow,6593,3073,3520,27,82,14,13
42731,49502,53,35075,53,allow,179,86,93,2,29,1,1
42732,59262,80,59262,80,allow,94514,14468,80046,152,15,41,111
42733,23022,443,23022,443,allow,10943,5186,5757,32,25,18,14
42734,56985,80,59526,80,allow,214,140,74,4,35,3,1
42735,57184,53,36086,53,allow,272,94,178,2,29,1,1
42736,22205,443,22205,443,allow,10793,2049,8744,23,30,14,9
42737,43743,53,43743,53,allow,240,98,142,2,29,1,1
42738,56981,80,19891,80,allow,214,140,74,4,35,3,1
42739,43039,53,27551,53,allow,168,78,90,2,29,1,1
42740,61217,53,50317,53,allow,281,94,187,2,30,1,1
42741,55552,53,60195,53,allow,211,102,109,2,30,1,1
42742,27005,28515,30330,28515,allow,1660,126,1534,4,30,2,2
42743,27005,27017,47971,27017,allow,1616,126,1490,4,30,2,2
42744,49182,53,44371,53,allow,211,102,109,2,30,1,1
42745,55531,53,57594,53,allow,370,126,244,2,30,1,1
42746,60121,161,0,0,allow,8215,3237,4978,30,30,15,15
42747,50502,123,1103,123,allow,184,94,90,2,30,1,1
42748,33027,161,0,0,allow,15505,6180,9325,50,30,25,25
42749,53512,53,23746,53,allow,168,78,90,2,30,1,1
42750,61567,53,3917,53,allow,183,86,97,2,30,1,1
42751,34044,161,0,0,allow,18549,5061,13488,54,30,27,27
42752,6881,48533,62658,48533,allow,502,150,352,2,1199,1,1
42753,57791,443,18201,443,allow,30057,13955,16102,146,556,65,81
42754,60276,80,60276,80,allow,671,313,358,7,75,4,3
42755,56990,80,57120,80,allow,214,140,74,4,35,3,1
42756,53471,161,0,0,allow,5907,2302,3605,22,30,11,11
42757,64438,53,23542,53,allow,211,102,109,2,30,1,1
42758,56852,6057,3356,6057,allow,2499,2499,0,22,300,22,0
42759,48962,161,0,0,allow,8507,3320,5187,28,30,14,14
42760,65166,53,40990,53,allow,211,102,109,2,30,1,1
42761,49826,80,54409,80,allow,6311,4340,1971,20,186,12,8
42762,64679,53,17226,53,allow,211,102,109,2,31,1,1
42763,60921,443,60921,443,allow,4886,1530,3356,17,17,10,7
42764,62295,443,30041,443,allow,3538,2015,1523,28,325,14,14
42765,56983,80,30863,80,allow,214,140,74,4,35,3,1
42766,56982,80,63526,80,allow,214,140,74,4,35,3,1
42767,8583,443,8583,443,allow,19994,4745,15249,47,82,21,26
42768,8168,443,8168,443,allow,10130,4701,5429,34,82,18,16
42769,41486,443,65300,443,allow,204,70,134,4,26,2,2
42770,65039,53,3857,53,allow,302,102,200,2,30,1,1
42771,23769,53,45289,53,allow,334,226,108,3,30,2,1
42772,64430,53,41812,53,allow,493,91,402,4,31,2,2
42773,49565,53,54064,53,allow,768,193,575,6,40,3,3
42774,22807,443,22807,443,allow,4518,1665,2853,19,25,11,8
42775,22983,443,22983,443,allow,205941,20753,185188,264,30,129,135
42776,56658,443,31194,443,allow,8007,1987,6020,20,15,11,9
42777,49736,443,25787,443,allow,8028,1787,6241,32,28,17,15
42778,64703,53,13570,53,allow,214,102,112,2,30,1,1
42779,56529,53,10690,53,allow,378,94,284,2,30,1,1
42780,46398,443,65303,443,allow,12982,7168,5814,50,165,23,27
42781,27005,27022,35280,27022,allow,1654,126,1528,4,31,2,2
42782,17750,12550,53024,12550,allow,491,150,341,2,1200,1,1
42783,27005,27018,36101,27018,allow,1634,126,1508,4,31,2,2
42784,27005,27019,51161,27019,allow,1698,126,1572,4,31,2,2
42785,61766,443,43724,443,allow,4326,2217,2109,14,120,7,7
42786,56648,443,37098,443,allow,1327,918,409,10,26,6,4
42787,63853,10659,14752,10659,allow,66,66,0,2,8,2,0
42788,48839,443,60350,443,allow,111590,17663,93927,212,115,93,119
42789,49936,80,9467,80,allow,1130,613,517,11,15,6,5
42790,64096,443,64096,443,allow,5661,2415,3246,26,160,14,12
42791,61286,443,41653,443,allow,248071,7320,240751,269,268,89,180
42792,65361,53,22669,53,allow,249,94,155,2,30,1,1
42793,49615,53,9854,53,allow,276,94,182,2,30,1,1
42794,56655,443,7969,443,allow,1272,876,396,10,26,6,4
42795,49737,443,13001,443,allow,37094,22774,14320,125,27,72,53
42796,64824,53,60323,53,allow,94,94,0,1,30,1,0
42797,27005,27015,55058,27015,allow,1666,126,1540,4,31,2,2
42798,56646,443,10246,443,allow,1327,918,409,10,26,6,4
42799,59291,53,59291,53,allow,197,90,107,2,30,1,1
42800,56660,445,0,0,drop,66,66,0,1,0,1,0
42801,61256,445,0,0,drop,70,70,0,1,0,1,0
42802,61252,445,0,0,drop,70,70,0,1,0,1,0
42803,61248,445,0,0,drop,70,70,0,1,0,1,0
42804,61247,445,0,0,drop,70,70,0,1,0,1,0
42805,55459,50584,0,0,deny,66,66,0,1,0,1,0
42806,56656,445,0,0,drop,66,66,0,1,0,1,0
42807,33563,14037,0,0,deny,78,78,0,1,0,1,0
42808,34247,48817,0,0,deny,145,145,0,1,0,1,0
42809,56336,445,0,0,drop,70,70,0,1,0,1,0
42810,54989,50265,0,0,deny,66,66,0,1,0,1,0
42811,51313,64147,0,0,deny,66,66,0,1,0,1,0
42812,50292,62413,0,0,deny,62,62,0,1,0,1,0
42813,46518,44847,0,0,deny,62,62,0,1,0,1,0
42814,60312,57470,0,0,deny,74,74,0,1,0,1,0
42815,11136,15503,0,0,deny,62,62,0,1,0,1,0
42816,61240,445,0,0,drop,70,70,0,1,0,1,0
42817,61236,445,0,0,drop,70,70,0,1,0,1,0
42818,61237,445,0,0,drop,70,70,0,1,0,1,0
42819,38683,17,0,0,deny,60,60,0,1,0,1,0
42820,56649,445,0,0,drop,66,66,0,1,0,1,0
42821,56331,445,0,0,drop,70,70,0,1,0,1,0
42822,56330,445,0,0,drop,70,70,0,1,0,1,0
42823,56643,445,0,0,drop,66,66,0,1,0,1,0
42824,56648,445,0,0,drop,66,66,0,1,0,1,0
42825,56645,445,0,0,drop,66,66,0,1,0,1,0
42826,34809,57470,0,0,deny,66,66,0,1,0,1,0
42827,56328,445,0,0,drop,70,70,0,1,0,1,0
42828,56640,445,0,0,drop,66,66,0,1,0,1,0
42829,56641,445,0,0,drop,66,66,0,1,0,1,0
42830,56638,445,0,0,drop,66,66,0,1,0,1,0
42831,1026,30188,0,0,deny,62,62,0,1,0,1,0
42832,45964,3111,0,0,deny,60,60,0,1,0,1,0
42833,62625,37965,0,0,deny,66,66,0,1,0,1,0
42834,17579,57470,0,0,deny,62,62,0,1,0,1,0
42835,65388,55783,0,0,deny,66,66,0,1,0,1,0
42836,24041,55783,0,0,deny,62,62,0,1,0,1,0
42837,61235,445,0,0,drop,70,70,0,1,0,1,0
42838,61230,445,0,0,drop,70,70,0,1,0,1,0
42839,61229,445,0,0,drop,70,70,0,1,0,1,0
42840,26921,57470,0,0,deny,62,62,0,1,0,1,0
42841,56635,445,0,0,drop,66,66,0,1,0,1,0
42842,61227,445,0,0,drop,70,70,0,1,0,1,0
42843,56633,445,0,0,drop,66,66,0,1,0,1,0
42844,54118,6004,0,0,deny,66,66,0,1,0,1,0
42845,56321,445,0,0,drop,70,70,0,1,0,1,0
42846,56631,445,0,0,drop,66,66,0,1,0,1,0
42847,56630,445,0,0,drop,66,66,0,1,0,1,0
42848,22399,22,0,0,deny,60,60,0,1,0,1,0
42849,56627,445,0,0,drop,66,66,0,1,0,1,0
42850,56319,445,0,0,drop,70,70,0,1,0,1,0
42851,57174,57470,0,0,deny,66,66,0,1,0,1,0
42852,10028,25604,0,0,deny,62,62,0,1,0,1,0
42853,35461,44847,0,0,deny,146,146,0,1,0,1,0
42854,61336,61689,0,0,deny,66,66,0,1,0,1,0
42855,31021,35440,0,0,deny,146,146,0,1,0,1,0
42856,61195,56205,0,0,deny,66,66,0,1,0,1,0
42857,56318,445,0,0,drop,70,70,0,1,0,1,0
42858,56944,35894,0,0,deny,62,62,0,1,0,1,0
42859,46701,1433,0,0,deny,60,60,0,1,0,1,0
42860,50991,443,38073,443,allow,6448,2376,4072,22,2,10,12
42861,56317,445,0,0,drop,70,70,0,1,0,1,0
42862,58743,35894,0,0,deny,66,66,0,1,0,1,0
42863,48283,42873,0,0,deny,66,66,0,1,0,1,0
42864,56316,445,0,0,drop,70,70,0,1,0,1,0
42865,1024,29892,0,0,deny,145,145,0,1,0,1,0
42866,56312,445,0,0,drop,70,70,0,1,0,1,0
42867,56310,445,0,0,drop,70,70,0,1,0,1,0
42868,61222,445,0,0,drop,70,70,0,1,0,1,0
42869,4257,35440,0,0,deny,62,62,0,1,0,1,0
42870,47037,1,0,0,deny,62,62,0,1,0,1,0
42871,59889,30188,0,0,deny,66,66,0,1,0,1,0
42872,61218,445,0,0,drop,70,70,0,1,0,1,0
42873,61210,445,0,0,drop,70,70,0,1,0,1,0
42874,57987,56125,0,0,deny,90,90,0,1,0,1,0
42875,24949,47224,0,0,deny,145,145,0,1,0,1,0
42876,52410,8604,0,0,deny,66,66,0,1,0,1,0
42877,56298,445,0,0,drop,70,70,0,1,0,1,0
42878,56297,445,0,0,drop,70,70,0,1,0,1,0
42879,56616,445,0,0,drop,66,66,0,1,0,1,0
42880,56291,445,0,0,drop,70,70,0,1,0,1,0
42881,56288,445,0,0,drop,70,70,0,1,0,1,0
42882,56287,445,0,0,drop,70,70,0,1,0,1,0
42883,37420,44847,0,0,deny,66,66,0,1,0,1,0
42884,44849,46478,0,0,deny,74,74,0,1,0,1,0
42885,9529,26467,0,0,deny,62,62,0,1,0,1,0
42886,52705,42873,0,0,deny,66,66,0,1,0,1,0
42887,42465,57470,0,0,deny,60,60,0,1,0,1,0
42888,56609,445,0,0,drop,66,66,0,1,0,1,0
42889,61199,445,0,0,drop,70,70,0,1,0,1,0
42890,49248,35993,0,0,deny,66,66,0,1,0,1,0
42891,64681,35993,0,0,deny,66,66,0,1,0,1,0
42892,56276,445,0,0,drop,70,70,0,1,0,1,0
42893,56606,445,0,0,drop,66,66,0,1,0,1,0
42894,59965,36237,0,0,deny,66,66,0,1,0,1,0
42895,1972,57470,0,0,deny,78,78,0,1,0,1,0
42896,28824,44847,0,0,deny,66,66,0,1,0,1,0
42897,56376,44847,0,0,deny,66,66,0,1,0,1,0
42898,56600,445,0,0,drop,66,66,0,1,0,1,0
42899,48755,23,0,0,deny,60,60,0,1,0,1,0
42900,57665,52700,0,0,deny,66,66,0,1,0,1,0
42901,56595,445,0,0,drop,66,66,0,1,0,1,0
42902,17561,52700,0,0,deny,62,62,0,1,0,1,0
42903,0,0,0,0,allow,124,64,60,2,0,1,1
42904,13285,29892,0,0,deny,145,145,0,1,0,1,0
42905,1024,64147,0,0,deny,62,62,0,1,0,1,0
42906,56272,445,0,0,drop,70,70,0,1,0,1,0
42907,30783,51505,0,0,deny,62,62,0,1,0,1,0
42908,10348,25604,0,0,deny,66,66,0,1,0,1,0
42909,443,20087,0,0,deny,83,83,0,1,0,1,0
42910,51093,57470,0,0,deny,66,66,0,1,0,1,0
42911,54305,26467,0,0,deny,66,66,0,1,0,1,0
42912,45964,7776,0,0,deny,60,60,0,1,0,1,0
42913,56263,445,0,0,drop,70,70,0,1,0,1,0
42914,56260,445,0,0,drop,70,70,0,1,0,1,0
42915,56261,445,0,0,drop,70,70,0,1,0,1,0
42916,56259,445,0,0,drop,70,70,0,1,0,1,0
42917,51818,37965,0,0,deny,66,66,0,1,0,1,0
42918,28364,23,0,0,deny,60,60,0,1,0,1,0
42919,56256,445,0,0,drop,70,70,0,1,0,1,0
42920,61192,445,0,0,drop,70,70,0,1,0,1,0
42921,61189,445,0,0,drop,70,70,0,1,0,1,0
42922,61187,445,0,0,drop,70,70,0,1,0,1,0
42923,56579,445,0,0,drop,66,66,0,1,0,1,0
42924,56580,445,0,0,drop,66,66,0,1,0,1,0
42925,56582,445,0,0,drop,66,66,0,1,0,1,0
42926,56584,445,0,0,drop,66,66,0,1,0,1,0
42927,56583,445,0,0,drop,66,66,0,1,0,1,0
42928,56581,445,0,0,drop,66,66,0,1,0,1,0
42929,56577,445,0,0,drop,66,66,0,1,0,1,0
42930,56576,445,0,0,drop,66,66,0,1,0,1,0
42931,58131,30228,0,0,deny,146,146,0,1,0,1,0
42932,6666,21,0,0,deny,60,60,0,1,0,1,0
42933,40521,23117,0,0,deny,66,66,0,1,0,1,0
42934,51183,56205,0,0,deny,62,62,0,1,0,1,0
42935,27407,36237,0,0,deny,146,146,0,1,0,1,0
42936,57234,21247,0,0,deny,66,66,0,1,0,1,0
42937,1035,26467,0,0,deny,62,62,0,1,0,1,0
42938,49976,5900,0,0,deny,60,60,0,1,0,1,0
42939,56249,445,0,0,drop,70,70,0,1,0,1,0
42940,48841,51221,0,0,deny,62,62,0,1,0,1,0
42941,59008,51221,0,0,deny,66,66,0,1,0,1,0
42942,62540,29892,0,0,deny,145,145,0,1,0,1,0
42943,16944,50584,0,0,deny,62,62,0,1,0,1,0
42944,61181,445,0,0,drop,70,70,0,1,0,1,0
42945,61180,445,0,0,drop,70,70,0,1,0,1,0
42946,61176,445,0,0,drop,70,70,0,1,0,1,0
42947,62438,37807,0,0,deny,62,62,0,1,0,1,0
42948,35849,30188,0,0,deny,62,62,0,1,0,1,0
42949,56563,445,0,0,drop,66,66,0,1,0,1,0
42950,56564,445,0,0,drop,66,66,0,1,0,1,0
42951,56562,445,0,0,drop,66,66,0,1,0,1,0
42952,56242,445,0,0,drop,70,70,0,1,0,1,0
42953,54210,64097,0,0,deny,66,66,0,1,0,1,0
42954,56241,445,0,0,drop,70,70,0,1,0,1,0
42955,61170,445,0,0,drop,70,70,0,1,0,1,0
42956,61167,445,0,0,drop,70,70,0,1,0,1,0
42957,60222,22114,0,0,deny,66,66,0,1,0,1,0
42958,54873,443,62397,443,allow,9238,3472,5766,43,75,24,19
42959,46415,53,46415,53,allow,211,80,131,2,30,1,1
42960,62408,3478,27920,3478,allow,140,140,0,1,30,1,0
42961,63856,6881,6366,6881,allow,66,66,0,2,8,2,0
42962,51434,53,0,0,allow,202,93,109,2,30,1,1
42963,55773,53,49268,53,allow,97,97,0,1,60,1,0
42964,27005,31010,2449,31010,allow,1626,126,1500,4,31,2,2
42965,57329,443,20931,443,allow,7472,2014,5458,29,16,16,13
42966,49651,443,6996,443,allow,920003,731041,188962,2024,929,1212,812
42967,63855,29799,24538,29799,allow,66,66,0,2,8,2,0
42968,51851,48605,8820,48605,allow,136,136,0,3,14,3,0
42969,57332,443,64135,443,allow,2687,1728,959,23,15,12,11
42970,57331,443,8045,443,allow,7468,2225,5243,27,16,15,12
42971,53450,443,18001,443,allow,5931,1750,4181,24,48,14,10
42972,64093,443,64093,443,allow,5663,2416,3247,26,159,14,12
42973,64097,443,64097,443,allow,13511,6811,6700,43,159,23,20
42974,46750,80,46750,80,allow,27124,1455,25669,41,15,20,21
42975,62457,7000,62457,7000,allow,3959,1738,2221,15,15,8,7
42976,57947,443,8723,443,allow,2791,1800,991,26,185,15,11
42977,56666,443,31326,443,allow,1299,730,569,13,25,7,6
42978,41842,443,41842,443,allow,4707,1800,2907,19,28,11,8
42979,56665,443,57309,443,allow,1299,730,569,13,25,7,6
42980,27005,27013,28763,27013,allow,1628,126,1502,4,31,2,2
42981,48655,53,0,0,allow,82,82,0,2,40,2,0
42982,46230,53,46230,53,allow,257,101,156,2,33,1,1
42983,51853,30585,59624,30585,allow,136,136,0,3,14,3,0
42984,33038,443,55545,443,allow,7338,2419,4919,19,35,12,7
42985,37534,443,60202,443,allow,6927,1883,5044,25,46,14,11
42986,59487,53,59487,53,allow,211,80,131,2,30,1,1
42987,60108,443,32347,443,allow,9091,2988,6103,47,19,22,25
42988,44467,53,44467,53,allow,211,80,131,2,30,1,1
42989,37485,161,0,0,allow,6435,2535,3900,22,30,11,11
42990,65408,53,49701,53,allow,817,98,719,2,30,1,1
42991,62408,3478,24308,3478,allow,140,140,0,1,30,1,0
42992,43749,443,15009,443,allow,8900,2090,6810,26,80,14,12
42993,64095,443,64095,443,allow,17046,2620,14426,42,159,19,23
42994,56662,443,60423,443,allow,1233,730,503,12,25,7,5
42995,56663,443,26937,443,allow,1299,730,569,13,25,7,6
42996,64573,443,63298,443,allow,29112,2866,26246,53,31,28,25
42997,80,34539,80,34539,allow,1468,1468,0,1,5,1,0
42998,64092,443,64092,443,allow,5643,2397,3246,26,159,14,12
42999,62408,3478,62290,3478,allow,140,140,0,1,30,1,0
43000,44949,443,55206,443,allow,190,70,120,4,15,2,2
43001,27005,30004,43558,30004,allow,1646,126,1520,4,30,2,2
43002,49300,443,31684,443,allow,4364,2129,2235,12,121,6,6
43003,46505,443,50685,443,allow,7072,1541,5531,27,271,12,15
43004,64538,443,60340,443,allow,4658,1652,3006,10,121,5,5
43005,56543,443,22323,443,allow,1323,616,707,18,120,9,9
43006,27200,34021,0,0,allow,66,66,0,1,90,1,0
43007,50930,443,14420,443,allow,1786,172,1614,7,121,3,4
43008,12060,37965,0,0,deny,66,66,0,1,0,1,0
43009,10436,37965,0,0,deny,62,62,0,1,0,1,0
43010,61165,445,0,0,drop,70,70,0,1,0,1,0
43011,61160,445,0,0,drop,70,70,0,1,0,1,0
43012,61156,445,0,0,drop,70,70,0,1,0,1,0
43013,56236,445,0,0,drop,70,70,0,1,0,1,0
43014,54423,21247,0,0,deny,66,66,0,1,0,1,0
43015,56234,445,0,0,drop,70,70,0,1,0,1,0
43016,53815,44847,0,0,deny,66,66,0,1,0,1,0
43017,20508,57470,0,0,deny,62,62,0,1,0,1,0
43018,18623,1,0,0,deny,66,66,0,1,0,1,0
43019,56230,445,0,0,drop,70,70,0,1,0,1,0
43020,60430,51413,63647,51413,allow,70,70,0,2,8,2,0
43021,37865,123,17478,123,allow,184,94,90,2,30,1,1
43022,53521,443,40751,443,allow,130,70,60,2,14,1,1
43023,55637,27816,50457,27816,allow,316,190,126,5,15,3,2
43024,56647,443,58814,443,allow,1327,918,409,10,25,6,4
43025,56653,443,22218,443,allow,1272,876,396,10,25,6,4
43026,49146,443,26817,443,allow,47589,17003,30586,283,238,128,155
43027,63983,53,48725,53,allow,447,94,353,4,54,2,2
43028,64374,53,21599,53,allow,211,94,117,2,30,1,1
43029,56657,443,53403,443,allow,8059,2039,6020,20,15,11,9
43030,49718,443,50184,443,allow,7644833,215496,7429337,8664,135,2509,6155
43031,56656,443,24919,443,allow,1342,918,424,10,25,6,4
43032,64094,443,64094,443,allow,5647,2402,3245,26,159,14,12
43033,45531,53,30846,53,allow,168,78,90,2,30,1,1
43034,38710,80,33174,80,allow,190,70,120,4,17,2,2
43035,56657,443,37201,443,allow,1342,918,424,10,25,6,4
43036,53934,443,47963,443,allow,360,360,0,7,4,7,0
43037,49440,53,64789,53,allow,415,88,327,4,52,2,2
43038,27005,27016,56293,27016,allow,1640,126,1514,4,31,2,2
43039,56631,80,19501,80,allow,234,234,0,4,12,4,0
43040,51854,13923,55002,13923,allow,136,136,0,3,13,3,0
43041,63563,24096,6074,24096,allow,70,70,0,1,5,1,0
43042,64685,53,19809,53,allow,535,100,435,4,36,2,2
43043,65179,53,9786,53,allow,289,102,187,2,30,1,1
43044,38772,53,26700,53,allow,168,78,90,2,30,1,1
43045,62447,53,48844,53,allow,296,94,202,2,30,1,1
43046,49934,80,37957,80,allow,1130,613,517,11,15,6,5
43047,49652,80,41270,80,allow,1854,945,909,13,106,7,6
43048,35023,53,0,0,allow,82,82,0,2,40,2,0
43049,49933,80,49306,80,allow,1130,613,517,11,15,6,5
43050,56651,443,36673,443,allow,4628,1035,3593,19,25,11,8
43051,50293,443,30749,443,allow,6697,1606,5091,23,36,13,10
43052,56655,443,40290,443,allow,8058,2038,6020,20,15,11,9
43053,58689,123,57350,123,allow,184,94,90,2,30,1,1
43054,60130,80,60130,80,allow,23216,1806,21410,40,28,20,20
43055,57294,53,58964,53,allow,387,134,253,2,30,1,1
43056,64914,53,14005,53,allow,224,94,130,2,30,1,1
43057,37531,443,49565,443,allow,17284,5197,12087,46,48,25,21
43058,64403,53,53109,53,allow,387,134,253,2,30,1,1
43059,58688,53,58261,53,allow,184,78,106,2,30,1,1
43060,57236,443,34862,443,allow,2294,1126,1168,25,120,12,13
43061,51872,48108,5295,48108,allow,70,70,0,2,8,2,0
43062,51852,18636,28064,18636,allow,136,136,0,3,13,3,0
43063,56656,443,38705,443,allow,8006,1986,6020,20,15,11,9
43064,57919,443,32808,443,allow,21293,7315,13978,85,188,37,48
43065,63952,53,35871,53,allow,289,102,187,2,30,1,1
43066,27005,27018,47150,27018,allow,1898,378,1520,6,31,4,2
43067,27005,27015,40771,27015,allow,1618,126,1492,4,31,2,2
43068,49663,443,52474,443,allow,8161,1929,6232,26,46,15,11
43069,45657,443,4313,443,allow,2553,1355,1198,22,77,13,9
43070,59261,80,59261,80,allow,109128,4773,104355,197,15,68,129
43071,49730,443,62541,443,allow,400810,14719,386091,506,39,164,342
43072,60379,443,42355,443,allow,4162,2121,2041,25,95,14,11
43073,37313,443,31778,443,allow,1364815,60410,1304405,1401,901,341,1060
43074,64574,443,40988,443,allow,9151,2109,7042,27,30,15,12
43075,52815,80,10358,80,allow,1152,712,440,10,15,5,5
43076,56654,443,1981,443,allow,8007,1987,6020,20,15,11,9
43077,53279,443,22916,443,allow,36459,6736,29723,54,29,24,30
43078,53648,80,65465,80,allow,2162,1608,554,10,34,6,4
43079,55638,32765,61121,32765,allow,564,318,246,9,15,5,4
43080,57946,443,19612,443,allow,2791,1800,991,26,185,15,11
43081,49935,80,29909,80,allow,1130,613,517,11,15,6,5
43082,56649,443,46574,443,allow,4628,1035,3593,19,25,11,8
43083,45124,80,4219,80,allow,1808,636,1172,16,16,8,8
43084,26923,443,40541,443,allow,7362,1770,5592,31,87,16,15
43085,56652,443,14295,443,allow,1272,876,396,10,25,6,4
43086,27005,27015,32807,27015,allow,1622,126,1496,4,30,2,2
43087,46308,123,1425,123,allow,184,94,90,2,30,1,1
43088,49892,53,17000,53,allow,525,110,415,4,43,2,2
43089,63854,16437,39591,16437,allow,66,66,0,2,7,2,0
43090,53128,29593,52824,29593,allow,70,70,0,1,4,1,0
43091,53640,443,55622,443,allow,3201,1057,2144,13,135,6,7
43092,56650,443,36450,443,allow,4628,1035,3593,19,25,11,8
43093,51870,40490,10666,40490,allow,70,70,0,2,8,2,0
43094,60429,46854,52028,46854,allow,70,70,0,2,8,2,0
43095,54828,443,16065,443,allow,572,572,0,5,11,5,0
43096,60760,20010,11977,20010,allow,70,70,0,1,5,1,0
43097,63838,80,51652,80,allow,314,192,122,6,15,4,2
43098,41857,443,32439,443,allow,1633,1010,623,14,2424,7,7
43099,60422,62456,45228,62456,allow,341,215,126,5,16,3,2
43100,45484,443,14429,443,allow,5766,1575,4191,24,589,13,11
43101,33982,80,37305,80,allow,1152,712,440,10,15,5,5
43102,55639,62954,47207,62954,allow,504,318,186,8,15,5,3
43103,52831,3389,52831,3389,allow,4145,1976,2169,22,18,13,9
43104,51971,80,13099,80,allow,60753,2612,58141,76,46,34,42
43105,64908,53,50995,53,allow,304,94,210,2,30,1,1
43106,49795,53,1877,53,allow,211,102,109,2,30,1,1
43107,52070,443,55434,443,allow,8971,4228,4743,20,95,12,8
43108,49651,80,48758,80,allow,1854,945,909,13,106,7,6
43109,62408,3478,14278,3478,allow,142,142,0,1,30,1,0
43110,50106,53,56744,53,allow,296,94,202,2,30,1,1
43111,45475,161,0,0,allow,41552,20621,20931,212,31,106,106
43112,35989,161,0,0,allow,18741,9242,9499,96,31,48,48
43113,62482,443,44604,443,allow,4427,2362,2065,11,119,6,5
43114,64090,443,49482,443,allow,7360,2435,4925,19,135,9,10
43115,51951,443,35308,443,allow,3854,1151,2703,20,135,10,10
43116,54520,443,49982,443,allow,8152,4874,3278,22,138,11,11
43117,37965,8999,40313,8999,allow,491,150,341,2,1199,1,1
43118,49924,53,63883,53,allow,353,94,259,2,31,1,1
43119,57470,22838,37190,22838,allow,481,150,331,2,1199,1,1
43120,6881,34746,2559,34746,allow,484,150,334,2,1200,1,1
43121,47053,5228,30906,5228,allow,11647,2439,9208,47,3724,21,26
43122,49661,443,46909,443,allow,10553,2117,8436,24,46,12,12
43123,62766,443,26712,443,allow,4911,3442,1469,29,322,16,13
43124,50484,80,53622,80,allow,318,192,126,6,26,4,2
43125,50485,80,52438,80,allow,318,192,126,6,26,4,2
43126,35412,443,65351,443,allow,1251,749,502,11,68,6,5
43127,45152,80,61047,80,allow,2865,2000,865,12,18,7,5
43128,56660,443,12588,443,allow,1579,988,591,13,25,7,6
43129,63928,53,2140,53,allow,376,126,250,2,30,1,1
43130,49318,53,58973,53,allow,718,94,624,2,30,1,1
43131,57171,443,13487,443,allow,13932,3673,10259,26,121,11,15
43132,53894,443,60349,443,allow,6375,1019,5356,21,16,11,10
43133,39108,443,16198,443,allow,330651,13398,317253,404,115,179,225
43134,39094,443,50838,443,allow,828718,43410,785308,1071,347,479,592
43135,50528,80,29242,80,allow,1658,1247,411,8,16,5,3
43136,60763,40010,33856,40010,allow,316,136,180,6,6,3,3
43137,64503,53,37724,53,allow,209,102,107,2,30,1,1
43138,64551,53,2637,53,allow,354,94,260,2,30,1,1
43139,29989,26467,0,0,deny,62,62,0,1,0,1,0
43140,51164,64147,0,0,deny,66,66,0,1,0,1,0
43141,53147,37965,0,0,deny,62,62,0,1,0,1,0
43142,63080,37965,0,0,deny,66,66,0,1,0,1,0
43143,24260,50584,0,0,deny,62,62,0,1,0,1,0
43144,42389,42873,0,0,deny,74,74,0,1,0,1,0
43145,56229,445,0,0,drop,70,70,0,1,0,1,0
43146,59509,64147,0,0,deny,145,145,0,1,0,1,0
43147,48676,53395,0,0,deny,60,60,0,1,0,1,0
43148,63271,52752,0,0,deny,78,78,0,1,0,1,0
43149,31637,17348,0,0,deny,60,60,0,1,0,1,0
43150,61145,445,0,0,drop,70,70,0,1,0,1,0
43151,61147,445,0,0,drop,70,70,0,1,0,1,0
43152,61144,445,0,0,drop,70,70,0,1,0,1,0
43153,50828,123,0,0,deny,234,234,0,1,0,1,0
43154,57878,55108,0,0,deny,148,148,0,1,0,1,0
43155,48676,53392,0,0,deny,60,60,0,1,0,1,0
43156,56222,445,0,0,drop,70,70,0,1,0,1,0
43157,61314,23,0,0,deny,60,60,0,1,0,1,0
43158,17781,50265,0,0,deny,62,62,0,1,0,1,0
43159,56540,445,0,0,drop,66,66,0,1,0,1,0
43160,47348,23,0,0,deny,60,60,0,1,0,1,0
43161,61140,445,0,0,drop,70,70,0,1,0,1,0
43162,61141,445,0,0,drop,70,70,0,1,0,1,0
43163,9353,32761,0,0,deny,110,110,0,1,0,1,0
43164,52569,30188,0,0,deny,66,66,0,1,0,1,0
43165,16430,31573,0,0,deny,62,62,0,1,0,1,0
43166,19204,56448,0,0,deny,78,78,0,1,0,1,0
43167,18754,30188,0,0,deny,66,66,0,1,0,1,0
43168,24882,50647,0,0,deny,60,60,0,1,0,1,0
43169,56209,445,0,0,drop,70,70,0,1,0,1,0
43170,52123,1433,0,0,deny,60,60,0,1,0,1,0
43171,52123,1433,0,0,deny,60,60,0,1,0,1,0
43172,56237,26467,0,0,deny,66,66,0,1,0,1,0
43173,56536,445,0,0,drop,66,66,0,1,0,1,0
43174,57987,56125,0,0,deny,90,90,0,1,0,1,0
43175,56578,64147,0,0,deny,62,62,0,1,0,1,0
43176,53156,35993,0,0,deny,66,66,0,1,0,1,0
43177,23197,44847,0,0,deny,62,62,0,1,0,1,0
43178,56532,445,0,0,drop,66,66,0,1,0,1,0
43179,61127,445,0,0,drop,70,70,0,1,0,1,0
43180,45964,2666,0,0,deny,60,60,0,1,0,1,0
43181,49325,41615,0,0,deny,157,157,0,1,0,1,0
43182,56206,445,0,0,drop,70,70,0,1,0,1,0
43183,61126,445,0,0,drop,70,70,0,1,0,1,0
43184,61124,445,0,0,drop,70,70,0,1,0,1,0
43185,61121,445,0,0,drop,70,70,0,1,0,1,0
43186,56529,445,0,0,drop,66,66,0,1,0,1,0
43187,26183,22114,0,0,deny,62,62,0,1,0,1,0
43188,16948,990,0,0,deny,60,60,0,1,0,1,0
43189,1024,6881,0,0,deny,62,62,0,1,0,1,0
43190,51222,35440,0,0,deny,66,66,0,1,0,1,0
43191,61114,445,0,0,drop,70,70,0,1,0,1,0
43192,56201,445,0,0,drop,70,70,0,1,0,1,0
43193,45673,30188,0,0,deny,146,146,0,1,0,1,0
43194,56200,445,0,0,drop,70,70,0,1,0,1,0
43195,61111,445,0,0,drop,70,70,0,1,0,1,0
43196,61109,445,0,0,drop,70,70,0,1,0,1,0
43197,61108,445,0,0,drop,70,70,0,1,0,1,0
43198,56523,445,0,0,drop,66,66,0,1,0,1,0
43199,2440,37807,0,0,deny,66,66,0,1,0,1,0
43200,56198,445,0,0,drop,70,70,0,1,0,1,0
43201,56516,445,0,0,drop,66,66,0,1,0,1,0
43202,56519,445,0,0,drop,66,66,0,1,0,1,0
43203,56517,445,0,0,drop,66,66,0,1,0,1,0
43204,19698,502,0,0,deny,60,60,0,1,0,1,0
43205,59699,55783,0,0,deny,62,62,0,1,0,1,0
43206,56512,445,0,0,drop,66,66,0,1,0,1,0
43207,56513,445,0,0,drop,66,66,0,1,0,1,0
43208,56511,445,0,0,drop,66,66,0,1,0,1,0
43209,44059,23,0,0,deny,60,60,0,1,0,1,0
43210,56127,35440,0,0,deny,62,62,0,1,0,1,0
43211,19096,64147,0,0,deny,62,62,0,1,0,1,0
43212,49367,51505,0,0,deny,66,66,0,1,0,1,0
43213,51745,57470,0,0,deny,62,62,0,1,0,1,0
43214,61107,445,0,0,drop,70,70,0,1,0,1,0
43215,61104,445,0,0,drop,70,70,0,1,0,1,0
43216,61102,445,0,0,drop,70,70,0,1,0,1,0
43217,40936,5900,0,0,deny,60,60,0,1,0,1,0
43218,56509,445,0,0,drop,66,66,0,1,0,1,0
43219,56191,445,0,0,drop,70,70,0,1,0,1,0
43220,61099,445,0,0,drop,70,70,0,1,0,1,0
43221,56505,445,0,0,drop,66,66,0,1,0,1,0
43222,56189,445,0,0,drop,70,70,0,1,0,1,0
43223,56502,445,0,0,drop,66,66,0,1,0,1,0
43224,56503,445,0,0,drop,66,66,0,1,0,1,0
43225,443,20087,0,0,deny,83,83,0,1,0,1,0
43226,9327,57470,0,0,deny,62,62,0,1,0,1,0
43227,56499,445,0,0,drop,66,66,0,1,0,1,0
43228,56188,445,0,0,drop,70,70,0,1,0,1,0
43229,19004,51505,0,0,deny,66,66,0,1,0,1,0
43230,56187,445,0,0,drop,70,70,0,1,0,1,0
43231,56186,445,0,0,drop,70,70,0,1,0,1,0
43232,50713,57470,0,0,deny,66,66,0,1,0,1,0
43233,56181,445,0,0,drop,70,70,0,1,0,1,0
43234,56183,445,0,0,drop,70,70,0,1,0,1,0
43235,28194,32468,0,0,deny,62,62,0,1,0,1,0
43236,42465,57470,0,0,deny,60,60,0,1,0,1,0
43237,61093,445,0,0,drop,70,70,0,1,0,1,0
43238,15701,37965,0,0,deny,146,146,0,1,0,1,0
43239,60248,30188,0,0,deny,66,66,0,1,0,1,0
43240,50470,61463,0,0,deny,86,86,0,1,0,1,0
43241,61090,445,0,0,drop,70,70,0,1,0,1,0
43242,61085,445,0,0,drop,70,70,0,1,0,1,0
43243,59481,30975,0,0,deny,146,146,0,1,0,1,0
43244,61002,37965,0,0,deny,145,145,0,1,0,1,0
43245,56168,445,0,0,drop,70,70,0,1,0,1,0
43246,56167,445,0,0,drop,70,70,0,1,0,1,0
43247,56164,445,0,0,drop,70,70,0,1,0,1,0
43248,54167,50584,0,0,deny,66,66,0,1,0,1,0
43249,56158,445,0,0,drop,70,70,0,1,0,1,0
43250,56157,445,0,0,drop,70,70,0,1,0,1,0
43251,50066,30188,0,0,deny,66,66,0,1,0,1,0
43252,47814,51505,0,0,deny,62,62,0,1,0,1,0
43253,56489,445,0,0,drop,66,66,0,1,0,1,0
43254,45682,37965,0,0,deny,62,62,0,1,0,1,0
43255,56753,44847,0,0,deny,146,146,0,1,0,1,0
43256,2828,35253,0,0,deny,66,66,0,1,0,1,0
43257,1972,57470,0,0,deny,78,78,0,1,0,1,0
43258,25297,11530,0,0,deny,145,145,0,1,0,1,0
43259,0,0,0,0,deny,164,164,0,2,0,2,0
43260,0,0,0,0,deny,70,70,0,1,0,1,0
43261,56481,445,0,0,drop,66,66,0,1,0,1,0
43262,61072,445,0,0,drop,70,70,0,1,0,1,0
43263,5222,27389,0,0,deny,66,66,0,1,0,1,0
43264,56146,445,0,0,drop,70,70,0,1,0,1,0
43265,38852,37965,0,0,deny,62,62,0,1,0,1,0
43266,56479,445,0,0,drop,66,66,0,1,0,1,0
43267,48557,37965,0,0,deny,62,62,0,1,0,1,0
43268,56472,445,0,0,drop,66,66,0,1,0,1,0
43269,56142,445,0,0,drop,70,70,0,1,0,1,0
43270,57820,32753,0,0,deny,361,361,0,1,0,1,0
43271,56461,445,0,0,drop,66,66,0,1,0,1,0
43272,17010,57470,0,0,deny,62,62,0,1,0,1,0
43273,56133,445,0,0,drop,70,70,0,1,0,1,0
43274,56131,445,0,0,drop,70,70,0,1,0,1,0
43275,56130,445,0,0,drop,70,70,0,1,0,1,0
43276,56129,445,0,0,drop,70,70,0,1,0,1,0
43277,56126,445,0,0,drop,70,70,0,1,0,1,0
43278,30015,36237,0,0,deny,66,66,0,1,0,1,0
43279,61062,445,0,0,drop,70,70,0,1,0,1,0
43280,61060,445,0,0,drop,70,70,0,1,0,1,0
43281,61059,445,0,0,drop,70,70,0,1,0,1,0
43282,56456,445,0,0,drop,66,66,0,1,0,1,0
43283,56450,445,0,0,drop,66,66,0,1,0,1,0
43284,56455,445,0,0,drop,66,66,0,1,0,1,0
43285,56453,445,0,0,drop,66,66,0,1,0,1,0
43286,56454,445,0,0,drop,66,66,0,1,0,1,0
43287,56449,445,0,0,drop,66,66,0,1,0,1,0
43288,56451,445,0,0,drop,66,66,0,1,0,1,0
43289,56448,445,0,0,drop,66,66,0,1,0,1,0
43290,1663,30188,0,0,deny,62,62,0,1,0,1,0
43291,443,20087,0,0,deny,83,83,0,1,0,1,0
43292,23277,53733,0,0,deny,66,66,0,1,0,1,0
43293,50090,50265,0,0,deny,66,66,0,1,0,1,0
43294,49186,53,49186,53,allow,257,101,156,2,32,1,1
43295,53710,80,64568,80,allow,2499,531,1968,11,75,6,5
43296,50504,443,62477,443,allow,6051,1149,4902,16,25,9,7
43297,61335,443,41509,443,allow,42437,8035,34402,79,247,30,49
43298,41973,443,27764,443,allow,26109,3251,22858,60,256,31,29
43299,53711,80,6435,80,allow,2391,532,1859,11,75,6,5
43300,50500,80,1291,80,allow,318,192,126,6,25,4,2
43301,50499,80,43182,80,allow,318,192,126,6,25,4,2
43302,59623,161,0,0,allow,11212,5520,5692,58,30,29,29
43303,49488,443,58643,443,allow,90030,13137,76893,92,47,29,63
43304,53713,80,58765,80,allow,5778,661,5117,17,75,8,9
43305,50479,80,2241,80,allow,312,192,120,6,25,4,2
43306,61304,443,62811,443,allow,8594,1042,7552,16,120,7,9
43307,61496,443,4674,443,allow,27232,3841,23391,42,38,17,25
43308,50125,443,44397,443,allow,9798,3571,6227,43,143,23,20
43309,36520,3142,36520,3142,allow,138,78,60,2,5,1,1
43310,61338,443,62752,443,allow,39067,7713,31354,74,247,29,45
43311,48890,443,48166,443,allow,79665,4371,75294,110,256,45,65
43312,27005,27016,41130,27016,allow,1622,126,1496,4,31,2,2
43313,36601,443,32906,443,allow,16455,11185,5270,37,271,22,15
43314,53712,80,11675,80,allow,2424,529,1895,11,75,6,5
43315,39569,443,39569,443,allow,4601,1694,2907,19,28,11,8
43316,46984,443,45323,443,allow,416,210,206,7,35,4,3
43317,61337,443,54439,443,allow,31111,6287,24824,62,247,25,37
43318,37533,443,8271,443,allow,5516,1774,3742,21,46,13,8
43319,62900,993,6178,993,allow,12900,4980,7920,91,117,51,40
43320,50501,80,58618,80,allow,318,192,126,6,25,4,2
43321,50503,443,63118,443,allow,5987,1085,4902,15,25,8,7
43322,50502,80,37094,80,allow,318,192,126,6,25,4,2
43323,59684,443,44849,443,allow,5173,860,4313,16,15,9,7
43324,50492,80,56917,80,allow,318,192,126,6,25,4,2
43325,65025,443,1842,443,allow,2227,1018,1209,17,16,8,9
43326,38476,161,0,0,allow,3304,1560,1744,18,30,9,9
43327,52042,53,52042,53,allow,81,81,0,1,30,1,0
43328,44032,161,0,0,allow,4491,2143,2348,24,30,12,12
43329,27005,27050,14571,27050,allow,1684,126,1558,4,31,2,2
43330,61339,443,59710,443,allow,31648,6288,25360,62,247,25,37
43331,61336,443,63223,443,allow,34919,6979,27940,68,247,27,41
43332,40811,80,13530,80,allow,31286,2032,29254,50,30,26,24
43333,50491,80,59883,80,allow,318,192,126,6,25,4,2
43334,27005,30003,56044,30003,allow,1640,126,1514,4,30,2,2
43335,57161,53,1657,53,allow,711,87,624,2,30,1,1
43336,51566,443,47460,443,allow,9451,3719,5732,45,76,25,20
43337,52537,443,37723,443,allow,132577,21019,111558,348,236,142,206
43338,8889,16991,8889,16991,allow,124,60,64,2,31,1,1
43339,27005,27019,21783,27019,allow,1648,126,1522,4,31,2,2
43340,55958,53,60321,53,allow,170,87,83,2,31,1,1
43341,56351,53,13734,53,allow,306,99,207,2,31,1,1
43342,49302,443,8225,443,allow,3182,1568,1614,8,120,4,4
43343,65487,443,51445,443,allow,3641,886,2755,13,136,6,7
43344,50701,443,1473,443,allow,45394,5743,39651,133,233,49,84
43345,27005,27022,12480,27022,allow,1882,378,1504,6,31,4,2
43346,50164,443,9375,443,allow,3312,1098,2214,19,137,10,9
43347,5757,80,5757,80,allow,104444,4047,100397,122,126,52,70
43348,53548,443,53548,443,allow,1386,751,635,15,181,8,7
43349,62299,53,62299,53,allow,259,108,151,2,31,1,1
43350,42870,443,3034,443,allow,20248,1033,19215,28,3620,9,19
43351,63927,50265,0,0,deny,62,62,0,1,0,1,0
43352,58574,21247,0,0,deny,66,66,0,1,0,1,0
43353,63445,64631,0,0,deny,66,66,0,1,0,1,0
43354,35460,35440,0,0,deny,146,146,0,1,0,1,0
43355,56119,445,0,0,drop,70,70,0,1,0,1,0
43356,27773,56205,0,0,deny,146,146,0,1,0,1,0
43357,45908,33330,0,0,deny,60,60,0,1,0,1,0
43358,22275,51505,0,0,deny,62,62,0,1,0,1,0
43359,61057,445,0,0,drop,70,70,0,1,0,1,0
43360,61055,445,0,0,drop,70,70,0,1,0,1,0
43361,61051,445,0,0,drop,70,70,0,1,0,1,0
43362,9283,57470,0,0,deny,66,66,0,1,0,1,0
43363,63768,53,12206,53,allow,298,102,196,2,30,1,1
43364,64133,53,32044,53,allow,216,102,114,2,30,1,1
43365,16387,3655,0,0,deny,60,60,0,1,0,1,0
43366,56112,445,0,0,drop,70,70,0,1,0,1,0
43367,16387,22272,0,0,deny,60,60,0,1,0,1,0
43368,16387,20045,0,0,deny,60,60,0,1,0,1,0
43369,56111,445,0,0,drop,70,70,0,1,0,1,0
43370,56436,445,0,0,drop,66,66,0,1,0,1,0
43371,56434,445,0,0,drop,66,66,0,1,0,1,0
43372,56435,445,0,0,drop,66,66,0,1,0,1,0
43373,16387,44427,0,0,deny,60,60,0,1,0,1,0
43374,16387,7205,0,0,deny,60,60,0,1,0,1,0
43375,16387,63752,0,0,deny,60,60,0,1,0,1,0
43376,16387,35583,0,0,deny,60,60,0,1,0,1,0
43377,16387,16862,0,0,deny,60,60,0,1,0,1,0
43378,16387,64075,0,0,deny,60,60,0,1,0,1,0
43379,61041,445,0,0,drop,70,70,0,1,0,1,0
43380,33193,50584,0,0,deny,62,62,0,1,0,1,0
43381,13281,51050,0,0,deny,66,66,0,1,0,1,0
43382,46839,51050,0,0,deny,146,146,0,1,0,1,0
43383,51324,11392,0,0,deny,66,66,0,1,0,1,0
43384,56106,445,0,0,drop,70,70,0,1,0,1,0
43385,54210,36237,0,0,deny,62,62,0,1,0,1,0
43386,61039,445,0,0,drop,70,70,0,1,0,1,0
43387,56104,445,0,0,drop,70,70,0,1,0,1,0
43388,2918,37965,0,0,deny,62,62,0,1,0,1,0
43389,61033,445,0,0,drop,70,70,0,1,0,1,0
43390,61031,445,0,0,drop,70,70,0,1,0,1,0
43391,61029,445,0,0,drop,70,70,0,1,0,1,0
43392,56256,62413,0,0,deny,66,66,0,1,0,1,0
43393,35120,26467,0,0,deny,62,62,0,1,0,1,0
43394,63447,44847,0,0,deny,66,66,0,1,0,1,0
43395,13462,35440,0,0,deny,66,66,0,1,0,1,0
43396,443,20087,0,0,deny,83,83,0,1,0,1,0
43397,56653,22114,0,0,deny,66,66,0,1,0,1,0
43398,56100,445,0,0,drop,70,70,0,1,0,1,0
43399,52430,35440,0,0,deny,62,62,0,1,0,1,0
43400,27785,37965,0,0,deny,66,66,0,1,0,1,0
43401,56099,445,0,0,drop,70,70,0,1,0,1,0
43402,39056,22114,0,0,deny,62,62,0,1,0,1,0
43403,61020,445,0,0,drop,70,70,0,1,0,1,0
43404,61017,445,0,0,drop,70,70,0,1,0,1,0
43405,61016,445,0,0,drop,70,70,0,1,0,1,0
43406,56094,445,0,0,drop,70,70,0,1,0,1,0
43407,50496,80,19242,80,allow,318,192,126,6,25,4,2
43408,50480,80,36021,80,allow,318,192,126,6,25,4,2
43409,55496,80,55496,80,allow,1099,578,521,10,15,6,4
43410,58556,80,23584,80,allow,884,529,355,10,255,6,4
43411,53709,443,33210,443,allow,7356,1014,6342,20,75,10,10
43412,49710,53,28433,53,allow,480,93,387,4,50,2,2
43413,60796,53,56563,53,allow,296,94,202,2,29,1,1
43414,56659,443,25934,443,allow,1579,988,591,13,24,7,6
43415,56653,443,38474,443,allow,8059,2039,6020,20,15,11,9
43416,50497,80,3021,80,allow,19946,10573,9373,29,25,14,15
43417,40919,443,40161,443,allow,12243,6818,5425,30,314,16,14
43418,62778,443,47503,443,allow,6676,2316,4360,34,318,16,18
43419,39107,443,62182,443,allow,692830,23263,669567,784,114,306,478
43420,57429,443,7406,443,allow,15017,8283,6734,47,18,24,23
43421,27005,27016,13972,27016,allow,1656,126,1530,4,30,2,2
43422,63938,53,63032,53,allow,385,110,275,2,30,1,1
43423,49172,53,32719,53,allow,227,102,125,2,29,1,1
43424,65352,53,63363,53,allow,321,102,219,2,29,1,1
43425,52042,53,52042,53,allow,478,292,186,5,30,3,2
43426,55640,54435,42654,54435,allow,70,70,0,1,5,1,0
43427,50482,80,36252,80,allow,314,192,122,6,25,4,2
43428,41911,443,53613,443,allow,9499,3786,5713,31,315,16,15
43429,42767,443,1762,443,allow,8995,2498,6497,40,256,19,21
43430,62139,53,5028,53,allow,298,102,196,2,30,1,1
43431,64845,53,4147,53,allow,289,110,179,2,30,1,1
43432,55234,443,6100,443,allow,9176,2226,6950,28,31,16,12
43433,56336,53,52213,53,allow,196,102,94,2,35,1,1
43434,64514,53,39075,53,allow,437,88,349,4,41,2,2
43435,50498,80,12035,80,allow,312,192,120,6,25,4,2
43436,50490,80,51282,80,allow,318,192,126,6,25,4,2
43437,56630,443,17918,443,allow,6156,918,5238,18,26,10,8
43438,57232,443,17235,443,allow,51152,3321,47831,81,100,38,43
43439,27176,53,64798,53,allow,396,257,139,3,30,2,1
43440,36008,443,16915,443,allow,5378,1423,3955,19,56,11,8
43441,58851,443,28195,443,allow,344,130,214,6,77,3,3
43442,21544,41599,31043,41599,allow,70,70,0,1,5,1,0
43443,56651,443,21328,443,allow,8058,2038,6020,20,15,11,9
43444,47640,443,10100,443,allow,1058,571,487,10,38,6,4
43445,56724,53,0,0,allow,86,86,0,1,30,1,0
43446,65207,53,42618,53,allow,277,110,167,2,30,1,1
43447,57092,53,43166,53,allow,270,102,168,2,30,1,1
43448,5588,5588,0,0,allow,3562,1936,1626,48,195,24,24
43449,50489,80,24870,80,allow,318,192,126,6,25,4,2
43450,57942,443,1661,443,allow,2791,1800,991,26,185,15,11
43451,62894,993,44411,993,allow,8840,4151,4689,80,190,41,39
43452,50505,80,62173,80,allow,318,192,126,6,25,4,2
43453,57386,443,57835,443,allow,1056,569,487,10,38,6,4
43454,47638,443,5364,443,allow,1056,569,487,10,38,6,4
43455,49932,443,32840,443,allow,8428,1889,6539,25,16,13,12
43456,46531,123,21322,123,allow,184,94,90,2,30,1,1
43457,60379,443,13895,443,allow,9593,3182,6411,19,23,8,11
43458,6881,6881,5588,6881,allow,324,150,174,2,1203,1,1
43459,62765,443,43288,443,allow,52223,3318,48905,75,321,30,45
43460,65428,53,65157,53,allow,516,86,430,4,32,2,2
43461,50493,80,1565,80,allow,318,192,126,6,25,4,2
43462,62899,993,51481,993,allow,9385,3246,6139,53,118,31,22
43463,5588,5588,0,0,allow,3562,1936,1626,48,194,24,24
43464,39101,443,49967,443,allow,201217,15748,185469,327,207,163,164
43465,49159,53,48232,53,allow,213,102,111,2,29,1,1
43466,52523,443,12913,443,allow,4307,2005,2302,37,18,20,17
43467,58039,161,0,0,allow,11672,5710,5962,60,29,30,30
43468,27005,27015,18996,27015,allow,1618,126,1492,4,30,2,2
43469,53664,13701,26986,13701,allow,70,70,0,1,4,1,0
43470,56395,443,25199,443,allow,7018,2751,4267,24,39,11,13
43471,57470,32348,51610,32348,allow,527,166,361,2,1199,1,1
43472,50481,80,4638,80,allow,318,192,126,6,25,4,2
43473,55270,443,14179,443,allow,6098,778,5320,17,15,8,9
43474,37855,443,39398,443,allow,25928,15100,10828,59,39,37,22
43475,35098,161,0,0,allow,15190,7454,7736,78,30,39,39
43476,56652,443,7084,443,allow,8006,1986,6020,20,15,11,9
43477,57372,53,20962,53,allow,177,94,83,2,30,1,1
43478,65481,443,11803,443,allow,138507,5990,132517,156,16,60,96
43479,33882,80,63489,80,allow,1454,866,588,11,58,7,4
43480,35716,53,38842,53,allow,168,78,90,2,30,1,1
43481,55153,443,47094,443,allow,5897,1982,3915,20,18,11,9
43482,49771,53,64611,53,allow,272,110,162,2,30,1,1
43483,56341,53,28637,53,allow,213,102,111,2,29,1,1
43484,51667,25826,12114,25826,allow,9434,9434,0,11,30,11,0
43485,64791,53,19786,53,allow,526,197,329,6,49,3,3
43486,55917,53,58501,53,allow,371,109,262,4,59,2,2
43487,64209,53,40539,53,allow,291,94,197,2,29,1,1
43488,57370,53,22264,53,allow,347,110,237,2,30,1,1
43489,34891,53,37025,53,allow,396,257,139,3,30,2,1
43490,54052,443,54052,443,allow,1386,751,635,15,181,8,7
43491,57470,53756,4202,53756,allow,132,132,0,3,1199,3,0
43492,48817,51413,48817,51413,allow,460,150,310,2,1200,1,1
43493,55877,38597,28809,38597,allow,481,150,331,2,1200,1,1
43494,53130,443,53130,443,allow,3121,1764,1357,19,181,10,9
43495,54053,443,54053,443,allow,1468,763,705,16,181,8,8
43496,53591,443,53591,443,allow,1468,763,705,16,181,8,8
43497,57470,23848,47855,23848,allow,545,166,379,2,1199,1,1
43498,51868,30305,49639,30305,allow,70,70,0,2,8,2,0
43499,63981,53,39748,53,allow,329,86,243,4,42,2,2
43500,54842,443,49660,443,allow,5860,1151,4709,18,283,10,8
43501,57384,443,57610,443,allow,1054,567,487,10,38,6,4
43502,62888,993,63963,993,allow,8786,4118,4668,80,200,41,39
43503,14914,443,14914,443,allow,16960,1347,15613,28,17,10,18
43504,57372,53,54871,53,allow,177,94,83,2,30,1,1
43505,36765,443,20693,443,allow,27557,20627,6930,89,5581,44,45
43506,37621,80,10654,80,allow,350,210,140,6,15,4,2
43507,59863,443,54710,443,allow,12809,7765,5044,95,84,55,40
43508,57729,443,45932,443,allow,12689,5742,6947,26,43,14,12
43509,54966,53,44405,53,allow,171,88,83,3,33,2,1
43510,51869,25355,58736,25355,allow,70,70,0,2,8,2,0
43511,10035,443,49026,443,allow,7915,1634,6281,25,315,11,14
43512,64268,53,45536,53,allow,334,103,231,4,54,2,2
43513,50018,53,44491,53,allow,270,102,168,2,30,1,1
43514,8282,39458,7982,39458,allow,78,78,0,1,30,1,0
43515,56233,53,2635,53,allow,399,97,302,4,59,2,2
43516,65073,53,40365,53,allow,293,102,191,2,30,1,1
43517,55958,53,40832,53,allow,177,94,83,2,30,1,1
43518,58869,443,38937,443,allow,4657,2146,2511,14,135,7,7
43519,44847,17977,12872,17977,allow,502,150,352,2,1200,1,1
43520,50506,80,64243,80,allow,318,192,126,6,25,4,2
43521,50488,80,56611,80,allow,318,192,126,6,25,4,2
43522,50495,80,9941,80,allow,312,192,120,6,25,4,2
43523,50483,80,35746,80,allow,374,192,182,7,25,4,3
43524,51641,443,64110,443,allow,4692,2882,1810,32,80,14,18
43525,56198,443,56198,443,allow,27729,5508,22221,60,18,31,29
43526,51867,48059,33998,48059,allow,258,70,188,4,8,2,2
43527,39616,443,20055,443,allow,60,60,0,2,5,2,0
43528,49761,53,36428,53,allow,373,99,274,4,41,2,2
43529,50477,80,59736,80,allow,648,256,392,8,25,5,3
43530,56654,443,53376,443,allow,4972,2136,2836,21,24,12,9
43531,65482,443,24363,443,allow,92212,4799,87413,107,16,43,64
43532,55004,53,63304,53,allow,270,102,168,2,30,1,1
43533,44169,443,53615,443,allow,12098,5328,6770,25,121,12,13
43534,35212,443,26645,443,allow,4477,2350,2127,16,135,8,8
43535,5819,53,5819,53,allow,197,90,107,2,30,1,1
43536,27005,27016,54268,27016,allow,1642,126,1516,4,31,2,2
43537,25504,53,50116,53,allow,311,86,225,2,30,1,1
43538,49818,53,37745,53,allow,86,86,0,1,30,1,0
43539,49301,443,34200,443,allow,7616,3064,4552,14,120,6,8
43540,36762,443,56086,443,allow,13119,3359,9760,39,120,19,20
43541,64537,443,9854,443,allow,3182,1568,1614,8,120,4,4
43542,6882,6999,21724,6999,allow,228,118,110,2,1200,1,1
43543,30188,41184,4045,41184,allow,509,150,359,2,1200,1,1
43544,56888,443,32016,443,allow,15807,12220,3587,44,242,18,26
43545,52038,80,51825,80,allow,70,70,0,1,5,1,0
43546,51846,41510,42814,41510,allow,70,70,0,1,5,1,0
43547,64753,53,63867,53,allow,94,94,0,1,30,1,0
43548,49622,53,58073,53,allow,244,94,150,2,30,1,1
43549,50098,443,16798,443,allow,12942,3659,9283,66,217,36,30
43550,62887,993,3389,993,allow,8921,4675,4246,77,200,47,30
43551,51866,23431,38401,23431,allow,70,70,0,2,8,2,0
43552,51467,443,51893,443,allow,194,70,124,3,11,1,2
43553,49406,443,41618,443,allow,7808,2879,4929,36,186,19,17
43554,64191,53,1179,53,allow,212,102,110,2,30,1,1
43555,64164,53,32232,53,allow,229,102,127,2,30,1,1
43556,55498,53,0,0,allow,86,86,0,1,30,1,0
43557,443,20087,0,0,deny,83,83,0,1,0,1,0
43558,10916,44847,0,0,deny,62,62,0,1,0,1,0
43559,49717,57470,0,0,deny,62,62,0,1,0,1,0
43560,52575,22114,0,0,deny,62,62,0,1,0,1,0
43561,47256,37807,0,0,deny,146,146,0,1,0,1,0
43562,52720,35894,0,0,deny,62,62,0,1,0,1,0
43563,15341,23,0,0,deny,60,60,0,1,0,1,0
43564,29000,48817,0,0,deny,148,148,0,1,0,1,0
43565,28897,35440,0,0,deny,66,66,0,1,0,1,0
43566,50637,44847,0,0,deny,66,66,0,1,0,1,0
43567,56410,445,0,0,drop,66,66,0,1,0,1,0
43568,56835,35894,0,0,deny,66,66,0,1,0,1,0
43569,61013,445,0,0,drop,70,70,0,1,0,1,0
43570,61012,445,0,0,drop,70,70,0,1,0,1,0
43571,14059,21247,0,0,deny,62,62,0,1,0,1,0
43572,43540,1433,0,0,deny,60,60,0,1,0,1,0
43573,40474,23117,0,0,deny,62,62,0,1,0,1,0
43574,50716,50584,0,0,deny,74,74,0,1,0,1,0
43575,736,23,0,0,deny,60,60,0,1,0,1,0
43576,7273,64147,0,0,deny,66,66,0,1,0,1,0
43577,56081,445,0,0,drop,70,70,0,1,0,1,0
43578,60646,11392,0,0,deny,66,66,0,1,0,1,0
43579,58131,42416,0,0,deny,146,146,0,1,0,1,0
43580,59739,35253,0,0,deny,62,62,0,1,0,1,0
43581,60126,35440,0,0,deny,66,66,0,1,0,1,0
43582,56406,445,0,0,drop,66,66,0,1,0,1,0
43583,45964,3111,0,0,deny,60,60,0,1,0,1,0
43584,56078,445,0,0,drop,70,70,0,1,0,1,0
43585,27783,57470,0,0,deny,62,62,0,1,0,1,0
43586,56404,445,0,0,drop,66,66,0,1,0,1,0
43587,60999,445,0,0,drop,70,70,0,1,0,1,0
43588,60997,445,0,0,drop,70,70,0,1,0,1,0
43589,60994,445,0,0,drop,70,70,0,1,0,1,0
43590,60993,445,0,0,drop,70,70,0,1,0,1,0
43591,64903,51050,0,0,deny,66,66,0,1,0,1,0
43592,23770,50584,0,0,deny,66,66,0,1,0,1,0
43593,56400,445,0,0,drop,66,66,0,1,0,1,0
43594,58382,50584,0,0,deny,146,146,0,1,0,1,0
43595,59564,57470,0,0,deny,66,66,0,1,0,1,0
43596,35163,30188,0,0,deny,62,62,0,1,0,1,0
43597,443,20087,0,0,deny,83,83,0,1,0,1,0
43598,56073,445,0,0,drop,70,70,0,1,0,1,0
43599,59937,37965,0,0,deny,66,66,0,1,0,1,0
43600,20400,64147,0,0,deny,62,62,0,1,0,1,0
43601,1334,8497,0,0,deny,148,148,0,1,0,1,0
43602,56072,445,0,0,drop,70,70,0,1,0,1,0
43603,60987,445,0,0,drop,70,70,0,1,0,1,0
43604,56070,445,0,0,drop,70,70,0,1,0,1,0
43605,60984,445,0,0,drop,70,70,0,1,0,1,0
43606,60982,445,0,0,drop,70,70,0,1,0,1,0
43607,60980,445,0,0,drop,70,70,0,1,0,1,0
43608,53090,59356,0,0,deny,66,66,0,1,0,1,0
43609,41220,59356,0,0,deny,62,62,0,1,0,1,0
43610,10775,35440,0,0,deny,66,66,0,1,0,1,0
43611,56395,445,0,0,drop,66,66,0,1,0,1,0
43612,56392,445,0,0,drop,66,66,0,1,0,1,0
43613,6666,50070,0,0,deny,60,60,0,1,0,1,0
43614,56391,445,0,0,drop,66,66,0,1,0,1,0
43615,56386,445,0,0,drop,66,66,0,1,0,1,0
43616,40185,64147,0,0,deny,66,66,0,1,0,1,0
43617,44496,57470,0,0,deny,66,66,0,1,0,1,0
43618,56384,445,0,0,drop,66,66,0,1,0,1,0
43619,56385,445,0,0,drop,66,66,0,1,0,1,0
43620,56383,445,0,0,drop,66,66,0,1,0,1,0
43621,3996,57470,0,0,deny,62,62,0,1,0,1,0
43622,65526,28793,0,0,deny,66,66,0,1,0,1,0
43623,61902,22114,0,0,deny,66,66,0,1,0,1,0
43624,17534,50584,0,0,deny,146,146,0,1,0,1,0
43625,56063,445,0,0,drop,70,70,0,1,0,1,0
43626,60978,445,0,0,drop,70,70,0,1,0,1,0
43627,60977,445,0,0,drop,70,70,0,1,0,1,0
43628,50052,65008,0,0,deny,60,60,0,1,0,1,0
43629,60972,445,0,0,drop,70,70,0,1,0,1,0
43630,56381,445,0,0,drop,66,66,0,1,0,1,0
43631,56061,445,0,0,drop,70,70,0,1,0,1,0
43632,60971,445,0,0,drop,70,70,0,1,0,1,0
43633,56377,445,0,0,drop,66,66,0,1,0,1,0
43634,58131,1,0,0,deny,146,146,0,1,0,1,0
43635,56060,445,0,0,drop,70,70,0,1,0,1,0
43636,56375,445,0,0,drop,66,66,0,1,0,1,0
43637,56373,445,0,0,drop,66,66,0,1,0,1,0
43638,56059,445,0,0,drop,70,70,0,1,0,1,0
43639,56058,445,0,0,drop,70,70,0,1,0,1,0
43640,56371,445,0,0,drop,66,66,0,1,0,1,0
43641,56053,445,0,0,drop,70,70,0,1,0,1,0
43642,56052,445,0,0,drop,70,70,0,1,0,1,0
43643,55678,5618,0,0,reset-both,145,145,0,1,0,1,0
43644,48258,37965,0,0,deny,62,62,0,1,0,1,0
43645,43584,24748,0,0,deny,156,156,0,1,0,1,0
43646,43584,24748,0,0,deny,156,156,0,1,0,1,0
43647,0,0,0,0,allow,480,244,236,4,0,2,2
43648,1972,57470,0,0,deny,78,78,0,1,0,1,0
43649,60965,445,0,0,drop,70,70,0,1,0,1,0
43650,57612,28793,0,0,deny,66,66,0,1,0,1,0
43651,63621,30188,0,0,deny,62,62,0,1,0,1,0
43652,56040,445,0,0,drop,70,70,0,1,0,1,0
43653,56039,445,0,0,drop,70,70,0,1,0,1,0
43654,59435,37807,0,0,deny,66,66,0,1,0,1,0
43655,51032,30188,0,0,deny,62,62,0,1,0,1,0
43656,56035,445,0,0,drop,70,70,0,1,0,1,0
43657,60959,445,0,0,drop,70,70,0,1,0,1,0
43658,60957,445,0,0,drop,70,70,0,1,0,1,0
43659,45099,57470,0,0,deny,62,62,0,1,0,1,0
43660,56030,445,0,0,drop,70,70,0,1,0,1,0
43661,56029,445,0,0,drop,70,70,0,1,0,1,0
43662,63867,64147,0,0,deny,62,62,0,1,0,1,0
43663,24236,8055,0,0,deny,148,148,0,1,0,1,0
43664,56360,445,0,0,drop,66,66,0,1,0,1,0
43665,5285,64147,0,0,deny,145,145,0,1,0,1,0
43666,15641,26467,0,0,deny,62,62,0,1,0,1,0
43667,50901,26467,0,0,deny,66,66,0,1,0,1,0
43668,55311,44847,0,0,deny,62,62,0,1,0,1,0
43669,22835,51221,0,0,deny,62,62,0,1,0,1,0
43670,58398,44847,0,0,deny,62,62,0,1,0,1,0
43671,54028,37965,0,0,deny,66,66,0,1,0,1,0
43672,56018,445,0,0,drop,70,70,0,1,0,1,0
43673,56353,445,0,0,drop,66,66,0,1,0,1,0
43674,60943,445,0,0,drop,70,70,0,1,0,1,0
43675,1040,37965,0,0,deny,62,62,0,1,0,1,0
43676,20608,28189,0,0,deny,60,60,0,1,0,1,0
43677,36034,35440,0,0,deny,62,62,0,1,0,1,0
43678,19875,30170,0,0,deny,145,145,0,1,0,1,0
43679,56752,44847,0,0,deny,66,66,0,1,0,1,0
43680,56350,445,0,0,drop,66,66,0,1,0,1,0
43681,58381,57470,0,0,deny,66,66,0,1,0,1,0
43682,60398,46776,0,0,deny,74,74,0,1,0,1,0
43683,32968,43890,0,0,deny,146,146,0,1,0,1,0
43684,33354,10387,0,0,deny,148,148,0,1,0,1,0
43685,56014,445,0,0,drop,70,70,0,1,0,1,0
43686,56343,445,0,0,drop,66,66,0,1,0,1,0
43687,53625,64147,0,0,deny,66,66,0,1,0,1,0
43688,56341,445,0,0,drop,66,66,0,1,0,1,0
43689,65289,46776,0,0,deny,66,66,0,1,0,1,0
43690,58369,443,14100,443,allow,155345,11568,143777,195,195,73,122
43691,59112,443,3834,443,allow,7174,1831,5343,31,110,17,14
43692,59117,443,59117,443,allow,4659,1752,2907,19,30,11,8
43693,49653,443,56043,443,allow,8915,2193,6722,22,46,13,9
43694,58999,53,58999,53,allow,825,99,726,2,30,1,1
43695,8978,53,8978,53,allow,1415,689,726,3,30,2,1
43696,59733,443,53510,443,allow,7165,2077,5088,22,105,12,10
43697,55158,443,7666,443,allow,7963,2657,5306,29,333,13,16
43698,52814,53,53198,53,allow,578,286,292,9,15,5,4
43699,37390,80,51104,80,allow,234,234,0,4,12,4,0
43700,53376,443,49944,443,allow,4814,1207,3607,17,75,10,7
43701,27005,27015,26613,27015,allow,1664,126,1538,4,30,2,2
43702,63015,53,58315,53,allow,303,85,218,2,31,1,1
43703,63016,443,62521,443,allow,303,85,218,2,31,1,1
43704,63024,53,42862,53,allow,569,164,405,2,30,1,1
43705,27005,27020,51720,27020,allow,1626,126,1500,4,30,2,2
43706,27005,27011,25017,27011,allow,1622,126,1496,4,31,2,2
43707,27005,27024,9068,27024,allow,1760,252,1508,5,31,3,2
43708,51631,443,52849,443,allow,36602,1919,34683,58,80,19,39
43709,27005,27020,2257,27020,allow,1622,126,1496,4,31,2,2
43710,43435,5228,26335,5228,allow,6668,1369,5299,20,3600,10,10
43711,63023,443,14505,443,allow,382,164,218,2,30,1,1
43712,38815,53,38815,53,allow,230,99,131,2,30,1,1
43713,37132,443,37132,443,allow,4381,1474,2907,19,27,11,8
43714,37836,443,46026,443,allow,4647,1536,3111,25,40,12,13
43715,48238,443,41856,443,allow,2227,1018,1209,17,15,8,9
43716,56627,443,41594,443,allow,4499,947,3552,14,25,8,6
43717,63835,30794,25747,30794,allow,66,66,0,1,5,1,0
43718,63849,16632,35962,16632,allow,66,66,0,2,8,2,0
43719,60421,6882,25350,6882,allow,70,70,0,1,5,1,0
43720,59259,80,59259,80,allow,101244,15308,85936,165,15,53,112
43721,50324,443,9934,443,allow,8725,2284,6441,17,120,8,9
43722,26050,22448,0,0,allow,62,62,0,1,60,1,0
43723,53377,443,17654,443,allow,4814,1207,3607,17,75,10,7
43724,49450,443,58155,443,allow,8411,2042,6369,25,251,13,12
43725,57932,443,47126,443,allow,29612,2205,27407,53,186,21,32
43726,64080,443,11837,443,allow,75064,64938,10126,147,277,71,76
43727,27005,27015,57738,27015,allow,1638,126,1512,4,30,2,2
43728,50119,443,44388,443,allow,10557,2063,8494,40,144,22,18
43729,38436,5222,53562,5222,allow,7338,3611,3727,74,616,37,37
43730,59128,443,26405,443,allow,92207,5395,86812,130,88,58,72
43731,27005,27018,56521,27018,allow,1672,126,1546,4,30,2,2
43732,57470,47191,13630,47191,allow,528,528,0,9,1200,9,0
43733,27005,27019,64712,27019,allow,1624,126,1498,4,31,2,2
43734,27005,27017,53801,27017,allow,1634,126,1508,4,31,2,2
43735,47595,33437,0,0,allow,106,106,0,1,61,1,0
43736,51221,51413,6783,51413,allow,459,149,310,2,1201,1,1
43737,65160,443,49536,443,allow,1786,172,1614,7,120,3,4
43738,56005,445,0,0,drop,70,70,0,1,0,1,0
43739,56003,445,0,0,drop,70,70,0,1,0,1,0
43740,54520,1433,0,0,deny,60,60,0,1,0,1,0
43741,56001,445,0,0,drop,70,70,0,1,0,1,0
43742,56000,445,0,0,drop,70,70,0,1,0,1,0
43743,61085,37965,0,0,deny,62,62,0,1,0,1,0
43744,55997,445,0,0,drop,70,70,0,1,0,1,0
43745,64997,51221,0,0,deny,66,66,0,1,0,1,0
43746,33801,62413,0,0,deny,66,66,0,1,0,1,0
43747,26180,35440,0,0,deny,66,66,0,1,0,1,0
43748,59352,37965,0,0,deny,66,66,0,1,0,1,0
43749,34306,37965,0,0,deny,62,62,0,1,0,1,0
43750,50481,443,29111,443,allow,16160,13969,2191,42,80,23,19
43751,41981,443,19357,443,allow,5164,2984,2180,42,1285,26,16
43752,64363,53,54171,53,allow,212,102,110,2,30,1,1
43753,50127,80,7047,80,allow,164773,6196,158577,200,135,83,117
43754,63785,55255,57684,55255,allow,3706,2125,1581,18,33,10,8
43755,43223,443,31934,443,allow,836939,25380,811559,864,64,302,562
43756,56838,35124,44520,35124,allow,70,70,0,1,5,1,0
43757,43487,443,46134,443,allow,10015,3476,6539,30,28,19,11
43758,60433,123,65242,123,allow,184,94,90,2,29,1,1
43759,55624,53,62232,53,allow,244,94,150,2,29,1,1
43760,62895,993,31409,993,allow,10457,4879,5578,98,186,50,48
43761,62893,993,15179,993,allow,8883,4621,4262,76,191,47,29
43762,56837,53,27740,53,allow,195,102,93,2,32,1,1
43763,26783,443,21530,443,allow,22489,15918,6571,39,26,21,18
43764,60287,80,62692,80,allow,1052,612,440,10,15,5,5
43765,62889,993,15893,993,allow,9608,4549,5059,88,199,45,43
43766,56650,443,37147,443,allow,8008,1988,6020,20,15,11,9
43767,63848,48560,48756,48560,allow,66,66,0,2,7,2,0
43768,63850,6881,54520,6881,allow,66,66,0,2,7,2,0
43769,62892,993,17111,993,allow,9588,4811,4777,85,193,49,36
43770,49931,443,45441,443,allow,3278,1835,1443,22,16,13,9
43771,55193,53,55120,53,allow,200,102,98,2,33,1,1
43772,56837,53,4890,53,allow,195,102,93,2,29,1,1
43773,65106,53,17651,53,allow,354,94,260,2,29,1,1
43774,57831,443,53060,443,allow,1320606,47731,1272875,1454,294,552,902
43775,39978,443,51684,443,allow,6834,2189,4645,40,29,26,14
43776,56649,443,38913,443,allow,8060,2040,6020,20,15,11,9
43777,58679,53,27207,53,allow,298,102,196,2,29,1,1
43778,55958,53,62913,53,allow,177,94,83,2,29,1,1
43779,56346,53,56346,53,allow,262,106,156,2,32,1,1
43780,54703,53,49581,53,allow,168,78,90,2,30,1,1
43781,38771,443,39867,443,allow,7407,3501,3906,18,15,10,8
43782,63021,443,34609,443,allow,512,166,346,2,30,1,1
43783,63830,15847,65256,15847,allow,1592,1044,548,15,15,9,6
43784,56648,443,26064,443,allow,8007,1987,6020,20,15,11,9
43785,38871,80,51643,80,allow,2057,1263,794,10,15,6,4
43786,50120,443,33702,443,allow,23870,3485,20385,55,143,29,26
43787,56839,49949,49715,49949,allow,70,70,0,1,5,1,0
43788,59258,80,59258,80,allow,107904,4143,103761,179,15,59,120
43789,56658,443,12805,443,allow,1560,988,572,13,23,7,6
43790,42522,443,26969,443,allow,7352,1592,5760,25,16,15,10
43791,49408,443,47633,443,allow,4728,2928,1800,28,95,15,13
43792,64047,53,55544,53,allow,604,89,515,4,45,2,2
43793,58481,53,42506,53,allow,290,110,180,2,30,1,1
43794,35722,123,29832,123,allow,94,94,0,1,30,1,0
43795,63027,443,10834,443,allow,384,166,218,2,30,1,1
43796,64338,53,41701,53,allow,200,102,98,2,30,1,1
43797,65188,53,34848,53,allow,213,102,111,2,30,1,1
43798,39615,443,17497,443,allow,130,70,60,3,5,2,1
43799,49166,443,10443,443,allow,70,70,0,1,5,1,0
43800,44034,80,44034,80,allow,18510,706,17804,22,16,6,16
43801,49250,53,62470,53,allow,298,87,211,4,48,2,2
43802,35321,443,13287,443,allow,9675,2671,7004,36,262,18,18
43803,58558,53,58236,53,allow,268,86,182,2,30,1,1
43804,51497,443,14907,443,allow,8939,3462,5477,25,263,12,13
43805,56630,80,55230,80,allow,234,234,0,4,12,4,0
43806,46460,443,35545,443,allow,5117,3501,1616,29,80,15,14
43807,65282,53,57609,53,allow,522,91,431,4,49,2,2
43808,37900,53,2466,53,allow,78,78,0,1,30,1,0
43809,55958,53,14434,53,allow,177,94,83,2,30,1,1
43810,55995,443,59419,443,allow,7563,2253,5310,20,157,11,9
43811,53819,443,53819,443,allow,1386,751,635,15,180,8,7
43812,63020,443,53282,443,allow,512,166,346,2,30,1,1
43813,57476,443,16400,443,allow,10068,3304,6764,28,36,17,11
43814,52069,443,58319,443,allow,8593,2221,6372,31,232,17,14
43815,34083,443,2580,443,allow,7510,2040,5470,24,210,13,11
43816,50222,443,19718,443,allow,9582,2201,7381,28,99,14,14
43817,62886,993,19324,993,allow,9557,4773,4784,84,199,48,36
43818,62890,993,29471,993,allow,9624,4559,5065,88,196,45,43
43819,51871,23801,64442,23801,allow,316,136,180,6,6,3,3
43820,63837,14023,26076,14023,allow,70,70,0,1,4,1,0
43821,54966,53,59029,53,allow,255,88,167,4,32,2,2
43822,63836,14791,37606,14791,allow,70,70,0,1,4,1,0
43823,49995,53,53855,53,allow,303,98,205,4,40,2,2
43824,51865,14732,26909,14732,allow,70,70,0,2,7,2,0
43825,37356,443,58036,443,allow,1842,1134,708,14,315,8,6
43826,65465,53,18720,53,allow,293,102,191,2,29,1,1
43827,49684,53,21165,53,allow,305,94,211,2,29,1,1
43828,50118,443,10177,443,allow,125395,8711,116684,178,143,83,95
43829,50129,443,15530,443,allow,9199,2329,6870,30,133,17,13
43830,52072,443,62613,443,allow,7737,6531,1206,21,16,12,9
43831,49497,53,38810,53,allow,297,102,195,2,29,1,1
43832,55600,53,56237,53,allow,168,78,90,2,30,1,1
43833,55762,53,8136,53,allow,196,86,110,2,29,1,1
43834,55762,53,54612,53,allow,184,102,82,2,29,1,1
43835,65212,53,14498,53,allow,273,118,155,2,30,1,1
43836,65093,53,16648,53,allow,266,118,148,2,29,1,1
43837,57065,53,34013,53,allow,272,110,162,2,29,1,1
43838,65389,53,51653,53,allow,94,94,0,1,30,1,0
43839,39814,53,58386,53,allow,168,78,90,2,30,1,1
43840,55193,53,45543,53,allow,200,102,98,2,30,1,1
43841,49378,53,56071,53,allow,268,94,174,2,30,1,1
43842,64512,53,55792,53,allow,244,118,126,2,30,1,1
43843,34531,443,54332,443,allow,135231,5033,130198,149,216,55,94
43844,57996,53,57996,53,allow,265,114,151,2,30,1,1
43845,56663,443,26392,443,allow,9691,2221,7470,16,120,8,8
43846,55308,443,1473,443,allow,4981,943,4038,20,360,10,10
43847,42861,443,12903,443,allow,2337,1394,943,17,275,9,8
43848,63013,443,17200,443,allow,304,86,218,2,30,1,1
43849,58259,53,23484,53,allow,168,78,90,2,30,1,1
43850,50503,443,44653,443,allow,9295,3094,6201,24,82,12,12
43851,42115,53,42115,53,allow,262,106,156,2,32,1,1
43852,10060,443,49510,443,allow,293424,16379,277045,410,93,193,217
43853,38770,443,2311,443,allow,7431,3525,3906,18,15,10,8
43854,63028,53,16966,53,allow,384,166,218,2,30,1,1
43855,63025,443,40805,443,allow,304,86,218,2,30,1,1
43856,11076,53,11076,53,allow,832,106,726,2,30,1,1
43857,56129,53,60836,53,allow,94,94,0,1,30,1,0
43858,53761,123,54980,123,allow,184,94,90,2,30,1,1
43859,55484,443,11193,443,allow,5039,2002,3037,14,120,7,7
43860,60874,443,51364,443,allow,1706,169,1537,6,121,3,3
43861,61231,443,59948,443,allow,1864,250,1614,8,121,4,4
43862,57586,443,39129,443,allow,3724,1963,1761,24,95,13,11
43863,64069,443,44966,443,allow,11223,3362,7861,62,280,27,35
43864,49187,80,38831,80,allow,1213,471,742,10,111,6,4
43865,57827,443,29156,443,allow,912754,34972,877782,1035,294,410,625
43866,49288,53,48281,53,allow,322,102,220,2,30,1,1
43867,49273,53,17508,53,allow,342,110,232,2,30,1,1
43868,64875,53,51837,53,allow,211,102,109,2,30,1,1
43869,44976,53,45616,53,allow,86,86,0,1,30,1,0
43870,49995,53,30507,53,allow,197,102,95,2,33,1,1
43871,33852,443,7849,443,allow,3419,2241,1178,16,16,8,8
43872,26869,53,19844,53,allow,290,110,180,2,30,1,1
43873,55228,53,59087,53,allow,212,102,110,2,30,1,1
43874,63980,53,48933,53,allow,225,102,123,2,30,1,1
43875,63026,53,55076,53,allow,304,86,218,2,30,1,1
43876,62329,53,9486,53,allow,268,86,182,2,30,1,1
43877,60920,53,22139,53,allow,268,86,182,2,30,1,1
43878,49161,53,1492,53,allow,385,102,283,2,30,1,1
43879,51933,53,51933,53,allow,253,106,147,2,30,1,1
43880,38334,53,4428,53,allow,168,78,90,2,31,1,1
43881,64724,443,50877,443,allow,8602,1050,7552,16,121,7,9
43882,15503,38120,41177,38120,allow,481,150,331,2,1200,1,1
43883,57470,48622,44893,48622,allow,166,166,0,1,1200,1,0
43884,57510,443,62415,443,allow,16532,2229,14303,26,133,11,15
43885,53678,31592,2735,31592,allow,70,70,0,2,8,2,0
43886,56802,80,23332,80,allow,1559,762,797,14,30,7,7
43887,64467,80,64467,80,allow,5570,699,4871,14,22,7,7
43888,64361,53,32766,53,allow,228,110,118,2,30,1,1
43889,58875,53,56659,53,allow,370,86,284,2,30,1,1
43890,49954,53,40035,53,allow,211,102,109,2,31,1,1
43891,54827,443,62409,443,allow,11291,2426,8865,21,121,10,11
43892,52401,443,47720,443,allow,12402,3972,8430,46,138,26,20
43893,38768,443,45644,443,allow,7380,3474,3906,18,16,10,8
43894,53677,10657,26875,10657,allow,70,70,0,2,8,2,0
43895,52705,80,52705,80,allow,7237,2578,4659,19,16,9,10
43896,57583,443,11570,443,allow,6150,4180,1970,21,95,13,8
43897,53481,443,12218,443,allow,5913,4482,1431,30,30,20,10
43898,19372,443,19372,443,allow,10461,1417,9044,23,16,10,13
43899,56647,443,45722,443,allow,8059,2039,6020,20,15,11,9
43900,38769,443,3016,443,allow,7352,3452,3900,18,15,10,8
43901,34709,443,21963,443,allow,2119,1310,809,21,27,12,9
43902,63012,53,5232,53,allow,304,86,218,2,30,1,1
43903,63011,443,30939,443,allow,304,86,218,2,30,1,1
43904,64076,53,18119,53,allow,353,118,235,2,30,1,1
43905,61510,37965,0,0,deny,66,66,0,1,0,1,0
43906,60936,445,0,0,drop,70,70,0,1,0,1,0
43907,60932,445,0,0,drop,70,70,0,1,0,1,0
43908,60931,445,0,0,drop,70,70,0,1,0,1,0
43909,44208,26467,0,0,deny,62,62,0,1,0,1,0
43910,56325,445,0,0,drop,66,66,0,1,0,1,0
43911,56326,445,0,0,drop,66,66,0,1,0,1,0
43912,56324,445,0,0,drop,66,66,0,1,0,1,0
43913,56320,445,0,0,drop,66,66,0,1,0,1,0
43914,56322,445,0,0,drop,66,66,0,1,0,1,0
43915,56323,445,0,0,drop,66,66,0,1,0,1,0
43916,56321,445,0,0,drop,66,66,0,1,0,1,0
43917,56319,445,0,0,drop,66,66,0,1,0,1,0
43918,15403,51505,0,0,deny,66,66,0,1,0,1,0
43919,46945,64147,0,0,deny,62,62,0,1,0,1,0
43920,57433,21247,0,0,deny,66,66,0,1,0,1,0
43921,6889,45129,0,0,deny,159,159,0,1,0,1,0
43922,55992,445,0,0,drop,70,70,0,1,0,1,0
43923,53227,64097,0,0,deny,62,62,0,1,0,1,0
43924,55459,50584,0,0,deny,66,66,0,1,0,1,0
43925,27679,37965,0,0,deny,62,62,0,1,0,1,0
43926,61002,37965,0,0,deny,145,145,0,1,0,1,0
43927,55984,445,0,0,drop,70,70,0,1,0,1,0
43928,60923,445,0,0,drop,70,70,0,1,0,1,0
43929,60922,445,0,0,drop,70,70,0,1,0,1,0
43930,60915,445,0,0,drop,70,70,0,1,0,1,0
43931,55981,445,0,0,drop,70,70,0,1,0,1,0
43932,50784,50584,0,0,deny,62,62,0,1,0,1,0
43933,56369,22114,0,0,deny,62,62,0,1,0,1,0
43934,56369,22114,0,0,deny,146,146,0,1,0,1,0
43935,56307,445,0,0,drop,66,66,0,1,0,1,0
43936,56306,445,0,0,drop,66,66,0,1,0,1,0
43937,56304,445,0,0,drop,66,66,0,1,0,1,0
43938,60913,445,0,0,drop,70,70,0,1,0,1,0
43939,26699,35253,0,0,deny,62,62,0,1,0,1,0
43940,52150,39109,0,0,deny,66,66,0,1,0,1,0
43941,55978,445,0,0,drop,70,70,0,1,0,1,0
43942,48980,11119,0,0,deny,146,146,0,1,0,1,0
43943,16387,3655,0,0,deny,60,60,0,1,0,1,0
43944,16387,22272,0,0,deny,60,60,0,1,0,1,0
43945,49197,30188,0,0,deny,62,62,0,1,0,1,0
43946,16387,20045,0,0,deny,60,60,0,1,0,1,0
43947,55976,445,0,0,drop,70,70,0,1,0,1,0
43948,12107,22114,0,0,deny,66,66,0,1,0,1,0
43949,60911,445,0,0,drop,70,70,0,1,0,1,0
43950,4427,50584,0,0,deny,62,62,0,1,0,1,0
43951,16387,44427,0,0,deny,60,60,0,1,0,1,0
43952,16387,7205,0,0,deny,60,60,0,1,0,1,0
43953,16387,16862,0,0,deny,60,60,0,1,0,1,0
43954,60909,445,0,0,drop,70,70,0,1,0,1,0
43955,60908,445,0,0,drop,70,70,0,1,0,1,0
43956,60900,445,0,0,drop,70,70,0,1,0,1,0
43957,34146,51221,0,0,deny,62,62,0,1,0,1,0
43958,51313,64147,0,0,deny,66,66,0,1,0,1,0
43959,55972,445,0,0,drop,70,70,0,1,0,1,0
43960,16387,63752,0,0,deny,60,60,0,1,0,1,0
43961,16387,35583,0,0,deny,60,60,0,1,0,1,0
43962,16387,64075,0,0,deny,60,60,0,1,0,1,0
43963,2876,35440,0,0,deny,62,62,0,1,0,1,0
43964,64283,37965,0,0,deny,74,74,0,1,0,1,0
43965,55971,445,0,0,drop,70,70,0,1,0,1,0
43966,28370,35440,0,0,deny,66,66,0,1,0,1,0
43967,11344,42873,0,0,deny,62,62,0,1,0,1,0
43968,1790,48817,0,0,deny,62,62,0,1,0,1,0
43969,8080,37965,0,0,deny,62,62,0,1,0,1,0
43970,53781,37965,0,0,deny,66,66,0,1,0,1,0
43971,34809,57470,0,0,deny,66,66,0,1,0,1,0
43972,59772,62413,0,0,deny,66,66,0,1,0,1,0
43973,60892,445,0,0,drop,70,70,0,1,0,1,0
43974,60891,445,0,0,drop,70,70,0,1,0,1,0
43975,60888,445,0,0,drop,70,70,0,1,0,1,0
43976,55966,445,0,0,drop,70,70,0,1,0,1,0
43977,29787,37965,0,0,deny,62,62,0,1,0,1,0
43978,62625,37965,0,0,deny,66,66,0,1,0,1,0
43979,27443,23,0,0,deny,60,60,0,1,0,1,0
43980,62725,51221,0,0,deny,62,62,0,1,0,1,0
43981,64693,26467,0,0,deny,62,62,0,1,0,1,0
43982,34499,8497,0,0,deny,148,148,0,1,0,1,0
43983,61195,56205,0,0,deny,66,66,0,1,0,1,0
43984,56281,445,0,0,drop,66,66,0,1,0,1,0
43985,55238,21247,0,0,deny,62,62,0,1,0,1,0
43986,60885,445,0,0,drop,70,70,0,1,0,1,0
43987,60884,445,0,0,drop,70,70,0,1,0,1,0
43988,13970,42873,0,0,deny,62,62,0,1,0,1,0
43989,55953,445,0,0,drop,70,70,0,1,0,1,0
43990,59724,64147,0,0,deny,66,66,0,1,0,1,0
43991,55950,445,0,0,drop,70,70,0,1,0,1,0
43992,58334,5223,0,0,deny,148,148,0,1,0,1,0
43993,56277,445,0,0,drop,66,66,0,1,0,1,0
43994,52410,8604,0,0,deny,66,66,0,1,0,1,0
43995,56275,445,0,0,drop,66,66,0,1,0,1,0
43996,60873,445,0,0,drop,70,70,0,1,0,1,0
43997,65495,11392,0,0,deny,66,66,0,1,0,1,0
43998,12087,59033,0,0,deny,148,148,0,1,0,1,0
43999,60868,445,0,0,drop,70,70,0,1,0,1,0
44000,60866,445,0,0,drop,70,70,0,1,0,1,0
44001,60865,445,0,0,drop,70,70,0,1,0,1,0
44002,7978,50584,0,0,deny,66,66,0,1,0,1,0
44003,56274,445,0,0,drop,66,66,0,1,0,1,0
44004,52870,22197,0,0,deny,66,66,0,1,0,1,0
44005,55945,445,0,0,drop,70,70,0,1,0,1,0
44006,55944,445,0,0,drop,70,70,0,1,0,1,0
44007,59889,30188,0,0,deny,66,66,0,1,0,1,0
44008,63740,64147,0,0,deny,66,66,0,1,0,1,0
44009,14924,44847,0,0,deny,62,62,0,1,0,1,0
44010,49248,35993,0,0,deny,66,66,0,1,0,1,0
44011,55942,445,0,0,drop,70,70,0,1,0,1,0
44012,60859,445,0,0,drop,70,70,0,1,0,1,0
44013,42968,56205,0,0,deny,146,146,0,1,0,1,0
44014,60856,445,0,0,drop,70,70,0,1,0,1,0
44015,60855,445,0,0,drop,70,70,0,1,0,1,0
44016,60852,445,0,0,drop,70,70,0,1,0,1,0
44017,56265,445,0,0,drop,66,66,0,1,0,1,0
44018,43584,24748,0,0,deny,156,156,0,1,0,1,0
44019,43584,24748,0,0,deny,156,156,0,1,0,1,0
44020,57131,35776,0,0,deny,145,145,0,1,0,1,0
44021,43584,24748,0,0,deny,156,156,0,1,0,1,0
44022,43584,24748,0,0,deny,156,156,0,1,0,1,0
44023,59965,36237,0,0,deny,66,66,0,1,0,1,0
44024,43584,24748,0,0,deny,156,156,0,1,0,1,0
44025,56263,445,0,0,drop,66,66,0,1,0,1,0
44026,56260,445,0,0,drop,66,66,0,1,0,1,0
44027,56258,445,0,0,drop,66,66,0,1,0,1,0
44028,443,2629,0,0,deny,135,135,0,1,0,1,0
44029,443,46223,0,0,deny,66,66,0,1,0,1,0
44030,56256,445,0,0,drop,66,66,0,1,0,1,0
44031,56255,445,0,0,drop,66,66,0,1,0,1,0
44032,56253,445,0,0,drop,66,66,0,1,0,1,0
44033,54530,35440,0,0,deny,66,66,0,1,0,1,0
44034,56376,44847,0,0,deny,66,66,0,1,0,1,0
44035,52724,64147,0,0,deny,62,62,0,1,0,1,0
44036,55935,445,0,0,drop,70,70,0,1,0,1,0
44037,0,0,0,0,allow,2000,1020,980,20,0,10,10
44038,57472,44847,0,0,deny,66,66,0,1,0,1,0
44039,14255,2767,0,0,deny,146,146,0,1,0,1,0
44040,55933,445,0,0,drop,70,70,0,1,0,1,0
44041,60849,445,0,0,drop,70,70,0,1,0,1,0
44042,60850,445,0,0,drop,70,70,0,1,0,1,0
44043,60848,445,0,0,drop,70,70,0,1,0,1,0
44044,10348,25604,0,0,deny,66,66,0,1,0,1,0
44045,54636,26467,0,0,deny,62,62,0,1,0,1,0
44046,26921,57470,0,0,deny,62,62,0,1,0,1,0
44047,10028,25604,0,0,deny,62,62,0,1,0,1,0
44048,23383,64147,0,0,deny,62,62,0,1,0,1,0
44049,51093,57470,0,0,deny,66,66,0,1,0,1,0
44050,38383,51221,0,0,deny,62,62,0,1,0,1,0
44051,64387,37965,0,0,deny,62,62,0,1,0,1,0
44052,56252,445,0,0,drop,66,66,0,1,0,1,0
44053,60843,445,0,0,drop,70,70,0,1,0,1,0
44054,55932,445,0,0,drop,70,70,0,1,0,1,0
44055,56247,445,0,0,drop,66,66,0,1,0,1,0
44056,57969,42873,0,0,deny,66,66,0,1,0,1,0
44057,55931,445,0,0,drop,70,70,0,1,0,1,0
44058,55930,445,0,0,drop,70,70,0,1,0,1,0
44059,55926,445,0,0,drop,70,70,0,1,0,1,0
44060,55927,445,0,0,drop,70,70,0,1,0,1,0
44061,56246,445,0,0,drop,66,66,0,1,0,1,0
44062,56244,445,0,0,drop,66,66,0,1,0,1,0
44063,3117,37965,0,0,deny,62,62,0,1,0,1,0
44064,6824,26467,0,0,deny,66,66,0,1,0,1,0
44065,54854,19847,0,0,deny,62,62,0,1,0,1,0
44066,43657,50011,0,0,deny,62,62,0,1,0,1,0
44067,50095,30188,0,0,deny,62,62,0,1,0,1,0
44068,57114,35440,0,0,deny,62,62,0,1,0,1,0
44069,55912,445,0,0,drop,70,70,0,1,0,1,0
44070,1972,57470,0,0,deny,78,78,0,1,0,1,0
44071,55911,445,0,0,drop,70,70,0,1,0,1,0
44072,55907,445,0,0,drop,70,70,0,1,0,1,0
44073,55902,445,0,0,drop,70,70,0,1,0,1,0
44074,52459,5555,0,0,deny,60,60,0,1,0,1,0
44075,55901,445,0,0,drop,70,70,0,1,0,1,0
44076,60838,445,0,0,drop,70,70,0,1,0,1,0
44077,28124,37965,0,0,deny,62,62,0,1,0,1,0
44078,16086,6881,0,0,deny,146,146,0,1,0,1,0
44079,20608,28189,0,0,deny,60,60,0,1,0,1,0
44080,6881,6881,0,0,deny,146,146,0,1,0,1,0
44081,60830,445,0,0,drop,70,70,0,1,0,1,0
44082,60825,445,0,0,drop,70,70,0,1,0,1,0
44083,55600,22,0,0,deny,60,60,0,1,0,1,0
44084,54047,50011,0,0,deny,66,66,0,1,0,1,0
44085,55145,11392,0,0,deny,66,66,0,1,0,1,0
44086,16944,50584,0,0,deny,62,62,0,1,0,1,0
44087,16944,50584,0,0,deny,146,146,0,1,0,1,0
44088,35849,30188,0,0,deny,62,62,0,1,0,1,0
44089,56231,445,0,0,drop,66,66,0,1,0,1,0
44090,55890,445,0,0,drop,70,70,0,1,0,1,0
44091,29300,35440,0,0,deny,62,62,0,1,0,1,0
44092,1821,64147,0,0,deny,66,66,0,1,0,1,0
44093,56224,445,0,0,drop,66,66,0,1,0,1,0
44094,60815,445,0,0,drop,70,70,0,1,0,1,0
44095,443,62451,0,0,deny,199,199,0,1,0,1,0
44096,51283,80,60981,80,allow,1114,534,580,12,16,7,5
44097,60419,33709,17912,33709,allow,504,318,186,8,16,5,3
44098,49487,443,25025,443,allow,72073,12550,59523,78,45,25,53
44099,37098,443,22843,443,allow,1835,1190,645,17,26,10,7
44100,55631,16191,24420,16191,allow,504,318,186,8,16,5,3
44101,51842,27665,45700,27665,allow,66,66,0,1,5,1,0
44102,54213,443,30339,443,allow,7498,2799,4699,24,17,13,11
44103,49295,443,9529,443,allow,4179,2599,1580,27,75,13,14
44104,27005,27025,48292,27025,allow,1774,252,1522,5,31,3,2
44105,56677,443,37200,443,allow,6313,2068,4245,21,20,12,9
44106,53645,62348,1333,62348,allow,2395,1145,1250,13,16,6,7
44107,60347,80,6401,80,allow,2018,1704,314,16,15,11,5
44108,48643,80,57942,80,allow,1912,1464,448,14,16,7,7
44109,57470,1028,19810,1028,allow,350,163,187,2,1200,1,1
44110,37095,443,45405,443,allow,1835,1190,645,17,26,10,7
44111,37097,443,17597,443,allow,1835,1190,645,17,26,10,7
44112,45132,443,57235,443,allow,5398,3277,2121,30,80,16,14
44113,37096,443,33249,443,allow,1753,1108,645,16,26,9,7
44114,38365,15000,43140,15000,allow,130,70,60,2,6,1,1
44115,48710,22,48710,22,allow,11002,3445,7557,60,42,26,34
44116,63214,53,63214,53,allow,261,103,158,2,30,1,1
44117,27005,27023,4968,27023,allow,1640,126,1514,4,30,2,2
44118,35123,443,15419,443,allow,17656,4044,13612,30,122,13,17
44119,60875,443,10095,443,allow,1786,172,1614,7,120,3,4
44120,52662,443,35849,443,allow,5382,1353,4029,19,135,10,9
44121,33356,80,44491,80,allow,1658,1344,314,10,15,5,5
44122,39328,80,54036,80,allow,78,78,0,1,5,1,0
44123,53656,58624,54901,58624,allow,70,70,0,1,5,1,0
44124,60417,443,24567,443,allow,8590,1987,6603,23,86,12,11
44125,27005,27017,60411,27017,allow,1644,126,1518,4,30,2,2
44126,55592,53,16143,53,allow,817,98,719,2,30,1,1
44127,49396,53,24683,53,allow,170,87,83,2,30,1,1
44128,55274,53,15789,53,allow,711,87,624,2,30,1,1
44129,61232,443,38058,443,allow,1786,172,1614,7,120,3,4
44130,61234,443,50660,443,allow,1786,172,1614,7,120,3,4
44131,50584,6881,56597,6881,allow,161,161,0,1,1201,1,0
44132,50584,44816,28229,44816,allow,161,161,0,1,1201,1,0
44133,53765,443,24226,443,allow,16482,9312,7170,39,141,19,20
44134,50265,21544,58613,21544,allow,390,266,124,6,1200,4,2
44135,49224,53,6029,53,allow,170,87,83,2,31,1,1
44136,30960,45718,62760,45718,allow,330,330,0,6,3609,6,0
44137,57277,5223,45346,5223,allow,4339,1521,2818,23,3002,14,9
44138,1024,21247,0,0,deny,62,62,0,1,0,1,0
44139,40322,23,0,0,deny,60,60,0,1,0,1,0
44140,7109,64147,0,0,deny,62,62,0,1,0,1,0
44141,56221,445,0,0,drop,66,66,0,1,0,1,0
44142,60222,22114,0,0,deny,66,66,0,1,0,1,0
44143,30913,33876,0,0,deny,145,145,0,1,0,1,0
44144,55886,445,0,0,drop,70,70,0,1,0,1,0
44145,56214,445,0,0,drop,66,66,0,1,0,1,0
44146,55877,445,0,0,drop,70,70,0,1,0,1,0
44147,55876,445,0,0,drop,70,70,0,1,0,1,0
44148,51164,64147,0,0,deny,66,66,0,1,0,1,0
44149,1024,64147,0,0,deny,62,62,0,1,0,1,0
44150,55872,445,0,0,drop,70,70,0,1,0,1,0
44151,55874,445,0,0,drop,70,70,0,1,0,1,0
44152,56211,445,0,0,drop,66,66,0,1,0,1,0
44153,55869,445,0,0,drop,70,70,0,1,0,1,0
44154,13663,23,0,0,deny,60,60,0,1,0,1,0
44155,52754,26467,0,0,deny,66,66,0,1,0,1,0
44156,57093,26467,0,0,deny,66,66,0,1,0,1,0
44157,25565,20455,0,0,deny,60,60,0,1,0,1,0
44158,4772,37965,0,0,deny,66,66,0,1,0,1,0
44159,60803,445,0,0,drop,70,70,0,1,0,1,0
44160,60805,445,0,0,drop,70,70,0,1,0,1,0
44161,60804,445,0,0,drop,70,70,0,1,0,1,0
44162,39452,123,25633,123,allow,184,94,90,2,30,1,1
44163,37653,5223,9635,5223,allow,417,417,0,4,13,4,0
44164,65352,443,3902,443,allow,12690,1918,10772,39,195,19,20
44165,49396,53,21722,53,allow,177,94,83,2,30,1,1
44166,46582,80,45383,80,allow,540,540,0,10,194,10,0
44167,49989,53,42243,53,allow,677,217,460,6,74,3,3
44168,9555,80,9555,80,allow,6893,704,6189,14,15,6,8
44169,64202,53,3004,53,allow,316,89,227,4,50,2,2
44170,63022,53,50452,53,allow,384,166,218,2,29,1,1
44171,63014,53,26673,53,allow,304,86,218,2,29,1,1
44172,61233,443,12202,443,allow,1775,169,1606,7,120,3,4
44173,51825,80,15500,80,allow,540,540,0,10,194,10,0
44174,49507,53,65329,53,allow,177,94,83,2,30,1,1
44175,53674,31724,4834,31724,allow,70,70,0,2,7,2,0
44176,60827,53,38613,53,allow,224,86,138,2,29,1,1
44177,63018,53,50611,53,allow,384,166,218,2,29,1,1
44178,63010,53,14322,53,allow,304,86,218,2,29,1,1
44179,65442,53,44743,53,allow,262,102,160,2,29,1,1
44180,49396,53,32920,53,allow,177,94,83,2,29,1,1
44181,54044,53,15773,53,allow,224,86,138,2,29,1,1
44182,51862,27758,32851,27758,allow,70,70,0,2,7,2,0
44183,39807,443,25771,443,allow,1684,1031,653,16,92,9,7
44184,34715,443,46649,443,allow,584,370,214,9,26,6,3
44185,64765,53,50725,53,allow,177,94,83,2,30,1,1
44186,34391,443,18031,443,allow,80160,3527,76633,98,76,38,60
44187,53652,57503,44187,57503,allow,492,306,186,8,15,5,3
44188,51861,23919,9665,23919,allow,70,70,0,2,7,2,0
44189,53647,80,49783,80,allow,1962,1287,675,13,27,7,6
44190,51841,21960,6708,21960,allow,136,136,0,3,14,3,0
44191,56837,46790,59586,46790,allow,70,70,0,1,5,1,0
44192,58870,443,45632,443,allow,1411,921,490,12,15,7,5
44193,55245,443,9754,443,allow,6799,1581,5218,27,25,14,13
44194,50086,80,23658,80,allow,3148,687,2461,12,15,7,5
44195,49606,53,55555,53,allow,328,94,234,4,43,2,2
44196,50084,80,12971,80,allow,2173,616,1557,10,15,6,4
44197,49640,443,55755,443,allow,2809,1729,1080,18,80,10,8
44198,26849,443,35279,443,allow,20979,15982,4997,38,36,22,16
44199,26854,53,44108,53,allow,222,86,136,2,30,1,1
44200,64608,53,19709,53,allow,718,94,624,2,30,1,1
44201,8283,52443,24980,52443,allow,70,70,0,1,30,1,0
44202,65081,443,33904,443,allow,5291,339,4952,11,120,5,6
44203,64670,53,49938,53,allow,228,94,134,2,30,1,1
44204,49507,53,33142,53,allow,177,94,83,2,30,1,1
44205,51863,22038,18854,22038,allow,70,70,0,2,7,2,0
44206,51486,4545,51486,4545,allow,156,156,0,3,8,3,0
44207,49334,53,5617,53,allow,300,99,201,4,38,2,2
44208,55327,443,55327,443,allow,16304,2069,14235,39,17,19,20
44209,64828,53,23782,53,allow,372,94,278,2,30,1,1
44210,64230,53,48297,53,allow,193,94,99,2,30,1,1
44211,51844,12471,8982,12471,allow,70,70,0,1,5,1,0
44212,51789,80,62386,80,allow,28433,1668,26765,39,20,18,21
44213,51787,80,42388,80,allow,26626,1555,25071,36,20,16,20
44214,34490,443,47026,443,allow,584,370,214,9,26,6,3
44215,56644,443,57838,443,allow,7862,1873,5989,20,15,11,9
44216,55217,443,42611,443,allow,8690,4119,4571,26,31,14,12
44217,19962,53,19962,53,allow,832,106,726,2,30,1,1
44218,10151,11809,51182,11809,allow,481,150,331,2,1200,1,1
44219,48285,80,8478,80,allow,6713,1736,4977,24,1130,8,16
44220,38010,443,65428,443,allow,5474,2239,3235,31,80,14,17
44221,45359,443,22644,443,allow,10480,4949,5531,22,15,12,10
44222,50085,80,7079,80,allow,3326,684,2642,12,15,7,5
44223,56646,443,12579,443,allow,7862,1873,5989,20,15,11,9
44224,48742,443,3234,443,allow,4801,2138,2663,23,15,12,11
44225,45360,443,43206,443,allow,10280,6167,4113,20,15,12,8
44226,52292,80,52292,80,allow,1914,1302,612,11,14,5,6
44227,36532,6555,55068,6555,allow,922,428,494,10,14,5,5
44228,52661,80,52661,80,allow,1950,1338,612,11,14,5,6
44229,53676,3678,29317,3678,allow,70,70,0,2,7,2,0
44230,34787,80,1192,80,allow,2989,813,2176,15,166,8,7
44231,39570,443,62469,443,allow,70,70,0,1,5,1,0
44232,41431,443,28233,443,allow,1843,996,847,17,275,8,9
44233,19125,80,19125,80,allow,12650,889,11761,20,16,9,11
44234,27005,27016,57250,27016,allow,1784,252,1532,5,31,3,2
44235,33165,443,61975,443,allow,7442,1260,6182,19,15,10,9
44236,55206,443,55206,443,allow,18965,2061,16904,35,17,18,17
44237,63019,53,40745,53,allow,512,166,346,2,29,1,1
44238,51791,80,21497,80,allow,1934,1083,851,9,15,5,4
44239,64542,53,47604,53,allow,234,94,140,2,29,1,1
44240,49474,53,54970,53,allow,224,86,138,2,29,1,1
44241,63017,443,7644,443,allow,571,166,405,2,29,1,1
44242,53290,443,5427,443,allow,494,288,206,8,26,5,3
44243,63009,443,26712,443,allow,304,86,218,2,29,1,1
44244,53649,26085,23135,26085,allow,612,306,306,10,15,5,5
44245,49396,53,18429,53,allow,177,94,83,2,29,1,1
44246,64966,53,26229,53,allow,376,126,250,2,29,1,1
44247,65197,53,14120,53,allow,177,86,91,2,30,1,1
44248,50059,53,45752,53,allow,718,94,624,2,30,1,1
44249,27005,27015,22209,27015,allow,1654,126,1528,4,30,2,2
44250,64722,443,16301,443,allow,61890,2830,59060,73,120,27,46
44251,65167,53,20946,53,allow,219,94,125,2,30,1,1
44252,49758,53,63769,53,allow,243,102,141,2,30,1,1
44253,46671,53,46671,53,allow,832,106,726,2,30,1,1
44254,64765,53,64580,53,allow,177,94,83,2,30,1,1
44255,50265,37711,22022,37711,allow,132,132,0,3,1200,3,0
44256,6881,55085,23823,55085,allow,509,150,359,2,1199,1,1
44257,50584,13560,50803,13560,allow,166,166,0,1,1200,1,0
44258,57470,24907,9136,24907,allow,1386,1386,0,22,1544,22,0
44259,57470,6881,62721,6881,allow,150,150,0,1,1200,1,0
44260,39820,443,15397,443,allow,2642442,95056,2547386,2730,3629,999,1731
44261,33850,443,55796,443,allow,6987,2005,4982,18,16,9,9
44262,51790,80,59266,80,allow,1936,1085,851,9,15,5,4
44263,56645,443,46847,443,allow,7914,1925,5989,20,15,11,9
44264,34392,443,49266,443,allow,1820,1101,719,18,76,10,8
44265,55808,53,55808,53,allow,257,106,151,2,30,1,1
44266,46887,443,50848,443,allow,118,118,0,1,30,1,0
44267,49338,53,20545,53,allow,368,94,274,2,30,1,1
44268,64561,53,17308,53,allow,461,91,370,4,60,2,2
44269,49559,443,1739,443,allow,3641,1047,2594,14,120,7,7
44270,47377,443,54637,443,allow,2725,1153,1572,19,208,8,11
44271,45275,443,51304,443,allow,9908271,123308,9784963,8531,359,1708,6823
44272,65105,80,65105,80,allow,23382,3770,19612,48,45,24,24
44273,39762,123,46956,123,allow,184,94,90,2,30,1,1
44274,64360,53,15501,53,allow,350,88,262,4,31,2,2
44275,44353,443,12767,443,allow,15234,2503,12731,45,135,20,25
44276,58004,443,48941,443,allow,13206,7781,5425,29,253,15,14
44277,63832,6969,32926,6969,allow,70,70,0,1,5,1,0
44278,56786,443,56786,443,allow,4381,1474,2907,19,27,11,8
44279,51788,80,12159,80,allow,35407,1784,33623,46,20,20,26
44280,50265,24387,44902,24387,allow,330,330,0,6,1200,6,0
44281,50584,51651,64737,51651,allow,166,166,0,1,1200,1,0
44282,41762,443,13178,443,allow,2306249,52358,2253891,2041,239,447,1594
44283,50584,49001,15411,49001,allow,889,161,728,3,1200,2,1
44284,33200,443,11701,443,allow,67123,10708,56415,100,124,41,59
44285,47089,443,11846,443,allow,172,172,0,2,5,2,0
44286,53654,8100,50250,8100,allow,70,70,0,1,5,1,0
44287,35168,443,20668,443,allow,7447,2133,5314,27,348,14,13
44288,49640,443,44264,443,allow,12619,3258,9361,33,47,19,14
44289,58440,53,59026,53,allow,305,102,203,2,31,1,1
44290,49746,53,24579,53,allow,479,88,391,4,58,2,2
44291,49293,80,54518,80,allow,75982,15645,60337,88,158,31,57
44292,53670,32016,15273,32016,allow,70,70,0,2,8,2,0
44293,64157,53,49752,53,allow,370,126,244,2,30,1,1
44294,64951,53,60545,53,allow,230,102,128,2,30,1,1
44295,49948,53,19107,53,allow,380,110,270,2,30,1,1
44296,56660,53,3127,53,allow,338,110,228,2,30,1,1
44297,27005,27025,58786,27025,allow,1634,126,1508,4,31,2,2
44298,56621,443,14784,443,allow,1327,918,409,10,26,6,4
44299,58866,443,52755,443,allow,2353,1453,900,16,15,8,8
44300,11324,443,11324,443,allow,6981,948,6033,17,28,10,7
44301,27005,27052,57707,27052,allow,1948,378,1570,6,33,4,2
44302,47528,8080,0,0,allow,184,78,106,3,10,2,1
44303,49649,443,20901,443,allow,10099,1721,8378,27,46,14,13
44304,57580,443,3612,443,allow,4049,1992,2057,23,96,13,10
44305,27005,27015,32114,27015,allow,1634,126,1508,4,31,2,2
44306,56197,445,0,0,drop,66,66,0,1,0,1,0
44307,56193,445,0,0,drop,66,66,0,1,0,1,0
44308,56192,445,0,0,drop,66,66,0,1,0,1,0
44309,56198,445,0,0,drop,66,66,0,1,0,1,0
44310,56194,445,0,0,drop,66,66,0,1,0,1,0
44311,56196,445,0,0,drop,66,66,0,1,0,1,0
44312,56195,445,0,0,drop,66,66,0,1,0,1,0
44313,56190,445,0,0,drop,66,66,0,1,0,1,0
44314,2370,23,0,0,deny,60,60,0,1,0,1,0
44315,37343,21247,0,0,deny,146,146,0,1,0,1,0
44316,55864,445,0,0,drop,70,70,0,1,0,1,0
44317,44129,64147,0,0,deny,145,145,0,1,0,1,0
44318,54868,1433,0,0,deny,60,60,0,1,0,1,0
44319,65492,2323,0,0,deny,60,60,0,1,0,1,0
44320,30783,51505,0,0,deny,62,62,0,1,0,1,0
44321,10252,11392,0,0,deny,62,62,0,1,0,1,0
44322,10331,6881,0,0,deny,146,146,0,1,0,1,0
44323,55856,445,0,0,drop,70,70,0,1,0,1,0
44324,6655,2323,0,0,deny,60,60,0,1,0,1,0
44325,55855,445,0,0,drop,70,70,0,1,0,1,0
44326,3436,46783,0,0,deny,62,62,0,1,0,1,0
44327,60802,445,0,0,drop,70,70,0,1,0,1,0
44328,60789,445,0,0,drop,70,70,0,1,0,1,0
44329,60788,445,0,0,drop,70,70,0,1,0,1,0
44330,25857,57354,0,0,deny,145,145,0,1,0,1,0
44331,11030,37965,0,0,deny,62,62,0,1,0,1,0
44332,56178,445,0,0,drop,66,66,0,1,0,1,0
44333,56177,445,0,0,drop,66,66,0,1,0,1,0
44334,56175,445,0,0,drop,66,66,0,1,0,1,0
44335,55850,445,0,0,drop,70,70,0,1,0,1,0
44336,52563,17235,0,0,deny,70,70,0,1,0,1,0
44337,55848,445,0,0,drop,70,70,0,1,0,1,0
44338,60786,445,0,0,drop,70,70,0,1,0,1,0
44339,47803,64147,0,0,deny,145,145,0,1,0,1,0
44340,63213,15503,0,0,deny,66,66,0,1,0,1,0
44341,58550,21247,0,0,deny,66,66,0,1,0,1,0
44342,60783,445,0,0,drop,70,70,0,1,0,1,0
44343,56148,37965,0,0,deny,66,66,0,1,0,1,0
44344,55844,445,0,0,drop,70,70,0,1,0,1,0
44345,60776,445,0,0,drop,70,70,0,1,0,1,0
44346,60779,445,0,0,drop,70,70,0,1,0,1,0
44347,60778,445,0,0,drop,70,70,0,1,0,1,0
44348,19632,37965,0,0,deny,62,62,0,1,0,1,0
44349,16387,3655,0,0,deny,60,60,0,1,0,1,0
44350,16387,22272,0,0,deny,60,60,0,1,0,1,0
44351,16387,20045,0,0,deny,60,60,0,1,0,1,0
44352,55981,31573,0,0,deny,146,146,0,1,0,1,0
44353,53543,44847,0,0,deny,62,62,0,1,0,1,0
44354,55843,445,0,0,drop,70,70,0,1,0,1,0
44355,16387,44427,0,0,deny,60,60,0,1,0,1,0
44356,16387,7205,0,0,deny,60,60,0,1,0,1,0
44357,16387,16862,0,0,deny,60,60,0,1,0,1,0
44358,16387,63752,0,0,deny,60,60,0,1,0,1,0
44359,16387,35583,0,0,deny,60,60,0,1,0,1,0
44360,16387,64075,0,0,deny,60,60,0,1,0,1,0
44361,3980,63710,0,0,deny,66,66,0,1,0,1,0
44362,20198,17372,0,0,deny,62,62,0,1,0,1,0
44363,51910,37965,0,0,deny,62,62,0,1,0,1,0
44364,56127,35440,0,0,deny,62,62,0,1,0,1,0
44365,1117,37965,0,0,deny,62,62,0,1,0,1,0
44366,55838,445,0,0,drop,70,70,0,1,0,1,0
44367,19096,64147,0,0,deny,62,62,0,1,0,1,0
44368,60766,445,0,0,drop,70,70,0,1,0,1,0
44369,60765,445,0,0,drop,70,70,0,1,0,1,0
44370,60764,445,0,0,drop,70,70,0,1,0,1,0
44371,56380,36829,0,0,deny,66,66,0,1,0,1,0
44372,38758,23,0,0,deny,60,60,0,1,0,1,0
44373,58286,37965,0,0,deny,66,66,0,1,0,1,0
44374,56153,445,0,0,drop,66,66,0,1,0,1,0
44375,55825,445,0,0,drop,70,70,0,1,0,1,0
44376,50713,57470,0,0,deny,66,66,0,1,0,1,0
44377,51745,57470,0,0,deny,62,62,0,1,0,1,0
44378,60758,445,0,0,drop,70,70,0,1,0,1,0
44379,55968,56205,0,0,deny,66,66,0,1,0,1,0
44380,57131,26296,0,0,deny,145,145,0,1,0,1,0
44381,3730,37965,0,0,deny,62,62,0,1,0,1,0
44382,60248,30188,0,0,deny,66,66,0,1,0,1,0
44383,55822,445,0,0,drop,70,70,0,1,0,1,0
44384,57499,80,58855,80,allow,30979,1798,29181,46,14,23,23
44385,51172,44847,0,0,deny,62,62,0,1,0,1,0
44386,51676,23718,0,0,deny,66,66,0,1,0,1,0
44387,56148,445,0,0,drop,66,66,0,1,0,1,0
44388,56146,445,0,0,drop,66,66,0,1,0,1,0
44389,60745,445,0,0,drop,70,70,0,1,0,1,0
44390,55817,445,0,0,drop,70,70,0,1,0,1,0
44391,60741,445,0,0,drop,70,70,0,1,0,1,0
44392,60740,445,0,0,drop,70,70,0,1,0,1,0
44393,60735,445,0,0,drop,70,70,0,1,0,1,0
44394,53003,11392,0,0,deny,66,66,0,1,0,1,0
44395,55816,445,0,0,drop,70,70,0,1,0,1,0
44396,56143,445,0,0,drop,66,66,0,1,0,1,0
44397,0,0,0,0,allow,320,320,0,5,0,5,0
44398,55814,445,0,0,drop,70,70,0,1,0,1,0
44399,17781,50265,0,0,deny,145,145,0,1,0,1,0
44400,52282,37965,0,0,deny,66,66,0,1,0,1,0
44401,45832,51050,0,0,deny,66,66,0,1,0,1,0
44402,50881,50584,0,0,deny,66,66,0,1,0,1,0
44403,60730,445,0,0,drop,70,70,0,1,0,1,0
44404,64294,64147,0,0,deny,62,62,0,1,0,1,0
44405,60728,445,0,0,drop,70,70,0,1,0,1,0
44406,60725,445,0,0,drop,70,70,0,1,0,1,0
44407,60724,445,0,0,drop,70,70,0,1,0,1,0
44408,56137,445,0,0,drop,66,66,0,1,0,1,0
44409,56131,445,0,0,drop,66,66,0,1,0,1,0
44410,56128,445,0,0,drop,66,66,0,1,0,1,0
44411,56130,445,0,0,drop,66,66,0,1,0,1,0
44412,55807,445,0,0,drop,70,70,0,1,0,1,0
44413,56127,445,0,0,drop,66,66,0,1,0,1,0
44414,56125,445,0,0,drop,66,66,0,1,0,1,0
44415,56126,445,0,0,drop,66,66,0,1,0,1,0
44416,2432,11392,0,0,deny,146,146,0,1,0,1,0
44417,55805,445,0,0,drop,70,70,0,1,0,1,0
44418,27300,36237,0,0,deny,146,146,0,1,0,1,0
44419,55804,445,0,0,drop,70,70,0,1,0,1,0
44420,20608,28189,0,0,deny,60,60,0,1,0,1,0
44421,60723,445,0,0,drop,70,70,0,1,0,1,0
44422,60720,445,0,0,drop,70,70,0,1,0,1,0
44423,60717,445,0,0,drop,70,70,0,1,0,1,0
44424,21641,51505,0,0,deny,62,62,0,1,0,1,0
44425,55803,445,0,0,drop,70,70,0,1,0,1,0
44426,55802,445,0,0,drop,70,70,0,1,0,1,0
44427,56123,445,0,0,drop,66,66,0,1,0,1,0
44428,26502,64147,0,0,deny,62,62,0,1,0,1,0
44429,62688,32480,0,0,deny,109,109,0,1,0,1,0
44430,55798,445,0,0,drop,70,70,0,1,0,1,0
44431,55799,445,0,0,drop,70,70,0,1,0,1,0
44432,60715,445,0,0,drop,70,70,0,1,0,1,0
44433,56118,445,0,0,drop,66,66,0,1,0,1,0
44434,48676,53395,0,0,deny,60,60,0,1,0,1,0
44435,36566,37965,0,0,deny,62,62,0,1,0,1,0
44436,60398,46776,0,0,deny,74,74,0,1,0,1,0
44437,30015,36237,0,0,deny,66,66,0,1,0,1,0
44438,56117,445,0,0,drop,66,66,0,1,0,1,0
44439,56115,445,0,0,drop,66,66,0,1,0,1,0
44440,56113,445,0,0,drop,66,66,0,1,0,1,0
44441,55784,445,0,0,drop,70,70,0,1,0,1,0
44442,55782,445,0,0,drop,70,70,0,1,0,1,0
44443,55777,445,0,0,drop,70,70,0,1,0,1,0
44444,59699,55783,0,0,deny,62,62,0,1,0,1,0
44445,51858,44647,64567,44647,allow,70,70,0,2,8,2,0
44446,53669,59056,24869,59056,allow,70,70,0,2,7,2,0
44447,10167,80,10167,80,allow,450,246,204,8,25,5,3
44448,59200,53,0,0,allow,82,82,0,1,30,1,0
44449,53126,47035,20200,47035,allow,70,70,0,1,5,1,0
44450,49639,443,59144,443,allow,13604,1980,11624,33,46,18,15
44451,27005,27018,26444,27018,allow,1634,126,1508,4,30,2,2
44452,61736,443,61172,443,allow,148467,8298,140169,192,17,93,99
44453,5588,5588,0,0,allow,3354,1792,1562,46,192,23,23
44454,58961,80,54182,80,allow,1674,1360,314,11,15,6,5
44455,54966,53,23127,53,allow,170,87,83,3,32,2,1
44456,55082,443,25259,443,allow,8944,4006,4938,31,16,18,13
44457,48617,443,54481,443,allow,10802,2841,7961,29,21,14,15
44458,64367,443,64367,443,allow,4347,1440,2907,19,26,11,8
44459,47401,80,21233,80,allow,3158,1159,1999,14,16,8,6
44460,11044,443,11044,443,allow,6981,948,6033,17,27,10,7
44461,11139,443,11139,443,allow,6981,948,6033,17,27,10,7
44462,55642,26872,53975,26872,allow,70,70,0,2,8,2,0
44463,57670,80,41385,80,allow,2274,1660,614,21,15,11,10
44464,53668,50678,24375,50678,allow,70,70,0,2,7,2,0
44465,56612,443,14658,443,allow,4378,1140,3238,14,26,9,5
44466,46669,80,58799,80,allow,1802,1488,314,11,16,6,5
44467,49228,53,49228,53,allow,825,99,726,2,30,1,1
44468,55859,53,0,0,allow,82,82,0,1,30,1,0
44469,50584,49533,38774,49533,allow,161,161,0,1,1200,1,0
44470,53129,38413,48065,38413,allow,70,70,0,2,8,2,0
44471,53646,16561,53092,16561,allow,422,140,282,6,15,3,3
44472,35078,443,8054,443,allow,234,234,0,4,12,4,0
44473,56613,443,45386,443,allow,4378,1140,3238,14,26,9,5
44474,27005,27021,13743,27021,allow,1616,126,1490,4,30,2,2
44475,64915,53,33891,53,allow,170,87,83,2,31,1,1
44476,49844,53,1140,53,allow,762,98,664,2,31,1,1
44477,42971,3478,43871,3478,allow,452,280,172,5,31,3,2
44478,56837,53,17666,53,allow,190,97,93,2,31,1,1
44479,65483,53,14095,53,allow,701,88,613,2,31,1,1
44480,54666,123,26890,123,allow,184,94,90,2,31,1,1
44481,64968,53,11084,53,allow,87,87,0,1,31,1,0
44482,53432,53,53432,53,allow,197,76,121,2,31,1,1
44483,54712,8080,31768,8080,allow,110,110,0,1,31,1,0
44484,29486,53,29486,53,allow,825,99,726,2,31,1,1
44485,36749,443,54855,443,allow,487330,18074,469256,508,122,148,360
44486,50584,39812,60344,39812,allow,161,161,0,1,1200,1,0
44487,45562,5228,50425,5228,allow,29298,3627,25671,67,5346,25,42
44488,55727,53,65316,53,allow,711,87,624,2,31,1,1
44489,49707,53,6726,53,allow,733,85,648,2,31,1,1
44490,57008,443,25539,443,allow,10572,5109,5463,24,122,12,12
44491,6881,5903,6718,5903,allow,501,150,351,2,1200,1,1
44492,53404,443,43178,443,allow,4972,1547,3425,22,149,10,12
44493,51221,31285,26575,31285,allow,2274,924,1350,30,3293,15,15
44494,42463,56205,0,0,deny,62,62,0,1,0,1,0
44495,55773,445,0,0,drop,70,70,0,1,0,1,0
44496,55774,445,0,0,drop,70,70,0,1,0,1,0
44497,11988,48817,0,0,deny,66,66,0,1,0,1,0
44498,60714,445,0,0,drop,70,70,0,1,0,1,0
44499,60702,445,0,0,drop,70,70,0,1,0,1,0
44500,60701,445,0,0,drop,70,70,0,1,0,1,0
44501,45363,23,0,0,deny,60,60,0,1,0,1,0
44502,62682,23,0,0,deny,60,60,0,1,0,1,0
44503,1024,44847,0,0,deny,146,146,0,1,0,1,0
44504,3818,37965,0,0,deny,66,66,0,1,0,1,0
44505,48706,23393,0,0,deny,60,60,0,1,0,1,0
44506,60363,443,34155,443,allow,2962,796,2166,10,120,5,5
44507,56102,445,0,0,drop,66,66,0,1,0,1,0
44508,9327,57470,0,0,deny,62,62,0,1,0,1,0
44509,9283,57470,0,0,deny,66,66,0,1,0,1,0
44510,28194,32468,0,0,deny,62,62,0,1,0,1,0
44511,55762,445,0,0,drop,70,70,0,1,0,1,0
44512,23296,23,0,0,deny,60,60,0,1,0,1,0
44513,62872,50584,0,0,deny,66,66,0,1,0,1,0
44514,25469,57470,0,0,deny,62,62,0,1,0,1,0
44515,56094,445,0,0,drop,66,66,0,1,0,1,0
44516,13281,51050,0,0,deny,66,66,0,1,0,1,0
44517,22619,10214,0,0,deny,66,66,0,1,0,1,0
44518,60688,445,0,0,drop,70,70,0,1,0,1,0
44519,61053,44847,0,0,deny,66,66,0,1,0,1,0
44520,51324,11392,0,0,deny,66,66,0,1,0,1,0
44521,26408,64147,0,0,deny,66,66,0,1,0,1,0
44522,10000,10214,0,0,deny,62,62,0,1,0,1,0
44523,43725,54532,0,0,deny,109,109,0,1,0,1,0
44524,56256,62413,0,0,deny,66,66,0,1,0,1,0
44525,63447,44847,0,0,deny,66,66,0,1,0,1,0
44526,55758,445,0,0,drop,70,70,0,1,0,1,0
44527,13462,35440,0,0,deny,66,66,0,1,0,1,0
44528,56092,445,0,0,drop,66,66,0,1,0,1,0
44529,2422,50584,0,0,deny,66,66,0,1,0,1,0
44530,27785,37965,0,0,deny,66,66,0,1,0,1,0
44531,48557,37965,0,0,deny,62,62,0,1,0,1,0
44532,1695,30349,0,0,deny,148,148,0,1,0,1,0
44533,55747,445,0,0,drop,70,70,0,1,0,1,0
44534,55748,445,0,0,drop,70,70,0,1,0,1,0
44535,54210,36237,0,0,deny,62,62,0,1,0,1,0
44536,50798,36237,0,0,deny,62,62,0,1,0,1,0
44537,49635,443,49110,443,allow,54634,6944,47690,99,47,47,52
44538,57504,443,39017,443,allow,5238,695,4543,14,25,8,6
44539,51046,443,28730,443,allow,17469,2444,15025,39,207,17,22
44540,57592,443,17732,443,allow,2614,1689,925,18,19,10,8
44541,10168,80,10168,80,allow,450,246,204,8,24,5,3
44542,57370,6969,42046,6969,allow,70,70,0,2,8,2,0
44543,50644,5222,32859,5222,allow,11661,4442,7219,87,71,41,46
44544,56301,443,56301,443,allow,4378,1471,2907,19,30,11,8
44545,57236,443,10665,443,allow,225524,59002,166522,402,78,192,210
44546,57441,53,16567,53,allow,177,94,83,2,29,1,1
44547,50584,64027,41636,64027,allow,166,166,0,1,1199,1,0
44548,8464,3389,8464,3389,allow,3910,1805,2105,20,18,12,8
44549,50139,5228,61271,5228,allow,7727,2172,5555,44,104,23,21
44550,56643,443,54840,443,allow,7914,1925,5989,20,15,11,9
44551,53671,60416,42593,60416,allow,70,70,0,2,7,2,0
44552,56620,443,2901,443,allow,1327,918,409,10,25,6,4
44553,62737,443,7478,443,allow,35936,2741,33195,62,15,30,32
44554,60762,40010,40997,40010,allow,316,136,180,6,6,3,3
44555,60426,25988,19003,25988,allow,70,70,0,2,8,2,0
44556,65110,53,12122,53,allow,754,191,563,6,51,3,3
44557,64974,53,51198,53,allow,493,111,382,4,57,2,2
44558,63930,53,2970,53,allow,377,94,283,2,29,1,1
44559,63762,123,63358,123,allow,184,94,90,2,29,1,1
44560,58440,53,26101,53,allow,305,102,203,2,30,1,1
44561,27005,27017,8108,27017,allow,1658,126,1532,4,30,2,2
44562,49469,443,43348,443,allow,8779,3672,5107,17,119,8,9
44563,64429,53,41917,53,allow,217,94,123,2,30,1,1
44564,58509,443,26840,443,allow,13973721,436876,13536845,14039,1629,4929,9110
44565,51860,53854,28127,53854,allow,70,70,0,2,7,2,0
44566,65175,53,18597,53,allow,269,94,175,2,30,1,1
44567,56629,80,58427,80,allow,234,234,0,4,12,4,0
44568,51839,27256,49193,27256,allow,70,70,0,1,5,1,0
44569,56617,443,38005,443,allow,5325,1074,4251,18,25,10,8
44570,56641,443,17125,443,allow,7942,1953,5989,20,15,11,9
44571,38941,443,53715,443,allow,4613,2811,1802,27,95,14,13
44572,45354,443,16907,443,allow,81504,6111,75393,108,20,53,55
44573,55217,53,39301,53,allow,210,102,108,2,30,1,1
44574,57238,443,50721,443,allow,7549,2807,4742,42,78,22,20
44575,49325,443,64992,443,allow,6141,949,5192,17,21,9,8
44576,34076,53,22329,53,allow,168,78,90,2,30,1,1
44577,65268,53,12409,53,allow,395,107,288,4,46,2,2
44578,52935,443,46702,443,allow,1769338,65258,1704080,1935,1200,735,1200
44579,38295,443,36563,443,allow,5247,3662,1585,21,310,11,10
44580,49224,53,17208,53,allow,185,102,83,2,30,1,1
44581,49648,443,58904,443,allow,11011,4522,6489,35,45,17,18
44582,27005,27015,55025,27015,allow,1624,126,1498,4,31,2,2
44583,27005,50002,4449,50002,allow,1642,126,1516,4,31,2,2
44584,60517,53,31898,53,allow,198,86,112,2,30,1,1
44585,60427,61137,3652,61137,allow,70,70,0,2,8,2,0
44586,55641,61762,32816,61762,allow,70,70,0,2,8,2,0
44587,51834,30309,10825,30309,allow,70,70,0,1,5,1,0
44588,54350,443,59930,443,allow,15567,5964,9603,27,21,14,13
44589,34424,443,56503,443,allow,773546,29906,743640,881,1166,350,531
44590,65211,53,49175,53,allow,216,102,114,2,30,1,1
44591,64915,53,11027,53,allow,177,94,83,2,30,1,1
44592,56336,53,12124,53,allow,196,102,94,2,30,1,1
44593,46703,443,29330,443,allow,4589,2090,2499,15,120,7,8
44594,51517,443,20075,443,allow,590874,19818,571056,669,42,271,398
44595,51859,35365,47948,35365,allow,70,70,0,2,7,2,0
44596,57245,443,39703,443,allow,170452,9659,160793,224,68,97,127
44597,59841,80,53537,80,allow,711697,18422,693275,716,50,253,463
44598,12656,53,33403,53,allow,211,86,125,2,30,1,1
44599,56921,443,49898,443,allow,8416,2142,6274,25,330,12,13
44600,62288,443,20087,443,allow,1638,776,862,22,120,11,11
44601,58814,443,50784,443,allow,1549485,41822,1507663,1612,179,520,1092
44602,27005,50001,15883,50001,allow,1656,126,1530,4,31,2,2
44603,56642,443,62625,443,allow,7890,1901,5989,20,15,11,9
44604,50584,16526,25996,16526,allow,166,166,0,1,1199,1,0
44605,12011,443,12011,443,allow,6981,948,6033,17,27,10,7
44606,51324,443,31259,443,allow,2359,1283,1076,17,17,9,8
44607,10166,80,10166,80,allow,450,246,204,8,24,5,3
44608,10169,80,10169,80,allow,450,246,204,8,24,5,3
44609,53177,443,2633,443,allow,6512167,186944,6325223,6347,1216,2089,4258
44610,49432,80,52783,80,allow,2231,899,1332,15,92,8,7
44611,64930,443,64930,443,allow,4596,1689,2907,19,27,11,8
44612,56336,53,53884,53,allow,196,102,94,2,35,1,1
44613,12150,443,12150,443,allow,6981,948,6033,17,27,10,7
44614,49444,53,42796,53,allow,401,88,313,4,38,2,2
44615,53672,20380,35772,20380,allow,70,70,0,2,7,2,0
44616,49756,53,16127,53,allow,396,94,302,4,41,2,2
44617,52931,80,27397,80,allow,78,78,0,1,4,1,0
44618,57247,443,40506,443,allow,93673,74276,19397,194,67,111,83
44619,64575,443,61163,443,allow,24686,1935,22751,36,16,17,19
44620,49633,53,1926,53,allow,245,94,151,2,29,1,1
44621,57246,443,63215,443,allow,360050,17258,342792,432,68,185,247
44622,64252,53,63103,53,allow,350,94,256,2,29,1,1
44623,57244,443,45761,443,allow,230914,10401,220513,290,76,121,169
44624,65377,443,4212,443,allow,4864,2496,2368,33,121,17,16
44625,31574,53,31574,53,allow,213,90,123,2,29,1,1
44626,5588,5588,0,0,allow,3562,1936,1626,48,193,24,24
44627,27005,27017,62934,27017,allow,1658,126,1532,4,30,2,2
44628,57441,53,9760,53,allow,177,94,83,2,29,1,1
44629,63008,53,31909,53,allow,183,86,97,2,30,1,1
44630,64873,53,26833,53,allow,380,110,270,2,30,1,1
44631,27005,27016,51582,27016,allow,1626,126,1500,4,30,2,2
44632,39624,53,30103,53,allow,168,78,90,2,30,1,1
44633,55631,443,48681,443,allow,17521,3850,13671,30,121,13,17
44634,31593,53,31593,53,allow,832,106,726,2,30,1,1
44635,49369,53,33288,53,allow,232,110,122,2,30,1,1
44636,49835,53,27246,53,allow,214,94,120,2,30,1,1
44637,50584,56221,62822,56221,allow,166,166,0,1,1199,1,0
44638,51835,29778,40587,29778,allow,70,70,0,1,5,1,0
44639,57242,443,22643,443,allow,291104,18601,272503,413,77,186,227
44640,65520,56330,49409,56330,allow,558,318,240,9,143,5,4
44641,55773,53,28630,53,allow,102,102,0,1,60,1,0
44642,50045,443,64654,443,allow,4551,2388,2163,16,120,8,8
44643,10164,80,10164,80,allow,7351,803,6548,16,24,7,9
44644,51857,40561,9754,40561,allow,70,70,0,2,8,2,0
44645,56222,443,56222,443,allow,4378,1471,2907,19,27,11,8
44646,56611,443,65034,443,allow,1473,868,605,10,25,6,4
44647,43719,53,43719,53,allow,295,90,205,2,30,1,1
44648,64367,53,24939,53,allow,257,110,147,2,30,1,1
44649,55625,53,6982,53,allow,94,94,0,1,30,1,0
44650,55633,54638,31495,54638,allow,504,318,186,8,15,5,3
44651,51585,80,50569,80,allow,3192,624,2568,10,155,5,5
44652,51840,34678,44195,34678,allow,70,70,0,1,5,1,0
44653,35203,443,62498,443,allow,232,172,60,3,5,2,1
44654,64482,53,36400,53,allow,322,95,227,4,39,2,2
44655,57248,443,32420,443,allow,1021056,38101,982955,1183,64,501,682
44656,36313,443,38446,443,allow,55608,48375,7233,140,95,81,59
44657,64716,53,33097,53,allow,385,134,251,2,30,1,1
44658,56777,53,34621,53,allow,210,94,116,2,30,1,1
44659,64758,443,35347,443,allow,5066,2558,2508,26,127,13,13
44660,49987,53,51873,53,allow,253,86,167,2,30,1,1
44661,27005,27027,58259,27027,allow,1654,126,1528,4,31,2,2
44662,27005,27019,28663,27019,allow,1652,126,1526,4,31,2,2
44663,58809,443,38293,443,allow,4055,1295,2760,11,121,6,5
44664,65453,53,50552,53,allow,242,94,148,2,30,1,1
44665,49855,53,11171,53,allow,290,102,188,2,30,1,1
44666,50584,26301,47178,26301,allow,161,161,0,2,1199,2,0
44667,57470,1337,56441,1337,allow,792,792,0,13,1199,13,0
44668,64915,53,41416,53,allow,177,94,83,2,31,1,1
44669,19473,6881,30849,6881,allow,491,150,341,2,1200,1,1
44670,57470,49001,13810,49001,allow,166,166,0,1,1200,1,0
44671,50584,50901,9302,50901,allow,166,166,0,1,1199,1,0
44672,46991,53,46991,53,allow,262,106,156,2,31,1,1
44673,52354,443,50559,443,allow,10417,5338,5079,22,135,11,11
44674,50584,32808,19666,32808,allow,166,166,0,1,1199,1,0
44675,50584,1283,8544,1283,allow,1617,161,1456,4,1199,2,2
44676,54145,443,52108,443,allow,118,118,0,1,120,1,0
44677,53651,47758,11315,47758,allow,70,70,0,1,5,1,0
44678,42971,3478,30951,3478,allow,312,140,172,4,30,2,2
44679,60049,443,35659,443,allow,10124,2145,7979,24,156,11,13
44680,56639,443,28147,443,allow,7849,1860,5989,20,16,11,9
44681,55744,445,0,0,drop,70,70,0,1,0,1,0
44682,55745,445,0,0,drop,70,70,0,1,0,1,0
44683,56085,445,0,0,drop,66,66,0,1,0,1,0
44684,55742,445,0,0,drop,70,70,0,1,0,1,0
44685,60350,51505,0,0,deny,66,66,0,1,0,1,0
44686,56082,445,0,0,drop,66,66,0,1,0,1,0
44687,25565,62144,0,0,deny,60,60,0,1,0,1,0
44688,57564,56205,0,0,deny,62,62,0,1,0,1,0
44689,55736,445,0,0,drop,70,70,0,1,0,1,0
44690,60678,445,0,0,drop,70,70,0,1,0,1,0
44691,60677,445,0,0,drop,70,70,0,1,0,1,0
44692,60675,445,0,0,drop,70,70,0,1,0,1,0
44693,56067,445,0,0,drop,66,66,0,1,0,1,0
44694,56069,445,0,0,drop,66,66,0,1,0,1,0
44695,56066,445,0,0,drop,66,66,0,1,0,1,0
44696,56063,445,0,0,drop,66,66,0,1,0,1,0
44697,56065,445,0,0,drop,66,66,0,1,0,1,0
44698,56061,445,0,0,drop,66,66,0,1,0,1,0
44699,56062,445,0,0,drop,66,66,0,1,0,1,0
44700,52720,35894,0,0,deny,62,62,0,1,0,1,0
44701,56835,35894,0,0,deny,66,66,0,1,0,1,0
44702,60168,35440,0,0,deny,66,66,0,1,0,1,0
44703,14059,21247,0,0,deny,62,62,0,1,0,1,0
44704,49616,30188,0,0,deny,62,62,0,1,0,1,0
44705,50637,44847,0,0,deny,66,66,0,1,0,1,0
44706,65064,30188,0,0,deny,66,66,0,1,0,1,0
44707,6931,55108,0,0,deny,139,139,0,1,0,1,0
44708,55728,445,0,0,drop,70,70,0,1,0,1,0
44709,55727,445,0,0,drop,70,70,0,1,0,1,0
44710,50716,50584,0,0,deny,74,74,0,1,0,1,0
44711,17579,57470,0,0,deny,62,62,0,1,0,1,0
44712,40474,23117,0,0,deny,62,62,0,1,0,1,0
44713,60671,445,0,0,drop,70,70,0,1,0,1,0
44714,60661,445,0,0,drop,70,70,0,1,0,1,0
44715,60660,445,0,0,drop,70,70,0,1,0,1,0
44716,55722,445,0,0,drop,70,70,0,1,0,1,0
44717,55720,445,0,0,drop,70,70,0,1,0,1,0
44718,56047,445,0,0,drop,66,66,0,1,0,1,0
44719,56049,445,0,0,drop,66,66,0,1,0,1,0
44720,56046,445,0,0,drop,66,66,0,1,0,1,0
44721,3883,50265,0,0,deny,66,66,0,1,0,1,0
44722,60657,445,0,0,drop,70,70,0,1,0,1,0
44723,56582,37965,0,0,deny,62,62,0,1,0,1,0
44724,23770,50584,0,0,deny,66,66,0,1,0,1,0
44725,59564,57470,0,0,deny,66,66,0,1,0,1,0
44726,27783,57470,0,0,deny,62,62,0,1,0,1,0
44727,64903,51050,0,0,deny,66,66,0,1,0,1,0
44728,55716,445,0,0,drop,70,70,0,1,0,1,0
44729,60655,445,0,0,drop,70,70,0,1,0,1,0
44730,19610,55839,0,0,deny,137,137,0,1,0,1,0
44731,65518,5710,0,0,deny,62,62,0,1,0,1,0
44732,55714,445,0,0,drop,70,70,0,1,0,1,0
44733,60654,445,0,0,drop,70,70,0,1,0,1,0
44734,60652,445,0,0,drop,70,70,0,1,0,1,0
44735,60650,445,0,0,drop,70,70,0,1,0,1,0
44736,20400,64147,0,0,deny,62,62,0,1,0,1,0
44737,20400,64147,0,0,deny,145,145,0,1,0,1,0
44738,11023,51505,0,0,deny,62,62,0,1,0,1,0
44739,43916,21,0,0,deny,60,60,0,1,0,1,0
44740,42252,33303,0,0,deny,60,60,0,1,0,1,0
44741,16387,3655,0,0,deny,60,60,0,1,0,1,0
44742,16387,22272,0,0,deny,60,60,0,1,0,1,0
44743,16387,20045,0,0,deny,60,60,0,1,0,1,0
44744,55710,445,0,0,drop,70,70,0,1,0,1,0
44745,16387,44427,0,0,deny,60,60,0,1,0,1,0
44746,20005,37965,0,0,deny,62,62,0,1,0,1,0
44747,16387,7205,0,0,deny,60,60,0,1,0,1,0
44748,16387,16862,0,0,deny,60,60,0,1,0,1,0
44749,16387,35583,0,0,deny,60,60,0,1,0,1,0
44750,16387,63752,0,0,deny,60,60,0,1,0,1,0
44751,16387,64075,0,0,deny,60,60,0,1,0,1,0
44752,13980,23,0,0,deny,60,60,0,1,0,1,0
44753,60637,445,0,0,drop,70,70,0,1,0,1,0
44754,60635,445,0,0,drop,70,70,0,1,0,1,0
44755,60632,445,0,0,drop,70,70,0,1,0,1,0
44756,3996,57470,0,0,deny,62,62,0,1,0,1,0
44757,61002,37965,0,0,deny,145,145,0,1,0,1,0
44758,63779,26467,0,0,deny,66,66,0,1,0,1,0
44759,26536,53,62994,53,allow,306,99,207,2,0,1,1
44760,55697,445,0,0,drop,70,70,0,1,0,1,0
44761,56025,445,0,0,drop,66,66,0,1,0,1,0
44762,60628,445,0,0,drop,70,70,0,1,0,1,0
44763,60629,445,0,0,drop,70,70,0,1,0,1,0
44764,52837,35440,0,0,deny,66,66,0,1,0,1,0
44765,55694,445,0,0,drop,70,70,0,1,0,1,0
44766,34808,22114,0,0,deny,62,62,0,1,0,1,0
44767,63621,30188,0,0,deny,62,62,0,1,0,1,0
44768,48016,57470,0,0,deny,62,62,0,1,0,1,0
44769,1024,50265,0,0,deny,62,62,0,1,0,1,0
44770,26391,44847,0,0,deny,146,146,0,1,0,1,0
44771,56020,445,0,0,drop,66,66,0,1,0,1,0
44772,45682,1,0,0,deny,62,62,0,1,0,1,0
44773,55690,445,0,0,drop,70,70,0,1,0,1,0
44774,56017,445,0,0,drop,66,66,0,1,0,1,0
44775,55688,445,0,0,drop,70,70,0,1,0,1,0
44776,60617,445,0,0,drop,70,70,0,1,0,1,0
44777,8889,10794,0,0,deny,60,60,0,1,0,1,0
44778,60614,445,0,0,drop,70,70,0,1,0,1,0
44779,60612,445,0,0,drop,70,70,0,1,0,1,0
44780,60607,445,0,0,drop,70,70,0,1,0,1,0
44781,55686,445,0,0,drop,70,70,0,1,0,1,0
44782,56013,445,0,0,drop,66,66,0,1,0,1,0
44783,20608,28189,0,0,deny,60,60,0,1,0,1,0
44784,45912,44847,0,0,deny,146,146,0,1,0,1,0
44785,49160,57470,0,0,deny,146,146,0,1,0,1,0
44786,1024,45129,0,0,deny,145,145,0,1,0,1,0
44787,60603,445,0,0,drop,70,70,0,1,0,1,0
44788,30114,65151,0,0,deny,60,60,0,1,0,1,0
44789,60398,46776,0,0,deny,74,74,0,1,0,1,0
44790,60600,445,0,0,drop,70,70,0,1,0,1,0
44791,60599,445,0,0,drop,70,70,0,1,0,1,0
44792,60598,445,0,0,drop,70,70,0,1,0,1,0
44793,58381,57470,0,0,deny,66,66,0,1,0,1,0
44794,56008,445,0,0,drop,66,66,0,1,0,1,0
44795,55679,445,0,0,drop,70,70,0,1,0,1,0
44796,56003,445,0,0,drop,66,66,0,1,0,1,0
44797,56005,445,0,0,drop,66,66,0,1,0,1,0
44798,56004,445,0,0,drop,66,66,0,1,0,1,0
44799,55677,445,0,0,drop,70,70,0,1,0,1,0
44800,55998,445,0,0,drop,66,66,0,1,0,1,0
44801,55997,445,0,0,drop,66,66,0,1,0,1,0
44802,1081,1970,0,0,deny,146,146,0,1,0,1,0
44803,53625,64147,0,0,deny,66,66,0,1,0,1,0
44804,63867,64147,0,0,deny,62,62,0,1,0,1,0
44805,49915,35440,0,0,deny,62,62,0,1,0,1,0
44806,55676,445,0,0,drop,70,70,0,1,0,1,0
44807,63421,53,63421,53,allow,223,86,137,2,30,1,1
44808,57289,443,13366,443,allow,2693,1361,1332,17,19,10,7
44809,57285,443,38646,443,allow,21198,9647,11551,97,20,52,45
44810,49181,2710,53031,2710,allow,70,70,0,2,8,2,0
44811,60115,443,39754,443,allow,268,120,148,5,10,3,2
44812,53776,53,0,0,allow,82,82,0,2,40,2,0
44813,57251,443,64913,443,allow,54515,20774,33741,167,36,88,79
44814,49499,443,5486,443,allow,8848,4908,3940,23,42,12,11
44815,64411,443,21450,443,allow,23357,2589,20768,33,120,13,20
44816,50949,443,50949,443,allow,4453,1546,2907,19,29,11,8
44817,45340,443,58208,443,allow,2504,1442,1062,22,29,12,10
44818,49632,443,35637,443,allow,5598,1185,4413,24,80,13,11
44819,56552,53,56552,53,allow,223,86,137,2,30,1,1
44820,62466,53,62466,53,allow,194,87,107,2,30,1,1
44821,40334,53,40334,53,allow,213,87,126,2,30,1,1
44822,55220,53,55080,53,allow,758,96,662,2,30,1,1
44823,57996,53,57996,53,allow,847,110,737,2,30,1,1
44824,55215,443,18070,443,allow,3717,2233,1484,34,80,20,14
44825,60900,443,51308,443,allow,7426,1877,5549,22,81,13,9
44826,57273,443,35041,443,allow,10926,3915,7011,50,33,28,22
44827,49628,443,15510,443,allow,5600,1187,4413,24,80,13,11
44828,56039,53,8952,53,allow,762,98,664,2,30,1,1
44829,60109,443,54198,443,allow,268,120,148,5,10,3,2
44830,56536,443,5996,443,allow,6044,3444,2600,49,501,25,24
44831,49629,443,16590,443,allow,5600,1187,4413,24,80,13,11
44832,42971,3478,56626,3478,allow,452,280,172,5,30,3,2
44833,60944,443,23317,443,allow,8264,4269,3995,17,31,9,8
44834,50382,80,4705,80,allow,1369,799,570,13,77,7,6
44835,42971,3478,30766,3478,allow,312,140,172,4,30,2,2
44836,46000,443,62571,443,allow,2583,334,2249,7,90,3,4
44837,56664,443,31995,443,allow,7561,2483,5078,26,20,13,13
44838,55193,53,9970,53,allow,200,102,98,2,30,1,1
44839,56836,1,16144,1,allow,130,70,60,2,5,1,1
44840,57892,443,5458,443,allow,6845,1743,5102,22,81,13,9
44841,61589,443,61589,443,allow,4672,1765,2907,19,28,11,8
44842,53653,17436,61017,17436,allow,70,70,0,1,5,1,0
44843,57287,443,20277,443,allow,8960,2778,6182,31,20,16,15
44844,57292,443,37855,443,allow,18591,5839,12752,78,18,44,34
44845,57322,443,7352,443,allow,8237,2784,5453,35,16,21,14
44846,57352,53,30931,53,allow,711,87,624,2,31,1,1
44847,49622,443,43494,443,allow,15336,2803,12533,47,202,24,23
44848,49615,443,24939,443,allow,48705,7643,41062,146,256,77,69
44849,57252,443,17744,443,allow,12683,4753,7930,59,36,33,26
44850,56828,53156,57681,53156,allow,70,70,0,2,8,2,0
44851,57254,443,23704,443,allow,6000,1578,4422,22,36,12,10
44852,51832,40607,33466,40607,allow,66,66,0,1,5,1,0
44853,60365,443,2645,443,allow,130,70,60,2,15,1,1
44854,59773,443,43322,443,allow,165464,10322,155142,189,71,69,120
44855,57291,443,9776,443,allow,2685,1353,1332,17,19,10,7
44856,57290,443,45371,443,allow,2693,1361,1332,17,19,10,7
44857,53650,37096,27046,37096,allow,70,70,0,1,5,1,0
44858,53647,16194,38859,16194,allow,70,70,0,1,5,1,0
44859,51220,443,53814,443,allow,7647,1917,5730,22,80,13,9
44860,49556,443,16559,443,allow,8602,2308,6294,23,82,13,10
44861,33166,53,0,0,allow,82,82,0,2,40,2,0
44862,65027,53,8113,53,allow,758,96,662,2,30,1,1
44863,35747,443,32307,443,allow,8676,3499,5177,31,373,17,14
44864,40127,53,0,0,allow,82,82,0,1,31,1,0
44865,55104,53,12993,53,allow,733,85,648,2,31,1,1
44866,55733,53,35309,53,allow,170,87,83,2,31,1,1
44867,56720,53,21366,53,allow,170,87,83,2,31,1,1
44868,56747,443,3267,443,allow,19030,7323,11707,51,122,23,28
44869,56045,53,44616,53,allow,754,94,660,2,31,1,1
44870,54654,443,37432,443,allow,4869,1016,3853,18,121,9,9
44871,58278,443,36015,443,allow,3581,1045,2536,10,122,5,5
44872,41164,443,62496,443,allow,8582,4759,3823,29,135,14,15
44873,55675,445,0,0,drop,70,70,0,1,0,1,0
44874,51412,51505,0,0,deny,66,66,0,1,0,1,0
44875,35065,23,0,0,deny,60,60,0,1,0,1,0
44876,55674,445,0,0,drop,70,70,0,1,0,1,0
44877,55672,445,0,0,drop,70,70,0,1,0,1,0
44878,55668,445,0,0,drop,70,70,0,1,0,1,0
44879,60594,445,0,0,drop,70,70,0,1,0,1,0
44880,60593,445,0,0,drop,70,70,0,1,0,1,0
44881,60589,445,0,0,drop,70,70,0,1,0,1,0
44882,50341,37965,0,0,deny,66,66,0,1,0,1,0
44883,52144,49344,0,0,deny,62,62,0,1,0,1,0
44884,55991,445,0,0,drop,66,66,0,1,0,1,0
44885,60587,445,0,0,drop,70,70,0,1,0,1,0
44886,33801,62413,0,0,deny,66,66,0,1,0,1,0
44887,55988,445,0,0,drop,66,66,0,1,0,1,0
44888,26180,35440,0,0,deny,66,66,0,1,0,1,0
44889,49191,35440,0,0,deny,66,66,0,1,0,1,0
44890,41794,41794,0,0,deny,308,308,0,1,0,1,0
44891,57282,443,46130,443,allow,11721,2230,9491,39,31,22,17
44892,53238,443,61389,443,allow,13597,1371,12226,26,323,11,15
44893,42644,443,8391,443,allow,8384,2161,6223,24,255,12,12
44894,50236,443,15469,443,allow,5858,791,5067,19,22,10,9
44895,27005,28018,47944,28018,allow,1640,126,1514,4,30,2,2
44896,27005,27017,53303,27017,allow,1634,126,1508,4,30,2,2
44897,27005,32030,25176,32030,allow,1796,252,1544,5,31,3,2
44898,35486,443,63942,443,allow,4630,2803,1827,29,80,14,15
44899,50543,443,30180,443,allow,38667,3344,35323,56,210,24,32
44900,50201,80,38325,80,allow,5015,2123,2892,25,96,14,11
44901,50486,80,43523,80,allow,378,192,186,7,21,4,3
44902,51457,443,1251,443,allow,334,70,264,5,17,1,4
44903,60423,52001,49584,52001,allow,260,140,120,5,9,3,2
44904,50116,22,50116,22,allow,184,120,64,4,4,3,1
44905,64780,53,56336,53,allow,203,86,117,2,29,1,1
44906,50002,53,23419,53,allow,183,102,81,2,30,1,1
44907,64915,53,19337,53,allow,177,94,83,2,29,1,1
44908,48151,123,24928,123,allow,184,94,90,2,30,1,1
44909,52417,443,14213,443,allow,8376,6877,1499,27,31,15,12
44910,37774,443,33221,443,allow,282171,13444,268727,377,201,175,202
44911,41959,443,65186,443,allow,5838,1840,3998,20,80,12,8
44912,51833,47388,62543,47388,allow,70,70,0,1,5,1,0
44913,53248,443,27776,443,allow,41125,3625,37500,62,323,25,37
44914,53242,443,60207,443,allow,42135,4098,38037,64,323,25,39
44915,53256,443,59014,443,allow,29039,3057,25982,46,323,19,27
44916,53252,443,27483,443,allow,31843,2847,28996,50,323,20,30
44917,64745,3389,64745,3389,allow,3413,1458,1955,16,18,8,8
44918,50020,53,1594,53,allow,210,102,108,2,30,1,1
44919,56835,27582,44303,27582,allow,130,70,60,2,5,1,1
44920,60719,443,32077,443,allow,71523,19991,51532,112,41,59,53
44921,55193,53,3630,53,allow,533,102,431,4,42,2,2
44922,42820,443,41684,443,allow,8155,1999,6156,22,81,13,9
44923,52657,53,48551,53,allow,302,210,92,3,30,2,1
44924,53258,443,42318,443,allow,31919,3528,28391,49,323,19,30
44925,49619,443,17429,443,allow,46202,8086,38116,131,243,69,62
44926,49623,443,29272,443,allow,36302,2869,33433,67,180,32,35
44927,52217,80,27362,80,allow,1074,565,509,11,16,6,5
44928,33257,443,43255,443,allow,19341,4612,14729,38,21,19,19
44929,59403,443,58702,443,allow,5853,2409,3444,35,80,16,19
44930,49623,443,17482,443,allow,3972,2532,1440,18,80,10,8
44931,56637,443,26633,443,allow,7907,1918,5989,20,15,11,9
44932,63826,80,41744,80,allow,314,192,122,6,15,4,2
44933,53241,443,7784,443,allow,24835,2671,22164,42,323,17,25
44934,59731,443,62257,443,allow,7236,827,6409,17,25,8,9
44935,56670,443,55495,443,allow,8308,3589,4719,25,19,15,10
44936,53251,443,22293,443,allow,24116,2677,21439,42,323,17,25
44937,59732,443,8520,443,allow,7310,967,6343,18,25,10,8
44938,47325,443,49234,443,allow,130,70,60,2,15,1,1
44939,56593,443,58940,443,allow,1165,662,503,11,25,6,5
44940,59844,80,25773,80,allow,397391,8624,388767,380,49,118,262
44941,64153,53,31839,53,allow,213,94,119,2,30,1,1
44942,50368,53,59190,53,allow,70,70,0,1,30,1,0
44943,57829,443,7967,443,allow,981499,39775,941724,1109,291,439,670
44944,49289,53,43256,53,allow,177,94,83,2,30,1,1
44945,61015,443,14729,443,allow,7863,1962,5901,29,270,16,13
44946,64656,53,38366,53,allow,718,94,624,2,30,1,1
44947,49767,53,47243,53,allow,185,102,83,2,30,1,1
44948,49817,53,12075,53,allow,167,86,81,2,30,1,1
44949,65299,53,37280,53,allow,177,94,83,2,30,1,1
44950,36287,443,35494,443,allow,6419,2962,3457,25,148,12,13
44951,60163,443,56805,443,allow,8929,3204,5725,25,80,14,11
44952,53369,80,53369,80,allow,81339,4340,76999,84,57,22,62
44953,53268,443,17713,443,allow,22541,2143,20398,38,322,16,22
44954,59733,443,63033,443,allow,7310,967,6343,18,25,10,8
44955,64224,53,56405,53,allow,280,94,186,2,30,1,1
44956,55275,53,25486,53,allow,213,94,119,2,30,1,1
44957,50734,443,16701,443,allow,1726,668,1058,13,2033,4,9
44958,50172,443,42288,443,allow,152228,30166,122062,215,153,92,123
44959,53282,443,19856,443,allow,13300,1695,11605,27,321,12,15
44960,53260,443,22555,443,allow,23664,2213,21451,41,323,17,24
44961,56643,443,24007,443,allow,1560,988,572,13,21,7,6
44962,57276,443,44097,443,allow,14236,2699,11537,51,31,27,24
44963,63843,53603,44636,53603,allow,312,132,180,6,6,3,3
44964,42618,443,18541,443,allow,4694,2432,2262,34,81,16,18
44965,51169,443,30146,443,allow,975832,29038,946794,991,51,341,650
44966,56572,443,48876,443,allow,10325,2594,7731,28,27,16,12
44967,43920,443,54926,443,allow,12666,4180,8486,37,504,20,17
44968,60228,443,13572,443,allow,1058,641,417,10,50,6,4
44969,58692,53,28574,53,allow,199,94,105,2,30,1,1
44970,64238,53,60413,53,allow,213,102,111,2,30,1,1
44971,49767,53,2563,53,allow,177,94,83,2,30,1,1
44972,65053,53,62092,53,allow,197,94,103,2,30,1,1
44973,49620,443,27552,443,allow,13241,2865,10376,60,242,26,34
44974,60848,443,33330,443,allow,6513,1863,4650,28,255,15,13
44975,57283,443,46704,443,allow,7792,2318,5474,38,27,22,16
44976,53246,443,34451,443,allow,30174,2792,27382,47,323,19,28
44977,54966,53,31791,53,allow,254,87,167,4,31,2,2
44978,53278,443,20618,443,allow,12634,1635,10999,26,322,11,15
44979,49505,443,2441,443,allow,35158,5065,30093,53,42,18,35
44980,57250,443,30751,443,allow,345315,16365,328950,459,36,206,253
44981,50386,80,26554,80,allow,6718,3126,3592,16,77,8,8
44982,42971,3478,49754,3478,allow,312,140,172,4,29,2,2
44983,36435,443,62505,443,allow,7046,3518,3528,66,612,35,31
44984,50475,80,52145,80,allow,2669,1434,1235,11,21,6,5
44985,53270,443,48173,443,allow,21684,2143,19541,38,322,16,22
44986,56640,443,64695,443,allow,7797,1808,5989,20,14,11,9
44987,50487,80,25708,80,allow,378,192,186,7,21,4,3
44988,53266,443,29507,443,allow,30264,2794,27470,47,322,19,28
44989,64644,53,30010,53,allow,364,89,275,4,33,2,2
44990,47002,53,47002,53,allow,244,98,146,2,31,1,1
44991,53272,443,47485,443,allow,20745,2083,18662,36,322,15,21
44992,56837,53,14391,53,allow,195,102,93,2,33,1,1
44993,51831,26270,17546,26270,allow,70,70,0,1,5,1,0
44994,51855,23268,62200,23268,allow,70,70,0,2,7,2,0
44995,60114,443,25008,443,allow,268,120,148,5,10,3,2
44996,53706,80,53481,80,allow,1398,590,808,9,111,6,3
44997,49930,443,7030,443,allow,7934,1836,6098,23,15,13,10
44998,50478,80,37121,80,allow,2869,1173,1696,11,21,6,5
44999,50472,80,63342,80,allow,12222,3865,8357,23,22,11,12
45000,60428,55172,58181,55172,allow,320,140,180,6,7,3,3
45001,12064,53,12064,53,allow,244,98,146,2,33,1,1
45002,56638,443,63919,443,allow,7855,1866,5989,20,15,11,9
45003,51836,37753,57785,37753,allow,70,70,0,1,4,1,0
45004,57299,443,9312,443,allow,23282,4482,18800,67,17,35,32
45005,59735,443,11468,443,allow,7310,967,6343,18,25,10,8
45006,57293,443,65420,443,allow,7057,2815,4242,37,18,21,16
45007,55629,36190,12886,36190,allow,504,318,186,8,16,5,3
45008,59134,443,19073,443,allow,6857,1727,5130,23,316,13,10
45009,55634,58846,20945,58846,allow,70,70,0,1,5,1,0
45010,43518,443,23490,443,allow,10265,2118,8147,23,81,13,10
45011,5588,5588,0,0,allow,3354,1792,1562,46,194,23,23
45012,52407,443,53495,443,allow,100194,6406,93788,171,24,85,86
45013,64459,53,56371,53,allow,251,94,157,2,29,1,1
45014,62736,80,60766,80,allow,1516,481,1035,11,15,6,5
45015,54447,53,9967,53,allow,199,94,105,2,29,1,1
45016,45701,80,26870,80,allow,1579,1217,362,8,15,5,3
45017,39850,53,3565,53,allow,199,94,105,2,29,1,1
45018,27005,27015,29834,27015,allow,1634,126,1508,4,30,2,2
45019,46455,53,32632,53,allow,168,78,90,2,30,1,1
45020,50659,53,45075,53,allow,168,78,90,2,30,1,1
45021,49289,53,16244,53,allow,177,94,83,2,30,1,1
45022,5588,5588,0,0,allow,3354,1792,1562,46,192,23,23
45023,32742,53,46400,53,allow,207,86,121,2,30,1,1
45024,56345,53,18764,53,allow,199,94,105,2,30,1,1
45025,54147,443,52345,443,allow,3334,331,3003,10,120,5,5
45026,50287,53,28262,53,allow,781,94,687,2,30,1,1
45027,50239,53,31652,53,allow,183,94,89,2,31,1,1
45028,27005,50003,20006,50003,allow,887,126,761,2,31,1,1
45029,49562,443,59931,443,allow,3380,346,3034,12,120,5,7
45030,38700,443,53165,443,allow,40207,7892,32315,59,152,23,36
45031,57470,58753,38248,58753,allow,166,166,0,1,1199,1,0
45032,57271,443,34428,443,allow,7155,2151,5004,34,33,20,14
45033,57274,443,44033,443,allow,11536,2572,8964,41,33,24,17
45034,55635,38649,44116,38649,allow,70,70,0,1,5,1,0
45035,50721,443,49373,443,allow,5828,1439,4389,16,75,9,7
45036,55628,13343,19881,13343,allow,634,388,246,10,18,6,4
45037,46328,443,26248,443,allow,446664,48034,398630,698,223,326,372
45038,37759,53,22729,53,allow,164,78,86,2,30,1,1
45039,27005,50003,10902,50003,allow,1636,126,1510,4,31,2,2
45040,57288,443,58142,443,allow,116807,21042,95765,315,19,161,154
45041,64749,3389,64749,3389,allow,3347,1458,1889,15,18,8,7
45042,57284,443,12442,443,allow,1402,917,485,12,27,7,5
45043,51838,29448,59159,29448,allow,70,70,0,1,5,1,0
45044,51830,32787,57258,32787,allow,70,70,0,1,5,1,0
45045,54100,80,44998,80,allow,78,78,0,1,5,1,0
45046,62952,38741,48558,38741,allow,18963,9580,9383,211,348,109,102
45047,52218,80,8584,80,allow,2373,614,1759,11,15,6,5
45048,50318,53,54870,53,allow,94,94,0,1,30,1,0
45049,65299,53,60442,53,allow,177,94,83,2,30,1,1
45050,59486,443,24695,443,allow,9161,2202,6959,28,374,14,14
45051,53245,443,1855,443,allow,28206,2737,25469,45,323,18,27
45052,57272,443,35317,443,allow,6445,2145,4300,29,33,17,12
45053,57275,443,6369,443,allow,22074,3005,19069,58,31,31,27
45054,54101,80,21675,80,allow,78,78,0,1,5,1,0
45055,55632,45682,33177,45682,allow,70,70,0,1,5,1,0
45056,56671,443,62348,443,allow,8300,3581,4719,25,19,15,10
45057,43762,443,5128,443,allow,7775,1963,5812,22,77,13,9
45058,57327,443,38850,443,allow,5613,733,4880,16,15,9,7
45059,49943,53,18559,53,allow,718,94,624,2,30,1,1
45060,43851,53,43851,53,allow,227,90,137,2,30,1,1
45061,48737,53,48737,53,allow,227,90,137,2,30,1,1
45062,49872,53,36268,53,allow,331,126,205,2,30,1,1
45063,49995,53,57379,53,allow,197,102,95,2,30,1,1
45064,56006,53,33224,53,allow,183,102,81,2,30,1,1
45065,55261,53,37106,53,allow,177,94,83,2,30,1,1
45066,64902,53,39715,53,allow,231,110,121,2,30,1,1
45067,6881,6881,48403,6881,allow,502,150,352,2,1200,1,1
45068,55619,53,59792,53,allow,241,78,163,2,30,1,1
45069,57364,53,64164,53,allow,177,94,83,2,30,1,1
45070,55757,53,48609,53,allow,177,94,83,2,30,1,1
45071,35041,443,38147,443,allow,16010,4754,11256,47,130,20,27
45072,21133,6889,63864,6889,allow,481,150,331,2,1199,1,1
45073,57470,43836,52896,43836,allow,402,132,270,6,1209,3,3
45074,42288,443,48757,443,allow,16985,7850,9135,39,121,19,20
45075,52317,5223,5494,5223,allow,6070,1779,4291,17,3600,8,9
45076,51860,443,38045,443,allow,6577,1938,4639,14,121,7,7
45077,50265,13826,10952,13826,allow,330,330,0,6,1200,6,0
45078,62704,443,4818,443,allow,6805,3445,3360,31,121,15,16
45079,36732,443,61155,443,allow,7449,2359,5090,15,120,7,8
45080,40183,443,34811,443,allow,6065,2277,3788,17,135,8,9
45081,57470,49160,41673,49160,allow,132,132,0,3,1199,3,0
45082,53667,49160,27701,49160,allow,320,140,180,6,7,3,3
45083,57308,443,32709,443,allow,8837,3033,5804,44,16,24,20
45084,64968,53,21697,53,allow,250,102,148,2,31,1,1
45085,53128,29593,28307,29593,allow,70,70,0,2,9,2,0
45086,38681,443,38681,443,allow,3028,1828,1200,19,21,11,8
45087,65521,53,52937,53,allow,167,86,81,2,30,1,1
45088,53643,8118,59357,8118,allow,2104,1209,895,15,16,7,8
45089,49528,53,57566,53,allow,177,94,83,2,30,1,1
45090,55009,53,51311,53,allow,241,78,163,2,30,1,1
45091,55987,445,0,0,drop,66,66,0,1,0,1,0
45092,55985,445,0,0,drop,66,66,0,1,0,1,0
45093,55656,445,0,0,drop,70,70,0,1,0,1,0
45094,55655,445,0,0,drop,70,70,0,1,0,1,0
45095,22683,39210,0,0,deny,60,60,0,1,0,1,0
45096,55651,445,0,0,drop,70,70,0,1,0,1,0
45097,55984,445,0,0,drop,66,66,0,1,0,1,0
45098,55645,445,0,0,drop,70,70,0,1,0,1,0
45099,55646,445,0,0,drop,70,70,0,1,0,1,0
45100,57433,21247,0,0,deny,66,66,0,1,0,1,0
45101,60586,445,0,0,drop,70,70,0,1,0,1,0
45102,54545,49344,0,0,deny,66,66,0,1,0,1,0
45103,22275,51505,0,0,deny,62,62,0,1,0,1,0
45104,60573,445,0,0,drop,70,70,0,1,0,1,0
45105,60569,445,0,0,drop,70,70,0,1,0,1,0
45106,55514,1604,0,0,deny,84,84,0,1,0,1,0
45107,55632,445,0,0,drop,70,70,0,1,0,1,0
45108,64990,55442,0,0,deny,66,66,0,1,0,1,0
45109,55973,445,0,0,drop,66,66,0,1,0,1,0
45110,55373,1,0,0,deny,66,66,0,1,0,1,0
45111,63194,50265,0,0,deny,62,62,0,1,0,1,0
45112,28370,35440,0,0,deny,66,66,0,1,0,1,0
45113,50280,57470,0,0,deny,78,78,0,1,0,1,0
45114,46362,35440,0,0,deny,66,66,0,1,0,1,0
45115,45941,23386,0,0,deny,60,60,0,1,0,1,0
45116,27641,39004,0,0,deny,62,62,0,1,0,1,0
45117,55965,445,0,0,drop,66,66,0,1,0,1,0
45118,54989,50265,0,0,deny,66,66,0,1,0,1,0
45119,12107,22114,0,0,deny,66,66,0,1,0,1,0
45120,60560,445,0,0,drop,70,70,0,1,0,1,0
45121,49197,30188,0,0,deny,62,62,0,1,0,1,0
45122,55628,445,0,0,drop,70,70,0,1,0,1,0
45123,26699,35253,0,0,deny,62,62,0,1,0,1,0
45124,55963,445,0,0,drop,66,66,0,1,0,1,0
45125,55618,445,0,0,drop,70,70,0,1,0,1,0
45126,55619,445,0,0,drop,70,70,0,1,0,1,0
45127,55616,445,0,0,drop,70,70,0,1,0,1,0
45128,55614,445,0,0,drop,70,70,0,1,0,1,0
45129,11136,15503,0,0,deny,62,62,0,1,0,1,0
45130,55611,445,0,0,drop,70,70,0,1,0,1,0
45131,55955,445,0,0,drop,66,66,0,1,0,1,0
45132,55952,445,0,0,drop,66,66,0,1,0,1,0
45133,58497,39004,0,0,deny,66,66,0,1,0,1,0
45134,59772,62413,0,0,deny,66,66,0,1,0,1,0
45135,64693,26467,0,0,deny,62,62,0,1,0,1,0
45136,36034,35440,0,0,deny,62,62,0,1,0,1,0
45137,55605,445,0,0,drop,70,70,0,1,0,1,0
45138,45908,33330,0,0,deny,60,60,0,1,0,1,0
45139,60548,445,0,0,drop,70,70,0,1,0,1,0
45140,60547,445,0,0,drop,70,70,0,1,0,1,0
45141,60549,445,0,0,drop,70,70,0,1,0,1,0
45142,4257,35440,0,0,deny,62,62,0,1,0,1,0
45143,55937,445,0,0,drop,66,66,0,1,0,1,0
45144,55940,445,0,0,drop,66,66,0,1,0,1,0
45145,55934,445,0,0,drop,66,66,0,1,0,1,0
45146,55935,445,0,0,drop,66,66,0,1,0,1,0
45147,55939,445,0,0,drop,66,66,0,1,0,1,0
45148,55933,445,0,0,drop,66,66,0,1,0,1,0
45149,55938,445,0,0,drop,66,66,0,1,0,1,0
45150,55932,445,0,0,drop,66,66,0,1,0,1,0
45151,59312,22,59312,22,deny,327,140,187,4,0,2,2
45152,57174,57470,0,0,deny,66,66,0,1,0,1,0
45153,55598,445,0,0,drop,70,70,0,1,0,1,0
45154,55596,445,0,0,drop,70,70,0,1,0,1,0
45155,55238,21247,0,0,deny,62,62,0,1,0,1,0
45156,48706,23394,0,0,deny,60,60,0,1,0,1,0
45157,55591,445,0,0,drop,70,70,0,1,0,1,0
45158,46292,42873,0,0,deny,72,72,0,1,0,1,0
45159,55590,445,0,0,drop,70,70,0,1,0,1,0
45160,59724,64147,0,0,deny,66,66,0,1,0,1,0
45161,60544,445,0,0,drop,70,70,0,1,0,1,0
45162,60540,445,0,0,drop,70,70,0,1,0,1,0
45163,46945,64147,0,0,deny,62,62,0,1,0,1,0
45164,60533,445,0,0,drop,70,70,0,1,0,1,0
45165,443,52504,0,0,deny,97,97,0,1,0,1,0
45166,55920,445,0,0,drop,66,66,0,1,0,1,0
45167,55919,445,0,0,drop,66,66,0,1,0,1,0
45168,55917,445,0,0,drop,66,66,0,1,0,1,0
45169,65495,11392,0,0,deny,66,66,0,1,0,1,0
45170,55586,445,0,0,drop,70,70,0,1,0,1,0
45171,62740,44847,0,0,deny,146,146,0,1,0,1,0
45172,60530,445,0,0,drop,70,70,0,1,0,1,0
45173,7978,50584,0,0,deny,66,66,0,1,0,1,0
45174,58213,37807,0,0,deny,66,66,0,1,0,1,0
45175,55585,445,0,0,drop,70,70,0,1,0,1,0
45176,60527,445,0,0,drop,70,70,0,1,0,1,0
45177,32707,11392,0,0,deny,62,62,0,1,0,1,0
45178,52870,22197,0,0,deny,66,66,0,1,0,1,0
45179,60519,445,0,0,drop,70,70,0,1,0,1,0
45180,60516,445,0,0,drop,70,70,0,1,0,1,0
45181,60515,445,0,0,drop,70,70,0,1,0,1,0
45182,47037,1,0,0,deny,62,62,0,1,0,1,0
45183,51818,37965,0,0,deny,66,66,0,1,0,1,0
45184,50784,50584,0,0,deny,62,62,0,1,0,1,0
45185,55580,445,0,0,drop,70,70,0,1,0,1,0
45186,50914,51505,0,0,deny,66,66,0,1,0,1,0
45187,54530,35440,0,0,deny,66,66,0,1,0,1,0
45188,60510,445,0,0,drop,70,70,0,1,0,1,0
45189,60508,445,0,0,drop,70,70,0,1,0,1,0
45190,60504,445,0,0,drop,70,70,0,1,0,1,0
45191,57472,44847,0,0,deny,66,66,0,1,0,1,0
45192,46495,4607,0,0,deny,60,60,0,1,0,1,0
45193,57969,42873,0,0,deny,66,66,0,1,0,1,0
45194,55567,445,0,0,drop,70,70,0,1,0,1,0
45195,59994,11446,0,0,deny,66,66,0,1,0,1,0
45196,57114,35440,0,0,deny,62,62,0,1,0,1,0
45197,55564,445,0,0,drop,70,70,0,1,0,1,0
45198,62438,37807,0,0,deny,66,66,0,1,0,1,0
45199,55898,445,0,0,drop,66,66,0,1,0,1,0
45200,51183,56205,0,0,deny,66,66,0,1,0,1,0
45201,60501,445,0,0,drop,70,70,0,1,0,1,0
45202,60498,445,0,0,drop,70,70,0,1,0,1,0
45203,45472,8168,0,0,deny,62,62,0,1,0,1,0
45204,58110,23,0,0,deny,60,60,0,1,0,1,0
45205,19875,30170,0,0,deny,145,145,0,1,0,1,0
45206,50438,50584,0,0,deny,146,146,0,1,0,1,0
45207,55560,445,0,0,drop,70,70,0,1,0,1,0
45208,54047,50011,0,0,deny,66,66,0,1,0,1,0
45209,43657,50011,0,0,deny,62,62,0,1,0,1,0
45210,55558,445,0,0,drop,70,70,0,1,0,1,0
45211,55891,445,0,0,drop,66,66,0,1,0,1,0
45212,60970,20541,0,0,deny,66,66,0,1,0,1,0
45213,55888,445,0,0,drop,66,66,0,1,0,1,0
45214,55556,445,0,0,drop,70,70,0,1,0,1,0
45215,16285,23,0,0,deny,60,60,0,1,0,1,0
45216,60489,445,0,0,drop,70,70,0,1,0,1,0
45217,14252,35993,0,0,deny,62,62,0,1,0,1,0
45218,60482,445,0,0,drop,70,70,0,1,0,1,0
45219,60481,445,0,0,drop,70,70,0,1,0,1,0
45220,60479,445,0,0,drop,70,70,0,1,0,1,0
45221,54210,64097,0,0,deny,66,66,0,1,0,1,0
45222,55884,445,0,0,drop,66,66,0,1,0,1,0
45223,1821,64147,0,0,deny,66,66,0,1,0,1,0
45224,52724,64147,0,0,deny,62,62,0,1,0,1,0
45225,28124,37965,0,0,deny,62,62,0,1,0,1,0
45226,64589,53,29733,53,allow,742,88,654,2,30,1,1
45227,55547,53,56945,53,allow,738,86,652,2,30,1,1
45228,38085,443,38085,443,allow,1452,817,635,16,20,9,7
45229,38464,443,38464,443,allow,33734,3007,30727,53,90,29,24
45230,41919,53,41919,53,allow,223,86,137,2,30,1,1
45231,49528,53,46480,53,allow,170,87,83,2,30,1,1
45232,65414,443,41456,443,allow,2494,1643,851,17,25,9,8
45233,137,137,40295,137,allow,114,114,0,2,32,2,0
45234,53479,80,7819,80,allow,3307,937,2370,17,16,10,7
45235,61500,443,52553,443,allow,14738,2175,12563,24,16,10,14
45236,44455,53,21066,53,allow,221,75,146,2,30,1,1
45237,59403,443,14686,443,allow,30995,9655,21340,65,121,27,38
45238,58649,443,35795,443,allow,7701,2215,5486,28,373,14,14
45239,56834,46513,28288,46513,allow,70,70,0,1,5,1,0
45240,38508,443,38508,443,allow,279067,22871,256196,327,90,145,182
45241,38144,443,38144,443,allow,14849,2263,12586,29,90,17,12
45242,46741,53,52840,53,allow,221,75,146,2,30,1,1
45243,64614,53,3783,53,allow,168,86,82,2,30,1,1
45244,50314,31652,0,0,allow,66,66,0,1,90,1,0
45245,57424,53,20131,53,allow,170,87,83,2,31,1,1
45246,38409,443,38409,443,allow,1452,817,635,16,20,9,7
45247,45339,443,35795,443,allow,2312,1382,930,19,34,11,8
45248,55940,53,24862,53,allow,168,86,82,2,30,1,1
45249,56143,3389,56143,3389,allow,4365,2581,1784,20,32,11,9
45250,45338,443,42439,443,allow,2719,1454,1265,22,34,12,10
45251,48981,15000,58211,15000,allow,130,70,60,2,5,1,1
45252,56717,53,9802,53,allow,711,87,624,2,30,1,1
45253,58280,443,25550,443,allow,1786,172,1614,7,121,3,4
45254,51690,443,24259,443,allow,9320,4615,4705,25,120,12,13
45255,50178,53,43275,53,allow,172,88,84,2,31,1,1
45256,9087,53,9087,53,allow,215,80,135,2,33,1,1
45257,49450,443,32537,443,allow,9704,2335,7369,20,26,10,10
45258,55782,53,3411,53,allow,238,87,151,2,30,1,1
45259,44847,51365,14892,51365,allow,509,150,359,2,1200,1,1
45260,50584,49647,42268,49647,allow,523,161,362,2,1200,1,1
45261,54522,443,63026,443,allow,4728282,133897,4594385,4756,80,1650,3106
45262,61719,80,27024,80,allow,32457,1499,30958,42,50,16,26
45263,58701,80,43595,80,allow,12499310,161518,12337792,10496,70,2325,8171
45264,50972,3544,16024,3544,allow,258,107,151,2,30,1,1
45265,61734,443,59784,443,allow,231110,14545,216565,307,18,154,153
45266,56336,53,18502,53,allow,192,98,94,2,30,1,1
45267,56131,53,17639,53,allow,238,87,151,2,30,1,1
45268,42959,443,5921,443,allow,795,795,0,2,154,2,0
45269,50584,48493,7175,48493,allow,161,161,0,1,1200,1,0
45270,50584,10312,63675,10312,allow,161,161,0,2,1200,2,0
45271,57000,53,25419,53,allow,188,96,92,2,31,1,1
45272,27005,30009,8020,30009,allow,889,126,763,3,31,2,1
45273,53810,443,53810,443,allow,7656,4622,3034,24,139,12,12
45274,56625,53,10109,53,allow,711,87,624,2,31,1,1
45275,55664,53,52942,53,allow,711,87,624,2,31,1,1
45276,57073,53,4074,53,allow,99,99,0,1,31,1,0
45277,38770,443,52968,443,allow,140155,6367,133788,173,145,62,111
45278,50584,63591,44593,63591,allow,161,161,0,2,1200,2,0
45279,50203,443,50531,443,allow,3792,871,2921,16,121,7,9
45280,50584,1070,63097,1070,allow,161,161,0,2,1200,2,0
45281,37371,5228,12391,5228,allow,3277,1954,1323,27,3600,14,13
45282,50584,16453,1503,16453,allow,161,161,0,2,1200,2,0
45283,50584,6889,32589,6889,allow,311,311,0,3,1200,3,0
45284,30960,45713,7044,45713,allow,330,330,0,6,3610,6,0
45285,53043,51050,0,0,deny,62,62,0,1,0,1,0
45286,21674,28189,0,0,deny,60,60,0,1,0,1,0
45287,1035,26467,0,0,deny,62,62,0,1,0,1,0
45288,5179,50265,0,0,deny,62,62,0,1,0,1,0
45289,60476,445,0,0,drop,70,70,0,1,0,1,0
45290,55549,445,0,0,drop,70,70,0,1,0,1,0
45291,58455,80,58455,80,allow,348,132,216,6,15,3,3
45292,60470,445,0,0,drop,70,70,0,1,0,1,0
45293,60471,445,0,0,drop,70,70,0,1,0,1,0
45294,60469,445,0,0,drop,70,70,0,1,0,1,0
45295,55877,445,0,0,drop,66,66,0,1,0,1,0
45296,55547,445,0,0,drop,70,70,0,1,0,1,0
45297,22971,50584,0,0,deny,62,62,0,1,0,1,0
45298,18623,1,0,0,deny,66,66,0,1,0,1,0
45299,55869,445,0,0,drop,66,66,0,1,0,1,0
45300,55875,445,0,0,drop,66,66,0,1,0,1,0
45301,55872,445,0,0,drop,66,66,0,1,0,1,0
45302,55866,445,0,0,drop,66,66,0,1,0,1,0
45303,55868,445,0,0,drop,66,66,0,1,0,1,0
45304,55865,445,0,0,drop,66,66,0,1,0,1,0
45305,55546,445,0,0,drop,70,70,0,1,0,1,0
45306,29989,26467,0,0,deny,66,66,0,1,0,1,0
45307,55545,445,0,0,drop,70,70,0,1,0,1,0
45308,55544,445,0,0,drop,70,70,0,1,0,1,0
45309,55542,445,0,0,drop,70,70,0,1,0,1,0
45310,55540,445,0,0,drop,70,70,0,1,0,1,0
45311,57093,26467,0,0,deny,66,66,0,1,0,1,0
45312,52526,30188,0,0,deny,62,62,0,1,0,1,0
45313,52754,26467,0,0,deny,66,66,0,1,0,1,0
45314,60466,445,0,0,drop,70,70,0,1,0,1,0
45315,60465,445,0,0,drop,70,70,0,1,0,1,0
45316,60464,445,0,0,drop,70,70,0,1,0,1,0
45317,55864,445,0,0,drop,66,66,0,1,0,1,0
45318,60459,445,0,0,drop,70,70,0,1,0,1,0
45319,55526,445,0,0,drop,70,70,0,1,0,1,0
45320,55525,445,0,0,drop,70,70,0,1,0,1,0
45321,443,21717,0,0,deny,97,97,0,1,0,1,0
45322,55859,445,0,0,drop,66,66,0,1,0,1,0
45323,55519,445,0,0,drop,70,70,0,1,0,1,0
45324,55515,445,0,0,drop,70,70,0,1,0,1,0
45325,55516,445,0,0,drop,70,70,0,1,0,1,0
45326,55858,445,0,0,drop,66,66,0,1,0,1,0
45327,55856,445,0,0,drop,66,66,0,1,0,1,0
45328,53661,34967,21536,34967,allow,70,70,0,2,8,2,0
45329,57307,443,21158,443,allow,8407,3013,5394,43,15,24,19
45330,33040,443,3946,443,allow,118,118,0,1,30,1,0
45331,54087,443,2699,443,allow,2637658,83234,2554424,2794,140,929,1865
45332,27005,30006,10243,30006,allow,888,126,762,3,31,2,1
45333,37854,443,37854,443,allow,1452,817,635,16,20,9,7
45334,57324,443,38455,443,allow,5612,733,4879,16,14,9,7
45335,58706,80,52999,80,allow,4175,3452,723,14,15,7,7
45336,55261,53,19096,53,allow,177,94,83,2,29,1,1
45337,55010,53,1751,53,allow,245,94,151,2,29,1,1
45338,55782,53,43309,53,allow,245,94,151,2,29,1,1
45339,55757,53,56073,53,allow,177,94,83,2,29,1,1
45340,49646,443,27491,443,allow,12279,4202,8077,33,43,16,17
45341,57000,53,24193,53,allow,194,102,92,2,30,1,1
45342,40025,443,22559,443,allow,10012,3016,6996,40,133,19,21
45343,55844,443,40826,443,allow,6881,2073,4808,37,255,18,19
45344,38534,443,44926,443,allow,8918,730,8188,20,72,7,13
45345,38143,443,38143,443,allow,36902,3203,33699,57,90,31,26
45346,51091,80,6090,80,allow,3324,663,2661,12,15,7,5
45347,37628,443,37628,443,allow,1452,817,635,16,20,9,7
45348,57326,443,4725,443,allow,5613,733,4880,16,14,9,7
45349,57325,443,9317,443,allow,5613,733,4880,16,14,9,7
45350,51025,443,40011,443,allow,6999,2523,4476,22,80,13,9
45351,55195,53,34217,53,allow,969,86,883,2,29,1,1
45352,38049,80,38049,80,allow,2180,1555,625,9,86,6,3
45353,58554,443,5045,443,allow,8626,2156,6470,24,81,14,10
45354,49349,53,12679,53,allow,405,110,295,4,38,2,2
45355,50042,53,35274,53,allow,738,86,652,2,29,1,1
45356,49929,443,23324,443,allow,7298,2303,4995,22,16,12,10
45357,49912,53,4964,53,allow,733,94,639,2,29,1,1
45358,55733,53,46336,53,allow,177,94,83,2,29,1,1
45359,57364,53,42885,53,allow,177,94,83,2,29,1,1
45360,52202,443,56757,443,allow,3036,818,2218,12,119,6,6
45361,28010,443,22569,443,allow,5515,1388,4127,18,15,9,9
45362,65521,53,38042,53,allow,167,86,81,2,29,1,1
45363,55782,53,22320,53,allow,245,94,151,2,29,1,1
45364,55734,53,29847,53,allow,733,94,639,2,30,1,1
45365,57396,53,31064,53,allow,183,94,89,2,30,1,1
45366,27005,33059,58962,33059,allow,900,126,774,3,30,2,1
45367,27005,33052,31448,33052,allow,873,126,747,2,30,1,1
45368,60769,443,60769,443,allow,13423,1386,12037,33,17,14,19
45369,60373,443,19425,443,allow,3875761,85491,3790270,3838,89,1315,2523
45370,52924,443,13021,443,allow,5583,1390,4193,19,15,9,10
45371,56131,53,29991,53,allow,245,94,151,2,30,1,1
45372,56720,53,20064,53,allow,177,94,83,2,30,1,1
45373,57396,53,6439,53,allow,183,94,89,2,30,1,1
45374,55940,53,15244,53,allow,168,86,82,2,30,1,1
45375,50124,443,33361,443,allow,24329,7675,16654,47,16,25,22
45376,52923,443,55900,443,allow,5581,1388,4193,19,15,9,10
45377,56581,443,17747,443,allow,4884,1015,3869,17,25,9,8
45378,57424,53,34088,53,allow,177,94,83,2,30,1,1
45379,47971,443,21107,443,allow,9021,1511,7510,21,121,11,10
45380,55223,53,34886,53,allow,168,86,82,2,31,1,1
45381,12532,80,12532,80,allow,6215,769,5446,14,16,7,7
45382,50273,53,27219,53,allow,718,94,624,2,30,1,1
45383,59282,123,52231,123,allow,184,94,90,2,30,1,1
45384,58132,80,58132,80,allow,348,132,216,6,15,3,3
45385,56131,53,25151,53,allow,245,94,151,2,30,1,1
45386,50239,53,39194,53,allow,183,94,89,2,30,1,1
45387,50642,53,60676,53,allow,173,94,79,2,30,1,1
45388,55122,53,24716,53,allow,173,94,79,2,30,1,1
45389,64752,53,32902,53,allow,186,102,84,2,30,1,1
45390,54930,443,22759,443,allow,2349,258,2091,10,120,4,6
45391,49501,443,27772,443,allow,1882,1108,774,17,135,10,7
45392,63064,443,24318,443,allow,12008,2367,9641,32,151,18,14
45393,56134,53,19695,53,allow,167,86,81,2,30,1,1
45394,57000,53,6517,53,allow,194,102,92,2,30,1,1
45395,57396,53,65107,53,allow,183,94,89,2,30,1,1
45396,60760,20010,54790,20010,allow,70,70,0,2,8,2,0
45397,64879,53,23535,53,allow,173,94,79,2,30,1,1
45398,65436,53,10665,53,allow,102,102,0,1,30,1,0
45399,50972,3544,63114,3544,allow,409,107,302,4,30,2,2
45400,52054,443,46268,443,allow,9339,4411,4928,20,135,10,10
45401,57318,443,48526,443,allow,5612,733,4879,16,15,9,7
45402,55112,53,21380,53,allow,245,94,151,2,30,1,1
45403,64879,53,13290,53,allow,165,86,79,2,30,1,1
45404,56720,53,7909,53,allow,177,94,83,2,30,1,1
45405,57470,6969,29118,6969,allow,528,528,0,9,1199,9,0
45406,42841,53,47596,53,allow,168,78,90,2,30,1,1
45407,50584,62758,61935,62758,allow,161,161,0,2,1199,2,0
45408,40107,53,34833,53,allow,168,78,90,2,30,1,1
45409,57321,443,61348,443,allow,5613,733,4880,16,14,9,7
45410,27005,32063,39805,32063,allow,889,126,763,2,30,1,1
45411,37580,443,37580,443,allow,1452,817,635,16,20,9,7
45412,53130,10168,25089,10168,allow,320,140,180,6,5,3,3
45413,49277,53,3822,53,allow,821,102,719,2,30,1,1
45414,57316,443,30855,443,allow,5613,733,4880,16,15,9,7
45415,55730,8060,61259,8060,allow,70,70,0,1,4,1,0
45416,57317,443,9547,443,allow,5614,733,4881,16,15,9,7
45417,38095,443,38095,443,allow,247172,58810,188362,325,90,174,151
45418,57323,443,4968,443,allow,5613,733,4880,16,14,9,7
45419,57320,443,20383,443,allow,5989,926,5063,19,14,10,9
45420,56394,443,3047,443,allow,5019,946,4073,19,34,9,10
45421,33967,5222,10318,5222,allow,74654,9673,64981,221,616,106,115
45422,55733,53,30284,53,allow,177,94,83,2,30,1,1
45423,50239,53,26724,53,allow,183,94,89,2,30,1,1
45424,56134,53,7161,53,allow,167,86,81,2,30,1,1
45425,49216,53,26832,53,allow,401,142,259,2,30,1,1
45426,56006,53,57116,53,allow,183,102,81,2,29,1,1
45427,27005,32078,22538,32078,allow,871,126,745,2,30,1,1
45428,55782,53,15555,53,allow,245,94,151,2,29,1,1
45429,56759,53,4446,53,allow,177,94,83,2,30,1,1
45430,49528,53,36226,53,allow,177,94,83,2,29,1,1
45431,27005,33076,26025,33076,allow,889,126,763,2,31,1,1
45432,63758,443,30040,443,allow,3263,1643,1620,9,119,5,4
45433,57470,13244,33439,13244,allow,166,166,0,1,1199,1,0
45434,50584,6881,19659,6881,allow,161,161,0,2,1200,2,0
45435,50584,9301,1872,9301,allow,498,150,348,4,2396,2,2
45436,56272,53,49117,53,allow,235,86,149,2,30,1,1
45437,49594,53,57290,53,allow,301,102,199,2,30,1,1
45438,56459,53,5237,53,allow,177,94,83,2,30,1,1
45439,27005,32028,64745,32028,allow,900,126,774,2,31,1,1
45440,49171,443,51614,443,allow,7966,2735,5231,22,120,10,12
45441,50584,42504,10356,42504,allow,161,161,0,2,1199,2,0
45442,57306,443,21388,443,allow,8699,3391,5308,40,15,24,16
45443,65480,443,49360,443,allow,310863,9840,301023,323,16,115,208
45444,65047,53,53893,53,allow,196,86,110,2,30,1,1
45445,65530,53,42402,53,allow,194,102,92,2,30,1,1
45446,49528,53,13440,53,allow,177,94,83,2,30,1,1
45447,55770,53,54138,53,allow,167,86,81,2,30,1,1
45448,51966,443,55026,443,allow,35199,15909,19290,70,152,34,36
45449,62377,443,62377,443,allow,4378,1471,2907,19,27,11,8
45450,53664,13701,27246,13701,allow,70,70,0,2,8,2,0
45451,53665,29135,50493,29135,allow,70,70,0,2,8,2,0
45452,49900,4500,63369,4500,allow,78,78,0,1,5,1,0
45453,56759,53,10512,53,allow,177,94,83,2,30,1,1
45454,57424,53,65254,53,allow,177,94,83,2,30,1,1
45455,50584,6881,59238,6881,allow,901,166,735,2,1200,1,1
45456,51850,11981,61118,11981,allow,316,136,180,6,7,3,3
45457,45457,443,33286,443,allow,11989,7908,4081,61,120,31,30
45458,49723,53,39151,53,allow,427,90,337,4,41,2,2
45459,28011,443,11393,443,allow,5577,1390,4187,19,15,9,10
45460,56429,80,57755,80,allow,17188,1559,15629,25,25,10,15
45461,42156,80,50916,80,allow,1323,335,988,10,15,5,5
45462,56131,53,31536,53,allow,245,94,151,2,30,1,1
45463,64531,53,13391,53,allow,754,94,660,2,30,1,1
45464,64614,53,55438,53,allow,168,86,82,2,30,1,1
45465,65047,53,60656,53,allow,184,102,82,2,30,1,1
45466,49431,53,38249,53,allow,767,102,665,2,30,1,1
45467,50642,53,41798,53,allow,165,86,79,2,30,1,1
45468,50584,50545,46451,50545,allow,166,166,0,1,1199,1,0
45469,50265,51413,14137,51413,allow,460,150,310,2,1200,1,1
45470,49557,53,33015,53,allow,211,102,109,2,30,1,1
45471,64286,53,59300,53,allow,274,94,180,2,30,1,1
45472,55910,53,42664,53,allow,183,94,89,2,30,1,1
45473,33288,53,0,0,allow,86,86,0,1,30,1,0
45474,55910,53,63749,53,allow,183,94,89,2,31,1,1
45475,56893,53,20902,53,allow,177,94,83,2,31,1,1
45476,27005,32055,61239,32055,allow,878,126,752,2,31,1,1
45477,55479,53,50336,53,allow,184,94,90,2,31,1,1
45478,64751,53,58884,53,allow,178,94,84,2,31,1,1
45479,45742,443,8175,443,allow,8471,3275,5196,21,120,11,10
45480,46641,443,43427,443,allow,8471,3278,5193,21,120,11,10
45481,58281,443,12495,443,allow,4039,805,3234,17,120,8,9
45482,27005,33035,34801,33035,allow,864,126,738,2,31,1,1
45483,65206,443,20256,443,allow,7525,3267,4258,36,120,17,19
45484,27005,33051,7331,33051,allow,887,126,761,2,31,1,1
45485,27005,32066,2938,32066,allow,881,126,755,2,31,1,1
45486,50584,8999,32902,8999,allow,311,311,0,3,1199,3,0
45487,50584,17991,30598,17991,allow,161,161,0,2,1199,2,0
45488,57470,13332,8538,13332,allow,166,166,0,1,1199,1,0
45489,50584,61421,62887,61421,allow,166,166,0,1,1199,1,0
45490,50584,8999,33361,8999,allow,1237,369,868,6,1199,3,3
45491,50584,64368,19845,64368,allow,161,161,0,2,1200,2,0
45492,50584,49001,14591,49001,allow,166,166,0,1,1199,1,0
45493,50584,18066,56366,18066,allow,1705,536,1169,5,1200,4,1
45494,57470,24451,64687,24451,allow,166,166,0,1,1200,1,0
45495,50584,6882,59204,6882,allow,371,311,60,4,1199,3,1
45496,6882,41923,41297,41923,allow,492,150,342,2,1200,1,1
45497,50584,40926,15001,40926,allow,166,166,0,1,1199,1,0
45498,30188,64511,50224,64511,allow,854,150,704,4,1200,2,2
45499,50584,6881,41717,6881,allow,1357,369,988,6,1200,3,3
45500,36488,443,36488,443,allow,8448,2150,6298,39,98,21,18
45501,65479,443,61050,443,allow,92397,4379,88018,102,16,37,65
45502,49495,443,44088,443,allow,9037,3596,5441,36,321,19,17
45503,55037,443,6546,443,allow,130,70,60,3,5,2,1
45504,50608,443,5976,443,allow,5039,2265,2774,21,30,11,10
45505,36067,443,36067,443,allow,228681,29484,199197,303,110,149,154
45506,56985,53,39491,53,allow,165,86,79,2,30,1,1
45507,50589,53,3456,53,allow,177,94,83,2,30,1,1
45508,35240,443,35240,443,allow,24155,3115,21040,55,98,27,28
45509,61355,443,38386,443,allow,17666,3045,14621,52,213,21,31
45510,52216,80,58055,80,allow,15824,805,15019,25,18,9,16
45511,40547,443,6575,443,allow,4916,2083,2833,24,43,13,11
45512,53208,80,52746,80,allow,2953,785,2168,12,116,8,4
45513,55842,443,52718,443,allow,8661,2036,6625,40,256,19,21
45514,56120,443,26246,443,allow,551795,18805,532990,603,43,220,383
45515,55122,53,17738,53,allow,173,94,79,2,30,1,1
45516,49647,443,38723,443,allow,11011,4522,6489,35,43,17,18
45517,38450,443,40244,443,allow,9299,2445,6854,25,81,14,11
45518,49451,443,61379,443,allow,12802,1977,10825,32,25,14,18
45519,57188,443,33520,443,allow,7162,1731,5431,29,32,14,15
45520,55854,445,0,0,drop,66,66,0,1,0,1,0
45521,51620,56205,0,0,deny,62,62,0,1,0,1,0
45522,60455,445,0,0,drop,70,70,0,1,0,1,0
45523,60444,445,0,0,drop,70,70,0,1,0,1,0
45524,60441,445,0,0,drop,70,70,0,1,0,1,0
45525,55504,445,0,0,drop,70,70,0,1,0,1,0
45526,24853,39828,0,0,deny,60,60,0,1,0,1,0
45527,58550,21247,0,0,deny,66,66,0,1,0,1,0
45528,55844,445,0,0,drop,66,66,0,1,0,1,0
45529,45908,33330,0,0,deny,60,60,0,1,0,1,0
45530,59210,8168,0,0,deny,66,66,0,1,0,1,0
45531,56578,64147,0,0,deny,66,66,0,1,0,1,0
45532,53156,35993,0,0,deny,66,66,0,1,0,1,0
45533,63731,26467,0,0,deny,62,62,0,1,0,1,0
45534,51244,57587,0,0,deny,100,100,0,1,0,1,0
45535,13973,50584,0,0,deny,146,146,0,1,0,1,0
45536,55500,445,0,0,drop,70,70,0,1,0,1,0
45537,443,20550,0,0,deny,97,97,0,1,0,1,0
45538,55836,445,0,0,drop,66,66,0,1,0,1,0
45539,60432,445,0,0,drop,70,70,0,1,0,1,0
45540,56148,37965,0,0,deny,66,66,0,1,0,1,0
45541,55490,445,0,0,drop,70,70,0,1,0,1,0
45542,55491,445,0,0,drop,70,70,0,1,0,1,0
45543,11030,37965,0,0,deny,62,62,0,1,0,1,0
45544,55488,445,0,0,drop,70,70,0,1,0,1,0
45545,55487,445,0,0,drop,70,70,0,1,0,1,0
45546,55834,445,0,0,drop,66,66,0,1,0,1,0
45547,55483,445,0,0,drop,70,70,0,1,0,1,0
45548,53543,44847,0,0,deny,62,62,0,1,0,1,0
45549,1070,26467,0,0,deny,62,62,0,1,0,1,0
45550,54858,51505,0,0,deny,62,62,0,1,0,1,0
45551,55827,445,0,0,drop,66,66,0,1,0,1,0
45552,2440,37807,0,0,deny,66,66,0,1,0,1,0
45553,55820,445,0,0,drop,66,66,0,1,0,1,0
45554,29300,35440,0,0,deny,62,62,0,1,0,1,0
45555,57070,30170,0,0,deny,146,146,0,1,0,1,0
45556,5664,36237,0,0,deny,62,62,0,1,0,1,0
45557,55478,445,0,0,drop,70,70,0,1,0,1,0
45558,17873,23117,0,0,deny,62,62,0,1,0,1,0
45559,56380,36829,0,0,deny,66,66,0,1,0,1,0
45560,55986,26467,0,0,deny,62,62,0,1,0,1,0
45561,3980,63710,0,0,deny,66,66,0,1,0,1,0
45562,60422,445,0,0,drop,70,70,0,1,0,1,0
45563,60420,445,0,0,drop,70,70,0,1,0,1,0
45564,60419,445,0,0,drop,70,70,0,1,0,1,0
45565,43916,21,0,0,deny,60,60,0,1,0,1,0
45566,55470,445,0,0,drop,70,70,0,1,0,1,0
45567,55811,445,0,0,drop,66,66,0,1,0,1,0
45568,55810,445,0,0,drop,66,66,0,1,0,1,0
45569,55808,445,0,0,drop,66,66,0,1,0,1,0
45570,55809,445,0,0,drop,66,66,0,1,0,1,0
45571,55807,445,0,0,drop,66,66,0,1,0,1,0
45572,55806,445,0,0,drop,66,66,0,1,0,1,0
45573,55804,445,0,0,drop,66,66,0,1,0,1,0
45574,55803,445,0,0,drop,66,66,0,1,0,1,0
45575,55469,445,0,0,drop,70,70,0,1,0,1,0
45576,15922,44847,0,0,deny,66,66,0,1,0,1,0
45577,60129,55442,0,0,deny,62,62,0,1,0,1,0
45578,55463,445,0,0,drop,70,70,0,1,0,1,0
45579,55462,445,0,0,drop,70,70,0,1,0,1,0
45580,53490,62413,0,0,deny,62,62,0,1,0,1,0
45581,8889,16520,0,0,deny,60,60,0,1,0,1,0
45582,50878,23,0,0,deny,60,60,0,1,0,1,0
45583,56491,56205,0,0,deny,146,146,0,1,0,1,0
45584,51676,23718,0,0,deny,66,66,0,1,0,1,0
45585,60413,445,0,0,drop,70,70,0,1,0,1,0
45586,60405,445,0,0,drop,70,70,0,1,0,1,0
45587,60404,445,0,0,drop,70,70,0,1,0,1,0
45588,55458,445,0,0,drop,70,70,0,1,0,1,0
45589,47814,51505,0,0,deny,66,66,0,1,0,1,0
45590,55791,445,0,0,drop,66,66,0,1,0,1,0
45591,55790,445,0,0,drop,66,66,0,1,0,1,0
45592,55789,445,0,0,drop,66,66,0,1,0,1,0
45593,58966,30188,0,0,deny,62,62,0,1,0,1,0
45594,60401,445,0,0,drop,70,70,0,1,0,1,0
45595,55457,445,0,0,drop,70,70,0,1,0,1,0
45596,53003,11392,0,0,deny,66,66,0,1,0,1,0
45597,45832,51050,0,0,deny,66,66,0,1,0,1,0
45598,0,0,0,0,deny,98,98,0,1,0,1,0
45599,0,0,0,0,allow,156,156,0,2,0,2,0
45600,0,0,0,0,deny,98,98,0,1,0,1,0
45601,0,0,0,0,deny,98,98,0,1,0,1,0
45602,0,0,0,0,allow,244,244,0,2,0,2,0
45603,0,0,0,0,deny,98,98,0,1,0,1,0
45604,60399,445,0,0,drop,70,70,0,1,0,1,0
45605,60392,445,0,0,drop,70,70,0,1,0,1,0
45606,60391,445,0,0,drop,70,70,0,1,0,1,0
45607,60387,445,0,0,drop,70,70,0,1,0,1,0
45608,50881,50584,0,0,deny,66,66,0,1,0,1,0
45609,55452,445,0,0,drop,70,70,0,1,0,1,0
45610,54742,50584,0,0,deny,66,66,0,1,0,1,0
45611,20198,17372,0,0,deny,62,62,0,1,0,1,0
45612,13907,57470,0,0,deny,62,62,0,1,0,1,0
45613,3803,51505,0,0,deny,62,62,0,1,0,1,0
45614,60382,445,0,0,drop,70,70,0,1,0,1,0
45615,60380,445,0,0,drop,70,70,0,1,0,1,0
45616,60376,445,0,0,drop,70,70,0,1,0,1,0
45617,43104,26467,0,0,deny,62,62,0,1,0,1,0
45618,55439,445,0,0,drop,70,70,0,1,0,1,0
45619,55436,445,0,0,drop,70,70,0,1,0,1,0
45620,23089,48817,0,0,deny,62,62,0,1,0,1,0
45621,16221,50584,0,0,deny,146,146,0,1,0,1,0
45622,1663,30188,0,0,deny,66,66,0,1,0,1,0
45623,55769,445,0,0,drop,66,66,0,1,0,1,0
45624,60374,445,0,0,drop,70,70,0,1,0,1,0
45625,54219,443,4743,443,allow,10323,2834,7489,44,256,21,23
45626,41114,53,0,0,allow,82,82,0,1,30,1,0
45627,55897,53,59750,53,allow,733,85,648,2,30,1,1
45628,55426,53,8033,53,allow,181,98,83,2,30,1,1
45629,55910,53,5285,53,allow,182,93,89,2,30,1,1
45630,56437,53,9819,53,allow,749,94,655,2,30,1,1
45631,33399,443,27816,443,allow,3603,2013,1590,21,42,12,9
45632,34873,80,34873,80,allow,2148,918,1230,10,20,6,4
45633,61497,443,26455,443,allow,15302,2355,12947,30,32,14,16
45634,41626,15000,7526,15000,allow,130,70,60,2,5,1,1
45635,34365,443,34038,443,allow,223826,45909,177917,356,44,176,180
45636,35271,443,35271,443,allow,134405,6968,127437,187,97,85,102
45637,55841,443,33701,443,allow,9333,2019,7314,41,255,19,22
45638,5588,5588,0,0,allow,3562,1936,1626,48,194,24,24
45639,36622,443,36622,443,allow,16116,3253,12863,52,97,29,23
45640,55131,53,48118,53,allow,744,95,649,2,30,1,1
45641,55180,53,64280,53,allow,780,93,687,2,31,1,1
45642,41524,443,23023,443,allow,3976,2652,1324,20,312,11,9
45643,38017,7275,45146,7275,allow,4615,664,3951,15,15,9,6
45644,55164,53,9551,53,allow,170,87,83,2,31,1,1
45645,56141,53,2789,53,allow,184,94,90,2,31,1,1
45646,50306,53,23964,53,allow,814,110,704,2,30,1,1
45647,40768,443,17418,443,allow,3287,2049,1238,12,32,7,5
45648,55630,43736,8013,43736,allow,70,70,0,1,5,1,0
45649,33397,443,15065,443,allow,1348,687,661,14,42,8,6
45650,46219,53,46219,53,allow,237,91,146,2,33,1,1
45651,19698,502,19698,502,allow,60,60,0,1,5,1,0
45652,55840,443,56226,443,allow,9374,2150,7224,42,255,19,23
45653,51272,12210,15332,12210,allow,70,70,0,1,5,1,0
45654,56504,443,16127,443,allow,4467051,102279,4364772,4340,46,1452,2888
45655,55839,443,48499,443,allow,13469,2007,11462,44,256,19,25
45656,57209,53,54053,53,allow,764,99,665,2,30,1,1
45657,38056,443,15075,443,allow,9528,2738,6790,27,81,15,12
45658,55148,53,64223,53,allow,711,87,624,2,30,1,1
45659,55223,53,54493,53,allow,168,86,82,2,31,1,1
45660,13868,53,13868,53,allow,215,80,135,2,34,1,1
45661,55087,443,24413,443,allow,101356,10743,90613,178,31,90,88
45662,55479,53,40449,53,allow,184,94,90,2,31,1,1
45663,54975,443,15865,443,allow,441892,86941,354951,716,73,343,373
45664,33404,443,64550,443,allow,4152,2734,1418,24,40,14,10
45665,38057,443,24418,443,allow,9486,2668,6818,26,81,14,12
45666,36053,443,36053,443,allow,79562,17054,62508,111,109,54,57
45667,51829,46209,24768,46209,allow,66,66,0,1,5,1,0
45668,50669,53,9177,53,allow,578,286,292,9,16,5,4
45669,58886,15000,23434,15000,allow,138,78,60,2,5,1,1
45670,55471,53,27819,53,allow,256,93,163,2,30,1,1
45671,52385,53,0,0,allow,138,69,69,2,30,1,1
45672,55770,53,35170,53,allow,166,85,81,2,30,1,1
45673,56956,53,28771,53,allow,182,93,89,2,30,1,1
45674,65021,53,29006,53,allow,256,93,163,2,30,1,1
45675,49867,53,44107,53,allow,170,87,83,2,30,1,1
45676,50313,53,2331,53,allow,744,95,649,2,30,1,1
45677,57166,53,41004,53,allow,170,87,83,2,30,1,1
45678,51594,53,51594,53,allow,219,92,127,2,30,1,1
45679,58688,53,58688,53,allow,235,92,143,2,30,1,1
45680,34240,53,34240,53,allow,229,89,140,2,31,1,1
45681,55727,53,47747,53,allow,701,88,613,2,31,1,1
45682,60781,443,56303,443,allow,5964,3582,2382,17,136,8,9
45683,49160,40527,18392,40527,allow,854,150,704,4,1201,2,2
45684,30960,45714,65388,45714,allow,330,330,0,6,3609,6,0
45685,55253,53,63534,53,allow,754,94,660,2,31,1,1
45686,27005,27023,64597,27023,allow,875,126,749,2,31,1,1
45687,57020,53,49369,53,allow,738,86,652,2,31,1,1
45688,49168,53,10918,53,allow,192,98,94,2,31,1,1
45689,33571,443,51011,443,allow,4281,1160,3121,12,122,6,6
45690,60701,443,27691,443,allow,5166,1989,3177,15,122,7,8
45691,60373,445,0,0,drop,70,70,0,1,0,1,0
45692,52633,30188,0,0,deny,62,62,0,1,0,1,0
45693,11988,48817,0,0,deny,66,66,0,1,0,1,0
45694,21674,28189,0,0,deny,60,60,0,1,0,1,0
45695,3730,37965,0,0,deny,62,62,0,1,0,1,0
45696,42252,33306,0,0,deny,60,60,0,1,0,1,0
45697,55431,445,0,0,drop,70,70,0,1,0,1,0
45698,55430,445,0,0,drop,70,70,0,1,0,1,0
45699,3818,37965,0,0,deny,66,66,0,1,0,1,0
45700,55428,445,0,0,drop,70,70,0,1,0,1,0
45701,55760,445,0,0,drop,66,66,0,1,0,1,0
45702,55759,445,0,0,drop,66,66,0,1,0,1,0
45703,54619,80,53235,80,allow,2269,1579,690,10,77,6,4
45704,56956,53,61460,53,allow,183,94,89,2,30,1,1
45705,10701,11392,0,0,deny,62,62,0,1,0,1,0
45706,60362,445,0,0,drop,70,70,0,1,0,1,0
45707,62029,36237,0,0,deny,62,62,0,1,0,1,0
45708,62872,50584,0,0,deny,66,66,0,1,0,1,0
45709,60358,445,0,0,drop,70,70,0,1,0,1,0
45710,60354,445,0,0,drop,70,70,0,1,0,1,0
45711,60351,445,0,0,drop,70,70,0,1,0,1,0
45712,22619,10214,0,0,deny,66,66,0,1,0,1,0
45713,10000,10214,0,0,deny,62,62,0,1,0,1,0
45714,7892,50584,0,0,deny,62,62,0,1,0,1,0
45715,55755,445,0,0,drop,66,66,0,1,0,1,0
45716,43260,41615,0,0,deny,145,145,0,1,0,1,0
45717,61053,44847,0,0,deny,66,66,0,1,0,1,0
45718,55421,445,0,0,drop,70,70,0,1,0,1,0
45719,60347,445,0,0,drop,70,70,0,1,0,1,0
45720,55419,445,0,0,drop,70,70,0,1,0,1,0
45721,2422,50584,0,0,deny,66,66,0,1,0,1,0
45722,60344,445,0,0,drop,70,70,0,1,0,1,0
45723,56715,53,50292,53,allow,807,94,713,2,30,1,1
45724,48521,53,27557,53,allow,78,78,0,1,30,1,0
45725,64566,53,24742,53,allow,194,102,92,2,30,1,1
45726,65000,53,35253,53,allow,184,102,82,2,30,1,1
45727,55426,53,25381,53,allow,177,94,83,2,30,1,1
45728,62546,443,43210,443,allow,7740,2603,5137,13,120,7,6
45729,56113,443,21683,443,allow,103486,7416,96070,161,42,82,79
45730,47330,443,38110,443,allow,9297,2727,6570,27,80,15,12
45731,45414,443,2299,443,allow,2215,1412,803,19,38,10,9
45732,44870,80,28005,80,allow,1119,1045,74,7,14,6,1
45733,56635,443,56247,443,allow,8654,2150,6504,20,15,11,9
45734,50589,53,31342,53,allow,177,94,83,2,29,1,1
45735,57424,53,34696,53,allow,177,94,83,2,30,1,1
45736,49867,53,10689,53,allow,177,94,83,2,30,1,1
45737,49867,53,63133,53,allow,177,94,83,2,30,1,1
45738,56119,443,4138,443,allow,144290,9387,134903,217,42,110,107
45739,57470,51413,47712,51413,allow,543,166,377,2,1199,1,1
45740,60927,443,47688,443,allow,3642,606,3036,13,119,6,7
45741,57305,443,15646,443,allow,1574,1089,485,13,15,8,5
45742,34257,7275,41230,7275,allow,2845,419,2426,12,15,7,5
45743,59861,443,36199,443,allow,2128,828,1300,19,40,8,11
45744,35292,443,36726,443,allow,4866,3323,1543,25,94,14,11
45745,57300,443,65390,443,allow,8979,3093,5886,43,15,24,19
45746,40549,443,43115,443,allow,1352,691,661,14,42,8,6
45747,57298,443,20012,443,allow,8313,2850,5463,42,15,24,18
45748,52437,443,30974,443,allow,384,384,0,7,33,7,0
45749,36144,443,36144,443,allow,170890,13800,157090,246,97,123,123
45750,63927,53,2248,53,allow,374,101,273,4,33,2,2
45751,41230,443,4213,443,allow,234,234,0,4,11,4,0
45752,35449,443,35449,443,allow,157435,9243,148192,220,97,101,119
45753,56628,80,40894,80,allow,234,234,0,4,11,4,0
45754,123,123,24489,123,allow,184,94,90,2,29,1,1
45755,50159,53,16650,53,allow,94,94,0,1,29,1,0
45756,53261,12348,58794,12348,allow,552,306,246,9,142,5,4
45757,56985,53,40638,53,allow,165,86,79,2,29,1,1
45758,50178,53,59652,53,allow,178,94,84,2,29,1,1
45759,55244,53,54182,53,allow,186,102,84,2,30,1,1
45760,57000,53,32346,53,allow,194,102,92,2,30,1,1
45761,55770,53,28096,53,allow,167,86,81,2,29,1,1
45762,49867,53,7070,53,allow,177,94,83,2,29,1,1
45763,27005,33038,17485,33038,allow,892,126,766,2,30,1,1
45764,65221,53,41318,53,allow,199,102,97,2,30,1,1
45765,55479,53,22790,53,allow,184,94,90,2,30,1,1
45766,43347,7275,22003,7275,allow,3299,665,2634,18,16,10,8
45767,54985,443,28045,443,allow,23913,3495,20418,50,48,24,26
45768,42117,80,40456,80,allow,1056,682,374,10,15,6,4
45769,56893,53,7619,53,allow,177,94,83,2,30,1,1
45770,49718,53,50641,53,allow,184,94,90,2,30,1,1
45771,64016,53,54267,53,allow,183,94,89,2,30,1,1
45772,56292,53,23956,53,allow,197,102,95,2,30,1,1
45773,55164,53,14668,53,allow,177,94,83,2,30,1,1
45774,35596,5228,54963,5228,allow,3235,1448,1787,26,811,8,18
45775,53141,443,52504,443,allow,37389,3972,33417,69,133,32,37
45776,54620,80,5302,80,allow,14855,1611,13244,26,77,14,12
45777,56688,443,37544,443,allow,32780,6864,25916,142,345,57,85
45778,56694,53,57041,53,allow,196,102,94,2,30,1,1
45779,60892,443,56728,443,allow,22772,8095,14677,46,54,24,22
45780,56634,443,30287,443,allow,8654,2150,6504,20,15,11,9
45781,57073,53,22592,53,allow,197,102,95,2,33,1,1
45782,64867,53,27823,53,allow,765,102,663,2,30,1,1
45783,52793,443,27629,443,allow,1942,1281,661,22,228,16,6
45784,54978,443,60259,443,allow,225539,162879,62660,476,70,262,214
45785,56472,53,44784,53,allow,177,94,83,2,30,1,1
45786,54986,443,39292,443,allow,5684,3042,2642,32,46,18,14
45787,56991,443,56991,443,allow,6305,1352,4953,19,16,10,9
45788,56715,53,19827,53,allow,184,94,90,2,30,1,1
45789,56568,443,49242,443,allow,1277,705,572,13,25,7,6
45790,64052,53,43180,53,allow,211,102,109,2,30,1,1
45791,56141,53,19077,53,allow,184,94,90,2,30,1,1
45792,56571,53,44608,53,allow,211,102,109,2,30,1,1
45793,65221,53,47234,53,allow,199,102,97,2,30,1,1
45794,55770,53,17489,53,allow,167,86,81,2,30,1,1
45795,55820,53,26876,53,allow,184,94,90,2,30,1,1
45796,55264,53,44429,53,allow,177,94,83,2,30,1,1
45797,58744,80,31824,80,allow,4635,1572,3063,12,15,7,5
45798,60894,443,20427,443,allow,34862,6364,28498,64,54,31,33
45799,51500,443,57250,443,allow,7211,823,6388,16,15,10,6
45800,57166,53,28476,53,allow,177,94,83,2,30,1,1
45801,64710,53,46845,53,allow,393,110,283,2,30,1,1
45802,53227,443,46822,443,allow,5430,687,4743,15,73,6,9
45803,53210,80,7510,80,allow,1726,940,786,8,51,5,3
45804,56956,53,13948,53,allow,183,94,89,2,30,1,1
45805,60608,53,20949,53,allow,199,94,105,2,30,1,1
45806,57155,53,11661,53,allow,396,102,294,2,30,1,1
45807,39068,443,31079,443,allow,10831,1381,9450,22,20,12,10
45808,56118,443,45922,443,allow,187927,12115,175812,276,42,137,139
45809,54454,5222,49306,5222,allow,9568,1982,7586,44,345,17,27
45810,46277,443,48047,443,allow,15670,12575,3095,51,37,30,21
45811,41474,443,44338,443,allow,190,70,120,4,15,2,2
45812,57606,443,40796,443,allow,11986,3075,8911,60,4981,31,29
45813,57302,443,55784,443,allow,5614,733,4881,16,15,9,7
45814,51984,80,5183,80,allow,48285,2659,45626,65,15,32,33
45815,57303,443,1835,443,allow,5612,733,4879,16,15,9,7
45816,59860,443,59422,443,allow,2165,987,1178,17,40,8,9
45817,40333,80,15004,80,allow,1049,975,74,6,15,5,1
45818,43274,443,35686,443,allow,6645,1668,4977,21,31,12,9
45819,58600,443,58600,443,allow,4398,1491,2907,19,28,11,8
45820,54981,443,51323,443,allow,36008,2548,33460,55,69,26,29
45821,53209,8081,13912,8081,allow,5349,1928,3421,17,114,10,7
45822,49173,80,62950,80,allow,254,128,126,5,15,3,2
45823,55079,443,57713,443,allow,7156,1187,5969,20,16,10,10
45824,64934,53,52297,53,allow,197,102,95,2,33,1,1
45825,52035,80,61330,80,allow,4185,3462,723,14,15,7,7
45826,35063,443,32697,443,allow,7105,1924,5181,20,25,10,10
45827,58286,20,58286,20,allow,100132,17467,82665,325,619,168,157
45828,53328,443,21893,443,allow,4670,2814,1856,33,81,15,18
45829,53642,39344,30760,39344,allow,612,306,306,10,15,5,5
45830,55244,53,5418,53,allow,186,102,84,2,29,1,1
45831,64800,53,3701,53,allow,343,92,251,4,50,2,2
45832,34305,80,22535,80,allow,2443,1794,649,11,76,6,5
45833,36811,53,36811,53,allow,227,90,137,2,29,1,1
45834,60632,53,3971,53,allow,179,86,93,2,29,1,1
45835,65239,53,28035,53,allow,757,102,655,2,29,1,1
45836,64046,53,35754,53,allow,259,110,149,2,29,1,1
45837,39927,443,15384,443,allow,7787,2370,5417,23,242,11,12
45838,64752,53,22741,53,allow,178,94,84,2,29,1,1
45839,64935,53,42263,53,allow,313,94,219,2,29,1,1
45840,56720,53,11601,53,allow,177,94,83,2,29,1,1
45841,56459,53,48405,53,allow,177,94,83,2,30,1,1
45842,56141,53,30553,53,allow,184,94,90,2,30,1,1
45843,50000,53,56621,53,allow,216,102,114,2,29,1,1
45844,38936,53,29060,53,allow,215,86,129,2,30,1,1
45845,49718,53,42238,53,allow,807,94,713,2,30,1,1
45846,49793,53,43171,53,allow,718,94,624,2,30,1,1
45847,65325,53,48288,53,allow,216,110,106,2,30,1,1
45848,56717,53,10005,53,allow,183,94,89,2,30,1,1
45849,54179,443,27953,443,allow,5037,2002,3035,14,120,7,7
45850,56736,443,56736,443,allow,120441,7846,112595,167,61,76,91
45851,59099,443,44771,443,allow,7066,1861,5205,32,1262,17,15
45852,21544,41599,59404,41599,allow,70,70,0,2,8,2,0
45853,51848,28960,25741,28960,allow,70,70,0,2,9,2,0
45854,39543,7276,23316,7276,allow,1142,558,584,16,16,8,8
45855,65324,53,6556,53,allow,749,94,655,2,30,1,1
45856,65221,53,62850,53,allow,199,102,97,2,30,1,1
45857,64016,53,50450,53,allow,183,94,89,2,30,1,1
45858,49913,53,16997,53,allow,216,110,106,2,31,1,1
45859,55919,53,44823,53,allow,177,94,83,2,30,1,1
45860,57301,443,1829,443,allow,5614,733,4881,16,15,9,7
45861,55640,54435,47783,54435,allow,70,70,0,2,8,2,0
45862,53478,443,15802,443,allow,7692,2183,5509,24,224,14,10
45863,53211,80,10536,80,allow,194,128,66,4,51,3,1
45864,34219,53,25349,53,allow,199,94,105,2,30,1,1
45865,65000,53,40784,53,allow,168,86,82,2,30,1,1
45866,56956,53,49926,53,allow,183,94,89,2,30,1,1
45867,55164,53,64984,53,allow,177,94,83,2,30,1,1
45868,64493,53,11797,53,allow,199,102,97,2,30,1,1
45869,55223,53,62144,53,allow,168,86,82,2,30,1,1
45870,59214,443,59214,443,allow,27659,5508,22151,59,47,31,28
45871,54976,443,13251,443,allow,8156,3281,4875,43,71,21,22
45872,51847,32112,38487,32112,allow,70,70,0,2,9,2,0
45873,56832,23900,53161,23900,allow,130,70,60,2,5,1,1
45874,56831,10434,25973,10434,allow,70,70,0,1,5,1,0
45875,60893,443,5461,443,allow,46690,9390,37300,77,54,36,41
45876,56563,443,19548,443,allow,4528,884,3644,15,26,9,6
45877,56472,53,22766,53,allow,177,94,83,2,30,1,1
45878,49642,443,30931,443,allow,17163,6197,10966,44,43,22,22
45879,53588,8999,41805,8999,allow,1268,960,308,9,32,5,4
45880,57166,53,13391,53,allow,177,94,83,2,30,1,1
45881,55910,53,26815,53,allow,183,94,89,2,30,1,1
45882,46965,443,48357,443,allow,1786,172,1614,7,120,3,4
45883,36857,80,4468,80,allow,11216,2684,8532,28,163,11,17
45884,57470,49160,27757,49160,allow,402,132,270,6,1209,3,3
45885,55479,53,23646,53,allow,184,94,90,2,31,1,1
45886,27005,33026,18106,33026,allow,879,126,753,2,31,1,1
45887,27005,32065,28721,32065,allow,877,126,751,2,31,1,1
45888,57342,53,55197,53,allow,167,86,81,2,31,1,1
45889,27005,33055,54134,33055,allow,888,126,762,2,31,1,1
45890,27005,32039,29232,32039,allow,883,126,757,2,31,1,1
45891,51821,443,38521,443,allow,3002,258,2744,9,119,4,5
45892,57470,9273,56118,9273,allow,491,150,341,2,1199,1,1
45893,55919,53,46329,53,allow,177,94,83,2,31,1,1
45894,27005,33060,25157,33060,allow,928,126,802,2,31,1,1
45895,49923,443,47836,443,allow,7759,2264,5495,19,120,9,10
45896,53863,443,64176,443,allow,13492,3615,9877,42,120,20,22
45897,57470,6881,22501,6881,allow,353,166,187,2,1199,1,1
45898,53350,443,13931,443,allow,5987,2780,3207,21,140,10,11
45899,37965,21859,39298,21859,allow,481,150,331,2,1199,1,1
45900,26467,6969,46826,6969,allow,192,192,0,4,1200,4,0
45901,56550,53,64220,53,allow,183,94,89,2,31,1,1
45902,60761,40010,63900,40010,allow,316,136,180,6,6,3,3
45903,64555,53,10175,53,allow,469,97,372,4,49,2,2
45904,60424,6881,10732,6881,allow,320,140,180,6,7,3,3
45905,64751,53,57978,53,allow,178,94,84,2,30,1,1
45906,57166,53,52593,53,allow,177,94,83,2,30,1,1
45907,50718,80,3998,80,allow,620,320,300,11,166,6,5
45908,61718,443,31970,443,allow,21125,2413,18712,42,49,20,22
45909,61703,80,42538,80,allow,1494,954,540,13,51,8,5
45910,63837,14023,10553,14023,allow,66,66,0,2,8,2,0
45911,54987,443,13107,443,allow,7502,2299,5203,37,18,21,16
45912,55264,53,25192,53,allow,177,94,83,2,30,1,1
45913,46726,53,27470,53,allow,168,78,90,2,30,1,1
45914,49903,53,65277,53,allow,231,110,121,2,30,1,1
45915,55043,53,37629,53,allow,167,86,81,2,30,1,1
45916,55164,53,26323,53,allow,177,94,83,2,30,1,1
45917,56785,443,18418,443,allow,288525,15601,272924,383,33,193,190
45918,56586,53,63496,53,allow,177,94,83,2,31,1,1
45919,64588,53,41773,53,allow,173,94,79,2,31,1,1
45920,27005,27999,21376,27999,allow,913,126,787,2,31,1,1
45921,60341,445,0,0,drop,70,70,0,1,0,1,0
45922,60340,445,0,0,drop,70,70,0,1,0,1,0
45923,55749,445,0,0,drop,66,66,0,1,0,1,0
45924,55418,445,0,0,drop,70,70,0,1,0,1,0
45925,55745,445,0,0,drop,66,66,0,1,0,1,0
45926,55744,445,0,0,drop,66,66,0,1,0,1,0
45927,55741,445,0,0,drop,66,66,0,1,0,1,0
45928,55417,445,0,0,drop,70,70,0,1,0,1,0
45929,50798,36237,0,0,deny,62,62,0,1,0,1,0
45930,55416,445,0,0,drop,70,70,0,1,0,1,0
45931,55411,445,0,0,drop,70,70,0,1,0,1,0
45932,55412,445,0,0,drop,70,70,0,1,0,1,0
45933,55739,445,0,0,drop,66,66,0,1,0,1,0
45934,55738,445,0,0,drop,66,66,0,1,0,1,0
45935,55736,445,0,0,drop,66,66,0,1,0,1,0
45936,23936,35440,0,0,deny,62,62,0,1,0,1,0
45937,39119,44847,0,0,deny,62,62,0,1,0,1,0
45938,60338,445,0,0,drop,70,70,0,1,0,1,0
45939,55398,445,0,0,drop,70,70,0,1,0,1,0
45940,60337,445,0,0,drop,70,70,0,1,0,1,0
45941,60335,445,0,0,drop,70,70,0,1,0,1,0
45942,55397,445,0,0,drop,70,70,0,1,0,1,0
45943,55392,445,0,0,drop,70,70,0,1,0,1,0
45944,55733,445,0,0,drop,66,66,0,1,0,1,0
45945,2918,37965,0,0,deny,62,62,0,1,0,1,0
45946,48676,53393,0,0,deny,60,60,0,1,0,1,0
45947,55388,445,0,0,drop,70,70,0,1,0,1,0
45948,55387,445,0,0,drop,70,70,0,1,0,1,0
45949,60331,445,0,0,drop,70,70,0,1,0,1,0
45950,64294,64147,0,0,deny,62,62,0,1,0,1,0
45951,55730,445,0,0,drop,66,66,0,1,0,1,0
45952,55728,445,0,0,drop,66,66,0,1,0,1,0
45953,55727,445,0,0,drop,66,66,0,1,0,1,0
45954,55725,445,0,0,drop,66,66,0,1,0,1,0
45955,10916,44847,0,0,deny,66,66,0,1,0,1,0
45956,52575,22114,0,0,deny,66,66,0,1,0,1,0
45957,60312,57470,0,0,deny,74,74,0,1,0,1,0
45958,60168,35440,0,0,deny,66,66,0,1,0,1,0
45959,63791,48817,0,0,deny,145,145,0,1,0,1,0
45960,65064,30188,0,0,deny,66,66,0,1,0,1,0
45961,11402,11119,0,0,deny,145,145,0,1,0,1,0
45962,60328,445,0,0,drop,70,70,0,1,0,1,0
45963,55376,445,0,0,drop,70,70,0,1,0,1,0
45964,49717,57470,0,0,deny,62,62,0,1,0,1,0
45965,60313,445,0,0,drop,70,70,0,1,0,1,0
45966,14059,21247,0,0,deny,146,146,0,1,0,1,0
45967,59739,35253,0,0,deny,62,62,0,1,0,1,0
45968,55713,445,0,0,drop,66,66,0,1,0,1,0
45969,55372,445,0,0,drop,70,70,0,1,0,1,0
45970,42463,56205,0,0,deny,62,62,0,1,0,1,0
45971,6882,64147,0,0,deny,146,146,0,1,0,1,0
45972,30306,23,0,0,deny,60,60,0,1,0,1,0
45973,55706,445,0,0,drop,66,66,0,1,0,1,0
45974,35163,30188,0,0,deny,66,66,0,1,0,1,0
45975,60303,445,0,0,drop,70,70,0,1,0,1,0
45976,55363,445,0,0,drop,70,70,0,1,0,1,0
45977,55361,445,0,0,drop,70,70,0,1,0,1,0
45978,55360,445,0,0,drop,70,70,0,1,0,1,0
45979,55358,445,0,0,drop,70,70,0,1,0,1,0
45980,55355,445,0,0,drop,70,70,0,1,0,1,0
45981,59937,37965,0,0,deny,66,66,0,1,0,1,0
45982,23006,48817,0,0,deny,62,62,0,1,0,1,0
45983,55704,445,0,0,drop,66,66,0,1,0,1,0
45984,58398,44847,0,0,deny,66,66,0,1,0,1,0
45985,20168,81,0,0,deny,60,60,0,1,0,1,0
45986,55695,445,0,0,drop,66,66,0,1,0,1,0
45987,55691,445,0,0,drop,66,66,0,1,0,1,0
45988,55349,445,0,0,drop,70,70,0,1,0,1,0
45989,61902,22114,0,0,deny,66,66,0,1,0,1,0
45990,44849,46478,0,0,deny,74,74,0,1,0,1,0
45991,44981,57470,0,0,deny,66,66,0,1,0,1,0
45992,63779,26467,0,0,deny,66,66,0,1,0,1,0
45993,52282,37965,0,0,deny,66,66,0,1,0,1,0
45994,51910,37965,0,0,deny,62,62,0,1,0,1,0
45995,53774,51505,0,0,deny,62,62,0,1,0,1,0
45996,55342,445,0,0,drop,70,70,0,1,0,1,0
45997,55339,445,0,0,drop,70,70,0,1,0,1,0
45998,60292,445,0,0,drop,70,70,0,1,0,1,0
45999,60293,445,0,0,drop,70,70,0,1,0,1,0
46000,60291,445,0,0,drop,70,70,0,1,0,1,0
46001,13285,29892,0,0,deny,145,145,0,1,0,1,0
46002,55674,445,0,0,drop,66,66,0,1,0,1,0
46003,55677,445,0,0,drop,66,66,0,1,0,1,0
46004,55679,445,0,0,drop,66,66,0,1,0,1,0
46005,55680,445,0,0,drop,66,66,0,1,0,1,0
46006,55681,445,0,0,drop,66,66,0,1,0,1,0
46007,55678,445,0,0,drop,66,66,0,1,0,1,0
46008,55675,445,0,0,drop,66,66,0,1,0,1,0
46009,55673,445,0,0,drop,66,66,0,1,0,1,0
46010,45941,23386,0,0,deny,60,60,0,1,0,1,0
46011,44203,8055,0,0,deny,159,159,0,1,0,1,0
46012,64898,35993,0,0,deny,74,74,0,1,0,1,0
46013,55335,445,0,0,drop,70,70,0,1,0,1,0
46014,30879,35440,0,0,deny,146,146,0,1,0,1,0
46015,55334,445,0,0,drop,70,70,0,1,0,1,0
46016,13285,29892,0,0,deny,145,145,0,1,0,1,0
46017,0,0,0,0,deny,70,70,0,1,0,1,0
46018,51032,30188,0,0,deny,66,66,0,1,0,1,0
46019,11937,35440,0,0,deny,146,146,0,1,0,1,0
46020,55330,445,0,0,drop,70,70,0,1,0,1,0
46021,61257,56448,0,0,deny,146,146,0,1,0,1,0
46022,60288,445,0,0,drop,70,70,0,1,0,1,0
46023,60282,445,0,0,drop,70,70,0,1,0,1,0
46024,60276,445,0,0,drop,70,70,0,1,0,1,0
46025,54196,11392,0,0,deny,66,66,0,1,0,1,0
46026,43129,15503,0,0,deny,62,62,0,1,0,1,0
46027,443,62451,0,0,deny,199,199,0,1,0,1,0
46028,55329,445,0,0,drop,70,70,0,1,0,1,0
46029,55311,44847,0,0,deny,66,66,0,1,0,1,0
46030,55658,445,0,0,drop,66,66,0,1,0,1,0
46031,55661,445,0,0,drop,66,66,0,1,0,1,0
46032,60273,445,0,0,drop,70,70,0,1,0,1,0
46033,52696,21247,0,0,deny,62,62,0,1,0,1,0
46034,22835,51221,0,0,deny,62,62,0,1,0,1,0
46035,443,5705,0,0,deny,60,60,0,1,0,1,0
46036,60271,445,0,0,drop,70,70,0,1,0,1,0
46037,38653,21247,0,0,deny,62,62,0,1,0,1,0
46038,60267,445,0,0,drop,70,70,0,1,0,1,0
46039,60266,445,0,0,drop,70,70,0,1,0,1,0
46040,60263,445,0,0,drop,70,70,0,1,0,1,0
46041,55324,445,0,0,drop,70,70,0,1,0,1,0
46042,59563,56205,0,0,deny,66,66,0,1,0,1,0
46043,17579,57470,0,0,deny,62,62,0,1,0,1,0
46044,24174,57470,0,0,deny,62,62,0,1,0,1,0
46045,62549,53733,0,0,deny,66,66,0,1,0,1,0
46046,49915,35440,0,0,deny,62,62,0,1,0,1,0
46047,30246,51050,0,0,deny,146,146,0,1,0,1,0
46048,17453,35440,0,0,deny,62,62,0,1,0,1,0
46049,59845,44847,0,0,deny,66,66,0,1,0,1,0
46050,60254,445,0,0,drop,70,70,0,1,0,1,0
46051,60251,445,0,0,drop,70,70,0,1,0,1,0
46052,64021,53,21293,53,allow,190,97,93,2,30,1,1
46053,55985,53,10494,53,allow,711,87,624,2,30,1,1
46054,49517,80,14591,80,allow,6123,3105,3018,16,38,8,8
46055,61700,443,65174,443,allow,12613,2946,9667,38,50,18,20
46056,59769,443,37962,443,allow,8432,1967,6465,35,68,17,18
46057,50574,443,59952,443,allow,5870,1785,4085,21,80,12,9
46058,49144,443,40050,443,allow,130,70,60,3,5,2,1
46059,44129,53,44129,53,allow,182,81,101,2,30,1,1
46060,33842,53,33842,53,allow,1415,689,726,3,31,2,1
46061,61698,80,14302,80,allow,7712,4248,3464,23,51,12,11
46062,59857,443,40076,443,allow,2118,1093,1025,22,44,9,13
46063,36357,443,35351,443,allow,14614,1935,12679,36,16,20,16
46064,56445,53,12217,53,allow,711,87,624,2,30,1,1
46065,56292,53,41121,53,allow,194,99,95,2,30,1,1
46066,49845,53,6637,53,allow,188,96,92,2,31,1,1
46067,55912,53,3506,53,allow,184,94,90,2,30,1,1
46068,55620,53,14188,53,allow,170,87,83,2,30,1,1
46069,50572,443,24489,443,allow,5867,1782,4085,21,80,12,9
46070,59843,443,50473,443,allow,1427,726,701,17,46,8,9
46071,65251,53,48559,53,allow,198,101,97,2,30,1,1
46072,56968,80,44242,80,allow,53181,50384,2797,75,20,39,36
46073,49515,80,17973,80,allow,5101,2867,2234,15,38,8,7
46074,57342,53,37406,53,allow,166,85,81,2,31,1,1
46075,50569,443,18328,443,allow,5941,1856,4085,22,81,13,9
46076,50567,443,16036,443,allow,5866,1781,4085,21,81,12,9
46077,49106,53,49106,53,allow,1415,689,726,3,30,2,1
46078,61733,443,10616,443,allow,168812,5693,163119,186,21,68,118
46079,63815,11372,42999,11372,allow,504,382,122,8,16,6,2
46080,59858,443,47016,443,allow,2069,1044,1025,22,44,9,13
46081,59848,443,53182,443,allow,2431,1164,1267,27,46,11,16
46082,55820,53,49464,53,allow,184,94,90,2,30,1,1
46083,56472,53,12167,53,allow,711,87,624,2,30,1,1
46084,55851,53,15581,53,allow,749,94,655,2,30,1,1
46085,45663,53,45663,53,allow,507,129,378,2,30,1,1
46086,55264,53,35896,53,allow,170,87,83,2,30,1,1
46087,64566,53,1628,53,allow,188,96,92,2,30,1,1
46088,49825,53,46479,53,allow,793,101,692,2,30,1,1
46089,64535,53,14565,53,allow,763,101,662,2,30,1,1
46090,62230,443,57839,443,allow,3709,1176,2533,14,135,7,7
46091,55267,53,18171,53,allow,168,86,82,2,31,1,1
46092,27328,443,23617,443,allow,3751,1007,2744,35,473,11,24
46093,49913,53,50642,53,allow,216,110,106,2,31,1,1
46094,55640,53,50783,53,allow,742,88,654,2,31,1,1
46095,57009,53,27487,53,allow,1435,98,1337,4,34,2,2
46096,50568,443,35404,443,allow,5877,1792,4085,21,81,12,9
46097,59842,443,63853,443,allow,1307,666,641,15,46,7,8
46098,53663,17904,16406,17904,allow,320,140,180,6,7,3,3
46099,63835,30794,60469,30794,allow,66,66,0,2,8,2,0
46100,65107,53,44757,53,allow,266,87,179,4,33,2,2
46101,51825,25501,31893,25501,allow,66,66,0,1,5,1,0
46102,59826,443,57652,443,allow,7284,1079,6205,29,53,13,16
46103,60421,6882,64164,6882,allow,70,70,0,2,8,2,0
46104,52658,80,12733,80,allow,214,140,74,4,15,3,1
46105,55208,80,41287,80,allow,1638,1324,314,10,15,5,5
46106,56694,53,29552,53,allow,192,98,94,2,30,1,1
46107,49483,80,60356,80,allow,318,192,126,6,40,4,2
46108,64751,53,29777,53,allow,172,88,84,2,30,1,1
46109,55838,443,19179,443,allow,7034,2039,4995,37,255,18,19
46110,56100,53,43759,53,allow,701,88,613,2,30,1,1
46111,50134,53,12196,53,allow,768,99,669,2,30,1,1
46112,64493,53,45305,53,allow,198,101,97,2,30,1,1
46113,56850,53,62960,53,allow,763,101,662,2,31,1,1
46114,56889,53,34055,53,allow,170,87,83,2,31,1,1
46115,50233,53,55519,53,allow,756,95,661,2,31,1,1
46116,56550,53,60039,53,allow,182,93,89,2,31,1,1
46117,55142,53,21559,53,allow,770,101,669,2,31,1,1
46118,54973,53,47397,53,allow,731,91,640,2,31,1,1
46119,56374,53,38425,53,allow,770,102,668,2,31,1,1
46120,55368,53,50855,53,allow,760,97,663,2,31,1,1
46121,49459,443,42939,443,allow,2572,330,2242,12,135,5,7
46122,57470,47004,40280,47004,allow,152,152,0,2,1200,2,0
46123,49166,53,45421,53,allow,770,101,669,2,31,1,1
46124,27005,27027,32399,27027,allow,880,126,754,2,31,1,1
46125,56757,53,3651,53,allow,783,96,687,2,31,1,1
46126,64791,53,42823,53,allow,184,94,90,2,31,1,1
46127,57100,53,41347,53,allow,192,90,102,2,31,1,1
46128,56612,53,36295,53,allow,184,94,90,2,31,1,1
46129,55105,53,18912,53,allow,747,93,654,2,31,1,1
46130,64766,53,59121,53,allow,212,108,104,2,31,1,1
46131,47493,53,47493,53,allow,227,92,135,2,31,1,1
46132,50196,53,48778,53,allow,756,95,661,2,31,1,1
46133,56484,443,15925,443,allow,2948,782,2166,10,121,5,5
46134,59651,60038,0,0,allow,66,66,0,1,90,1,0
46135,37587,5228,8359,5228,allow,5509,2203,3306,22,3600,10,12
46136,56623,443,24976,443,allow,8963,2190,6773,18,138,8,10
46137,56308,53,54603,53,allow,184,94,90,2,31,1,1
46138,35713,443,23137,443,allow,5315,2861,2454,16,135,8,8
46139,30960,45705,10345,45705,allow,396,396,0,7,3617,7,0
46140,60247,445,0,0,drop,70,70,0,1,0,1,0
46141,51412,51505,0,0,deny,66,66,0,1,0,1,0
46142,55539,57470,0,0,deny,66,66,0,1,0,1,0
46143,55311,445,0,0,drop,70,70,0,1,0,1,0
46144,21674,28189,0,0,deny,60,60,0,1,0,1,0
46145,20005,37965,0,0,deny,62,62,0,1,0,1,0
46146,64997,51221,0,0,deny,66,66,0,1,0,1,0
46147,50341,37965,0,0,deny,66,66,0,1,0,1,0
46148,6713,2222,0,0,deny,60,60,0,1,0,1,0
46149,49191,35440,0,0,deny,66,66,0,1,0,1,0
46150,55308,445,0,0,deny,70,70,0,1,0,1,0
46151,2541,51505,0,0,deny,62,62,0,1,0,1,0
46152,42110,80,55658,80,allow,1056,682,374,10,15,6,4
46153,55743,53,57939,53,allow,165,86,79,2,30,1,1
46154,50281,53,4430,53,allow,767,102,665,2,30,1,1
46155,55937,443,21508,443,allow,3363,797,2566,14,135,7,7
46156,55636,445,0,0,drop,66,66,0,1,0,1,0
46157,60243,445,0,0,drop,70,70,0,1,0,1,0
46158,60241,445,0,0,drop,70,70,0,1,0,1,0
46159,55303,445,0,0,drop,70,70,0,1,0,1,0
46160,54545,49344,0,0,deny,66,66,0,1,0,1,0
46161,32388,26467,0,0,deny,66,66,0,1,0,1,0
46162,55302,445,0,0,drop,70,70,0,1,0,1,0
46163,52144,49344,0,0,deny,62,62,0,1,0,1,0
46164,53227,64097,0,0,deny,66,66,0,1,0,1,0
46165,50577,23,0,0,deny,60,60,0,1,0,1,0
46166,55300,445,0,0,drop,70,70,0,1,0,1,0
46167,19885,64147,0,0,deny,145,145,0,1,0,1,0
46168,55267,53,21533,53,allow,168,86,82,2,30,1,1
46169,51827,48432,31400,48432,allow,160,70,90,2,4,1,1
46170,57372,443,37935,443,allow,4612,700,3912,12,15,8,4
46171,64021,53,18880,53,allow,195,102,93,2,29,1,1
46172,64188,53,49847,53,allow,216,94,122,2,29,1,1
46173,65325,53,33633,53,allow,216,110,106,2,29,1,1
46174,55264,53,48968,53,allow,177,94,83,2,30,1,1
46175,27005,26258,35412,26258,allow,886,126,760,2,30,1,1
46176,56141,53,40551,53,allow,713,94,619,4,54,2,2
46177,50019,80,29484,80,allow,814,674,140,6,28,4,2
46178,50717,80,38874,80,allow,3317,2376,941,17,165,9,8
46179,61711,80,55600,80,allow,4448,2223,2225,18,49,10,8
46180,65107,53,56824,53,allow,266,87,179,4,32,2,2
46181,51846,41510,18249,41510,allow,70,70,0,2,8,2,0
46182,53644,58085,53471,58085,allow,70,70,0,1,4,1,0
46183,56829,33418,63291,33418,allow,316,136,180,6,5,3,3
46184,56292,443,38026,443,allow,162,102,60,2,5,1,1
46185,64554,53,30164,53,allow,94,94,0,1,29,1,0
46186,55820,53,22468,53,allow,184,94,90,2,29,1,1
46187,64493,53,42355,53,allow,199,102,97,2,29,1,1
46188,49771,53,57877,53,allow,177,94,83,2,29,1,1
46189,56717,53,4326,53,allow,183,94,89,2,29,1,1
46190,50320,53,19368,53,allow,754,94,660,2,29,1,1
46191,64566,53,26350,53,allow,194,102,92,2,29,1,1
46192,56717,53,57782,53,allow,183,94,89,2,29,1,1
46193,56694,53,47429,53,allow,196,102,94,2,29,1,1
46194,39444,53,0,0,allow,86,86,0,1,29,1,0
46195,64021,53,54662,53,allow,195,102,93,2,30,1,1
46196,46176,53,12412,53,allow,168,78,90,2,30,1,1
46197,53124,52917,26989,52917,allow,70,70,0,1,5,1,0
46198,50232,443,24591,443,allow,7292,950,6342,19,75,9,10
46199,60786,3389,60786,3389,allow,4226,2201,2025,19,18,10,9
46200,49406,80,24541,80,allow,32206,1049,31157,37,89,11,26
46201,49235,80,47953,80,allow,1783342,58977,1724365,1613,162,445,1168
46202,49523,80,32458,80,allow,1399,826,573,11,38,6,5
46203,52223,443,45658,443,allow,6710,4371,2339,33,109,18,15
46204,56506,53,39583,53,allow,807,94,713,2,30,1,1
46205,55912,53,46949,53,allow,184,94,90,2,30,1,1
46206,59325,53,7735,53,allow,211,78,133,2,30,1,1
46207,55223,53,31444,53,allow,168,86,82,2,30,1,1
46208,55738,53,4750,53,allow,309,94,215,2,30,1,1
46209,49913,53,47185,53,allow,216,110,106,2,30,1,1
46210,49168,53,14343,53,allow,196,102,94,2,30,1,1
46211,55912,53,61558,53,allow,184,94,90,2,30,1,1
46212,64722,53,58551,53,allow,214,110,104,2,30,1,1
46213,56308,53,37236,53,allow,184,94,90,2,31,1,1
46214,49713,53,55679,53,allow,734,94,640,2,30,1,1
46215,64751,53,33597,53,allow,178,94,84,2,30,1,1
46216,49925,80,49556,80,allow,1126,609,517,11,15,6,5
46217,65201,53,45437,53,allow,334,94,240,2,30,1,1
46218,60398,443,27669,443,allow,2847,1797,1050,24,85,13,11
46219,65439,53,54009,53,allow,168,86,82,2,30,1,1
46220,56586,53,7181,53,allow,177,94,83,2,30,1,1
46221,57342,53,19842,53,allow,167,86,81,2,30,1,1
46222,49891,53,62229,53,allow,822,102,720,2,30,1,1
46223,35266,53,50904,53,allow,164,78,86,2,30,1,1
46224,49525,80,7498,80,allow,454,262,192,8,38,5,3
46225,55625,10480,18268,10480,allow,564,318,246,9,15,5,4
46226,53639,15079,39945,15079,allow,546,306,240,9,15,5,4
46227,49701,53,61542,53,allow,197,102,95,2,30,1,1
46228,59714,3389,59714,3389,allow,4134,2109,2025,18,17,9,9
46229,49236,80,22987,80,allow,1904818,59945,1844873,1747,162,498,1249
46230,55620,53,23313,53,allow,177,94,83,2,30,1,1
46231,60544,53,63580,53,allow,211,78,133,2,30,1,1
46232,65251,53,53427,53,allow,199,102,97,2,30,1,1
46233,64588,53,47202,53,allow,165,86,79,2,30,1,1
46234,49202,53,58969,53,allow,295,86,209,2,30,1,1
46235,64722,53,36705,53,allow,214,110,104,2,30,1,1
46236,65473,53,40939,53,allow,309,94,215,2,30,1,1
46237,56292,53,4815,53,allow,197,102,95,2,30,1,1
46238,57294,443,36134,443,allow,5614,733,4881,16,15,9,7
46239,49478,80,36631,80,allow,28629,4862,23767,33,39,13,20
46240,56786,443,61415,443,allow,238132,13988,224144,317,32,161,156
46241,55896,53,29667,53,allow,733,94,639,2,30,1,1
46242,49168,53,25368,53,allow,196,102,94,2,30,1,1
46243,49971,53,19251,53,allow,779,110,669,2,30,1,1
46244,56966,53,53823,53,allow,177,94,83,2,30,1,1
46245,65251,53,42946,53,allow,199,102,97,2,30,1,1
46246,49269,53,8382,53,allow,198,110,88,2,30,1,1
46247,59977,53,61405,53,allow,168,78,90,2,30,1,1
46248,50430,53,3410,53,allow,789,102,687,2,30,1,1
46249,57297,443,9892,443,allow,5614,733,4881,16,15,9,7
46250,49260,80,56058,80,allow,2013987,64000,1949987,1818,160,504,1314
46251,49891,53,46766,53,allow,199,102,97,2,30,1,1
46252,51490,5223,60793,5223,allow,9801,5352,4449,28,473,16,12
46253,55743,53,47802,53,allow,165,86,79,2,30,1,1
46254,55620,53,48166,53,allow,177,94,83,2,30,1,1
46255,56889,53,24379,53,allow,177,94,83,2,30,1,1
46256,49179,443,25006,443,allow,686176,17574,668602,702,18,252,450
46257,53332,443,6381,443,allow,23215,18990,4225,44,405,24,20
46258,48354,5222,3961,5222,allow,7786,1403,6383,44,434,15,29
46259,49446,443,57880,443,allow,1280822,27768,1253054,1241,40,365,876
46260,40452,1488,40452,1488,allow,156,156,0,3,8,3,0
46261,57295,443,4265,443,allow,5614,733,4881,16,15,9,7
46262,42166,443,46667,443,allow,162,102,60,2,5,1,1
46263,21017,3389,21017,3389,allow,4085,1916,2169,21,18,12,9
46264,46360,443,51396,443,allow,1053,566,487,10,16,6,4
46265,65107,53,20258,53,allow,266,87,179,4,32,2,2
46266,50335,80,17897,80,allow,3855,828,3027,11,15,5,6
46267,49471,80,33120,80,allow,10175,1359,8816,18,78,7,11
46268,49519,80,21026,80,allow,2981,1514,1467,12,38,7,5
46269,61687,80,48451,80,allow,11437,2775,8662,32,53,15,17
46270,64638,53,33072,53,allow,215,102,113,2,29,1,1
46271,63836,14791,9109,14791,allow,66,66,0,2,7,2,0
46272,57161,53,42229,53,allow,224,102,122,2,29,1,1
46273,53692,53,53692,53,allow,262,82,180,2,29,1,1
46274,49379,80,26229,80,allow,6307,2851,3456,18,150,9,9
46275,49524,80,21220,80,allow,1401,828,573,11,38,6,5
46276,64493,53,5722,53,allow,353,101,252,4,54,2,2
46277,49771,53,28192,53,allow,177,94,83,2,29,1,1
46278,56292,53,5398,53,allow,197,102,95,2,29,1,1
46279,49484,80,60761,80,allow,318,192,126,6,39,4,2
46280,65325,53,57020,53,allow,216,110,106,2,29,1,1
46281,49237,80,10310,80,allow,1934086,60476,1873610,1754,162,493,1261
46282,27005,33070,2152,33070,allow,883,126,757,2,30,1,1
46283,49051,443,25390,443,allow,7683,1817,5866,42,3089,15,27
46284,55043,53,56883,53,allow,167,86,81,2,29,1,1
46285,60792,53,38025,53,allow,168,78,90,2,29,1,1
46286,49168,53,56952,53,allow,196,102,94,2,30,1,1
46287,64733,53,63976,53,allow,889,404,485,10,30,5,5
46288,55820,53,12238,53,allow,184,94,90,2,30,1,1
46289,64650,53,46019,53,allow,193,94,99,2,30,1,1
46290,49432,53,34624,53,allow,812,110,702,2,30,1,1
46291,50545,53,44269,53,allow,765,102,663,2,30,1,1
46292,55123,53,24178,53,allow,295,86,209,2,30,1,1
46293,49797,53,57522,53,allow,306,94,212,2,30,1,1
46294,50289,53,1310,53,allow,189,102,87,2,30,1,1
46295,64791,53,7738,53,allow,184,94,90,2,30,1,1
46296,64722,53,55455,53,allow,214,110,104,2,30,1,1
46297,55235,53,63921,53,allow,178,94,84,2,30,1,1
46298,64592,53,65035,53,allow,209,110,99,2,31,1,1
46299,57362,53,9411,53,allow,346,102,244,2,31,1,1
46300,56612,53,64503,53,allow,184,94,90,2,31,1,1
46301,57188,443,9507,443,allow,20317684,620294,19697390,20965,186,6716,14249
46302,56986,53,21320,53,allow,177,94,83,2,31,1,1
46303,64021,53,7172,53,allow,402,97,305,4,31,2,2
46304,52998,443,2559,443,allow,190,70,120,4,15,2,2
46305,56624,443,23164,443,allow,8536,3817,4719,25,20,15,10
46306,57296,443,59127,443,allow,5613,733,4880,16,15,9,7
46307,56548,443,12998,443,allow,4145,1069,3076,14,25,8,6
46308,49482,80,62281,80,allow,378,192,186,7,39,4,3
46309,37004,80,37004,80,allow,13825,1203,12622,22,29,9,13
46310,49514,80,16033,80,allow,1352,832,520,12,38,7,5
46311,56966,53,65099,53,allow,177,94,83,2,30,1,1
46312,52266,53,15275,53,allow,168,78,90,2,30,1,1
46313,56139,53,55354,53,allow,306,94,212,2,30,1,1
46314,55229,53,33453,53,allow,173,94,79,2,30,1,1
46315,50072,53,22723,53,allow,779,86,693,2,30,1,1
46316,51849,21091,51027,21091,allow,316,136,180,6,7,3,3
46317,49927,80,35490,80,allow,1126,609,517,11,15,6,5
46318,49926,80,8028,80,allow,1126,609,517,11,15,6,5
46319,60767,443,60767,443,allow,2406,1218,1188,21,16,11,10
46320,49234,80,29641,80,allow,1103248,36317,1066931,1001,162,276,725
46321,49701,53,61488,53,allow,197,102,95,2,30,1,1
46322,56986,53,63697,53,allow,177,94,83,2,30,1,1
46323,55229,53,8520,53,allow,173,94,79,2,30,1,1
46324,53662,55043,16806,55043,allow,320,140,180,6,6,3,3
46325,50116,22,50116,22,allow,152,66,86,2,9,1,1
46326,49928,80,49356,80,allow,1270,679,591,13,15,7,6
46327,59715,3389,59715,3389,allow,3331,1442,1889,15,17,8,7
46328,52215,80,59875,80,allow,1009,506,503,10,16,5,5
46329,49512,80,18348,80,allow,2225,1649,576,10,38,6,4
46330,65355,53,46648,53,allow,592,105,487,4,50,2,2
46331,56506,53,3362,53,allow,184,94,90,2,30,1,1
46332,65129,53,27603,53,allow,213,102,111,2,30,1,1
46333,56618,443,44259,443,allow,22938,14436,8502,43,41,23,20
46334,56889,53,34075,53,allow,177,94,83,2,30,1,1
46335,64389,53,21920,53,allow,244,94,150,2,30,1,1
46336,65218,443,1874,443,allow,2767,681,2086,10,120,5,5
46337,49663,53,27941,53,allow,168,86,82,2,31,1,1
46338,49936,53,50715,53,allow,152,78,74,2,31,1,1
46339,27005,33111,35417,33111,allow,895,126,769,2,31,1,1
46340,6881,37232,47143,37232,allow,502,150,352,2,1199,1,1
46341,55877,22374,2922,22374,allow,150,150,0,1,1200,1,0
46342,64766,53,62502,53,allow,214,110,104,2,31,1,1
46343,42989,443,61280,443,allow,9878,1936,7942,36,121,18,18
46344,64766,53,32517,53,allow,214,110,104,2,30,1,1
46345,56667,53,18172,53,allow,199,102,97,2,30,1,1
46346,64686,53,28216,53,allow,811,94,717,2,30,1,1
46347,55912,53,21691,53,allow,184,94,90,2,31,1,1
46348,55431,53,2541,53,allow,196,102,94,2,31,1,1
46349,50017,53,58091,53,allow,195,102,93,2,31,1,1
46350,42764,53,15953,53,allow,164,78,86,2,31,1,1
46351,27005,32073,48886,32073,allow,884,126,758,2,31,1,1
46352,57342,53,16666,53,allow,167,86,81,2,31,1,1
46353,27005,27057,3516,27057,allow,917,126,791,2,31,1,1
46354,27005,27091,19292,27091,allow,883,126,757,2,31,1,1
46355,38566,443,54032,443,allow,4108,1272,2836,11,121,5,6
46356,48817,30201,48817,30201,allow,469,150,319,2,1200,1,1
46357,65077,443,2224,443,allow,6118,5698,420,12,123,6,6
46358,42225,443,6040,443,allow,8962,1601,7361,26,186,14,12
46359,51982,443,54748,443,allow,9010,2779,6231,30,361,15,15
46360,33059,58962,0,0,deny,774,774,0,1,0,1,0
46361,55631,445,0,0,drop,66,66,0,1,0,1,0
46362,5227,50584,0,0,deny,146,146,0,1,0,1,0
46363,34936,30188,0,0,deny,62,62,0,1,0,1,0
46364,45682,1,0,0,deny,62,62,0,1,0,1,0
46365,55373,1,0,0,deny,66,66,0,1,0,1,0
46366,49687,53,60160,53,allow,197,102,95,2,31,1,1
46367,58074,443,57514,443,allow,2974,408,2566,13,135,6,7
46368,64364,53,21283,53,allow,193,94,99,2,31,1,1
46369,27005,32025,48806,32025,allow,887,126,761,2,31,1,1
46370,49480,53,38554,53,allow,428,96,332,4,52,2,2
46371,60718,443,23092,443,allow,71105,20647,50458,107,38,53,54
46372,56626,80,44276,80,allow,234,234,0,4,12,4,0
46373,64658,53,8151,53,allow,195,102,93,2,30,1,1
46374,56889,53,35698,53,allow,177,94,83,2,30,1,1
46375,27005,27111,16900,27111,allow,913,126,787,2,31,1,1
46376,51767,80,59527,80,allow,2169,1263,906,13,75,8,5
46377,56067,53,11884,53,allow,189,102,87,2,31,1,1
46378,49206,53,42939,53,allow,179,94,85,2,31,1,1
46379,50413,123,48114,123,allow,184,94,90,2,31,1,1
46380,57100,53,28423,53,allow,180,94,86,2,31,1,1
46381,49996,53,3311,53,allow,458,188,270,6,31,3,3
46382,51690,80,52942,80,allow,21064,2772,18292,38,175,18,20
46383,65107,53,22367,53,allow,266,87,179,4,35,2,2
46384,57030,53,7649,53,allow,283,101,182,4,39,2,2
46385,32787,80,54491,80,allow,1412,848,564,14,316,8,6
46386,39423,443,60458,443,allow,121145,3578,117567,128,77,39,89
46387,57283,53,15261,53,allow,185,102,83,2,30,1,1
46388,55482,53,16639,53,allow,822,102,720,2,30,1,1
46389,50500,53,25369,53,allow,166,86,80,2,30,1,1
46390,55628,445,0,0,drop,66,66,0,1,0,1,0
46391,18650,23718,0,0,deny,62,62,0,1,0,1,0
46392,60233,445,0,0,drop,70,70,0,1,0,1,0
46393,1025,46232,0,0,deny,145,145,0,1,0,1,0
46394,60230,445,0,0,drop,70,70,0,1,0,1,0
46395,60228,445,0,0,drop,70,70,0,1,0,1,0
46396,60222,445,0,0,drop,70,70,0,1,0,1,0
46397,49479,56205,0,0,deny,62,62,0,1,0,1,0
46398,55625,445,0,0,drop,66,66,0,1,0,1,0
46399,52150,39109,0,0,deny,66,66,0,1,0,1,0
46400,55293,445,0,0,drop,70,70,0,1,0,1,0
46401,55291,445,0,0,drop,70,70,0,1,0,1,0
46402,54989,50265,0,0,deny,66,66,0,1,0,1,0
46403,60218,445,0,0,drop,70,70,0,1,0,1,0
46404,64283,37965,0,0,deny,74,74,0,1,0,1,0
46405,57633,50584,0,0,deny,62,62,0,1,0,1,0
46406,55290,445,0,0,drop,70,70,0,1,0,1,0
46407,60216,445,0,0,drop,70,70,0,1,0,1,0
46408,60212,445,0,0,drop,70,70,0,1,0,1,0
46409,60213,445,0,0,drop,70,70,0,1,0,1,0
46410,4427,50584,0,0,deny,62,62,0,1,0,1,0
46411,55289,445,0,0,drop,70,70,0,1,0,1,0
46412,44208,26467,0,0,deny,62,62,0,1,0,1,0
46413,55617,445,0,0,drop,66,66,0,1,0,1,0
46414,55288,445,0,0,drop,70,70,0,1,0,1,0
46415,55286,445,0,0,drop,70,70,0,1,0,1,0
46416,55282,445,0,0,drop,70,70,0,1,0,1,0
46417,34146,51221,0,0,deny,62,62,0,1,0,1,0
46418,55614,445,0,0,drop,66,66,0,1,0,1,0
46419,55616,445,0,0,drop,66,66,0,1,0,1,0
46420,55610,445,0,0,drop,66,66,0,1,0,1,0
46421,13985,34159,0,0,deny,62,62,0,1,0,1,0
46422,2876,35440,0,0,deny,62,62,0,1,0,1,0
46423,55609,445,0,0,drop,66,66,0,1,0,1,0
46424,55608,445,0,0,drop,66,66,0,1,0,1,0
46425,55606,445,0,0,drop,66,66,0,1,0,1,0
46426,55270,445,0,0,drop,70,70,0,1,0,1,0
46427,55268,445,0,0,drop,70,70,0,1,0,1,0
46428,55267,445,0,0,drop,70,70,0,1,0,1,0
46429,55259,445,0,0,drop,70,70,0,1,0,1,0
46430,55260,445,0,0,drop,70,70,0,1,0,1,0
46431,60210,445,0,0,drop,70,70,0,1,0,1,0
46432,60209,445,0,0,drop,70,70,0,1,0,1,0
46433,60206,445,0,0,drop,70,70,0,1,0,1,0
46434,62725,51221,0,0,deny,66,66,0,1,0,1,0
46435,55604,445,0,0,drop,66,66,0,1,0,1,0
46436,1790,48817,0,0,deny,66,66,0,1,0,1,0
46437,60203,445,0,0,drop,70,70,0,1,0,1,0
46438,4257,35440,0,0,deny,62,62,0,1,0,1,0
46439,55600,445,0,0,drop,66,66,0,1,0,1,0
46440,80,57411,0,0,deny,1514,1514,0,1,0,1,0
46441,46518,44847,0,0,deny,146,146,0,1,0,1,0
46442,55598,445,0,0,drop,66,66,0,1,0,1,0
46443,55594,445,0,0,drop,66,66,0,1,0,1,0
46444,80,36466,0,0,deny,1514,1514,0,1,0,1,0
46445,57174,57470,0,0,deny,66,66,0,1,0,1,0
46446,11344,42873,0,0,deny,62,62,0,1,0,1,0
46447,55248,445,0,0,drop,70,70,0,1,0,1,0
46448,48706,23393,0,0,deny,60,60,0,1,0,1,0
46449,60198,445,0,0,drop,70,70,0,1,0,1,0
46450,13970,42873,0,0,deny,66,66,0,1,0,1,0
46451,60191,445,0,0,drop,70,70,0,1,0,1,0
46452,60186,445,0,0,drop,70,70,0,1,0,1,0
46453,55583,445,0,0,drop,66,66,0,1,0,1,0
46454,46292,42873,0,0,deny,72,72,0,1,0,1,0
46455,55244,445,0,0,drop,70,70,0,1,0,1,0
46456,443,24425,0,0,deny,151,151,0,1,0,1,0
46457,55235,445,0,0,drop,70,70,0,1,0,1,0
46458,55233,445,0,0,drop,70,70,0,1,0,1,0
46459,64387,37965,0,0,deny,66,66,0,1,0,1,0
46460,14924,44847,0,0,deny,66,66,0,1,0,1,0
46461,55232,445,0,0,drop,70,70,0,1,0,1,0
46462,55230,445,0,0,drop,70,70,0,1,0,1,0
46463,55576,445,0,0,drop,66,66,0,1,0,1,0
46464,55228,445,0,0,drop,70,70,0,1,0,1,0
46465,60175,445,0,0,drop,70,70,0,1,0,1,0
46466,55573,445,0,0,drop,66,66,0,1,0,1,0
46467,11136,15503,0,0,deny,62,62,0,1,0,1,0
46468,1162,57470,0,0,deny,62,62,0,1,0,1,0
46469,20108,64147,0,0,deny,62,62,0,1,0,1,0
46470,57410,37965,0,0,deny,66,66,0,1,0,1,0
46471,55221,445,0,0,drop,70,70,0,1,0,1,0
46472,55567,445,0,0,drop,66,66,0,1,0,1,0
46473,55561,445,0,0,drop,66,66,0,1,0,1,0
46474,55214,445,0,0,drop,70,70,0,1,0,1,0
46475,38383,51221,0,0,deny,66,66,0,1,0,1,0
46476,54636,26467,0,0,deny,66,66,0,1,0,1,0
46477,55211,445,0,0,drop,70,70,0,1,0,1,0
46478,60165,445,0,0,drop,70,70,0,1,0,1,0
46479,60164,445,0,0,drop,70,70,0,1,0,1,0
46480,60163,445,0,0,drop,70,70,0,1,0,1,0
46481,55550,445,0,0,drop,66,66,0,1,0,1,0
46482,55546,445,0,0,drop,66,66,0,1,0,1,0
46483,55545,445,0,0,drop,66,66,0,1,0,1,0
46484,55548,445,0,0,drop,66,66,0,1,0,1,0
46485,55551,445,0,0,drop,66,66,0,1,0,1,0
46486,55544,445,0,0,drop,66,66,0,1,0,1,0
46487,55549,445,0,0,drop,66,66,0,1,0,1,0
46488,55543,445,0,0,drop,66,66,0,1,0,1,0
46489,55207,445,0,0,drop,70,70,0,1,0,1,0
46490,54898,36237,0,0,deny,66,66,0,1,0,1,0
46491,55206,445,0,0,drop,70,70,0,1,0,1,0
46492,54854,19847,0,0,deny,66,66,0,1,0,1,0
46493,51183,56205,0,0,deny,66,66,0,1,0,1,0
46494,3117,37965,0,0,deny,62,62,0,1,0,1,0
46495,50095,30188,0,0,deny,66,66,0,1,0,1,0
46496,55202,445,0,0,drop,70,70,0,1,0,1,0
46497,60161,445,0,0,drop,70,70,0,1,0,1,0
46498,60158,445,0,0,drop,70,70,0,1,0,1,0
46499,60148,445,0,0,drop,70,70,0,1,0,1,0
46500,55201,445,0,0,drop,70,70,0,1,0,1,0
46501,55145,11392,0,0,deny,66,66,0,1,0,1,0
46502,50116,22,0,0,deny,60,60,0,1,0,1,0
46503,55531,445,0,0,drop,66,66,0,1,0,1,0
46504,55529,445,0,0,drop,66,66,0,1,0,1,0
46505,55528,445,0,0,drop,66,66,0,1,0,1,0
46506,33370,22,0,0,deny,60,60,0,1,0,1,0
46507,62438,37807,0,0,deny,66,66,0,1,0,1,0
46508,60145,445,0,0,drop,70,70,0,1,0,1,0
46509,54210,64097,0,0,deny,66,66,0,1,0,1,0
46510,45908,33330,0,0,deny,60,60,0,1,0,1,0
46511,1081,64910,0,0,deny,146,146,0,1,0,1,0
46512,55196,445,0,0,drop,70,70,0,1,0,1,0
46513,41801,53,41801,53,allow,213,87,126,2,30,1,1
46514,55651,53,6764,53,allow,760,97,663,2,30,1,1
46515,48972,443,48972,443,allow,4657,1750,2907,19,31,11,8
46516,56120,53,56120,53,allow,237,91,146,2,33,1,1
46517,50734,80,51242,80,allow,1114,534,580,12,16,7,5
46518,51807,443,51807,443,allow,1466,856,610,13,27,6,7
46519,51076,80,51076,80,allow,8170,844,7326,17,42,7,10
46520,57746,15000,19364,15000,allow,130,70,60,2,6,1,1
46521,53972,443,53972,443,allow,4380,1473,2907,19,29,11,8
46522,50951,80,50951,80,allow,514,246,268,9,42,5,4
46523,65378,53,28736,53,allow,770,102,668,2,30,1,1
46524,49983,53,51189,53,allow,749,89,660,2,30,1,1
46525,56227,53,8068,53,allow,188,96,92,2,30,1,1
46526,56526,443,53927,443,allow,1560,988,572,13,25,7,6
46527,53656,58624,15076,58624,allow,70,70,0,2,8,2,0
46528,50883,80,50883,80,allow,514,246,268,9,42,5,4
46529,55871,53,11606,53,allow,711,87,624,2,30,1,1
46530,49762,53,23081,53,allow,760,97,663,2,30,1,1
46531,49837,53,39920,53,allow,212,108,104,2,30,1,1
46532,53575,53,50120,53,allow,198,93,105,2,30,1,1
46533,60945,443,60945,443,allow,4680,1773,2907,19,29,11,8
46534,62738,443,30177,443,allow,126,60,66,3,10,2,1
46535,38386,80,38386,80,allow,6261,833,5428,15,20,8,7
46536,44258,443,15237,443,allow,14478,1815,12663,30,170,14,16
46537,54990,80,38273,80,allow,9054746,285623,8769123,10474,214,4673,5801
46538,53880,443,53880,443,allow,4686,1779,2907,19,30,11,8
46539,57030,53,58226,53,allow,283,101,182,4,38,2,2
46540,56541,443,2047,443,allow,1560,988,572,13,25,7,6
46541,50757,80,50757,80,allow,514,246,268,9,42,5,4
46542,51140,80,51140,80,allow,514,246,268,9,42,5,4
46543,51810,443,51810,443,allow,1536,856,680,14,27,6,8
46544,53835,7000,53835,7000,allow,2099,676,1423,13,15,7,6
46545,56242,53,42071,53,allow,711,87,624,2,30,1,1
46546,49192,53,18280,53,allow,747,93,654,2,30,1,1
46547,64592,53,37714,53,allow,202,103,99,2,31,1,1
46548,55129,53,28774,53,allow,754,94,660,2,31,1,1
46549,51798,443,51798,443,allow,14904,6448,8456,33,30,18,15
46550,10099,80,20785,80,allow,130,70,60,2,15,1,1
46551,55237,53,13670,53,allow,259,87,172,4,56,2,2
46552,53354,80,22791,80,allow,2722,1530,1192,12,316,7,5
46553,50500,53,52272,53,allow,164,84,80,2,30,1,1
46554,57067,53,64624,53,allow,172,88,84,2,30,1,1
46555,56765,53,52854,53,allow,711,87,624,2,30,1,1
46556,27005,27019,17502,27019,allow,873,126,747,2,30,1,1
46557,64949,53,27237,53,allow,744,89,655,2,30,1,1
46558,56986,53,24262,53,allow,170,87,83,2,30,1,1
46559,55141,53,48144,53,allow,744,89,655,2,30,1,1
46560,65328,53,16469,53,allow,174,89,85,2,30,1,1
46561,56589,53,53742,53,allow,711,87,624,2,30,1,1
46562,55759,53,54947,53,allow,756,95,661,2,30,1,1
46563,27005,27017,50516,27017,allow,873,126,747,2,30,1,1
46564,55877,53,16386,53,allow,164,84,80,2,30,1,1
46565,56553,53,14002,53,allow,198,101,97,2,30,1,1
46566,49206,53,61280,53,allow,174,89,85,2,31,1,1
46567,65370,53,4186,53,allow,778,103,675,2,31,1,1
46568,56334,53,41390,53,allow,767,102,665,2,31,1,1
46569,39703,443,48474,443,allow,4719,2313,2406,15,132,7,8
46570,15503,6881,37170,6881,allow,490,149,341,2,1200,1,1
46571,52028,53,52028,53,allow,194,87,107,2,31,1,1
46572,50017,53,55318,53,allow,190,97,93,2,31,1,1
46573,59893,53,45221,53,allow,198,93,105,2,30,1,1
46574,64560,53,23612,53,allow,802,104,698,2,30,1,1
46575,49513,53,13327,53,allow,200,102,98,2,31,1,1
46576,55533,53,30263,53,allow,816,97,719,2,31,1,1
46577,27005,30005,39246,30005,allow,890,126,764,2,31,1,1
46578,56342,53,27382,53,allow,733,93,640,2,31,1,1
46579,57470,40870,29859,40870,allow,535,163,372,2,1200,1,1
46580,56633,53,17988,53,allow,194,99,95,2,31,1,1
46581,56250,53,20280,53,allow,802,104,698,2,31,1,1
46582,64790,53,49419,53,allow,182,93,89,2,31,1,1
46583,64934,53,46124,53,allow,194,99,95,2,31,1,1
46584,47595,33436,0,0,allow,106,106,0,1,60,1,0
46585,36228,80,25190,80,allow,1114,540,574,17,191,10,7
46586,56076,443,18045,443,allow,1786,172,1614,7,120,3,4
46587,56000,53,40530,53,allow,170,87,83,2,31,1,1
46588,53635,22383,54338,22383,allow,492,306,186,8,17,5,3
46589,49687,53,12525,53,allow,194,99,95,2,31,1,1
46590,56380,53,55619,53,allow,170,87,83,2,31,1,1
46591,56693,53,6310,53,allow,756,95,661,2,31,1,1
46592,65516,53,45586,53,allow,749,94,655,2,31,1,1
46593,64053,53,7121,53,allow,186,95,91,2,31,1,1
46594,64257,53,54453,53,allow,168,86,82,2,31,1,1
46595,65171,53,47372,53,allow,760,97,663,2,31,1,1
46596,55680,53,52561,53,allow,749,94,655,2,31,1,1
46597,55027,53,18379,53,allow,168,86,82,2,31,1,1
46598,27005,30008,53621,30008,allow,890,126,764,2,31,1,1
46599,49157,53,58041,53,allow,184,94,90,2,31,1,1
46600,33949,80,17456,80,allow,1360,540,820,20,191,10,10
46601,56511,53,19992,53,allow,200,102,98,2,31,1,1
46602,41284,443,45151,443,allow,7252,2147,5105,18,136,8,10
46603,57256,53,42871,53,allow,771,101,670,2,31,1,1
46604,57470,59216,60669,59216,allow,594,594,0,10,1200,10,0
46605,55994,53,19158,53,allow,182,93,89,2,31,1,1
46606,41694,443,48276,443,allow,16107,3200,12907,35,362,17,18
46607,64983,53,38581,53,allow,777,87,690,2,31,1,1
46608,55179,53,42268,53,allow,172,88,84,2,31,1,1
46609,55902,53,9062,53,allow,178,91,87,2,31,1,1
46610,49936,53,59450,53,allow,216,110,106,2,31,1,1
46611,57106,53,8204,53,allow,760,97,663,2,31,1,1
46612,64825,53,5593,53,allow,728,96,632,2,31,1,1
46613,55031,443,25745,443,allow,3625,1378,2247,14,135,7,7
46614,52170,443,36243,443,allow,7228,1589,5639,22,362,11,11
46615,6881,6881,43192,6881,allow,150,150,0,1,1200,1,0
46616,60143,445,0,0,drop,70,70,0,1,0,1,0
46617,8239,37965,0,0,deny,146,146,0,1,0,1,0
46618,52323,44847,0,0,deny,146,146,0,1,0,1,0
46619,1081,59353,0,0,deny,146,146,0,1,0,1,0
46620,60142,445,0,0,drop,70,70,0,1,0,1,0
46621,60138,445,0,0,drop,70,70,0,1,0,1,0
46622,60135,445,0,0,drop,70,70,0,1,0,1,0
46623,21674,28189,0,0,deny,60,60,0,1,0,1,0
46624,29263,50939,0,0,deny,148,148,0,1,0,1,0
46625,51446,57587,0,0,deny,100,100,0,1,0,1,0
46626,1081,21162,0,0,deny,146,146,0,1,0,1,0
46627,443,64347,0,0,deny,131,131,0,1,0,1,0
46628,53652,1900,0,0,deny,139,139,0,1,0,1,0
46629,23383,64147,0,0,deny,62,62,0,1,0,1,0
46630,7109,64147,0,0,deny,66,66,0,1,0,1,0
46631,5179,50265,0,0,deny,62,62,0,1,0,1,0
46632,1081,43109,0,0,deny,146,146,0,1,0,1,0
46633,1081,14984,0,0,deny,146,146,0,1,0,1,0
46634,56550,53,61639,53,allow,183,94,89,2,30,1,1
46635,44246,80,45320,80,allow,5584,2543,3041,20,27,11,9
46636,47037,1,0,0,deny,62,62,0,1,0,1,0
46637,13795,2323,0,0,deny,60,60,0,1,0,1,0
46638,18623,1,0,0,deny,66,66,0,1,0,1,0
46639,51197,57470,0,0,deny,62,62,0,1,0,1,0
46640,29989,26467,0,0,deny,66,66,0,1,0,1,0
46641,55183,445,0,0,drop,70,70,0,1,0,1,0
46642,43260,41615,0,0,deny,145,145,0,1,0,1,0
46643,60126,445,0,0,drop,70,70,0,1,0,1,0
46644,60123,445,0,0,drop,70,70,0,1,0,1,0
46645,60119,445,0,0,drop,70,70,0,1,0,1,0
46646,32707,11392,0,0,deny,62,62,0,1,0,1,0
46647,51446,3033,0,0,deny,100,100,0,1,0,1,0
46648,31035,23,0,0,deny,60,60,0,1,0,1,0
46649,51446,3855,0,0,deny,100,100,0,1,0,1,0
46650,51446,17500,0,0,deny,100,100,0,1,0,1,0
46651,55180,445,0,0,drop,70,70,0,1,0,1,0
46652,51742,30317,0,0,deny,66,66,0,1,0,1,0
46653,39920,22114,0,0,deny,146,146,0,1,0,1,0
46654,27005,27018,61508,27018,allow,252,252,0,3,2,3,0
46655,4772,37965,0,0,deny,66,66,0,1,0,1,0
46656,62888,23,0,0,deny,60,60,0,1,0,1,0
46657,39548,8696,0,0,deny,60,60,0,1,0,1,0
46658,55176,445,0,0,drop,70,70,0,1,0,1,0
46659,22971,50584,0,0,deny,62,62,0,1,0,1,0
46660,55504,445,0,0,drop,66,66,0,1,0,1,0
46661,55992,53,33542,53,allow,194,94,100,2,30,1,1
46662,50091,53,37575,53,allow,183,94,89,2,30,1,1
46663,56000,53,49191,53,allow,177,94,83,2,30,1,1
46664,38111,443,61640,443,allow,566856,28278,538578,737,37,351,386
46665,39416,443,22181,443,allow,621104,12188,608916,575,78,149,426
46666,50076,443,58457,443,allow,9920,5013,4907,41,15,25,16
46667,56353,53,32385,53,allow,216,102,114,2,29,1,1
46668,65439,53,5065,53,allow,198,94,104,2,30,1,1
46669,65414,53,56360,53,allow,216,102,114,2,30,1,1
46670,64541,53,6698,53,allow,363,94,269,2,30,1,1
46671,56380,53,5120,53,allow,177,94,83,2,30,1,1
46672,39422,443,26393,443,allow,557795,16003,541792,528,76,139,389
46673,57429,80,55023,80,allow,1056,682,374,10,15,6,4
46674,51765,80,50481,80,allow,5569,3270,2299,21,74,13,8
46675,51691,80,8687,80,allow,19384,2720,16664,36,174,18,18
46676,51763,80,41535,80,allow,3830,2255,1575,16,74,10,6
46677,51764,80,40729,80,allow,5605,3306,2299,21,74,13,8
46678,55627,26192,18323,26192,allow,70,70,0,1,5,1,0
46679,50929,443,35060,443,allow,9571,2966,6605,52,35,29,23
46680,57422,80,40149,80,allow,10454,4931,5523,21,30,10,11
46681,57117,53,45575,53,allow,366,102,264,4,46,2,2
46682,55837,443,59967,443,allow,39628,2279,37349,63,255,23,40
46683,55475,53,28600,53,allow,757,102,655,2,29,1,1
46684,59368,53,55998,53,allow,241,118,123,2,29,1,1
46685,56550,53,48765,53,allow,183,94,89,2,29,1,1
46686,64658,53,60447,53,allow,195,102,93,2,29,1,1
46687,56369,53,50667,53,allow,168,86,82,2,29,1,1
46688,65439,53,2036,53,allow,168,86,82,2,29,1,1
46689,56667,53,55956,53,allow,199,102,97,2,29,1,1
46690,55235,53,18331,53,allow,178,94,84,2,29,1,1
46691,64332,53,12232,53,allow,195,102,93,2,30,1,1
46692,49646,53,5301,53,allow,199,102,97,2,30,1,1
46693,49687,53,16473,53,allow,197,102,95,2,29,1,1
46694,57258,53,4190,53,allow,177,94,83,2,29,1,1
46695,55027,53,13864,53,allow,168,86,82,2,30,1,1
46696,55933,53,32005,53,allow,177,94,83,2,30,1,1
46697,56612,53,46131,53,allow,184,94,90,2,29,1,1
46698,50289,53,8502,53,allow,189,102,87,2,30,1,1
46699,57258,53,16585,53,allow,177,94,83,2,30,1,1
46700,60638,53,31002,53,allow,337,86,251,2,29,1,1
46701,22013,53,22013,53,allow,198,90,108,2,30,1,1
46702,64792,53,34890,53,allow,338,110,228,2,30,1,1
46703,56626,443,50553,443,allow,8240,3521,4719,25,18,15,10
46704,49211,80,44277,80,allow,8971,1094,7877,17,15,7,10
46705,36172,443,19620,443,allow,6295,1324,4971,22,983,10,12
46706,54348,443,26587,443,allow,12594,5098,7496,32,35,17,15
46707,40273,53,38821,53,allow,164,78,86,2,30,1,1
46708,49837,53,42825,53,allow,214,110,104,2,30,1,1
46709,56242,53,30808,53,allow,231,86,145,2,30,1,1
46710,64882,53,8935,53,allow,246,94,152,2,30,1,1
46711,57135,53,40947,53,allow,443,182,261,6,30,3,3
46712,50819,443,23164,443,allow,1663508,63528,1599980,1853,251,692,1161
46713,60420,2924,28301,2924,allow,320,140,180,6,7,3,3
46714,53633,443,6086,443,allow,8473,1099,7374,20,18,9,11
46715,50200,53,14002,53,allow,758,102,656,2,30,1,1
46716,55295,53,52273,53,allow,779,86,693,2,30,1,1
46717,10001,443,23014,443,allow,8370,2798,5572,31,315,15,16
46718,55439,53,44673,53,allow,177,94,83,2,30,1,1
46719,56825,16648,32548,16648,allow,164,70,94,2,7,1,1
46720,64620,53,50964,53,allow,166,86,80,2,30,1,1
46721,45157,7,33504,7,allow,138,78,60,2,5,1,1
46722,56628,443,13354,443,allow,8240,3521,4719,25,18,15,10
46723,56000,53,42944,53,allow,177,94,83,2,30,1,1
46724,54989,80,38298,80,allow,8159037,271621,7887416,9644,214,4424,5220
46725,56553,53,56242,53,allow,199,102,97,2,30,1,1
46726,46872,80,56165,80,allow,29218,27458,1760,36,22,24,12
46727,51510,7000,51510,7000,allow,3490,1923,1567,14,16,7,7
46728,55675,53,10351,53,allow,195,102,93,2,30,1,1
46729,49329,53,8761,53,allow,258,102,156,2,30,1,1
46730,49646,53,18495,53,allow,199,102,97,2,30,1,1
46731,49837,53,47456,53,allow,214,110,104,2,30,1,1
46732,64591,53,55985,53,allow,179,86,93,2,30,1,1
46733,53868,53,38630,53,allow,164,78,86,2,30,1,1
46734,44409,53,42084,53,allow,199,94,105,2,30,1,1
46735,43770,53,60550,53,allow,199,94,105,2,30,1,1
46736,49889,53,4477,53,allow,338,110,228,2,30,1,1
46737,47483,53,19312,53,allow,164,78,86,2,30,1,1
46738,38732,443,56897,443,allow,9217,1548,7669,25,50,13,12
46739,33846,443,41735,443,allow,7760,2646,5114,24,16,13,11
46740,61455,443,28409,443,allow,8947,1130,7817,28,124,13,15
46741,60432,80,60432,80,allow,19915,764,19151,23,16,7,16
46742,10090,443,45576,443,allow,20612,7872,12740,57,643,21,36
46743,55933,53,58575,53,allow,177,94,83,2,30,1,1
46744,50456,53,42563,53,allow,754,94,660,2,30,1,1
46745,64332,53,56016,53,allow,195,102,93,2,30,1,1
46746,56928,53,57142,53,allow,178,94,84,2,30,1,1
46747,56421,53,5669,53,allow,350,94,256,2,30,1,1
46748,49708,53,14475,53,allow,185,102,83,2,30,1,1
46749,56668,53,12015,53,allow,199,94,105,2,30,1,1
46750,56989,53,25786,53,allow,168,94,74,2,30,1,1
46751,51806,443,51806,443,allow,1466,856,610,13,27,6,7
46752,38733,443,28389,443,allow,9058,1542,7516,25,50,13,12
46753,63964,53,22176,53,allow,323,85,238,4,34,2,2
46754,55237,53,6417,53,allow,259,87,172,4,56,2,2
46755,56553,53,8293,53,allow,199,102,97,2,30,1,1
46756,49936,53,17708,53,allow,168,94,74,2,30,1,1
46757,57288,53,1558,53,allow,354,94,260,2,30,1,1
46758,56950,53,2496,53,allow,183,94,89,2,30,1,1
46759,50236,443,16316,443,allow,4954,1768,3186,18,143,9,9
46760,55237,53,24870,53,allow,259,87,172,4,56,2,2
46761,63832,6969,23907,6969,allow,66,66,0,2,8,2,0
46762,37991,49152,57920,49152,allow,156,156,0,3,7,3,0
46763,51762,80,41389,80,allow,3945,2315,1630,18,74,11,7
46764,56826,31310,8679,31310,allow,70,70,0,1,5,1,0
46765,44545,443,4712,443,allow,546,280,266,9,26,5,4
46766,51809,443,51809,443,allow,1466,856,610,13,27,6,7
46767,57368,443,57368,443,allow,4401,1494,2907,19,28,11,8
46768,51844,12471,17127,12471,allow,70,70,0,2,8,2,0
46769,50331,80,36568,80,allow,1677,862,815,10,15,5,5
46770,37992,49152,18454,49152,allow,156,156,0,3,7,3,0
46771,51766,80,8995,80,allow,2190,1284,906,13,74,8,5
46772,55626,63805,23725,63805,allow,70,70,0,1,5,1,0
46773,51826,58925,47237,58925,allow,70,70,0,1,4,1,0
46774,49891,80,30734,80,allow,1694,666,1028,10,75,6,4
46775,56602,53,56281,53,allow,423,102,321,4,38,2,2
46776,63822,14382,38807,14382,allow,70,70,0,1,4,1,0
46777,53284,80,44514,80,allow,6995,783,6212,14,317,7,7
46778,49212,80,10274,80,allow,912,410,502,10,15,5,5
46779,50330,80,61342,80,allow,736,670,66,6,15,5,1
46780,64791,53,16107,53,allow,184,94,90,2,29,1,1
46781,27450,443,32260,443,allow,10099,1635,8464,31,83,14,17
46782,61453,443,29702,443,allow,8052,1307,6745,27,125,16,11
46783,65251,53,12989,53,allow,199,102,97,2,29,1,1
46784,56986,53,31308,53,allow,177,94,83,2,29,1,1
46785,49269,53,5251,53,allow,198,110,88,2,29,1,1
46786,55620,53,11702,53,allow,177,94,83,2,29,1,1
46787,57089,53,22992,53,allow,239,94,145,2,29,1,1
46788,56633,53,19316,53,allow,197,102,95,2,30,1,1
46789,56667,53,35653,53,allow,199,102,97,2,29,1,1
46790,56996,53,30047,53,allow,177,94,83,2,29,1,1
46791,57283,53,20762,53,allow,185,102,83,2,29,1,1
46792,55482,53,39470,53,allow,199,102,97,2,30,1,1
46793,56996,53,54322,53,allow,177,94,83,2,30,1,1
46794,56574,53,4025,53,allow,198,94,104,2,30,1,1
46795,57067,53,26997,53,allow,178,94,84,2,30,1,1
46796,49845,53,33096,53,allow,194,102,92,2,30,1,1
46797,64168,53,53054,53,allow,306,94,212,2,30,1,1
46798,65359,53,4725,53,allow,443,182,261,6,30,3,3
46799,56369,53,3400,53,allow,168,86,82,2,30,1,1
46800,65067,53,58003,53,allow,214,110,104,2,30,1,1
46801,16403,16385,35308,16385,allow,308,128,180,6,30,3,3
46802,65067,53,2919,53,allow,214,110,104,2,30,1,1
46803,65328,53,23014,53,allow,179,94,85,2,30,1,1
46804,50827,443,7368,443,allow,388366,15919,372447,435,219,158,277
46805,56821,53,11694,53,allow,235,94,141,2,30,1,1
46806,49913,53,6290,53,allow,216,110,106,2,30,1,1
46807,58087,123,31892,123,allow,184,94,90,2,30,1,1
46808,55877,53,52511,53,allow,166,86,80,2,30,1,1
46809,50017,53,60474,53,allow,195,102,93,2,30,1,1
46810,56067,53,20488,53,allow,189,102,87,2,30,1,1
46811,64804,53,31085,53,allow,182,102,80,2,30,1,1
46812,56612,53,50823,53,allow,184,94,90,2,30,1,1
46813,64257,53,1307,53,allow,168,86,82,2,30,1,1
46814,64257,53,50451,53,allow,168,86,82,2,31,1,1
46815,57394,53,17167,53,allow,193,102,91,2,31,1,1
46816,65007,53,7048,53,allow,165,86,79,2,30,1,1
46817,49744,53,33458,53,allow,193,102,91,2,30,1,1
46818,49157,53,4191,53,allow,184,94,90,2,30,1,1
46819,56155,53,9599,53,allow,199,102,97,2,30,1,1
46820,49206,53,44411,53,allow,179,94,85,2,30,1,1
46821,60613,443,54092,443,allow,154465,11473,142992,244,212,101,143
46822,56928,53,51278,53,allow,178,94,84,2,30,1,1
46823,53532,53,52838,53,allow,329,102,227,2,30,1,1
46824,56196,53,38043,53,allow,214,110,104,2,30,1,1
46825,49964,53,63838,53,allow,380,110,270,2,31,1,1
46826,64959,53,63198,53,allow,245,102,143,2,31,1,1
46827,55199,53,53506,53,allow,214,110,104,2,31,1,1
46828,49936,53,6002,53,allow,216,110,106,2,31,1,1
46829,56548,53,54465,53,allow,199,102,97,2,31,1,1
46830,56553,53,46585,53,allow,199,102,97,2,30,1,1
46831,56827,18318,42346,18318,allow,70,70,0,1,5,1,0
46832,47147,443,62760,443,allow,70,70,0,1,5,1,0
46833,63940,3389,63940,3389,allow,3347,1458,1889,15,17,8,7
46834,50072,443,58353,443,allow,827,484,343,8,15,5,3
46835,37248,80,37248,80,allow,7850,1208,6642,16,20,8,8
46836,49882,53,52287,53,allow,441,104,337,4,48,2,2
46837,50091,53,60727,53,allow,183,94,89,2,30,1,1
46838,49845,53,47352,53,allow,194,102,92,2,30,1,1
46839,56219,53,21871,53,allow,211,102,109,2,30,1,1
46840,57018,53,10253,53,allow,177,94,83,2,30,1,1
46841,55983,53,48141,53,allow,255,102,153,2,30,1,1
46842,56041,53,6902,53,allow,185,102,83,2,30,1,1
46843,61456,443,24877,443,allow,9577,1475,8102,30,124,14,16
46844,50818,80,50818,80,allow,514,246,268,9,42,5,4
46845,53634,443,2193,443,allow,2005,1100,905,16,17,9,7
46846,47982,443,20773,443,allow,83558,8567,74991,180,171,92,88
46847,63939,3389,63939,3389,allow,4134,2109,2025,18,17,9,9
46848,51997,53,57972,53,allow,164,78,86,2,30,1,1
46849,56308,53,13825,53,allow,184,94,90,2,30,1,1
46850,55439,53,11568,53,allow,177,94,83,2,30,1,1
46851,64592,53,31524,53,allow,209,110,99,2,30,1,1
46852,56155,53,9723,53,allow,199,102,97,2,30,1,1
46853,45394,53,64814,53,allow,199,94,105,2,30,1,1
46854,55497,53,48989,53,allow,168,86,82,2,30,1,1
46855,65419,53,59811,53,allow,200,102,98,2,30,1,1
46856,49744,53,14742,53,allow,816,102,714,2,30,1,1
46857,49687,53,13204,53,allow,197,102,95,2,31,1,1
46858,60612,443,17628,443,allow,117190,11380,105810,171,212,67,104
46859,56812,49600,3950,49600,allow,3060,1569,1491,12,16,7,5
46860,61454,443,53913,443,allow,8673,1722,6951,30,125,18,12
46861,35372,443,41929,443,allow,269750,10062,259688,285,152,92,193
46862,51808,443,51808,443,allow,1466,856,610,13,27,6,7
46863,57030,53,12910,53,allow,283,101,182,4,38,2,2
46864,56644,443,53305,443,allow,3079,1895,1184,18,16,10,8
46865,49636,53,5352,53,allow,790,110,680,2,30,1,1
46866,49663,53,41171,53,allow,184,102,82,2,30,1,1
46867,50829,443,2487,443,allow,1445207,43930,1401277,1562,219,556,1006
46868,56190,53,16437,53,allow,196,94,102,2,30,1,1
46869,49603,53,17814,53,allow,766,102,664,2,30,1,1
46870,64620,53,58577,53,allow,166,86,80,2,30,1,1
46871,57319,53,46855,53,allow,353,94,259,2,30,1,1
46872,56799,53,3973,53,allow,353,94,259,2,30,1,1
46873,56633,53,60296,53,allow,197,102,95,2,30,1,1
46874,56380,53,35466,53,allow,177,94,83,2,30,1,1
46875,65007,53,25899,53,allow,165,86,79,2,30,1,1
46876,16403,16386,26193,16386,allow,308,128,180,6,30,3,3
46877,47463,53,25330,53,allow,167,78,89,2,30,1,1
46878,51150,53,51368,53,allow,167,78,89,2,30,1,1
46879,55336,53,18020,53,allow,308,94,214,2,30,1,1
46880,49708,53,2580,53,allow,177,94,83,2,30,1,1
46881,55027,53,18719,53,allow,168,86,82,2,30,1,1
46882,49837,53,16345,53,allow,214,110,104,2,30,1,1
46883,50082,53,51299,53,allow,199,94,105,2,30,1,1
46884,58852,443,26155,443,allow,3723,1793,1930,21,69,10,11
46885,57617,53,32772,53,allow,164,78,86,2,30,1,1
46886,45103,80,17939,80,allow,1748,716,1032,19,409,6,13
46887,49513,53,36009,53,allow,200,102,98,2,30,1,1
46888,27005,32036,64099,32036,allow,876,126,750,2,31,1,1
46889,27005,33086,32717,33086,allow,877,126,751,2,31,1,1
46890,6881,32056,50769,32056,allow,509,150,359,2,1199,1,1
46891,56989,53,15263,53,allow,152,78,74,2,30,1,1
46892,39094,443,9909,443,allow,350650,19028,331622,494,83,251,243
46893,57018,53,57758,53,allow,177,94,83,2,30,1,1
46894,49714,53,21823,53,allow,767,102,665,2,30,1,1
46895,56227,53,19451,53,allow,194,102,92,2,30,1,1
46896,55534,53,6633,53,allow,86,86,0,1,30,1,0
46897,56950,53,53864,53,allow,183,94,89,2,30,1,1
46898,50108,53,30433,53,allow,969,86,883,2,30,1,1
46899,55675,53,24009,53,allow,195,102,93,2,30,1,1
46900,64804,53,26105,53,allow,182,102,80,2,30,1,1
46901,56512,53,17535,53,allow,166,86,80,2,30,1,1
46902,65143,53,18193,53,allow,184,94,90,2,30,1,1
46903,56728,53,16534,53,allow,166,86,80,2,30,1,1
46904,64257,53,2954,53,allow,168,86,82,2,30,1,1
46905,49316,53,24928,53,allow,184,94,90,2,31,1,1
46906,57157,53,38785,53,allow,173,94,79,2,30,1,1
46907,50213,53,31929,53,allow,774,102,672,2,30,1,1
46908,56266,53,40991,53,allow,166,86,80,2,31,1,1
46909,56183,53,29912,53,allow,179,94,85,2,31,1,1
46910,55902,53,8610,53,allow,181,94,87,2,31,1,1
46911,49825,53,30889,53,allow,336,110,226,2,31,1,1
46912,56041,53,39211,53,allow,185,102,83,2,31,1,1
46913,27005,32038,32589,32038,allow,868,126,742,2,31,1,1
46914,57018,53,23896,53,allow,177,94,83,2,31,1,1
46915,65143,53,4098,53,allow,184,94,90,2,31,1,1
46916,27005,50019,8990,50019,allow,877,126,751,2,31,1,1
46917,60813,443,34578,443,allow,658,140,518,10,3632,3,7
46918,60027,443,59128,443,allow,25215,5119,20096,55,144,26,29
46919,65122,443,26133,443,allow,5500,1277,4223,17,180,8,9
46920,56710,53,40167,53,allow,195,102,93,2,31,1,1
46921,65235,53,33492,53,allow,209,110,99,2,31,1,1
46922,64332,53,56454,53,allow,195,102,93,2,31,1,1
46923,56728,53,8699,53,allow,166,86,80,2,31,1,1
46924,55325,53,11184,53,allow,210,110,100,2,31,1,1
46925,43560,443,3098,443,allow,8964,2125,6839,34,120,18,16
46926,57470,49294,38558,49294,allow,132,132,0,3,1199,3,0
46927,57470,44046,49985,44046,allow,166,166,0,1,1199,1,0
46928,57470,44172,25895,44172,allow,353,166,187,2,1199,1,1
46929,52936,5228,12223,5228,allow,9201,2130,7071,41,5528,21,20
46930,27005,33084,40774,33084,allow,906,126,780,2,31,1,1
46931,55237,53,51535,53,allow,259,87,172,4,56,2,2
46932,56633,53,46953,53,allow,342,99,243,4,32,2,2
46933,63814,12906,14738,12906,allow,70,70,0,1,5,1,0
46934,56308,53,53406,53,allow,700,282,418,8,81,4,4
46935,27005,32056,54567,32056,allow,886,126,760,2,31,1,1
46936,63813,53455,10491,53455,allow,70,70,0,1,5,1,0
46937,49225,443,49225,443,allow,854266,56622,797644,969,98,420,549
46938,54706,443,10559,443,allow,5612,1051,4561,20,16,11,9
46939,56928,53,11160,53,allow,178,94,84,2,31,1,1
46940,55431,53,1200,53,allow,196,102,94,2,31,1,1
46941,55179,53,2667,53,allow,178,94,84,2,31,1,1
46942,64381,53,50743,53,allow,198,102,96,2,31,1,1
46943,60292,8630,2625,8630,allow,324,250,74,5,3605,4,1
46944,48941,443,29294,443,allow,7437,2128,5309,22,33,13,9
46945,53654,8100,3351,8100,allow,70,70,0,2,8,2,0
46946,53641,16605,52302,16605,allow,70,70,0,1,5,1,0
46947,50017,53,24863,53,allow,300,97,203,4,36,2,2
46948,56391,443,8649,443,allow,13706,5958,7748,78,202,42,36
46949,55174,445,0,0,drop,70,70,0,1,0,1,0
46950,60117,445,0,0,drop,70,70,0,1,0,1,0
46951,60115,445,0,0,drop,70,70,0,1,0,1,0
46952,10216,11392,0,0,deny,66,66,0,1,0,1,0
46953,41447,64147,0,0,deny,62,62,0,1,0,1,0
46954,55172,445,0,0,drop,70,70,0,1,0,1,0
46955,24838,39828,0,0,deny,60,60,0,1,0,1,0
46956,14309,56205,0,0,deny,146,146,0,1,0,1,0
46957,55502,445,0,0,drop,66,66,0,1,0,1,0
46958,55498,445,0,0,drop,66,66,0,1,0,1,0
46959,60106,445,0,0,drop,70,70,0,1,0,1,0
46960,56578,64147,0,0,deny,66,66,0,1,0,1,0
46961,53156,35993,0,0,deny,66,66,0,1,0,1,0
46962,52563,17235,0,0,deny,74,74,0,1,0,1,0
46963,60102,445,0,0,drop,70,70,0,1,0,1,0
46964,60099,445,0,0,drop,70,70,0,1,0,1,0
46965,60096,445,0,0,drop,70,70,0,1,0,1,0
46966,55165,445,0,0,drop,70,70,0,1,0,1,0
46967,55497,445,0,0,drop,66,66,0,1,0,1,0
46968,53020,61903,0,0,deny,159,159,0,1,0,1,0
46969,55163,445,0,0,drop,70,70,0,1,0,1,0
46970,3436,46783,0,0,deny,62,62,0,1,0,1,0
46971,64240,50584,0,0,deny,62,62,0,1,0,1,0
46972,55162,445,0,0,drop,70,70,0,1,0,1,0
46973,55161,445,0,0,drop,70,70,0,1,0,1,0
46974,60093,445,0,0,drop,70,70,0,1,0,1,0
46975,55160,445,0,0,drop,70,70,0,1,0,1,0
46976,55158,445,0,0,drop,70,70,0,1,0,1,0
46977,55156,445,0,0,drop,70,70,0,1,0,1,0
46978,19632,37965,0,0,deny,62,62,0,1,0,1,0
46979,1035,26467,0,0,deny,62,62,0,1,0,1,0
46980,60084,445,0,0,drop,70,70,0,1,0,1,0
46981,60086,445,0,0,drop,70,70,0,1,0,1,0
46982,51424,30188,0,0,deny,62,62,0,1,0,1,0
46983,55489,445,0,0,drop,66,66,0,1,0,1,0
46984,55485,445,0,0,drop,66,66,0,1,0,1,0
46985,55484,445,0,0,drop,66,66,0,1,0,1,0
46986,55481,445,0,0,drop,66,66,0,1,0,1,0
46987,542,46783,0,0,deny,62,62,0,1,0,1,0
46988,63814,81,0,0,deny,60,60,0,1,0,1,0
46989,6881,6881,0,0,deny,146,146,0,1,0,1,0
46990,55478,445,0,0,drop,66,66,0,1,0,1,0
46991,38338,443,60739,443,allow,499,425,74,4,0,3,1
46992,53853,443,38658,443,allow,499,425,74,4,0,3,1
46993,53852,443,26865,443,allow,499,425,74,4,0,3,1
46994,38337,443,4269,443,allow,499,425,74,4,1,3,1
46995,55479,445,0,0,drop,66,66,0,1,0,1,0
46996,55476,445,0,0,drop,66,66,0,1,0,1,0
46997,55142,445,0,0,drop,70,70,0,1,0,1,0
46998,55141,445,0,0,drop,70,70,0,1,0,1,0
46999,55137,445,0,0,drop,70,70,0,1,0,1,0
47000,2440,37807,0,0,deny,66,66,0,1,0,1,0
47001,64940,26467,0,0,deny,62,62,0,1,0,1,0
47002,55132,445,0,0,drop,70,70,0,1,0,1,0
47003,55131,445,0,0,drop,70,70,0,1,0,1,0
47004,58687,12883,0,0,deny,143,143,0,1,0,1,0
47005,60079,445,0,0,drop,70,70,0,1,0,1,0
47006,60077,445,0,0,drop,70,70,0,1,0,1,0
47007,60076,445,0,0,drop,70,70,0,1,0,1,0
47008,21844,50584,0,0,deny,146,146,0,1,0,1,0
47009,55473,445,0,0,drop,66,66,0,1,0,1,0
47010,60075,445,0,0,drop,70,70,0,1,0,1,0
47011,32424,50584,0,0,deny,146,146,0,1,0,1,0
47012,58286,37965,0,0,deny,66,66,0,1,0,1,0
47013,55470,445,0,0,drop,66,66,0,1,0,1,0
47014,52699,26467,0,0,deny,62,62,0,1,0,1,0
47015,55469,445,0,0,drop,66,66,0,1,0,1,0
47016,43916,21,0,0,deny,60,60,0,1,0,1,0
47017,55466,445,0,0,drop,66,66,0,1,0,1,0
47018,55120,445,0,0,drop,70,70,0,1,0,1,0
47019,45964,5333,0,0,deny,60,60,0,1,0,1,0
47020,26851,59858,0,0,deny,146,146,0,1,0,1,0
47021,57853,64147,0,0,deny,62,62,0,1,0,1,0
47022,23531,31573,0,0,deny,146,146,0,1,0,1,0
47023,55968,56205,0,0,deny,66,66,0,1,0,1,0
47024,60074,445,0,0,drop,70,70,0,1,0,1,0
47025,60064,445,0,0,drop,70,70,0,1,0,1,0
47026,60059,445,0,0,drop,70,70,0,1,0,1,0
47027,443,10010,0,0,deny,60,60,0,1,0,1,0
47028,44098,1433,0,0,deny,60,60,0,1,0,1,0
47029,55116,445,0,0,drop,70,70,0,1,0,1,0
47030,51172,44847,0,0,deny,66,66,0,1,0,1,0
47031,55454,445,0,0,drop,66,66,0,1,0,1,0
47032,47814,51505,0,0,deny,66,66,0,1,0,1,0
47033,55106,445,0,0,drop,70,70,0,1,0,1,0
47034,55107,445,0,0,drop,70,70,0,1,0,1,0
47035,55102,445,0,0,drop,70,70,0,1,0,1,0
47036,55101,445,0,0,drop,70,70,0,1,0,1,0
47037,59459,37807,0,0,deny,66,66,0,1,0,1,0
47038,55099,445,0,0,drop,70,70,0,1,0,1,0
47039,6666,2222,0,0,deny,60,60,0,1,0,1,0
47040,55447,445,0,0,drop,66,66,0,1,0,1,0
47041,60048,445,0,0,drop,70,70,0,1,0,1,0
47042,17027,1,0,0,deny,62,62,0,1,0,1,0
47043,0,0,0,0,allow,320,320,0,5,0,5,0
47044,0,0,0,0,deny,70,70,0,1,0,1,0
47045,57131,7774,0,0,deny,145,145,0,1,0,1,0
47046,50624,26467,0,0,deny,66,66,0,1,0,1,0
47047,55445,445,0,0,drop,66,66,0,1,0,1,0
47048,60133,1,0,0,deny,62,62,0,1,0,1,0
47049,55093,445,0,0,drop,70,70,0,1,0,1,0
47050,63956,44512,0,0,deny,145,145,0,1,0,1,0
47051,55437,445,0,0,drop,66,66,0,1,0,1,0
47052,56966,35440,0,0,deny,62,62,0,1,0,1,0
47053,55427,445,0,0,drop,66,66,0,1,0,1,0
47054,57943,1433,0,0,deny,60,60,0,1,0,1,0
47055,55086,445,0,0,drop,70,70,0,1,0,1,0
47056,55084,445,0,0,drop,70,70,0,1,0,1,0
47057,1025,35447,0,0,deny,62,62,0,1,0,1,0
47058,19875,30170,0,0,deny,145,145,0,1,0,1,0
47059,52618,23718,0,0,deny,146,146,0,1,0,1,0
47060,42034,28189,0,0,deny,145,145,0,1,0,1,0
47061,55079,445,0,0,drop,70,70,0,1,0,1,0
47062,26048,21,0,0,deny,60,60,0,1,0,1,0
47063,60038,445,0,0,drop,70,70,0,1,0,1,0
47064,60036,445,0,0,drop,70,70,0,1,0,1,0
47065,60035,445,0,0,drop,70,70,0,1,0,1,0
47066,55078,445,0,0,drop,70,70,0,1,0,1,0
47067,55422,445,0,0,drop,66,66,0,1,0,1,0
47068,55419,445,0,0,drop,66,66,0,1,0,1,0
47069,55417,445,0,0,drop,66,66,0,1,0,1,0
47070,55416,445,0,0,drop,66,66,0,1,0,1,0
47071,55420,445,0,0,drop,66,66,0,1,0,1,0
47072,55421,445,0,0,drop,66,66,0,1,0,1,0
47073,55418,445,0,0,drop,66,66,0,1,0,1,0
47074,55415,445,0,0,drop,66,66,0,1,0,1,0
47075,50419,26467,0,0,deny,62,62,0,1,0,1,0
47076,59833,48817,0,0,deny,107,107,0,1,0,1,0
47077,62649,48817,0,0,deny,148,148,0,1,0,1,0
47078,20894,51505,0,0,deny,62,62,0,1,0,1,0
47079,45941,23386,0,0,deny,60,60,0,1,0,1,0
47080,1663,30188,0,0,deny,66,66,0,1,0,1,0
47081,51823,15843,53132,15843,allow,66,66,0,2,9,2,0
47082,51822,12637,54729,12637,allow,136,136,0,3,14,3,0
47083,50409,53,47032,53,allow,731,85,646,2,30,1,1
47084,55771,80,55771,80,allow,3538,701,2837,11,20,6,5
47085,55002,80,41422,80,allow,10872190,337459,10534731,12500,208,5532,6968
47086,59985,443,16838,443,allow,25649,1485,24164,36,144,14,22
47087,34628,443,42980,443,allow,6392,1025,5367,18,27,9,9
47088,45119,15000,61352,15000,allow,130,70,60,2,5,1,1
47089,53640,28937,28393,28937,allow,70,70,0,1,5,1,0
47090,43972,80,64832,80,allow,1894,1520,374,15,15,9,6
47091,49420,443,13090,443,allow,5241,1194,4047,19,40,9,10
47092,48272,15000,32471,15000,allow,130,70,60,2,5,1,1
47093,61412,443,58094,443,allow,4934,771,4163,18,28,8,10
47094,34625,443,10799,443,allow,6393,1025,5368,18,27,9,9
47095,60039,80,53912,80,allow,3431,2292,1139,17,142,10,7
47096,60053,443,33088,443,allow,3190,1599,1591,17,142,9,8
47097,60023,443,8218,443,allow,9660,4678,4982,30,144,15,15
47098,56710,53,43417,53,allow,190,97,93,2,31,1,1
47099,65143,53,7897,53,allow,184,94,90,2,30,1,1
47100,56811,44008,31634,44008,allow,3034,1547,1487,12,16,7,5
47101,53126,47035,16520,47035,allow,70,70,0,2,8,2,0
47102,61413,443,10754,443,allow,4933,771,4162,18,28,8,10
47103,49921,53,38148,53,allow,212,108,104,2,31,1,1
47104,10077,443,21308,443,allow,10940,4625,6315,36,347,19,17
47105,57394,53,16872,53,allow,186,95,91,2,31,1,1
47106,54962,53,32571,53,allow,188,96,92,2,30,1,1
47107,50311,80,32414,80,allow,366,180,186,7,57,4,3
47108,55656,53,20503,53,allow,760,96,664,2,30,1,1
47109,64381,53,47350,53,allow,196,100,96,2,30,1,1
47110,51615,15000,33004,15000,allow,130,70,60,2,5,1,1
47111,58172,443,58172,443,allow,4526,1619,2907,19,26,11,8
47112,47165,15000,50664,15000,allow,130,70,60,2,5,1,1
47113,61423,443,8022,443,allow,1113,589,524,12,28,6,6
47114,60051,80,25182,80,allow,1327,839,488,10,142,6,4
47115,60418,39537,10622,39537,allow,70,70,0,1,5,1,0
47116,50403,8080,50403,8080,allow,2203,575,1628,10,15,6,4
47117,53835,15000,42611,15000,allow,130,70,60,2,5,1,1
47118,52544,443,52544,443,allow,4487,1580,2907,19,26,11,8
47119,59983,80,41468,80,allow,1745,779,966,12,144,7,5
47120,55484,53,28906,53,allow,711,87,624,2,30,1,1
47121,59997,443,62198,443,allow,3063,1395,1668,16,144,8,8
47122,60022,443,54871,443,allow,4962,2551,2411,19,144,10,9
47123,56548,53,6954,53,allow,198,101,97,2,31,1,1
47124,56728,53,35265,53,allow,164,84,80,2,31,1,1
47125,56183,53,46991,53,allow,174,89,85,2,31,1,1
47126,61431,443,2753,443,allow,1401,940,461,11,28,7,4
47127,47088,15000,21651,15000,allow,138,78,60,2,6,1,1
47128,41543,443,50786,443,allow,78,78,0,1,5,1,0
47129,61424,443,36108,443,allow,1119,589,530,12,28,6,6
47130,60049,443,36353,443,allow,23967,5983,17984,40,142,17,23
47131,59999,443,56048,443,allow,3047,1277,1770,16,144,8,8
47132,52028,53,0,0,allow,354,81,273,2,30,1,1
47133,55580,53,22194,53,allow,788,108,680,2,30,1,1
47134,60012,443,29771,443,allow,6438,2599,3839,21,144,10,11
47135,57005,53,24332,53,allow,762,98,664,2,30,1,1
47136,56262,53,49362,53,allow,701,88,613,2,30,1,1
47137,60000,443,1189,443,allow,34450,1943,32507,47,144,16,31
47138,49995,53,4642,53,allow,99,99,0,1,30,1,0
47139,36453,443,24873,443,allow,7298,2661,4637,21,18,11,10
47140,50310,80,55858,80,allow,7979,802,7177,17,57,8,9
47141,52606,53,0,0,allow,223,91,132,2,30,1,1
47142,55431,53,28791,53,allow,192,98,94,2,30,1,1
47143,56928,53,33620,53,allow,172,88,84,2,30,1,1
47144,57018,53,1950,53,allow,170,87,83,2,30,1,1
47145,64790,53,30667,53,allow,182,93,89,2,30,1,1
47146,57281,53,42469,53,allow,172,88,84,2,30,1,1
47147,55534,53,23781,53,allow,168,86,82,2,30,1,1
47148,57246,53,53043,53,allow,182,93,89,2,31,1,1
47149,56767,53,17852,53,allow,170,87,83,2,31,1,1
47150,59093,53,0,0,allow,215,77,138,2,31,1,1
47151,65304,53,2754,53,allow,202,103,99,2,31,1,1
47152,51909,443,57663,443,allow,8801,2032,6769,28,361,14,14
47153,56562,53,8442,53,allow,726,85,641,2,30,1,1
47154,56914,53,41623,53,allow,731,85,646,2,30,1,1
47155,55666,53,48851,53,allow,728,96,632,2,30,1,1
47156,64582,53,25024,53,allow,202,103,99,2,30,1,1
47157,55994,53,14780,53,allow,182,93,89,2,30,1,1
47158,57263,53,62100,53,allow,166,85,81,2,30,1,1
47159,55205,53,36429,53,allow,166,85,81,2,31,1,1
47160,49547,53,1649,53,allow,186,95,91,2,31,1,1
47161,49242,53,7199,53,allow,166,85,81,2,31,1,1
47162,28176,34021,0,0,allow,66,66,0,1,90,1,0
47163,57470,6881,10120,6881,allow,163,163,0,1,1200,1,0
47164,60814,443,39150,443,allow,740,222,518,11,3631,4,7
47165,55199,53,58104,53,allow,212,108,104,2,30,1,1
47166,59352,53,59352,53,allow,283,114,169,2,31,1,1
47167,49707,53,0,0,allow,82,82,0,1,31,1,0
47168,44967,53,51774,53,allow,198,93,105,2,31,1,1
47169,49806,53,49806,53,allow,229,89,140,2,31,1,1
47170,38910,53,21140,53,allow,198,93,105,2,31,1,1
47171,64016,53,9177,53,allow,93,93,0,1,31,1,0
47172,27005,30007,41112,30007,allow,890,126,764,2,31,1,1
47173,55440,53,49182,53,allow,752,93,659,2,31,1,1
47174,64074,53,3754,53,allow,202,103,99,2,31,1,1
47175,64678,53,7690,53,allow,758,93,665,2,31,1,1
47176,56729,53,56729,53,allow,229,89,140,2,31,1,1
47177,50201,53,18513,53,allow,751,95,656,2,31,1,1
47178,55937,53,44427,53,allow,758,93,665,2,31,1,1
47179,55489,53,54406,53,allow,186,95,91,2,31,1,1
47180,64761,53,64761,53,allow,220,100,120,2,31,1,1
47181,55271,53,61756,53,allow,751,95,656,2,31,1,1
47182,47787,53,24914,53,allow,198,93,105,2,31,1,1
47183,56396,53,44233,53,allow,182,93,89,2,31,1,1
47184,52377,53,52377,53,allow,229,89,140,2,31,1,1
47185,41713,443,59804,443,allow,61983,10061,51922,85,130,35,50
47186,20624,53,20624,53,allow,229,89,140,2,31,1,1
47187,43927,443,42119,443,allow,3410,1249,2161,16,136,8,8
47188,57470,16721,16664,16721,allow,163,163,0,1,1200,1,0
47189,57146,53,31700,53,allow,198,101,97,2,31,1,1
47190,64820,53,13245,53,allow,190,97,93,2,31,1,1
47191,57346,53,4986,53,allow,204,104,100,2,31,1,1
47192,27005,30006,32139,30006,allow,890,126,764,3,31,2,1
47193,49157,53,49157,53,allow,229,89,140,2,31,1,1
47194,39029,53,55192,53,allow,198,93,105,2,31,1,1
47195,56487,53,29660,53,allow,778,103,675,2,31,1,1
47196,59583,53,59583,53,allow,229,89,140,2,31,1,1
47197,50298,443,51193,443,allow,11984,6772,5212,52,222,30,22
47198,49334,53,23056,53,allow,184,94,90,2,31,1,1
47199,57470,42329,52817,42329,allow,1782,1782,0,28,1559,28,0
47200,59444,53,35195,53,allow,489,114,375,2,31,1,1
47201,40159,53,40159,53,allow,229,89,140,2,31,1,1
47202,55855,53,55855,53,allow,221,89,132,2,31,1,1
47203,54786,30188,0,0,deny,66,66,0,1,0,1,0
47204,46573,50584,0,0,deny,62,62,0,1,0,1,0
47205,55074,445,0,0,drop,70,70,0,1,0,1,0
47206,26502,64147,0,0,deny,62,62,0,1,0,1,0
47207,443,3846,0,0,deny,100,100,0,1,0,1,0
47208,47457,41615,0,0,deny,145,145,0,1,0,1,0
47209,39313,37965,0,0,deny,62,62,0,1,0,1,0
47210,26408,64147,0,0,deny,66,66,0,1,0,1,0
47211,25536,50584,0,0,deny,146,146,0,1,0,1,0
47212,36080,26467,0,0,deny,62,62,0,1,0,1,0
47213,55072,445,0,0,drop,70,70,0,1,0,1,0
47214,60026,445,0,0,drop,70,70,0,1,0,1,0
47215,60021,445,0,0,drop,70,70,0,1,0,1,0
47216,60019,445,0,0,drop,70,70,0,1,0,1,0
47217,55401,445,0,0,drop,66,66,0,1,0,1,0
47218,55402,445,0,0,drop,66,66,0,1,0,1,0
47219,55400,445,0,0,drop,66,66,0,1,0,1,0
47220,60018,445,0,0,drop,70,70,0,1,0,1,0
47221,60073,80,45095,80,allow,10676,6719,3957,23,141,12,11
47222,49767,53,52894,53,allow,727,86,641,2,30,1,1
47223,38591,53,55685,53,allow,391,102,289,2,30,1,1
47224,55325,53,50233,53,allow,210,110,100,2,30,1,1
47225,57263,53,12000,53,allow,167,86,81,2,30,1,1
47226,55489,53,32012,53,allow,193,102,91,2,30,1,1
47227,60611,443,2263,443,allow,478331,21023,457308,573,211,201,372
47228,61419,443,15902,443,allow,6661,862,5799,18,28,9,9
47229,50324,80,23988,80,allow,1083,653,430,8,15,5,3
47230,59982,80,63868,80,allow,207418,4580,202838,194,143,50,144
47231,55600,53,57524,53,allow,184,94,90,2,30,1,1
47232,50820,443,64516,443,allow,2760048,78471,2681577,2863,250,962,1901
47233,60610,443,53274,443,allow,187258,9720,177538,225,211,86,139
47234,55485,53,64726,53,allow,212,102,110,2,30,1,1
47235,59324,53,10357,53,allow,211,78,133,2,30,1,1
47236,54962,53,15807,53,allow,194,102,92,2,30,1,1
47237,49226,443,49226,443,allow,118943,24432,94511,156,96,79,77
47238,50688,5222,17560,5222,allow,622,284,338,10,29,5,5
47239,63819,18445,34551,18445,allow,70,70,0,1,4,1,0
47240,63820,27441,46760,27441,allow,70,70,0,1,4,1,0
47241,44792,80,52125,80,allow,1295,781,514,12,16,6,6
47242,56767,53,58838,53,allow,177,94,83,2,30,1,1
47243,63817,50808,64390,50808,allow,70,70,0,1,4,1,0
47244,63816,2073,59297,2073,allow,70,70,0,1,4,1,0
47245,59944,80,15920,80,allow,1052,612,440,10,15,5,5
47246,50826,443,44270,443,allow,820870,30523,790347,918,218,337,581
47247,54705,443,23468,443,allow,5411,851,4560,17,15,8,9
47248,60417,55100,62868,55100,allow,164,70,94,2,5,1,1
47249,49513,53,63183,53,allow,200,102,98,2,29,1,1
47250,55431,53,52036,53,allow,196,102,94,2,29,1,1
47251,59878,53,26296,53,allow,391,102,289,2,29,1,1
47252,65037,53,26531,53,allow,210,110,100,2,29,1,1
47253,62330,443,31152,443,allow,21361086,218978,21142108,16512,170,2203,14309
47254,49498,53,63118,53,allow,734,94,640,2,29,1,1
47255,59010,53,59010,53,allow,832,106,726,2,29,1,1
47256,39095,443,56882,443,allow,310402,12194,298208,374,82,157,217
47257,56227,53,39156,53,allow,194,102,92,2,30,1,1
47258,64592,53,58811,53,allow,209,110,99,2,30,1,1
47259,56512,53,8579,53,allow,166,86,80,2,29,1,1
47260,61420,443,13668,443,allow,6327,1143,5184,18,28,9,9
47261,36785,443,22172,443,allow,1799,1224,575,13,26,8,5
47262,57362,53,38084,53,allow,177,94,83,2,30,1,1
47263,65304,53,18529,53,allow,209,110,99,2,30,1,1
47264,56183,53,22164,53,allow,179,94,85,2,30,1,1
47265,56710,53,13287,53,allow,195,102,93,2,30,1,1
47266,57394,53,63615,53,allow,193,102,91,2,30,1,1
47267,55199,53,63151,53,allow,214,110,104,2,30,1,1
47268,50226,80,43900,80,allow,9659,1454,8205,28,278,13,15
47269,51840,34678,2661,34678,allow,70,70,0,2,8,2,0
47270,51824,53021,25345,53021,allow,66,66,0,2,8,2,0
47271,61417,443,31390,443,allow,4890,1219,3671,17,28,10,7
47272,61414,443,14574,443,allow,5020,860,4160,18,28,9,9
47273,60033,443,16938,443,allow,2845,1765,1080,15,142,8,7
47274,60045,80,49980,80,allow,1455,965,490,10,142,6,4
47275,55410,53,52970,53,allow,212,102,110,2,30,1,1
47276,54962,53,25167,53,allow,194,102,92,2,30,1,1
47277,60095,443,60308,443,allow,2357,1467,890,15,140,8,7
47278,56606,443,53334,443,allow,9679,1633,8046,25,20,14,11
47279,59991,443,45209,443,allow,5108,2834,2274,21,143,10,11
47280,60543,53,6634,53,allow,211,78,133,2,30,1,1
47281,38639,80,55224,80,allow,1013,504,509,10,15,6,4
47282,36786,443,50412,443,allow,1798,1223,575,13,26,8,5
47283,60091,443,19389,443,allow,2531,1288,1243,17,140,9,8
47284,55655,53,4325,53,allow,524,214,310,6,57,3,3
47285,60061,443,58385,443,allow,3195,1426,1769,15,141,8,7
47286,60011,443,19677,443,allow,8413,3768,4645,25,143,12,13
47287,60063,443,64614,443,allow,432803,9264,423539,427,141,135,292
47288,49991,53,12205,53,allow,198,102,96,2,30,1,1
47289,60007,443,50307,443,allow,2798,1652,1146,15,143,8,7
47290,64854,53,12372,53,allow,1431,101,1330,4,50,2,2
47291,63811,80,47846,80,allow,314,192,122,6,15,4,2
47292,55772,53,24055,53,allow,269,110,159,2,30,1,1
47293,55771,53,21538,53,allow,283,98,185,4,52,2,2
47294,49316,53,61603,53,allow,184,94,90,2,30,1,1
47295,65446,53,11171,53,allow,168,86,82,2,30,1,1
47296,57362,53,3531,53,allow,177,94,83,2,30,1,1
47297,55027,53,65292,53,allow,343,86,257,4,58,2,2
47298,65206,53,46359,53,allow,167,86,81,2,30,1,1
47299,57281,53,14335,53,allow,178,94,84,2,30,1,1
47300,57685,53,47518,53,allow,275,86,189,2,30,1,1
47301,56767,53,32268,53,allow,177,94,83,2,30,1,1
47302,56511,53,32498,53,allow,200,102,98,2,30,1,1
47303,61700,53,0,0,allow,202,86,116,2,30,1,1
47304,50067,53,31624,53,allow,177,94,83,2,30,1,1
47305,64381,53,26257,53,allow,198,102,96,2,30,1,1
47306,64582,53,17757,53,allow,209,110,99,2,30,1,1
47307,55450,53,2536,53,allow,102,102,0,1,30,1,0
47308,55475,53,23006,53,allow,784,94,690,2,30,1,1
47309,47370,443,20985,443,allow,350,210,140,6,75,4,2
47310,50315,80,20802,80,allow,1030,310,720,11,56,6,5
47311,34331,443,8773,443,allow,1717,1153,564,13,26,7,6
47312,34330,443,44282,443,allow,1717,1153,564,13,26,7,6
47313,60055,443,24328,443,allow,2314,1232,1082,15,141,8,7
47314,60065,443,12163,443,allow,6395,2524,3871,18,141,10,8
47315,60367,443,45021,443,allow,4847,963,3884,22,63,11,11
47316,60605,53,5384,53,allow,275,86,189,2,30,1,1
47317,56533,53,11547,53,allow,498,204,294,6,30,3,3
47318,56266,53,53849,53,allow,182,102,80,2,30,1,1
47319,55199,53,8107,53,allow,214,110,104,2,30,1,1
47320,56809,53,37625,53,allow,167,86,81,2,30,1,1
47321,61411,443,46300,443,allow,4775,894,3881,18,28,10,8
47322,60085,443,22950,443,allow,1000,557,443,11,141,6,5
47323,60047,80,39100,80,allow,2634,1780,854,14,142,8,6
47324,60067,443,11544,443,allow,14085,1879,12206,27,141,12,15
47325,60003,443,18889,443,allow,32538,7037,25501,49,143,20,29
47326,60060,443,7904,443,allow,4648,1505,3143,17,141,9,8
47327,57281,53,55108,53,allow,178,94,84,2,30,1,1
47328,49601,53,30637,53,allow,178,94,84,2,30,1,1
47329,65235,53,42179,53,allow,209,110,99,2,30,1,1
47330,16225,443,41335,443,allow,13126,5105,8021,37,31,21,16
47331,64381,53,3642,53,allow,198,102,96,2,30,1,1
47332,64934,53,64886,53,allow,197,102,95,2,30,1,1
47333,64790,53,41786,53,allow,183,94,89,2,30,1,1
47334,65087,53,12187,53,allow,413,170,243,6,30,3,3
47335,65206,53,7977,53,allow,167,86,81,2,30,1,1
47336,57246,53,12592,53,allow,183,94,89,2,30,1,1
47337,65073,53,7816,53,allow,195,102,93,2,30,1,1
47338,61433,443,18649,443,allow,7796,766,7030,16,27,8,8
47339,55076,80,31296,80,allow,1129,580,549,11,74,6,5
47340,61407,443,5972,443,allow,6248,829,5419,17,29,9,8
47341,40432,443,35104,443,allow,12022,2731,9291,53,20,26,27
47342,50928,443,1946,443,allow,3347,2025,1322,31,34,18,13
47343,57030,53,42325,53,allow,283,101,182,4,37,2,2
47344,39096,443,59336,443,allow,1268772,32833,1235939,1288,81,409,879
47345,60019,443,11836,443,allow,76774,9184,67590,104,143,41,63
47346,53234,443,19776,443,allow,21571,8604,12967,38,34,19,19
47347,60088,443,5059,443,allow,1000,557,443,11,141,6,5
47348,60727,443,60727,443,allow,2169,1158,1011,20,15,11,9
47349,34332,443,1542,443,allow,1717,1153,564,13,26,7,6
47350,60089,443,5576,443,allow,1000,557,443,11,141,6,5
47351,63818,19291,22268,19291,allow,70,70,0,1,4,1,0
47352,60093,443,46965,443,allow,2090,1218,872,15,140,8,7
47353,60043,443,26610,443,allow,1015,572,443,11,142,6,5
47354,60014,443,60627,443,allow,4275,1488,2787,17,143,9,8
47355,55050,80,49586,80,allow,246,120,126,5,15,3,2
47356,50309,80,22924,80,allow,2481,723,1758,12,57,6,6
47357,50307,80,42606,80,allow,3179,863,2316,13,57,7,6
47358,38640,80,6468,80,allow,1013,504,509,10,15,6,4
47359,60069,443,38195,443,allow,3045,1340,1705,16,141,8,8
47360,63808,40608,41042,40608,allow,504,382,122,8,15,6,2
47361,60006,80,32015,80,allow,1836,816,1020,12,143,7,5
47362,60890,443,40246,443,allow,15081,6817,8264,31,34,14,17
47363,56196,53,30280,53,allow,214,110,104,2,29,1,1
47364,60075,443,54321,443,allow,6300,1427,4873,20,141,9,11
47365,55534,53,10719,53,allow,168,86,82,2,29,1,1
47366,56380,53,36495,53,allow,177,94,83,2,30,1,1
47367,49991,53,8139,53,allow,198,102,96,2,30,1,1
47368,49936,53,39032,53,allow,216,110,106,2,29,1,1
47369,56000,53,18353,53,allow,177,94,83,2,29,1,1
47370,57157,53,8214,53,allow,165,86,79,2,30,1,1
47371,49206,53,41774,53,allow,301,89,212,4,48,2,2
47372,64598,53,18969,53,allow,222,94,128,2,29,1,1
47373,55497,53,23337,53,allow,184,102,82,2,29,1,1
47374,64053,53,35360,53,allow,193,102,91,2,29,1,1
47375,64766,53,47744,53,allow,214,110,104,2,29,1,1
47376,64053,53,10506,53,allow,193,102,91,2,30,1,1
47377,65037,53,16035,53,allow,210,110,100,2,29,1,1
47378,49601,53,44219,53,allow,178,94,84,2,30,1,1
47379,64484,53,57722,53,allow,168,86,82,2,30,1,1
47380,65037,53,41367,53,allow,210,110,100,2,29,1,1
47381,57246,53,9725,53,allow,183,94,89,2,30,1,1
47382,49157,53,42050,53,allow,184,94,90,2,29,1,1
47383,55179,53,31015,53,allow,178,94,84,2,30,1,1
47384,56548,53,18583,53,allow,199,102,97,2,30,1,1
47385,64053,53,26364,53,allow,193,102,91,2,30,1,1
47386,55994,53,14095,53,allow,183,94,89,2,30,1,1
47387,65446,53,2812,53,allow,184,102,82,2,30,1,1
47388,49730,53,34658,53,allow,194,102,92,2,30,1,1
47389,57281,53,33051,53,allow,178,94,84,2,30,1,1
47390,64582,53,29517,53,allow,209,110,99,2,30,1,1
47391,49157,53,54699,53,allow,184,94,90,2,30,1,1
47392,56629,53,37533,53,allow,177,94,83,2,30,1,1
47393,49547,53,49951,53,allow,193,102,91,2,30,1,1
47394,55205,53,50575,53,allow,167,86,81,2,30,1,1
47395,64587,53,36595,53,allow,167,86,81,2,31,1,1
47396,41085,443,36619,443,allow,5553,1055,4498,19,121,9,10
47397,57470,44919,55339,44919,allow,166,166,0,1,1199,1,0
47398,49921,53,27368,53,allow,214,110,104,2,30,1,1
47399,57193,53,40448,53,allow,229,110,119,2,30,1,1
47400,49730,53,40205,53,allow,194,102,92,2,30,1,1
47401,49921,53,58309,53,allow,214,110,104,2,30,1,1
47402,57263,53,19540,53,allow,167,86,81,2,30,1,1
47403,55205,53,56363,53,allow,167,86,81,2,30,1,1
47404,50034,53,15680,53,allow,179,94,85,2,30,1,1
47405,55889,53,7976,53,allow,168,86,82,2,30,1,1
47406,60542,53,46573,53,allow,260,86,174,2,30,1,1
47407,10151,6881,7271,6881,allow,490,150,340,2,1200,1,1
47408,61434,443,24839,443,allow,8005,830,7175,19,27,9,10
47409,58600,53,58600,53,allow,217,82,135,2,32,1,1
47410,60083,443,30237,443,allow,490571,27526,463045,511,141,170,341
47411,60015,443,28429,443,allow,6340,3788,2552,21,143,10,11
47412,60029,443,40871,443,allow,1057,590,467,11,142,6,5
47413,60010,443,42426,443,allow,4795,2875,1920,19,143,10,9
47414,55001,80,28763,80,allow,9249354,297929,8951425,10789,208,4872,5917
47415,60898,443,32262,443,allow,10104,1643,8461,28,46,15,13
47416,56609,443,13546,443,allow,11061,1566,9495,25,19,13,12
47417,55250,443,44147,443,allow,1271,918,353,9,15,6,3
47418,56511,53,50821,53,allow,200,102,98,2,30,1,1
47419,55325,53,2560,53,allow,210,110,100,2,30,1,1
47420,50067,53,8496,53,allow,177,94,83,2,30,1,1
47421,57346,53,32731,53,allow,210,110,100,2,30,1,1
47422,56548,53,28244,53,allow,199,102,97,2,31,1,1
47423,56343,53,58460,53,allow,194,102,92,2,31,1,1
47424,35888,443,35888,443,allow,4481,1574,2907,19,26,11,8
47425,60416,55998,54141,55998,allow,70,70,0,1,5,1,0
47426,60037,443,65363,443,allow,4722,2945,1777,18,142,10,8
47427,50299,80,31739,80,allow,2316,1206,1110,16,81,9,7
47428,33252,443,7874,443,allow,89817,21083,68734,148,36,77,71
47429,55902,53,58638,53,allow,181,94,87,2,30,1,1
47430,64582,53,64118,53,allow,209,110,99,2,30,1,1
47431,55600,53,36294,53,allow,184,94,90,2,30,1,1
47432,50034,53,21368,53,allow,179,94,85,2,30,1,1
47433,55165,53,15099,53,allow,199,102,97,2,30,1,1
47434,56090,53,62587,53,allow,195,94,101,2,30,1,1
47435,56809,53,9821,53,allow,167,86,81,2,30,1,1
47436,56511,53,55404,53,allow,200,102,98,2,30,1,1
47437,55165,53,30043,53,allow,199,102,97,2,30,1,1
47438,57246,53,49639,53,allow,183,94,89,2,31,1,1
47439,50828,443,8189,443,allow,178483,7778,170705,219,218,90,129
47440,60018,443,59209,443,allow,117023,8825,108198,138,143,49,89
47441,60098,443,41490,443,allow,1011,568,443,11,139,6,5
47442,36781,443,37104,443,allow,1798,1223,575,13,26,8,5
47443,64934,53,51307,53,allow,197,102,95,2,33,1,1
47444,60105,443,39991,443,allow,4856,1587,3269,17,138,9,8
47445,60041,443,53446,443,allow,1015,572,443,11,142,6,5
47446,55623,62853,62347,62853,allow,504,318,186,8,15,5,3
47447,50314,80,10727,80,allow,1030,310,720,11,56,6,5
47448,50317,80,30399,80,allow,5438,2832,2606,18,56,10,8
47449,56608,443,21691,443,allow,10062,1631,8431,25,19,14,11
47450,56413,53,29873,53,allow,233,94,139,2,30,1,1
47451,56710,53,54162,53,allow,355,97,258,4,60,2,2
47452,59925,443,55867,443,allow,10302,3853,6449,27,61,16,11
47453,64820,53,3092,53,allow,195,102,93,2,30,1,1
47454,57029,53,54997,53,allow,413,170,243,6,30,3,3
47455,55266,53,20409,53,allow,365,102,263,2,30,1,1
47456,55662,53,45972,53,allow,212,102,110,2,30,1,1
47457,65304,53,46271,53,allow,209,110,99,2,30,1,1
47458,55889,53,65516,53,allow,168,86,82,2,30,1,1
47459,55179,53,47200,53,allow,178,94,84,2,30,1,1
47460,65096,53,51459,53,allow,216,94,122,2,30,1,1
47461,56629,53,33066,53,allow,177,94,83,2,30,1,1
47462,65143,53,45277,53,allow,184,94,90,2,30,1,1
47463,59323,53,1369,53,allow,260,86,174,2,30,1,1
47464,65229,53,45181,53,allow,195,102,93,2,31,1,1
47465,27005,27056,45270,27056,allow,908,126,782,2,31,1,1
47466,57146,53,33353,53,allow,199,102,97,2,31,1,1
47467,56704,53,8695,53,allow,194,102,92,2,31,1,1
47468,49921,53,21465,53,allow,214,110,104,2,31,1,1
47469,50438,53,15254,53,allow,296,101,195,4,31,2,2
47470,50438,53,44786,53,allow,296,101,195,4,31,2,2
47471,60811,443,53507,443,allow,740,222,518,11,3631,4,7
47472,56767,53,44423,53,allow,177,94,83,2,30,1,1
47473,56183,53,23444,53,allow,179,94,85,2,30,1,1
47474,49513,53,20128,53,allow,391,102,289,4,31,2,2
47475,65241,53,34581,53,allow,198,102,96,2,30,1,1
47476,55955,53,56880,53,allow,184,94,90,2,30,1,1
47477,49334,53,14859,53,allow,184,94,90,2,30,1,1
47478,49265,53,12727,53,allow,181,94,87,2,31,1,1
47479,65437,53,61379,53,allow,195,102,93,2,31,1,1
47480,57394,53,39709,53,allow,193,102,91,2,31,1,1
47481,55955,53,35067,53,allow,184,94,90,2,31,1,1
47482,27005,27055,64070,27055,allow,915,126,789,2,31,1,1
47483,65165,53,21302,53,allow,200,102,98,2,31,1,1
47484,27005,28002,27297,28002,allow,918,126,792,2,31,1,1
47485,65482,53,46055,53,allow,179,94,85,2,31,1,1
47486,27005,27058,26884,27058,allow,908,126,782,2,31,1,1
47487,49334,53,54606,53,allow,184,94,90,2,31,1,1
47488,6881,6881,34489,6881,allow,253,118,135,2,1199,1,1
47489,54644,443,43384,443,allow,4679,3387,1292,18,304,10,8
47490,51835,443,19929,443,allow,48635,5346,43289,83,151,38,45
47491,55902,53,57612,53,allow,181,94,87,2,30,1,1
47492,56396,53,37010,53,allow,183,94,89,2,30,1,1
47493,64074,53,54669,53,allow,209,110,99,2,30,1,1
47494,55071,53,33464,53,allow,177,94,83,2,31,1,1
47495,51221,57522,58823,57522,allow,481,150,331,2,1200,1,1
47496,60759,40010,60253,40010,allow,316,136,180,6,7,3,3
47497,2037,23,2037,23,allow,152,66,86,2,10,1,1
47498,49843,80,51294,80,allow,2901,1805,1096,17,108,13,4
47499,27005,27054,8800,27054,allow,921,126,795,2,31,1,1
47500,27005,26259,57804,26259,allow,889,126,763,2,31,1,1
47501,53534,443,20648,443,allow,7639,1831,5808,29,76,15,14
47502,43314,443,48162,443,allow,6102,782,5320,17,67,8,9
47503,14434,443,32675,443,allow,2556,1470,1086,17,16,8,9
47504,40845,53,40845,53,allow,210,98,112,2,31,1,1
47505,62311,443,60007,443,allow,4778,1121,3657,15,280,8,7
47506,51845,11201,33761,11201,allow,316,136,180,6,6,3,3
47507,49162,53,30620,53,allow,401,94,307,4,32,2,2
47508,55068,445,0,0,drop,70,70,0,1,0,1,0
47509,10701,11392,0,0,deny,62,62,0,1,0,1,0
47510,7892,50584,0,0,deny,62,62,0,1,0,1,0
47511,60015,445,0,0,drop,70,70,0,1,0,1,0
47512,60013,445,0,0,drop,70,70,0,1,0,1,0
47513,60009,445,0,0,drop,70,70,0,1,0,1,0
47514,60004,445,0,0,drop,70,70,0,1,0,1,0
47515,16948,990,0,0,deny,60,60,0,1,0,1,0
47516,50631,23,0,0,deny,60,60,0,1,0,1,0
47517,39548,8696,0,0,deny,60,60,0,1,0,1,0
47518,55053,445,0,0,drop,70,70,0,1,0,1,0
47519,39540,37965,0,0,deny,66,66,0,1,0,1,0
47520,57768,37965,0,0,deny,62,62,0,1,0,1,0
47521,443,62451,0,0,deny,199,199,0,1,0,1,0
47522,63586,46824,0,0,deny,62,62,0,1,0,1,0
47523,59995,445,0,0,drop,70,70,0,1,0,1,0
47524,59998,445,0,0,drop,70,70,0,1,0,1,0
47525,59993,445,0,0,drop,70,70,0,1,0,1,0
47526,55050,445,0,0,drop,70,70,0,1,0,1,0
47527,57564,56205,0,0,deny,66,66,0,1,0,1,0
47528,55045,445,0,0,drop,70,70,0,1,0,1,0
47529,10916,44847,0,0,deny,66,66,0,1,0,1,0
47530,55044,445,0,0,drop,70,70,0,1,0,1,0
47531,60350,51505,0,0,deny,66,66,0,1,0,1,0
47532,52575,22114,0,0,deny,66,66,0,1,0,1,0
47533,49616,30188,0,0,deny,66,66,0,1,0,1,0
47534,55378,445,0,0,drop,66,66,0,1,0,1,0
47535,58264,44847,0,0,deny,66,66,0,1,0,1,0
47536,55042,445,0,0,drop,70,70,0,1,0,1,0
47537,59989,445,0,0,drop,70,70,0,1,0,1,0
47538,59988,445,0,0,drop,70,70,0,1,0,1,0
47539,25469,57470,0,0,deny,62,62,0,1,0,1,0
47540,55374,445,0,0,drop,66,66,0,1,0,1,0
47541,59739,35253,0,0,deny,62,62,0,1,0,1,0
47542,55035,445,0,0,drop,70,70,0,1,0,1,0
47543,55370,445,0,0,drop,66,66,0,1,0,1,0
47544,59977,445,0,0,drop,70,70,0,1,0,1,0
47545,55033,445,0,0,drop,70,70,0,1,0,1,0
47546,53459,37807,0,0,deny,62,62,0,1,0,1,0
47547,59971,445,0,0,drop,70,70,0,1,0,1,0
47548,59968,445,0,0,drop,70,70,0,1,0,1,0
47549,59967,445,0,0,drop,70,70,0,1,0,1,0
47550,55367,445,0,0,drop,66,66,0,1,0,1,0
47551,4300,37838,0,0,deny,146,146,0,1,0,1,0
47552,56582,37965,0,0,deny,66,66,0,1,0,1,0
47553,55032,445,0,0,drop,70,70,0,1,0,1,0
47554,3559,30188,0,0,deny,62,62,0,1,0,1,0
47555,18246,64097,0,0,deny,62,62,0,1,0,1,0
47556,55031,445,0,0,drop,70,70,0,1,0,1,0
47557,55030,445,0,0,drop,70,70,0,1,0,1,0
47558,35163,30188,0,0,deny,66,66,0,1,0,1,0
47559,55921,43890,0,0,deny,62,62,0,1,0,1,0
47560,55027,445,0,0,drop,70,70,0,1,0,1,0
47561,55024,445,0,0,drop,70,70,0,1,0,1,0
47562,59964,445,0,0,drop,70,70,0,1,0,1,0
47563,59937,37965,0,0,deny,66,66,0,1,0,1,0
47564,2918,37965,0,0,deny,62,62,0,1,0,1,0
47565,59960,445,0,0,drop,70,70,0,1,0,1,0
47566,59959,445,0,0,drop,70,70,0,1,0,1,0
47567,59956,445,0,0,drop,70,70,0,1,0,1,0
47568,55361,445,0,0,drop,66,66,0,1,0,1,0
47569,65518,5710,0,0,deny,62,62,0,1,0,1,0
47570,443,45940,0,0,deny,85,85,0,1,0,1,0
47571,55012,445,0,0,drop,70,70,0,1,0,1,0
47572,55011,445,0,0,drop,70,70,0,1,0,1,0
47573,55358,445,0,0,drop,66,66,0,1,0,1,0
47574,55355,445,0,0,drop,66,66,0,1,0,1,0
47575,55352,445,0,0,drop,66,66,0,1,0,1,0
47576,43916,21,0,0,deny,60,60,0,1,0,1,0
47577,58481,37838,0,0,deny,146,146,0,1,0,1,0
47578,55009,445,0,0,drop,70,70,0,1,0,1,0
47579,58338,3369,0,0,deny,60,60,0,1,0,1,0
47580,55001,445,0,0,drop,70,70,0,1,0,1,0
47581,55002,445,0,0,drop,70,70,0,1,0,1,0
47582,55351,445,0,0,drop,66,66,0,1,0,1,0
47583,55350,445,0,0,drop,66,66,0,1,0,1,0
47584,55349,445,0,0,drop,66,66,0,1,0,1,0
47585,11023,51505,0,0,deny,66,66,0,1,0,1,0
47586,61902,22114,0,0,deny,66,66,0,1,0,1,0
47587,35421,30188,0,0,deny,146,146,0,1,0,1,0
47588,33287,57354,0,0,deny,145,145,0,1,0,1,0
47589,49717,57470,0,0,deny,62,62,0,1,0,1,0
47590,59954,445,0,0,drop,70,70,0,1,0,1,0
47591,59952,445,0,0,drop,70,70,0,1,0,1,0
47592,59951,445,0,0,drop,70,70,0,1,0,1,0
47593,44981,57470,0,0,deny,66,66,0,1,0,1,0
47594,55346,445,0,0,drop,66,66,0,1,0,1,0
47595,59947,445,0,0,drop,70,70,0,1,0,1,0
47596,33948,15503,0,0,deny,146,146,0,1,0,1,0
47597,55343,445,0,0,drop,66,66,0,1,0,1,0
47598,49255,44847,0,0,deny,62,62,0,1,0,1,0
47599,55341,445,0,0,drop,66,66,0,1,0,1,0
47600,55339,445,0,0,drop,66,66,0,1,0,1,0
47601,54990,445,0,0,drop,70,70,0,1,0,1,0
47602,48629,63131,0,0,deny,74,74,0,1,0,1,0
47603,55338,445,0,0,drop,66,66,0,1,0,1,0
47604,46670,51505,0,0,deny,146,146,0,1,0,1,0
47605,23936,35440,0,0,deny,62,62,0,1,0,1,0
47606,52837,35440,0,0,deny,66,66,0,1,0,1,0
47607,59941,445,0,0,drop,70,70,0,1,0,1,0
47608,34808,22114,0,0,deny,66,66,0,1,0,1,0
47609,56202,15503,0,0,deny,146,146,0,1,0,1,0
47610,39119,44847,0,0,deny,62,62,0,1,0,1,0
47611,59938,445,0,0,drop,70,70,0,1,0,1,0
47612,59929,445,0,0,drop,70,70,0,1,0,1,0
47613,54986,445,0,0,drop,70,70,0,1,0,1,0
47614,51032,30188,0,0,deny,66,66,0,1,0,1,0
47615,48016,57470,0,0,deny,62,62,0,1,0,1,0
47616,58481,15503,0,0,deny,146,146,0,1,0,1,0
47617,61838,37965,0,0,deny,62,62,0,1,0,1,0
47618,54975,445,0,0,drop,70,70,0,1,0,1,0
47619,54977,445,0,0,drop,70,70,0,1,0,1,0
47620,55327,445,0,0,drop,66,66,0,1,0,1,0
47621,1024,50265,0,0,deny,62,62,0,1,0,1,0
47622,54971,445,0,0,drop,70,70,0,1,0,1,0
47623,54974,445,0,0,drop,70,70,0,1,0,1,0
47624,6666,50070,0,0,deny,60,60,0,1,0,1,0
47625,54970,445,0,0,drop,70,70,0,1,0,1,0
47626,55311,44847,0,0,deny,66,66,0,1,0,1,0
47627,55319,445,0,0,drop,66,66,0,1,0,1,0
47628,45964,3111,0,0,deny,60,60,0,1,0,1,0
47629,59919,445,0,0,drop,70,70,0,1,0,1,0
47630,38653,21247,0,0,deny,62,62,0,1,0,1,0
47631,58398,44847,0,0,deny,66,66,0,1,0,1,0
47632,55316,445,0,0,drop,66,66,0,1,0,1,0
47633,54963,445,0,0,drop,70,70,0,1,0,1,0
47634,30114,65151,0,0,deny,60,60,0,1,0,1,0
47635,17579,57470,0,0,deny,62,62,0,1,0,1,0
47636,55310,445,0,0,drop,66,66,0,1,0,1,0
47637,54956,445,0,0,drop,70,70,0,1,0,1,0
47638,55300,445,0,0,drop,66,66,0,1,0,1,0
47639,25010,30188,0,0,deny,146,146,0,1,0,1,0
47640,4515,37807,0,0,deny,62,62,0,1,0,1,0
47641,54954,445,0,0,drop,70,70,0,1,0,1,0
47642,36061,53,36061,53,allow,220,100,120,2,30,1,1
47643,30478,53,30478,53,allow,229,89,140,2,30,1,1
47644,63831,31539,8065,31539,allow,312,132,180,6,7,3,3
47645,55771,53,58272,53,allow,283,98,185,4,51,2,2
47646,15523,53,15523,53,allow,227,88,139,2,30,1,1
47647,60373,80,60373,80,allow,116680,5773,110907,126,21,46,80
47648,46633,53,46633,53,allow,237,91,146,2,32,1,1
47649,53647,16194,65302,16194,allow,70,70,0,2,8,2,0
47650,65497,53,35507,53,allow,194,99,95,2,31,1,1
47651,64335,53,18778,53,allow,186,95,91,2,30,1,1
47652,15239,53,15239,53,allow,229,89,140,2,30,1,1
47653,56625,443,54912,443,allow,6734,2065,4669,21,16,11,10
47654,49227,443,49227,443,allow,155471,20626,134845,193,95,92,101
47655,57174,53,65010,53,allow,755,94,661,2,30,1,1
47656,51230,80,8702,80,allow,1594,1280,314,10,15,5,5
47657,56656,443,8282,443,allow,7743,3072,4671,18,125,10,8
47658,49162,53,60010,53,allow,182,93,89,2,31,1,1
47659,55955,53,59557,53,allow,184,94,90,2,30,1,1
47660,61697,443,10867,443,allow,9963,2631,7332,37,48,20,17
47661,53560,443,34440,443,allow,10823,1626,9197,27,28,15,12
47662,61678,80,36347,80,allow,79505,3799,75706,105,53,43,62
47663,55071,53,10472,53,allow,170,87,83,2,31,1,1
47664,49265,53,7053,53,allow,178,91,87,2,31,1,1
47665,53653,17436,48182,17436,allow,70,70,0,2,8,2,0
47666,56695,53,57441,53,allow,776,102,674,2,30,1,1
47667,57406,53,28886,53,allow,761,100,661,2,30,1,1
47668,38678,443,31559,443,allow,484,210,274,8,26,4,4
47669,65437,53,50016,53,allow,190,97,93,2,30,1,1
47670,55450,53,15433,53,allow,186,95,91,2,30,1,1
47671,53650,37096,53395,37096,allow,70,70,0,2,8,2,0
47672,65241,53,65497,53,allow,196,100,96,2,30,1,1
47673,51928,443,37238,443,allow,18581,9681,8900,62,103,33,29
47674,59828,53,0,0,allow,275,75,200,2,30,1,1
47675,65229,53,65354,53,allow,190,97,93,2,31,1,1
47676,56704,53,19637,53,allow,188,96,92,2,31,1,1
47677,65165,53,54019,53,allow,200,102,98,2,31,1,1
47678,57072,53,1078,53,allow,190,97,93,2,31,1,1
47679,53561,443,46196,443,allow,4586,1216,3370,17,28,10,7
47680,48422,53,48422,53,allow,229,89,140,2,30,1,1
47681,51819,59208,18687,59208,allow,66,66,0,2,8,2,0
47682,50034,53,9396,53,allow,174,89,85,2,30,1,1
47683,60796,80,60796,80,allow,13869,3749,10120,28,26,15,13
47684,64587,53,28928,53,allow,166,85,81,2,30,1,1
47685,40905,443,30832,443,allow,6982,1535,5447,30,26,15,15
47686,27005,27021,33565,27021,allow,879,126,753,2,30,1,1
47687,50584,6881,48204,6881,allow,161,161,0,1,1200,1,0
47688,57470,6889,39885,6889,allow,507,163,344,2,1200,1,1
47689,30960,45708,10232,45708,allow,330,330,0,6,3609,6,0
47690,32390,53,32390,53,allow,229,89,140,2,30,1,1
47691,38791,53,38791,53,allow,229,89,140,2,30,1,1
47692,55032,53,0,0,allow,288,79,209,2,31,1,1
47693,57275,53,1884,53,allow,186,95,91,2,31,1,1
47694,55871,53,0,0,allow,82,82,0,1,31,1,0
47695,49843,53,31745,53,allow,186,95,91,2,31,1,1
47696,53546,443,23696,443,allow,7268,3166,4102,19,136,10,9
47697,36306,53,36306,53,allow,229,89,140,2,30,1,1
47698,5881,53,5881,53,allow,231,90,141,2,31,1,1
47699,64999,53,11642,53,allow,757,98,659,2,31,1,1
47700,50054,53,65410,53,allow,775,103,672,2,31,1,1
47701,57266,53,10699,53,allow,753,96,657,2,31,1,1
47702,48627,443,55025,443,allow,638,70,568,10,207,2,8
47703,52280,5228,18366,5228,allow,2147,1315,832,14,3601,7,7
47704,47163,53,47163,53,allow,825,99,726,2,31,1,1
47705,42153,443,25509,443,allow,12306,2097,10209,31,360,15,16
47706,50584,58516,43586,58516,allow,161,161,0,1,1200,1,0
47707,57470,6881,14174,6881,allow,490,163,327,2,1200,1,1
47708,57096,53,22814,53,allow,196,100,96,2,31,1,1
47709,57296,53,12062,53,allow,200,102,98,2,31,1,1
47710,64904,53,60868,53,allow,198,101,97,2,31,1,1
47711,49654,53,58330,53,allow,184,94,90,2,31,1,1
47712,50584,6881,21374,6881,allow,161,161,0,1,1200,1,0
47713,57470,51413,13214,51413,allow,490,163,327,2,1200,1,1
47714,49522,53,15202,53,allow,753,96,657,2,31,1,1
47715,65439,53,55852,53,allow,751,95,656,2,31,1,1
47716,64946,53,40387,53,allow,202,95,107,2,31,1,1
47717,55481,53,52263,53,allow,793,101,692,2,31,1,1
47718,26352,53,26352,53,allow,231,90,141,2,31,1,1
47719,27005,37579,27251,37579,allow,886,126,760,2,31,1,1
47720,49812,53,21383,53,allow,164,84,80,2,31,1,1
47721,49159,53,33263,53,allow,733,86,647,2,31,1,1
47722,65482,53,40607,53,allow,174,89,85,2,31,1,1
47723,49761,53,10383,53,allow,182,93,89,2,31,1,1
47724,56536,53,9836,53,allow,202,103,99,2,31,1,1
47725,64559,53,44867,53,allow,168,86,82,2,31,1,1
47726,56387,53,8885,53,allow,757,98,659,2,31,1,1
47727,57470,51413,34257,51413,allow,508,163,345,2,1200,1,1
47728,56783,53,31906,53,allow,751,95,656,2,31,1,1
47729,56855,53,37174,53,allow,775,103,672,2,31,1,1
47730,57109,53,37634,53,allow,168,86,82,2,31,1,1
47731,65345,53,26359,53,allow,782,105,677,2,31,1,1
47732,55062,53,13920,53,allow,733,86,647,2,31,1,1
47733,48114,443,5239,443,allow,4515,2193,2322,14,135,7,7
47734,50584,18047,33742,18047,allow,851,369,482,5,1200,3,2
47735,19473,28109,14230,28109,allow,468,149,319,2,1200,1,1
47736,50584,8999,10076,8999,allow,161,161,0,1,1200,1,0
47737,57470,43259,40741,43259,allow,517,163,354,2,1200,1,1
47738,19983,18242,0,0,reset-both,146,146,0,1,0,1,0
47739,64997,51221,0,0,deny,66,66,0,1,0,1,0
47740,22835,51221,0,0,deny,62,62,0,1,0,1,0
47741,54950,445,0,0,drop,70,70,0,1,0,1,0
47742,54948,445,0,0,drop,70,70,0,1,0,1,0
47743,59909,445,0,0,drop,70,70,0,1,0,1,0
47744,55489,53,26827,53,allow,193,102,91,2,30,1,1
47745,55208,53,14602,53,allow,177,94,83,2,30,1,1
47746,64587,53,13030,53,allow,167,86,81,2,30,1,1
47747,49568,53,17593,53,allow,214,102,112,2,30,1,1
47748,55771,53,45760,53,allow,283,98,185,4,51,2,2
47749,59908,445,0,0,drop,70,70,0,1,0,1,0
47750,59907,445,0,0,drop,70,70,0,1,0,1,0
47751,55294,445,0,0,drop,66,66,0,1,0,1,0
47752,55293,445,0,0,drop,66,66,0,1,0,1,0
47753,55292,445,0,0,drop,66,66,0,1,0,1,0
47754,55291,445,0,0,drop,66,66,0,1,0,1,0
47755,55290,445,0,0,drop,66,66,0,1,0,1,0
47756,55289,445,0,0,drop,66,66,0,1,0,1,0
47757,55288,445,0,0,drop,66,66,0,1,0,1,0
47758,55287,445,0,0,drop,66,66,0,1,0,1,0
47759,19678,36237,0,0,deny,146,146,0,1,0,1,0
47760,54944,445,0,0,drop,70,70,0,1,0,1,0
47761,19361,37965,0,0,deny,66,66,0,1,0,1,0
47762,54943,445,0,0,drop,70,70,0,1,0,1,0
47763,43260,41615,0,0,deny,145,145,0,1,0,1,0
47764,52643,15941,0,0,deny,62,62,0,1,0,1,0
47765,22683,39210,0,0,deny,60,60,0,1,0,1,0
47766,53227,64097,0,0,deny,66,66,0,1,0,1,0
47767,53140,80,7682,80,allow,9602,814,8788,19,129,10,9
47768,53648,31637,17348,31637,allow,70,70,0,2,7,2,0
47769,51835,29778,4690,29778,allow,70,70,0,2,7,2,0
47770,64820,53,5211,53,allow,195,102,93,2,29,1,1
47771,56343,53,26376,53,allow,194,102,92,2,29,1,1
47772,49242,53,1581,53,allow,167,86,81,2,29,1,1
47773,56106,53,61650,53,allow,816,102,714,2,30,1,1
47774,61702,80,48411,80,allow,1553,953,600,14,47,8,6
47775,41420,443,4151,443,allow,4858,855,4003,16,64,9,7
47776,43875,443,31372,443,allow,18367,3429,14938,41,500,23,18
47777,56655,53,21531,53,allow,209,110,99,2,30,1,1
47778,65482,53,50244,53,allow,179,94,85,2,30,1,1
47779,65360,53,6269,53,allow,763,102,661,2,30,1,1
47780,49186,53,28433,53,allow,821,102,719,2,30,1,1
47781,56704,53,43778,53,allow,194,102,92,2,29,1,1
47782,61701,80,22637,80,allow,1495,954,541,13,47,8,5
47783,65437,53,38141,53,allow,195,102,93,2,29,1,1
47784,54670,443,29364,443,allow,18487,3434,15053,37,80,20,17
47785,37179,443,24898,443,allow,7440,3165,4275,31,358,17,14
47786,57146,53,5349,53,allow,199,102,97,2,29,1,1
47787,36541,443,3197,443,allow,4322,797,3525,14,64,8,6
47788,50209,1688,16419,1688,allow,70,70,0,1,4,1,0
47789,49547,53,33121,53,allow,193,102,91,2,29,1,1
47790,49242,53,38872,53,allow,167,86,81,2,29,1,1
47791,55450,53,40761,53,allow,193,102,91,2,29,1,1
47792,57146,53,13566,53,allow,199,102,97,2,29,1,1
47793,64335,53,30399,53,allow,193,102,91,2,29,1,1
47794,56396,53,60964,53,allow,183,94,89,2,30,1,1
47795,65073,53,50486,53,allow,195,102,93,2,29,1,1
47796,57263,53,2666,53,allow,167,86,81,2,29,1,1
47797,55571,53,22113,53,allow,70,70,0,1,29,1,0
47798,54962,53,60392,53,allow,194,102,92,2,29,1,1
47799,55205,53,45357,53,allow,167,86,81,2,29,1,1
47800,64074,53,30034,53,allow,209,110,99,2,29,1,1
47801,55858,53,14376,53,allow,214,102,112,2,30,1,1
47802,61704,80,4261,80,allow,1555,954,601,14,47,8,6
47803,60335,7010,60335,7010,allow,6127,4018,2109,19,17,11,8
47804,49441,443,28685,443,allow,2921276,89544,2831732,3090,63,1086,2004
47805,49242,53,5506,53,allow,167,86,81,2,30,1,1
47806,49769,53,30329,53,allow,785,110,675,2,30,1,1
47807,49169,53,65143,53,allow,184,94,90,2,30,1,1
47808,49162,53,28701,53,allow,183,94,89,2,30,1,1
47809,56010,53,24880,53,allow,184,94,90,2,30,1,1
47810,64587,53,63035,53,allow,167,86,81,2,30,1,1
47811,17752,53,17752,53,allow,230,90,140,2,30,1,1
47812,56935,53,51699,53,allow,821,102,719,2,30,1,1
47813,49337,53,44481,53,allow,199,102,97,2,30,1,1
47814,51839,27256,26214,27256,allow,70,70,0,2,7,2,0
47815,65229,53,47918,53,allow,195,102,93,2,30,1,1
47816,49186,53,38504,53,allow,198,102,96,2,30,1,1
47817,57162,443,26306,443,allow,1798,1223,575,13,25,8,5
47818,39296,80,42810,80,allow,740,452,288,11,17,7,4
47819,40705,443,7502,443,allow,5721,3240,2481,35,147,14,21
47820,64922,53,63289,53,allow,431,95,336,4,55,2,2
47821,57536,53,46039,53,allow,199,94,105,2,30,1,1
47822,50179,80,50179,80,allow,1473,920,553,9,137,6,3
47823,51424,53,58777,53,allow,269,94,175,2,30,1,1
47824,50377,53,24974,53,allow,753,94,659,2,30,1,1
47825,65478,443,30120,443,allow,92279,4799,87480,107,16,43,64
47826,49773,53,17034,53,allow,199,94,105,2,30,1,1
47827,49850,53,46784,53,allow,166,86,80,2,30,1,1
47828,60211,443,55686,443,allow,126490514,2726981,123763533,123275,553,41466,81809
47829,55095,53,28399,53,allow,194,102,92,2,30,1,1
47830,49812,53,5502,53,allow,166,86,80,2,30,1,1
47831,56441,80,22718,80,allow,1272,389,883,16,394,4,12
47832,55972,53,29588,53,allow,262,126,136,2,30,1,1
47833,64904,53,43718,53,allow,199,102,97,2,30,1,1
47834,60732,443,1345,443,allow,193520,11019,182501,280,276,140,140
47835,51820,53738,51101,53738,allow,66,66,0,2,8,2,0
47836,53144,443,6960,443,allow,7121,2564,4557,26,127,15,11
47837,50033,53,63649,53,allow,533,184,349,6,76,3,3
47838,55771,53,49572,53,allow,283,98,185,4,51,2,2
47839,65530,53,2612,53,allow,102,102,0,1,30,1,0
47840,65443,53,19494,53,allow,215,102,113,2,30,1,1
47841,49242,53,51879,53,allow,183,94,89,2,30,1,1
47842,65005,53,27346,53,allow,776,102,674,2,30,1,1
47843,64016,53,48329,53,allow,183,94,89,2,30,1,1
47844,49518,443,56139,443,allow,7834,1758,6076,26,171,13,13
47845,55635,38649,60618,38649,allow,70,70,0,2,8,2,0
47846,51836,37753,15245,37753,allow,70,70,0,2,7,2,0
47847,65477,443,34529,443,allow,409770,12150,397620,421,16,148,273
47848,49327,53,15373,53,allow,396,102,294,2,30,1,1
47849,49337,53,52249,53,allow,199,102,97,2,30,1,1
47850,49242,53,36950,53,allow,183,94,89,2,30,1,1
47851,64789,53,40256,53,allow,193,102,91,2,30,1,1
47852,50354,53,23392,53,allow,209,110,99,2,30,1,1
47853,56665,53,14967,53,allow,223,86,137,2,30,1,1
47854,33473,443,49097,443,allow,146684,25233,121451,183,189,75,108
47855,49730,443,40154,443,allow,3233,1141,2092,14,135,7,7
47856,40488,443,48919,443,allow,3635,2114,1521,22,515,13,9
47857,49936,53,34115,53,allow,318,110,208,4,50,2,2
47858,35637,443,59473,443,allow,5611,1559,4052,22,648,13,9
47859,60350,443,44026,443,allow,5242,861,4381,17,16,9,8
47860,38405,443,30504,443,allow,9876,1976,7900,27,27,13,14
47861,41322,443,26107,443,allow,6332,944,5388,19,66,10,9
47862,51834,30309,65352,30309,allow,70,70,0,2,7,2,0
47863,56625,80,20338,80,allow,234,234,0,4,11,4,0
47864,56823,50291,65479,50291,allow,316,136,180,6,6,3,3
47865,52585,53,6341,53,allow,265,91,174,4,40,2,2
47866,64397,53,47942,53,allow,658,186,472,6,51,3,3
47867,57188,8525,57188,8525,allow,138,78,60,2,6,1,1
47868,50518,443,27027,443,allow,1352,691,661,14,47,8,6
47869,55534,53,27868,53,allow,168,86,82,2,29,1,1
47870,54835,443,59753,443,allow,678,280,398,11,26,5,6
47871,38031,80,38031,80,allow,37629,3025,34604,51,24,22,29
47872,55489,53,32876,53,allow,193,102,91,2,29,1,1
47873,56344,443,64957,443,allow,8111,1413,6698,21,28,12,9
47874,46596,443,51995,443,allow,4146,2690,1456,31,37,16,15
47875,65497,53,55657,53,allow,197,102,95,2,29,1,1
47876,56343,443,34805,443,allow,350,210,140,6,27,4,2
47877,65241,53,47217,53,allow,198,102,96,2,29,1,1
47878,56728,53,11841,53,allow,166,86,80,2,30,1,1
47879,53651,47758,20351,47758,allow,70,70,0,2,7,2,0
47880,55450,53,10732,53,allow,193,102,91,2,29,1,1
47881,57072,53,9949,53,allow,195,102,93,2,30,1,1
47882,56824,55829,39772,55829,allow,70,70,0,1,5,1,0
47883,55208,53,2198,53,allow,177,94,83,2,30,1,1
47884,49547,53,39009,53,allow,193,102,91,2,30,1,1
47885,52405,443,45940,443,allow,227267,18022,209245,424,38,239,185
47886,23997,53,23997,53,allow,230,90,140,2,30,1,1
47887,60047,443,35596,443,allow,1350,689,661,14,44,8,6
47888,60045,443,3000,443,allow,1573,769,804,16,47,9,7
47889,48734,443,7322,443,allow,256887,11565,245322,293,56,112,181
47890,60372,80,60372,80,allow,186272,9792,176480,216,21,93,123
47891,50072,53,48106,53,allow,172,94,78,2,30,1,1
47892,65497,53,26978,53,allow,197,102,95,2,30,1,1
47893,55071,53,59621,53,allow,177,94,83,2,30,1,1
47894,49928,53,49928,53,allow,229,90,139,2,30,1,1
47895,57072,53,19221,53,allow,195,102,93,2,30,1,1
47896,57346,53,23622,53,allow,210,110,100,2,29,1,1
47897,57470,18531,64727,18531,allow,166,166,0,1,1200,1,0
47898,50584,38496,45984,38496,allow,166,166,0,1,1200,1,0
47899,57470,60560,62247,60560,allow,527,166,361,2,1200,1,1
47900,64789,53,62569,53,allow,816,102,714,2,30,1,1
47901,49843,53,13877,53,allow,193,102,91,2,30,1,1
47902,50354,53,24829,53,allow,209,110,99,2,30,1,1
47903,64335,53,25261,53,allow,193,102,91,2,30,1,1
47904,49630,53,20567,53,allow,374,126,248,2,30,1,1
47905,49812,53,4769,53,allow,166,86,80,2,30,1,1
47906,57096,53,45247,53,allow,198,102,96,2,30,1,1
47907,56322,53,19434,53,allow,166,86,80,2,30,1,1
47908,50234,53,30924,53,allow,775,102,673,2,30,1,1
47909,55810,53,5823,53,allow,183,94,89,2,31,1,1
47910,6882,64287,36114,64287,allow,228,118,110,2,1200,1,1
47911,55342,53,57972,53,allow,994,86,908,2,30,1,1
47912,56616,53,31793,53,allow,183,94,89,2,30,1,1
47913,64837,53,23710,53,allow,196,94,102,2,30,1,1
47914,65012,53,58709,53,allow,775,102,673,2,30,1,1
47915,56935,53,62999,53,allow,198,102,96,2,30,1,1
47916,64719,53,54824,53,allow,196,102,94,2,30,1,1
47917,56396,53,42377,53,allow,183,94,89,2,30,1,1
47918,55071,53,51447,53,allow,177,94,83,2,30,1,1
47919,55192,53,5787,53,allow,178,94,84,2,31,1,1
47920,49162,53,41472,53,allow,183,94,89,2,30,1,1
47921,49220,53,32308,53,allow,755,94,661,2,30,1,1
47922,50072,53,26115,53,allow,164,86,78,2,30,1,1
47923,44511,53,15897,53,allow,199,94,105,2,30,1,1
47924,45872,53,25002,53,allow,199,94,105,2,30,1,1
47925,65165,53,53498,53,allow,200,102,98,2,30,1,1
47926,64414,53,3637,53,allow,193,102,91,2,30,1,1
47927,57978,80,62070,80,allow,4402,2878,1524,29,105,15,14
47928,39802,443,21011,443,allow,3025,1958,1067,26,49,14,12
47929,23824,80,23824,80,allow,24232,4550,19682,59,17,34,25
47930,55632,45682,28003,45682,allow,70,70,0,2,8,2,0
47931,50516,443,44017,443,allow,1575,771,804,16,47,9,7
47932,56622,443,50835,443,allow,8302,3583,4719,24,17,14,10
47933,42446,123,14987,123,allow,184,94,90,2,30,1,1
47934,63765,3389,63765,3389,allow,3444,1730,1714,16,33,8,8
47935,47180,443,38596,443,allow,6007,1727,4280,27,1128,15,12
47936,65304,53,61262,53,allow,209,110,99,2,30,1,1
47937,7003,53,7003,53,allow,229,90,139,2,30,1,1
47938,49265,53,37179,53,allow,181,94,87,2,30,1,1
47939,56616,53,21461,53,allow,183,94,89,2,30,1,1
47940,49850,53,15104,53,allow,166,86,80,2,30,1,1
47941,49156,53,27997,53,allow,304,118,186,2,30,1,1
47942,56106,53,18399,53,allow,193,102,91,2,30,1,1
47943,4025,53,4025,53,allow,230,90,140,2,30,1,1
47944,57275,53,22434,53,allow,193,102,91,2,30,1,1
47945,53122,29070,40660,29070,allow,758,320,438,11,16,6,5
47946,51838,29448,55370,29448,allow,70,70,0,2,7,2,0
47947,55634,58846,18331,58846,allow,70,70,0,2,8,2,0
47948,55624,80,56586,80,allow,70,70,0,1,5,1,0
47949,51459,443,53569,443,allow,202,70,132,3,11,1,2
47950,60897,443,29377,443,allow,10706,1679,9027,27,46,15,12
47951,64074,53,19017,53,allow,209,110,99,2,30,1,1
47952,65241,53,1849,53,allow,198,102,96,2,30,1,1
47953,65216,53,15859,53,allow,994,86,908,2,30,1,1
47954,50034,53,20576,53,allow,179,94,85,2,30,1,1
47955,49337,53,49651,53,allow,199,102,97,2,30,1,1
47956,64820,53,31810,53,allow,195,102,93,2,30,1,1
47957,5773,53,5773,53,allow,229,90,139,2,30,1,1
47958,49840,53,48921,53,allow,277,102,175,2,30,1,1
47959,64137,53,61015,53,allow,216,102,114,2,30,1,1
47960,49676,53,9085,53,allow,200,94,106,2,30,1,1
47961,55786,53,42852,53,allow,200,102,98,2,30,1,1
47962,14694,53,14694,53,allow,230,90,140,2,30,1,1
47963,50257,53,13525,53,allow,199,102,97,2,30,1,1
47964,49843,53,43292,53,allow,193,102,91,2,30,1,1
47965,55955,53,53026,53,allow,184,94,90,2,30,1,1
47966,56536,53,49265,53,allow,209,110,99,2,30,1,1
47967,27005,33058,7981,33058,allow,884,126,758,2,31,1,1
47968,57470,51413,27069,51413,allow,807,275,532,4,1200,2,2
47969,50584,9045,4330,9045,allow,166,166,0,1,1200,1,0
47970,57470,8999,29205,8999,allow,863,363,500,4,1200,2,2
47971,57470,45340,41159,45340,allow,527,166,361,2,1200,1,1
47972,57202,53,28601,53,allow,184,94,90,2,30,1,1
47973,56409,53,35272,53,allow,199,102,97,2,30,1,1
47974,56536,53,3128,53,allow,209,110,99,2,31,1,1
47975,64719,53,44200,53,allow,196,102,94,2,31,1,1
47976,65165,53,58294,53,allow,200,102,98,2,31,1,1
47977,57275,53,13596,53,allow,193,102,91,2,31,1,1
47978,27005,30008,41191,30008,allow,881,126,755,2,31,1,1
47979,57494,443,51749,443,allow,2435128,54736,2380392,2151,346,331,1820
47980,57470,6887,18117,6887,allow,471,269,202,4,1199,2,2
47981,57470,44573,53035,44573,allow,883,288,595,4,1200,2,2
47982,57470,65534,12773,65534,allow,773,271,502,4,1200,2,2
47983,64461,53,47213,53,allow,177,94,83,2,31,1,1
47984,57296,53,45722,53,allow,200,102,98,2,30,1,1
47985,56086,53,3627,53,allow,172,94,78,2,30,1,1
47986,57275,53,15169,53,allow,193,102,91,2,30,1,1
47987,64917,53,1366,53,allow,243,94,149,2,30,1,1
47988,56409,53,61903,53,allow,199,102,97,2,31,1,1
47989,55192,53,55863,53,allow,178,94,84,2,30,1,1
47990,64414,53,29559,53,allow,193,102,91,2,31,1,1
47991,57150,53,61382,53,allow,166,86,80,2,31,1,1
47992,64390,53,22708,53,allow,225,110,115,2,30,1,1
47993,65487,53,64939,53,allow,184,94,90,2,31,1,1
47994,32897,443,57512,443,allow,3166,936,2230,18,120,9,9
47995,65074,443,20920,443,allow,7584,7094,490,14,124,7,7
47996,50584,63015,51175,63015,allow,166,166,0,1,1200,1,0
47997,57470,32517,51554,32517,allow,166,166,0,1,1199,1,0
47998,50584,12899,63307,12899,allow,166,166,0,1,1200,1,0
47999,50584,6889,59579,6889,allow,161,161,0,2,1200,2,0
48000,57470,51413,6363,51413,allow,493,166,327,2,1200,1,1
48001,50584,61867,27152,61867,allow,166,166,0,1,1200,1,0
48002,57470,6881,5972,6881,allow,755,275,480,4,1200,2,2
48003,57470,34590,16143,34590,allow,527,166,361,2,1200,1,1
48004,57470,46487,30671,46487,allow,527,166,361,2,1200,1,1
48005,27005,27015,8192,27015,allow,912,126,786,2,31,1,1
48006,27005,33056,59284,33056,allow,885,126,759,2,31,1,1
48007,54680,443,15778,443,allow,1786,172,1614,7,120,3,4
48008,57470,46941,64707,46941,allow,899,288,611,4,1199,2,2
48009,57470,11696,14471,11696,allow,353,166,187,2,1199,1,1
48010,57470,51413,16094,51413,allow,700,275,425,4,1200,2,2
48011,50584,28387,54140,28387,allow,161,161,0,2,1200,2,0
48012,44847,51572,8318,51572,allow,509,150,359,2,1200,1,1
48013,57470,6881,62748,6881,allow,525,166,359,2,1200,1,1
48014,57470,43576,31912,43576,allow,545,166,379,2,1200,1,1
48015,39338,443,58557,443,allow,4362,1145,3217,17,26,9,8
48016,54830,443,23517,443,allow,4478,1133,3345,13,26,8,5
48017,50384,443,12155,443,allow,6147,911,5236,18,16,10,8
48018,27005,27015,19164,27015,allow,871,126,745,2,31,1,1
48019,56308,443,13053,443,allow,1622,1137,485,11,26,7,4
48020,56352,80,27612,80,allow,1258,752,506,13,16,7,6
48021,56704,53,10036,53,allow,194,102,92,2,31,1,1
48022,41439,443,30443,443,allow,4370,1148,3222,17,26,9,8
48023,39337,443,52807,443,allow,4362,1145,3217,17,26,9,8
48024,56342,443,42448,443,allow,1463,988,475,12,27,7,5
48025,18767,35440,0,0,deny,146,146,0,1,0,1,0
48026,59896,445,0,0,drop,70,70,0,1,0,1,0
48027,59892,445,0,0,drop,70,70,0,1,0,1,0
48028,59891,445,0,0,drop,70,70,0,1,0,1,0
48029,64990,55442,0,0,deny,66,66,0,1,0,1,0
48030,48640,47993,0,0,deny,145,145,0,1,0,1,0
48031,39548,8696,0,0,deny,60,60,0,1,0,1,0
48032,54938,445,0,0,drop,70,70,0,1,0,1,0
48033,55272,445,0,0,drop,66,66,0,1,0,1,0
48034,55274,445,0,0,drop,66,66,0,1,0,1,0
48035,55271,445,0,0,drop,66,66,0,1,0,1,0
48036,63194,50265,0,0,deny,66,66,0,1,0,1,0
48037,48676,53392,0,0,deny,60,60,0,1,0,1,0
48038,46670,51505,0,0,deny,62,62,0,1,0,1,0
48039,52860,9694,0,0,deny,146,146,0,1,0,1,0
48040,59890,445,0,0,drop,70,70,0,1,0,1,0
48041,46362,35440,0,0,deny,66,66,0,1,0,1,0
48042,52150,39109,0,0,deny,66,66,0,1,0,1,0
48043,59887,445,0,0,drop,70,70,0,1,0,1,0
48044,51525,35440,0,0,deny,66,66,0,1,0,1,0
48045,38723,37838,0,0,deny,146,146,0,1,0,1,0
48046,2876,35440,0,0,deny,62,62,0,1,0,1,0
48047,2394,43890,0,0,deny,62,62,0,1,0,1,0
48048,59883,445,0,0,drop,70,70,0,1,0,1,0
48049,59882,445,0,0,drop,70,70,0,1,0,1,0
48050,59884,445,0,0,drop,70,70,0,1,0,1,0
48051,49197,30188,0,0,deny,146,146,0,1,0,1,0
48052,61223,37965,0,0,deny,62,62,0,1,0,1,0
48053,4427,50584,0,0,deny,62,62,0,1,0,1,0
48054,46740,55108,0,0,deny,148,148,0,1,0,1,0
48055,27679,37965,0,0,deny,62,62,0,1,0,1,0
48056,64283,37965,0,0,deny,74,74,0,1,0,1,0
48057,54925,445,0,0,drop,70,70,0,1,0,1,0
48058,27641,39004,0,0,deny,62,62,0,1,0,1,0
48059,59430,50584,0,0,deny,66,66,0,1,0,1,0
48060,54922,445,0,0,drop,70,70,0,1,0,1,0
48061,60312,57470,0,0,deny,74,74,0,1,0,1,0
48062,58497,39004,0,0,deny,66,66,0,1,0,1,0
48063,59868,445,0,0,drop,70,70,0,1,0,1,0
48064,59867,445,0,0,drop,70,70,0,1,0,1,0
48065,59864,445,0,0,drop,70,70,0,1,0,1,0
48066,62725,51221,0,0,deny,66,66,0,1,0,1,0
48067,30610,41615,0,0,deny,145,145,0,1,0,1,0
48068,54918,445,0,0,drop,70,70,0,1,0,1,0
48069,443,62451,0,0,deny,199,199,0,1,0,1,0
48070,54916,445,0,0,drop,70,70,0,1,0,1,0
48071,42798,26467,0,0,deny,62,62,0,1,0,1,0
48072,6881,6881,0,0,deny,62,62,0,1,0,1,0
48073,54914,445,0,0,drop,70,70,0,1,0,1,0
48074,55249,445,0,0,drop,66,66,0,1,0,1,0
48075,59861,445,0,0,drop,70,70,0,1,0,1,0
48076,59862,445,0,0,drop,70,70,0,1,0,1,0
48077,1790,48817,0,0,deny,66,66,0,1,0,1,0
48078,13970,42873,0,0,deny,66,66,0,1,0,1,0
48079,53840,443,34687,443,allow,499,425,74,4,0,3,1
48080,53847,443,28382,443,allow,499,425,74,4,0,3,1
48081,53841,443,33528,443,allow,499,425,74,4,0,3,1
48082,11344,42873,0,0,deny,62,62,0,1,0,1,0
48083,18713,40108,0,0,deny,146,146,0,1,0,1,0
48084,6060,15503,0,0,deny,146,146,0,1,0,1,0
48085,54907,445,0,0,drop,70,70,0,1,0,1,0
48086,55246,445,0,0,drop,66,66,0,1,0,1,0
48087,55396,26467,0,0,deny,62,62,0,1,0,1,0
48088,53843,443,32315,443,allow,499,425,74,4,0,3,1
48089,53844,443,56188,443,allow,499,425,74,4,0,3,1
48090,53845,443,42345,443,allow,499,425,74,4,0,3,1
48091,53846,443,62098,443,allow,499,425,74,4,0,3,1
48092,53842,443,26608,443,allow,499,425,74,4,0,3,1
48093,53839,443,31646,443,allow,499,425,74,4,0,3,1
48094,53837,443,2999,443,allow,499,425,74,4,0,3,1
48095,53836,443,61812,443,allow,499,425,74,4,0,3,1
48096,53834,443,62616,443,allow,499,425,74,4,0,3,1
48097,53838,443,50005,443,allow,499,425,74,4,0,3,1
48098,53831,443,39132,443,allow,499,425,74,4,0,3,1
48099,53832,443,1159,443,allow,499,425,74,4,0,3,1
48100,54905,445,0,0,drop,70,70,0,1,0,1,0
48101,55242,445,0,0,drop,66,66,0,1,0,1,0
48102,43916,21,0,0,deny,60,60,0,1,0,1,0
48103,59847,445,0,0,drop,70,70,0,1,0,1,0
48104,42459,22114,0,0,deny,62,62,0,1,0,1,0
48105,59844,445,0,0,drop,70,70,0,1,0,1,0
48106,53829,443,25937,443,allow,499,425,74,4,0,3,1
48107,53835,443,32854,443,allow,499,425,74,4,0,3,1
48108,53823,443,24155,443,allow,499,425,74,4,0,3,1
48109,53827,443,32061,443,allow,499,425,74,4,0,3,1
48110,53830,443,40467,443,allow,499,425,74,4,0,3,1
48111,53826,443,31854,443,allow,499,425,74,4,0,3,1
48112,53825,443,49613,443,allow,499,425,74,4,0,3,1
48113,53833,443,61114,443,allow,499,425,74,4,0,3,1
48114,53822,443,12016,443,allow,499,425,74,4,0,3,1
48115,53828,443,58283,443,allow,499,425,74,4,0,3,1
48116,53824,443,33513,443,allow,499,425,74,4,0,3,1
48117,53821,443,22487,443,allow,499,425,74,4,0,3,1
48118,59845,445,0,0,drop,70,70,0,1,0,1,0
48119,59843,445,0,0,drop,70,70,0,1,0,1,0
48120,34129,19410,0,0,deny,60,60,0,1,0,1,0
48121,54904,445,0,0,drop,70,70,0,1,0,1,0
48122,55238,445,0,0,drop,66,66,0,1,0,1,0
48123,9865,15503,0,0,deny,146,146,0,1,0,1,0
48124,54903,445,0,0,drop,70,70,0,1,0,1,0
48125,54902,445,0,0,drop,70,70,0,1,0,1,0
48126,2077,45850,0,0,reset-both,145,145,0,1,0,1,0
48127,58213,37807,0,0,deny,66,66,0,1,0,1,0
48128,54897,445,0,0,drop,70,70,0,1,0,1,0
48129,54896,445,0,0,drop,70,70,0,1,0,1,0
48130,60152,26467,0,0,deny,62,62,0,1,0,1,0
48131,44849,46478,0,0,deny,74,74,0,1,0,1,0
48132,59834,445,0,0,drop,70,70,0,1,0,1,0
48133,59832,445,0,0,drop,70,70,0,1,0,1,0
48134,59828,445,0,0,drop,70,70,0,1,0,1,0
48135,59830,445,0,0,drop,70,70,0,1,0,1,0
48136,54884,445,0,0,drop,70,70,0,1,0,1,0
48137,54883,445,0,0,drop,70,70,0,1,0,1,0
48138,54880,445,0,0,drop,70,70,0,1,0,1,0
48139,55233,445,0,0,drop,66,66,0,1,0,1,0
48140,54874,445,0,0,drop,70,70,0,1,0,1,0
48141,54873,445,0,0,drop,70,70,0,1,0,1,0
48142,55675,53,17939,53,allow,190,97,93,2,0,1,1
48143,48629,63131,0,0,deny,74,74,0,1,0,1,0
48144,18650,23718,0,0,deny,62,62,0,1,0,1,0
48145,55225,445,0,0,drop,66,66,0,1,0,1,0
48146,55228,445,0,0,drop,66,66,0,1,0,1,0
48147,55229,445,0,0,drop,66,66,0,1,0,1,0
48148,50914,51505,0,0,deny,66,66,0,1,0,1,0
48149,55222,445,0,0,drop,66,66,0,1,0,1,0
48150,55223,445,0,0,drop,66,66,0,1,0,1,0
48151,55221,445,0,0,drop,66,66,0,1,0,1,0
48152,48388,44847,0,0,deny,146,146,0,1,0,1,0
48153,64880,9694,0,0,deny,66,66,0,1,0,1,0
48154,14924,44847,0,0,deny,66,66,0,1,0,1,0
48155,0,0,0,0,deny,110,110,0,1,0,1,0
48156,0,0,0,0,deny,98,98,0,1,0,1,0
48157,0,0,0,0,allow,480,244,236,4,0,2,2
48158,18203,23,0,0,deny,60,60,0,1,0,1,0
48159,13285,29892,0,0,deny,145,145,0,1,0,1,0
48160,38723,15503,0,0,deny,146,146,0,1,0,1,0
48161,59824,445,0,0,drop,70,70,0,1,0,1,0
48162,59822,445,0,0,drop,70,70,0,1,0,1,0
48163,59820,445,0,0,drop,70,70,0,1,0,1,0
48164,54636,26467,0,0,deny,66,66,0,1,0,1,0
48165,44208,26467,0,0,deny,62,62,0,1,0,1,0
48166,55217,445,0,0,drop,66,66,0,1,0,1,0
48167,38383,51221,0,0,deny,66,66,0,1,0,1,0
48168,19204,41864,0,0,deny,159,159,0,1,0,1,0
48169,34146,51221,0,0,deny,62,62,0,1,0,1,0
48170,59819,445,0,0,drop,70,70,0,1,0,1,0
48171,54862,445,0,0,drop,70,70,0,1,0,1,0
48172,57633,50584,0,0,deny,62,62,0,1,0,1,0
48173,55215,445,0,0,drop,66,66,0,1,0,1,0
48174,55213,445,0,0,drop,66,66,0,1,0,1,0
48175,55211,445,0,0,drop,66,66,0,1,0,1,0
48176,64387,37965,0,0,deny,66,66,0,1,0,1,0
48177,55210,445,0,0,drop,66,66,0,1,0,1,0
48178,59994,11446,0,0,deny,66,66,0,1,0,1,0
48179,50095,30188,0,0,deny,66,66,0,1,0,1,0
48180,46495,4607,0,0,deny,60,60,0,1,0,1,0
48181,10354,81,0,0,deny,60,60,0,1,0,1,0
48182,53833,26467,0,0,deny,62,62,0,1,0,1,0
48183,54854,19847,0,0,deny,66,66,0,1,0,1,0
48184,54858,445,0,0,drop,70,70,0,1,0,1,0
48185,45941,23388,0,0,deny,60,60,0,1,0,1,0
48186,48706,23393,0,0,deny,60,60,0,1,0,1,0
48187,3911,50584,0,0,deny,62,62,0,1,0,1,0
48188,59813,445,0,0,drop,70,70,0,1,0,1,0
48189,22367,50584,0,0,deny,146,146,0,1,0,1,0
48190,59807,445,0,0,drop,70,70,0,1,0,1,0
48191,59802,445,0,0,drop,70,70,0,1,0,1,0
48192,50052,65008,0,0,deny,60,60,0,1,0,1,0
48193,54849,445,0,0,drop,70,70,0,1,0,1,0
48194,54848,445,0,0,drop,70,70,0,1,0,1,0
48195,54844,445,0,0,drop,70,70,0,1,0,1,0
48196,54846,445,0,0,drop,70,70,0,1,0,1,0
48197,49229,6921,0,0,deny,145,145,0,1,0,1,0
48198,54841,445,0,0,drop,70,70,0,1,0,1,0
48199,55199,445,0,0,drop,66,66,0,1,0,1,0
48200,55145,11392,0,0,deny,66,66,0,1,0,1,0
48201,11859,64147,0,0,deny,62,62,0,1,0,1,0
48202,14252,35993,0,0,deny,66,66,0,1,0,1,0
48203,27005,12345,54236,12345,allow,898,126,772,2,30,1,1
48204,55192,53,45038,53,allow,172,88,84,2,30,1,1
48205,11295,40033,39520,40033,allow,213,89,124,4,49,2,2
48206,39983,80,29072,80,allow,1614,1300,314,10,16,5,5
48207,50329,443,35211,443,allow,12026,3494,8532,28,82,14,14
48208,51818,43942,60184,43942,allow,156,66,90,2,5,1,1
48209,5588,5588,0,0,allow,3354,1792,1562,46,192,23,23
48210,50759,53,62224,53,allow,578,286,292,9,16,5,4
48211,37842,443,37842,443,allow,109189,6692,102497,151,80,69,82
48212,55311,53,55274,53,allow,298,101,197,4,31,2,2
48213,46404,53,46404,53,allow,237,91,146,2,32,1,1
48214,65446,53,45033,53,allow,204,104,100,2,30,1,1
48215,64461,53,10856,53,allow,170,87,83,2,30,1,1
48216,64414,53,6612,53,allow,186,95,91,2,30,1,1
48217,56788,53,36118,53,allow,198,101,97,2,30,1,1
48218,38160,443,38160,443,allow,11290,5394,5896,37,80,21,16
48219,45939,443,45939,443,allow,4504,1597,2907,19,27,11,8
48220,37234,443,63563,443,allow,1622,1137,485,11,26,7,4
48221,63807,38976,41497,38976,allow,66,66,0,1,5,1,0
48222,49296,443,51414,443,allow,7419,2173,5246,17,16,9,8
48223,51832,40607,46819,40607,allow,70,70,0,2,7,2,0
48224,39582,80,57536,80,allow,1614,1300,314,10,15,5,5
48225,33960,22,33960,22,allow,5468,1991,3477,27,34,15,12
48226,64882,53,2357,53,allow,176,90,86,2,30,1,1
48227,17018,53,17018,53,allow,217,87,130,2,30,1,1
48228,50277,80,19151,80,allow,12764,7749,5015,28,84,14,14
48229,54371,443,18994,443,allow,11828,2811,9017,31,76,16,15
48230,50317,80,56458,80,allow,3800,2776,1024,16,83,9,7
48231,49962,53,19275,53,allow,184,94,90,2,31,1,1
48232,36236,443,36236,443,allow,4625,1718,2907,19,31,11,8
48233,63809,45193,55077,45193,allow,66,66,0,1,5,1,0
48234,49749,53,61513,53,allow,200,102,98,2,30,1,1
48235,54370,443,2250,443,allow,11876,2769,9107,30,76,15,15
48236,37977,443,37977,443,allow,5763,2553,3210,24,80,14,10
48237,54124,80,4965,80,allow,1594,1280,314,10,15,5,5
48238,51842,27665,50059,27665,allow,70,70,0,1,5,1,0
48239,55810,53,12633,53,allow,182,93,89,2,30,1,1
48240,59134,80,59134,80,allow,104133,2163,101970,103,15,32,71
48241,38888,22,38888,22,allow,5130,2103,3027,28,25,16,12
48242,56978,53,58165,53,allow,774,101,673,2,30,1,1
48243,57202,53,47171,53,allow,184,94,90,2,30,1,1
48244,55171,53,21824,53,allow,198,101,97,2,31,1,1
48245,55788,53,13740,53,allow,755,93,662,2,31,1,1
48246,64128,53,11418,53,allow,186,95,91,2,31,1,1
48247,54356,80,42803,80,allow,9608,746,8862,19,82,9,10
48248,54372,443,7862,443,allow,11828,2811,9017,31,76,16,15
48249,32846,80,52606,80,allow,1644,1324,320,10,15,5,5
48250,50316,80,40877,80,allow,2062,872,1190,13,83,7,6
48251,18907,53,18907,53,allow,237,91,146,2,32,1,1
48252,59298,443,18109,443,allow,20971,2840,18131,52,89,24,28
48253,58077,36653,53473,36653,allow,204,64,140,4,11,2,2
48254,50330,443,24584,443,allow,9585,2138,7447,26,82,13,13
48255,53625,39198,33493,39198,allow,552,306,246,9,16,5,4
48256,55095,53,24827,53,allow,188,96,92,2,30,1,1
48257,27005,37569,49792,37569,allow,892,126,766,2,30,1,1
48258,55042,53,54765,53,allow,782,105,677,2,30,1,1
48259,65117,53,5041,53,allow,196,100,96,2,31,1,1
48260,13257,53,13257,53,allow,227,88,139,2,31,1,1
48261,27005,23333,15007,23333,allow,890,126,764,2,30,1,1
48262,64719,53,59437,53,allow,192,98,94,2,30,1,1
48263,65487,53,21256,53,allow,184,94,90,2,30,1,1
48264,57150,53,55226,53,allow,164,84,80,2,30,1,1
48265,55997,53,30863,53,allow,716,95,621,2,30,1,1
48266,49263,53,22784,53,allow,172,88,84,2,31,1,1
48267,60914,53,60914,53,allow,220,100,120,2,31,1,1
48268,64266,53,49573,53,allow,168,86,82,2,31,1,1
48269,57470,22070,58715,22070,allow,559,198,361,5,1200,4,1
48270,56455,53,48314,53,allow,182,93,89,2,31,1,1
48271,64538,53,28152,53,allow,188,96,92,2,31,1,1
48272,57406,53,60835,53,allow,188,96,92,2,30,1,1
48273,64169,53,10688,53,allow,202,103,99,2,30,1,1
48274,56846,53,23614,53,allow,192,98,94,2,31,1,1
48275,56837,53,43966,53,allow,176,90,86,2,31,1,1
48276,55271,53,11109,53,allow,168,86,82,2,31,1,1
48277,63964,53,46604,53,allow,190,97,93,2,31,1,1
48278,64482,53,10257,53,allow,192,98,94,2,31,1,1
48279,54976,443,15305,443,allow,10335,2317,8018,24,188,13,11
48280,33967,80,35208,80,allow,1836,662,1174,15,3826,6,9
48281,49317,53,61249,53,allow,164,84,80,2,31,1,1
48282,27005,30010,6041,30010,allow,887,126,761,2,31,1,1
48283,55066,53,18793,53,allow,176,90,86,2,31,1,1
48284,39392,80,20430,80,allow,1325,442,883,16,414,4,12
48285,56945,53,27105,53,allow,176,90,86,2,31,1,1
48286,64695,53,9580,53,allow,186,95,91,2,31,1,1
48287,54800,443,18015,443,allow,18814,10011,8803,42,129,21,21
48288,57470,34879,21991,34879,allow,1914,1914,0,30,1766,30,0
48289,35461,5228,26150,5228,allow,8648,2111,6537,40,7038,21,19
48290,55191,445,0,0,drop,66,66,0,1,0,1,0
48291,59792,445,0,0,drop,70,70,0,1,0,1,0
48292,19698,502,0,0,deny,60,60,0,1,0,1,0
48293,53043,51050,0,0,deny,66,66,0,1,0,1,0
48294,46576,23718,0,0,deny,62,62,0,1,0,1,0
48295,32768,22,0,0,deny,60,60,0,1,0,1,0
48296,54836,445,0,0,drop,70,70,0,1,0,1,0
48297,58343,23718,0,0,deny,66,66,0,1,0,1,0
48298,55188,445,0,0,drop,66,66,0,1,0,1,0
48299,58564,50432,0,0,deny,66,66,0,1,0,1,0
48300,443,62451,0,0,deny,199,199,0,1,0,1,0
48301,60970,20541,0,0,deny,66,66,0,1,0,1,0
48302,37428,53,37182,53,allow,168,78,90,2,30,1,1
48303,64169,53,8733,53,allow,209,110,99,2,30,1,1
48304,49431,53,43013,53,allow,194,102,92,2,30,1,1
48305,65331,53,36726,53,allow,193,102,91,2,30,1,1
48306,45472,8168,0,0,deny,62,62,0,1,0,1,0
48307,54828,445,0,0,drop,70,70,0,1,0,1,0
48308,55182,445,0,0,drop,66,66,0,1,0,1,0
48309,54827,445,0,0,drop,70,70,0,1,0,1,0
48310,55174,445,0,0,drop,66,66,0,1,0,1,0
48311,34731,22114,0,0,deny,62,62,0,1,0,1,0
48312,52526,30188,0,0,deny,66,66,0,1,0,1,0
48313,55075,8080,0,0,deny,60,60,0,1,0,1,0
48314,43111,8080,0,0,deny,60,60,0,1,0,1,0
48315,54822,445,0,0,drop,70,70,0,1,0,1,0
48316,48929,62609,0,0,deny,148,148,0,1,0,1,0
48317,54820,445,0,0,drop,70,70,0,1,0,1,0
48318,4772,37965,0,0,deny,66,66,0,1,0,1,0
48319,59782,445,0,0,drop,70,70,0,1,0,1,0
48320,59779,445,0,0,drop,70,70,0,1,0,1,0
48321,59780,445,0,0,drop,70,70,0,1,0,1,0
48322,3117,37965,0,0,deny,62,62,0,1,0,1,0
48323,59505,53733,0,0,deny,62,62,0,1,0,1,0
48324,55163,445,0,0,drop,66,66,0,1,0,1,0
48325,55164,445,0,0,drop,66,66,0,1,0,1,0
48326,55162,445,0,0,drop,66,66,0,1,0,1,0
48327,55166,445,0,0,drop,66,66,0,1,0,1,0
48328,55165,445,0,0,drop,66,66,0,1,0,1,0
48329,55159,445,0,0,drop,66,66,0,1,0,1,0
48330,55158,445,0,0,drop,66,66,0,1,0,1,0
48331,55161,445,0,0,drop,66,66,0,1,0,1,0
48332,39548,8696,0,0,deny,60,60,0,1,0,1,0
48333,54816,445,0,0,drop,70,70,0,1,0,1,0
48334,52887,37807,0,0,deny,62,62,0,1,0,1,0
48335,54815,445,0,0,drop,70,70,0,1,0,1,0
48336,62566,35993,0,0,deny,62,62,0,1,0,1,0
48337,6889,25975,0,0,deny,143,143,0,1,0,1,0
48338,10216,11392,0,0,deny,66,66,0,1,0,1,0
48339,51620,56205,0,0,deny,66,66,0,1,0,1,0
48340,53453,2767,0,0,deny,62,62,0,1,0,1,0
48341,1694,30188,0,0,deny,62,62,0,1,0,1,0
48342,59770,445,0,0,drop,70,70,0,1,0,1,0
48343,59765,445,0,0,drop,70,70,0,1,0,1,0
48344,59763,445,0,0,drop,70,70,0,1,0,1,0
48345,54810,445,0,0,drop,70,70,0,1,0,1,0
48346,36943,10387,0,0,deny,159,159,0,1,0,1,0
48347,55146,445,0,0,drop,66,66,0,1,0,1,0
48348,50140,53,17472,53,allow,209,110,99,2,30,1,1
48349,56536,53,64182,53,allow,209,110,99,2,30,1,1
48350,49812,53,11228,53,allow,166,86,80,2,30,1,1
48351,47866,53,1378,53,allow,199,94,105,2,30,1,1
48352,65085,53,47896,53,allow,196,94,102,2,30,1,1
48353,49843,53,21434,53,allow,193,102,91,2,30,1,1
48354,65100,53,65386,53,allow,720,94,626,2,30,1,1
48355,52319,443,62232,443,allow,569666,25343,544323,721,46,320,401
48356,38701,443,3001,443,allow,4478,1133,3345,13,27,8,5
48357,56312,443,54503,443,allow,564,292,272,9,25,5,4
48358,52406,443,12118,443,allow,11463,850,10613,23,25,7,16
48359,49662,443,52708,443,allow,4353,1145,3208,17,25,9,8
48360,51439,443,29374,443,allow,396,66,330,7,17,2,5
48361,54361,443,48340,443,allow,12268,2979,9289,35,81,18,17
48362,52501,80,52501,80,allow,79714,5592,74122,102,23,45,57
48363,54369,443,44287,443,allow,11876,2769,9107,30,77,15,15
48364,49663,443,36491,443,allow,4271,1075,3196,16,25,8,8
48365,52931,80,5991,80,allow,234,234,0,4,11,4,0
48366,53123,59228,59037,59228,allow,70,70,0,1,4,1,0
48367,50278,443,46463,443,allow,6466,2862,3604,21,163,11,10
48368,50473,80,6625,80,allow,1658,1247,411,8,15,5,3
48369,41440,443,30380,443,allow,4370,1148,3222,17,25,9,8
48370,42557,443,48761,443,allow,123082,8734,114348,200,84,101,99
48371,38700,443,59895,443,allow,4478,1133,3345,13,27,8,5
48372,38406,443,5076,443,allow,564,292,272,9,26,5,4
48373,50277,443,12688,443,allow,3937,1191,2746,20,163,9,11
48374,56086,53,3323,53,allow,172,94,78,2,29,1,1
48375,57202,53,54278,53,allow,293,94,199,4,43,2,2
48376,55095,53,63653,53,allow,194,102,92,2,29,1,1
48377,65487,53,58054,53,allow,184,94,90,2,29,1,1
48378,55810,53,35208,53,allow,183,94,89,2,29,1,1
48379,64559,53,60231,53,allow,258,110,148,2,29,1,1
48380,58850,53,58850,53,allow,231,90,141,2,29,1,1
48381,57150,53,42037,53,allow,166,86,80,2,29,1,1
48382,49667,443,61228,443,allow,334,140,194,6,25,3,3
48383,65446,53,26325,53,allow,210,110,100,2,30,1,1
48384,56322,53,21211,53,allow,166,86,80,2,29,1,1
48385,55786,53,41972,53,allow,200,102,98,2,29,1,1
48386,49379,53,28766,53,allow,199,102,97,2,30,1,1
48387,55627,53,60150,53,allow,193,102,91,2,30,1,1
48388,57109,53,6255,53,allow,168,86,82,2,30,1,1
48389,57120,443,27868,443,allow,23906,9380,14526,40,16,24,16
48390,53631,43562,1567,43562,allow,492,306,186,8,15,5,3
48391,51830,32787,47434,32787,allow,70,70,0,2,6,2,0
48392,64942,53,20482,53,allow,215,94,121,2,30,1,1
48393,57406,53,49515,53,allow,194,102,92,2,30,1,1
48394,49749,53,60642,53,allow,200,102,98,2,30,1,1
48395,54995,53,57538,53,allow,199,102,97,2,30,1,1
48396,64461,53,2582,53,allow,177,94,83,2,30,1,1
48397,39872,53,48299,53,allow,78,78,0,1,30,1,0
48398,49962,53,48309,53,allow,184,94,90,2,30,1,1
48399,57292,53,58837,53,allow,395,102,293,2,30,1,1
48400,47136,53,53463,53,allow,222,78,144,2,30,1,1
48401,56619,443,13998,443,allow,6895,2273,4622,21,17,12,9
48402,55171,53,40871,53,allow,199,102,97,2,30,1,1
48403,46848,80,53629,80,allow,25162,23336,1826,34,19,21,13
48404,55271,53,6211,53,allow,168,86,82,2,30,1,1
48405,46509,53,4834,53,allow,168,78,90,2,30,1,1
48406,50468,80,2157,80,allow,314,192,122,6,28,4,2
48407,57406,53,10288,53,allow,194,102,92,2,30,1,1
48408,36042,53,8305,53,allow,168,78,90,2,30,1,1
48409,51918,443,34743,443,allow,28031,11553,16478,122,108,61,61
48410,51954,443,51642,443,allow,2995,1894,1101,20,46,11,9
48411,49761,53,14047,53,allow,183,94,89,2,30,1,1
48412,60340,80,29761,80,allow,9406,1913,7493,14,16,7,7
48413,49006,443,37569,443,allow,119425284,929428,118495856,93687,498,9675,84012
48414,65446,53,21925,53,allow,210,110,100,2,30,1,1
48415,38576,443,38576,443,allow,225915,9896,216019,283,80,128,155
48416,64719,53,8538,53,allow,381,98,283,4,51,2,2
48417,64169,53,20022,53,allow,209,110,99,2,30,1,1
48418,21082,53,21082,53,allow,226,90,136,2,30,1,1
48419,54427,53,16738,53,allow,199,94,105,2,30,1,1
48420,64559,53,43720,53,allow,168,86,82,2,30,1,1
48421,54429,443,55314,443,allow,9970,3706,6264,44,272,21,23
48422,49171,53,3246,53,allow,199,102,97,2,30,1,1
48423,49654,53,49736,53,allow,184,94,90,2,30,1,1
48424,56455,53,58599,53,allow,183,94,89,2,30,1,1
48425,50290,53,2460,53,allow,211,110,101,2,30,1,1
48426,55627,53,4823,53,allow,193,102,91,2,30,1,1
48427,50321,443,43498,443,allow,8156,1586,6570,24,82,11,13
48428,51833,47388,26582,47388,allow,70,70,0,2,6,2,0
48429,49761,53,31558,53,allow,183,94,89,2,30,1,1
48430,49654,53,26382,53,allow,184,94,90,2,30,1,1
48431,46734,53,39721,53,allow,168,78,90,2,30,1,1
48432,55849,53,3530,53,allow,889,404,485,10,30,5,5
48433,56788,53,30869,53,allow,199,102,97,2,30,1,1
48434,55935,53,36129,53,allow,819,102,717,2,30,1,1
48435,55967,53,30635,53,allow,209,110,99,2,30,1,1
48436,49787,53,35169,53,allow,193,102,91,2,30,1,1
48437,56822,39352,35185,39352,allow,70,70,0,1,5,1,0
48438,49475,53,56421,53,allow,196,102,94,2,30,1,1
48439,56113,53,57844,53,allow,194,102,92,2,30,1,1
48440,55935,53,44322,53,allow,196,102,94,2,30,1,1
48441,65482,53,43448,53,allow,179,94,85,2,30,1,1
48442,63964,53,35341,53,allow,195,102,93,2,30,1,1
48443,56788,53,1582,53,allow,199,102,97,2,30,1,1
48444,55192,53,17598,53,allow,178,94,84,2,30,1,1
48445,65122,53,25897,53,allow,410,110,300,2,30,1,1
48446,64904,53,63887,53,allow,199,102,97,2,30,1,1
48447,64396,53,1161,53,allow,211,102,109,2,30,1,1
48448,52320,443,52845,443,allow,65770,4466,61304,94,46,44,50
48449,51691,993,8747,993,allow,17462,4583,12879,93,19,47,46
48450,14433,443,47619,443,allow,2589,1443,1146,18,15,8,10
48451,51689,993,61833,993,allow,11580,4032,7548,79,19,40,39
48452,52191,443,40696,443,allow,7018,1766,5252,23,19,13,10
48453,35610,80,8611,80,allow,1970,977,993,12,61,7,5
48454,32729,3389,32729,3389,allow,4021,1916,2105,20,18,12,8
48455,60720,443,36383,443,allow,41921,15385,26536,69,34,37,32
48456,34613,80,39992,80,allow,1013,504,509,10,17,6,4
48457,61694,443,25571,443,allow,8696,3245,5451,36,47,16,20
48458,38672,443,23620,443,allow,4478,1133,3345,13,35,8,5
48459,56614,443,7546,443,allow,20451,1899,18552,33,17,14,19
48460,53621,443,63130,443,allow,2005,1100,905,16,17,9,7
48461,61689,443,8639,443,allow,8036,3293,4743,32,48,18,14
48462,22,37469,22,37469,allow,178,118,60,2,4,1,1
48463,39336,443,13653,443,allow,4362,1145,3217,17,25,9,8
48464,51828,11916,54336,11916,allow,316,136,180,6,6,3,3
48465,53590,8999,22601,8999,allow,1207,605,602,10,25,5,5
48466,55730,8060,62180,8060,allow,70,70,0,2,7,2,0
48467,39340,443,15093,443,allow,334,140,194,6,25,3,3
48468,38807,443,38807,443,allow,5741,2532,3209,24,80,14,10
48469,28007,443,65025,443,allow,10168,968,9200,19,15,9,10
48470,50319,443,50669,443,allow,9933,2306,7627,27,82,13,14
48471,38573,443,38573,443,allow,5744,2534,3210,24,80,14,10
48472,54959,53,54959,53,allow,230,90,140,2,29,1,1
48473,50337,443,21907,443,allow,9653,1740,7913,23,81,12,11
48474,64904,53,57832,53,allow,199,102,97,2,29,1,1
48475,60761,53,45233,53,allow,198,86,112,2,29,1,1
48476,56677,53,50989,53,allow,286,103,183,4,49,2,2
48477,57202,53,37225,53,allow,184,94,90,2,29,1,1
48478,55810,53,11576,53,allow,183,94,89,2,29,1,1
48479,56655,53,57319,53,allow,209,110,99,2,29,1,1
48480,49171,53,6707,53,allow,199,102,97,2,30,1,1
48481,57346,53,18432,53,allow,210,110,100,2,29,1,1
48482,50257,53,50801,53,allow,199,102,97,2,29,1,1
48483,57096,53,11827,53,allow,198,102,96,2,30,1,1
48484,123,123,8340,123,allow,184,94,90,2,29,1,1
48485,49962,53,28111,53,allow,184,94,90,2,30,1,1
48486,57072,53,14779,53,allow,195,102,93,2,30,1,1
48487,57296,53,58059,53,allow,200,102,98,2,29,1,1
48488,49265,53,28768,53,allow,181,94,87,2,29,1,1
48489,56455,53,12391,53,allow,183,94,89,2,30,1,1
48490,65229,53,24708,53,allow,195,102,93,2,30,1,1
48491,50140,53,26490,53,allow,209,110,99,2,30,1,1
48492,57296,53,48552,53,allow,200,102,98,2,30,1,1
48493,65331,53,63156,53,allow,816,102,714,2,30,1,1
48494,57096,53,39504,53,allow,198,102,96,2,30,1,1
48495,55967,53,41577,53,allow,209,110,99,2,30,1,1
48496,50629,53,6662,53,allow,756,94,662,2,30,1,1
48497,64882,53,14352,53,allow,180,94,86,2,30,1,1
48498,65342,53,59254,53,allow,183,94,89,2,30,1,1
48499,56846,53,43478,53,allow,196,102,94,2,30,1,1
48500,57095,53,22428,53,allow,211,110,101,2,30,1,1
48501,63964,53,34726,53,allow,195,102,93,2,30,1,1
48502,55066,53,62750,53,allow,180,94,86,2,30,1,1
48503,56846,53,22209,53,allow,196,102,94,2,31,1,1
48504,56907,53,11065,53,allow,193,102,91,2,31,1,1
48505,57470,6890,10619,6890,allow,520,166,354,2,1199,1,1
48506,32768,53,4546,53,allow,86,86,0,1,30,1,0
48507,55095,53,40942,53,allow,194,102,92,2,30,1,1
48508,64256,53,29163,53,allow,244,94,150,2,30,1,1
48509,64634,53,16629,53,allow,786,110,676,2,30,1,1
48510,41764,443,65468,443,allow,9028,5092,3936,36,257,12,24
48511,64071,53,55557,53,allow,194,102,92,2,31,1,1
48512,49317,53,16697,53,allow,166,86,80,2,31,1,1
48513,49379,53,24029,53,allow,199,102,97,2,30,1,1
48514,55025,443,34661,443,allow,7654,2110,5544,21,46,13,8
48515,53620,443,60649,443,allow,15422,1623,13799,34,18,14,20
48516,56583,443,5338,443,allow,9416,2366,7050,25,19,14,11
48517,51831,26270,32908,26270,allow,70,70,0,2,6,2,0
48518,8432,23,8432,23,allow,130,66,64,2,5,1,1
48519,34896,53,34896,53,allow,231,90,141,2,30,1,1
48520,65385,53,9523,53,allow,227,110,117,2,30,1,1
48521,57352,53,35059,53,allow,816,102,714,2,30,1,1
48522,56952,53,60759,53,allow,193,102,91,2,30,1,1
48523,64260,53,40725,53,allow,230,86,144,2,30,1,1
48524,49236,53,40534,53,allow,723,102,621,2,30,1,1
48525,49544,53,31008,53,allow,226,86,140,2,30,1,1
48526,64112,53,32226,53,allow,281,94,187,2,30,1,1
48527,55311,53,15716,53,allow,298,101,197,4,31,2,2
48528,55311,53,38927,53,allow,298,101,197,4,31,2,2
48529,64439,53,35218,53,allow,199,102,97,2,31,1,1
48530,55618,53,59211,53,allow,255,102,153,2,30,1,1
48531,50899,80,61517,80,allow,130,70,60,2,15,1,1
48532,51665,443,64553,443,allow,8783,4321,4462,39,94,19,20
48533,49654,53,5508,53,allow,184,94,90,2,30,1,1
48534,56113,53,19299,53,allow,817,102,715,2,30,1,1
48535,57352,53,28583,53,allow,193,102,91,2,30,1,1
48536,56846,53,45229,53,allow,196,102,94,2,30,1,1
48537,23414,53,23414,53,allow,197,90,107,2,30,1,1
48538,49749,53,2042,53,allow,200,102,98,2,30,1,1
48539,49787,53,19694,53,allow,193,102,91,2,30,1,1
48540,55171,53,44438,53,allow,199,102,97,2,30,1,1
48541,56788,53,32214,53,allow,199,102,97,2,30,1,1
48542,55050,443,45507,443,allow,1480,1029,451,11,151,6,5
48543,55311,53,61632,53,allow,298,101,197,4,31,2,2
48544,50326,443,7479,443,allow,7819,2474,5345,25,82,13,12
48545,49431,53,39469,53,allow,817,102,715,2,30,1,1
48546,49475,53,30283,53,allow,819,102,717,2,30,1,1
48547,54995,53,9641,53,allow,199,102,97,2,30,1,1
48548,59979,443,21635,443,allow,30171,25514,4657,77,37,42,35
48549,54211,53,7944,53,allow,339,94,245,2,30,1,1
48550,50290,53,11389,53,allow,211,110,101,2,30,1,1
48551,65342,53,40557,53,allow,183,94,89,2,30,1,1
48552,64128,53,37051,53,allow,193,102,91,2,30,1,1
48553,65487,53,62444,53,allow,184,94,90,2,30,1,1
48554,64169,53,31527,53,allow,209,110,99,2,30,1,1
48555,56952,53,29584,53,allow,193,102,91,2,30,1,1
48556,49263,53,43703,53,allow,178,94,84,2,30,1,1
48557,56773,53,31138,53,allow,183,94,89,2,30,1,1
48558,65117,53,17216,53,allow,198,102,96,2,30,1,1
48559,56200,53,10019,53,allow,211,110,101,2,30,1,1
48560,64565,53,48582,53,allow,226,110,116,2,30,1,1
48561,57406,53,8433,53,allow,194,102,92,2,31,1,1
48562,56769,53,51571,53,allow,183,94,89,2,31,1,1
48563,55049,443,4491,443,allow,1600,1089,511,13,151,7,6
48564,36262,53,36262,53,allow,216,90,126,2,30,1,1
48565,64414,53,43076,53,allow,193,102,91,2,30,1,1
48566,49472,53,42476,53,allow,210,110,100,2,31,1,1
48567,56200,53,31034,53,allow,211,110,101,2,31,1,1
48568,49962,53,58375,53,allow,184,94,90,2,31,1,1
48569,27005,27015,60094,27015,allow,876,126,750,2,31,1,1
48570,64128,53,2686,53,allow,193,102,91,2,30,1,1
48571,55023,53,43972,53,allow,216,102,114,2,30,1,1
48572,56907,53,52225,53,allow,193,102,91,2,30,1,1
48573,49263,53,17752,53,allow,178,94,84,2,30,1,1
48574,49749,53,47748,53,allow,200,102,98,2,30,1,1
48575,65117,53,1871,53,allow,198,102,96,2,30,1,1
48576,63981,53,11790,53,allow,199,102,97,2,30,1,1
48577,48822,53,49162,53,allow,168,78,90,2,30,1,1
48578,35218,53,23519,53,allow,168,78,90,2,30,1,1
48579,56907,53,55203,53,allow,193,102,91,2,30,1,1
48580,49472,53,37751,53,allow,210,110,100,2,30,1,1
48581,56837,53,12687,53,allow,180,94,86,2,30,1,1
48582,16857,53,16857,53,allow,832,106,726,2,30,1,1
48583,55066,53,23255,53,allow,180,94,86,2,31,1,1
48584,65446,53,24128,53,allow,210,110,100,2,30,1,1
48585,56455,53,54287,53,allow,183,94,89,2,31,1,1
48586,27005,27080,13244,27080,allow,926,126,800,2,31,1,1
48587,27005,29999,13147,29999,allow,876,126,750,2,31,1,1
48588,61745,443,5419,443,allow,8123,5308,2815,18,134,9,9
48589,46129,443,13770,443,allow,6255,1125,5130,26,413,9,17
48590,55048,443,61386,443,allow,1600,1089,511,13,151,7,6
48591,49379,53,35998,53,allow,199,102,97,2,31,1,1
48592,1100,27540,2700,27540,allow,132,70,62,2,31,1,1
48593,21133,63622,33830,63622,allow,150,150,0,1,1199,1,0
48594,57470,51413,18747,51413,allow,604,275,329,4,1199,2,2
48595,27005,27001,28063,27001,allow,887,126,761,2,31,1,1
48596,50470,80,36047,80,allow,8593,2011,6582,17,23,8,9
48597,49354,443,56660,443,allow,4379,2565,1814,24,81,11,13
48598,60371,443,40685,443,allow,7202,2596,4606,24,83,12,12
48599,40103,443,5740,443,allow,416,210,206,7,34,4,3
48600,60079,80,9698,80,allow,31418,1784,29634,37,126,14,23
48601,41233,443,15671,443,allow,1807,1048,759,16,26,8,8
48602,27005,29999,60743,29999,allow,887,126,761,2,31,1,1
48603,50313,80,19871,80,allow,3450,1386,2064,15,83,8,7
48604,54676,443,17245,443,allow,5747,1892,3855,19,17,11,8
48605,60395,443,53609,443,allow,10672,1729,8943,24,81,12,12
48606,41235,443,2013,443,allow,1807,1048,759,16,26,8,8
48607,49349,53,37003,53,allow,183,94,89,2,31,1,1
48608,27005,27015,35363,27015,allow,884,126,758,2,31,1,1
48609,49735,443,60036,443,allow,378,256,122,7,18,5,2
48610,39065,443,4463,443,allow,3589,1251,2338,15,20,9,6
48611,50310,80,45251,80,allow,2958,1116,1842,15,83,8,7
48612,56624,80,12583,80,allow,234,234,0,4,12,4,0
48613,55143,445,0,0,drop,66,66,0,1,0,1,0
48614,55145,445,0,0,drop,66,66,0,1,0,1,0
48615,59210,8168,0,0,deny,66,66,0,1,0,1,0
48616,52563,17235,0,0,deny,74,74,0,1,0,1,0
48617,1070,26467,0,0,deny,62,62,0,1,0,1,0
48618,55986,26467,0,0,deny,66,66,0,1,0,1,0
48619,59761,445,0,0,drop,70,70,0,1,0,1,0
48620,63731,26467,0,0,deny,66,66,0,1,0,1,0
48621,35944,23,0,0,deny,60,60,0,1,0,1,0
48622,28878,51505,0,0,deny,146,146,0,1,0,1,0
48623,443,62451,0,0,deny,199,199,0,1,0,1,0
48624,48692,57470,0,0,deny,62,62,0,1,0,1,0
48625,59759,445,0,0,drop,70,70,0,1,0,1,0
48626,59756,445,0,0,drop,70,70,0,1,0,1,0
48627,59750,445,0,0,drop,70,70,0,1,0,1,0
48628,59749,445,0,0,drop,70,70,0,1,0,1,0
48629,33324,42873,0,0,deny,62,62,0,1,0,1,0
48630,15296,37965,0,0,deny,62,62,0,1,0,1,0
48631,10166,44847,0,0,deny,62,62,0,1,0,1,0
48632,54797,445,0,0,drop,70,70,0,1,0,1,0
48633,54790,1433,0,0,deny,60,60,0,1,0,1,0
48634,63221,53436,0,0,deny,62,62,0,1,0,1,0
48635,54794,445,0,0,drop,70,70,0,1,0,1,0
48636,54858,51505,0,0,deny,66,66,0,1,0,1,0
48637,49992,5900,0,0,deny,60,60,0,1,0,1,0
48638,59740,445,0,0,drop,70,70,0,1,0,1,0
48639,59736,445,0,0,drop,70,70,0,1,0,1,0
48640,59737,445,0,0,drop,70,70,0,1,0,1,0
48641,54789,445,0,0,drop,70,70,0,1,0,1,0
48642,17873,23117,0,0,deny,66,66,0,1,0,1,0
48643,54788,445,0,0,drop,70,70,0,1,0,1,0
48644,58286,37965,0,0,deny,66,66,0,1,0,1,0
48645,19632,37965,0,0,deny,62,62,0,1,0,1,0
48646,4545,1900,0,0,deny,136,136,0,1,0,1,0
48647,64066,23718,0,0,deny,62,62,0,1,0,1,0
48648,5664,36237,0,0,deny,66,66,0,1,0,1,0
48649,54786,445,0,0,drop,70,70,0,1,0,1,0
48650,3504,23,0,0,deny,60,60,0,1,0,1,0
48651,43916,21,0,0,deny,60,60,0,1,0,1,0
48652,42532,22114,0,0,deny,146,146,0,1,0,1,0
48653,57899,34317,0,0,deny,145,145,0,1,0,1,0
48654,15922,44847,0,0,deny,66,66,0,1,0,1,0
48655,55123,445,0,0,drop,66,66,0,1,0,1,0
48656,59734,445,0,0,drop,70,70,0,1,0,1,0
48657,59733,445,0,0,drop,70,70,0,1,0,1,0
48658,60129,55442,0,0,deny,66,66,0,1,0,1,0
48659,55968,56205,0,0,deny,66,66,0,1,0,1,0
48660,60162,53436,0,0,deny,66,66,0,1,0,1,0
48661,54779,445,0,0,drop,70,70,0,1,0,1,0
48662,53490,62413,0,0,deny,66,66,0,1,0,1,0
48663,55933,64097,0,0,deny,62,62,0,1,0,1,0
48664,443,62451,0,0,deny,199,199,0,1,0,1,0
48665,54777,445,0,0,drop,70,70,0,1,0,1,0
48666,34083,22,0,0,deny,60,60,0,1,0,1,0
48667,51172,44847,0,0,deny,66,66,0,1,0,1,0
48668,55116,445,0,0,drop,66,66,0,1,0,1,0
48669,57500,37965,0,0,deny,62,62,0,1,0,1,0
48670,2021,44847,0,0,deny,66,66,0,1,0,1,0
48671,55114,445,0,0,drop,66,66,0,1,0,1,0
48672,54776,445,0,0,drop,70,70,0,1,0,1,0
48673,59724,445,0,0,drop,70,70,0,1,0,1,0
48674,54775,445,0,0,drop,70,70,0,1,0,1,0
48675,54774,445,0,0,drop,70,70,0,1,0,1,0
48676,59718,445,0,0,drop,70,70,0,1,0,1,0
48677,59711,445,0,0,drop,70,70,0,1,0,1,0
48678,59712,445,0,0,drop,70,70,0,1,0,1,0
48679,54770,445,0,0,drop,70,70,0,1,0,1,0
48680,54772,445,0,0,drop,70,70,0,1,0,1,0
48681,63778,50584,0,0,deny,146,146,0,1,0,1,0
48682,58966,30188,0,0,deny,66,66,0,1,0,1,0
48683,55110,445,0,0,drop,66,66,0,1,0,1,0
48684,3377,50584,0,0,deny,62,62,0,1,0,1,0
48685,54756,445,0,0,deny,70,70,0,1,0,1,0
48686,54755,445,0,0,drop,70,70,0,1,0,1,0
48687,54749,445,0,0,drop,70,70,0,1,0,1,0
48688,59709,445,0,0,drop,70,70,0,1,0,1,0
48689,57325,37965,0,0,deny,62,62,0,1,0,1,0
48690,54745,445,0,0,drop,70,70,0,1,0,1,0
48691,54746,445,0,0,drop,70,70,0,1,0,1,0
48692,59703,445,0,0,drop,70,70,0,1,0,1,0
48693,59704,445,0,0,drop,70,70,0,1,0,1,0
48694,59700,445,0,0,drop,70,70,0,1,0,1,0
48695,55105,445,0,0,drop,66,66,0,1,0,1,0
48696,54742,50584,0,0,deny,66,66,0,1,0,1,0
48697,50727,57470,0,0,deny,78,78,0,1,0,1,0
48698,55102,445,0,0,drop,66,66,0,1,0,1,0
48699,55099,445,0,0,drop,66,66,0,1,0,1,0
48700,55097,445,0,0,drop,66,66,0,1,0,1,0
48701,55095,445,0,0,drop,66,66,0,1,0,1,0
48702,55094,445,0,0,drop,66,66,0,1,0,1,0
48703,55093,445,0,0,drop,66,66,0,1,0,1,0
48704,53779,51505,0,0,deny,66,66,0,1,0,1,0
48705,17226,35440,0,0,deny,62,62,0,1,0,1,0
48706,43363,26467,0,0,deny,66,66,0,1,0,1,0
48707,13907,57470,0,0,deny,66,66,0,1,0,1,0
48708,3803,51505,0,0,deny,66,66,0,1,0,1,0
48709,10319,42707,0,0,deny,62,62,0,1,0,1,0
48710,54734,445,0,0,drop,70,70,0,1,0,1,0
48711,59697,445,0,0,drop,70,70,0,1,0,1,0
48712,59696,445,0,0,drop,70,70,0,1,0,1,0
48713,55090,445,0,0,drop,66,66,0,1,0,1,0
48714,59691,445,0,0,drop,70,70,0,1,0,1,0
48715,46901,26672,0,0,deny,60,60,0,1,0,1,0
48716,55087,445,0,0,drop,66,66,0,1,0,1,0
48717,44822,40108,0,0,deny,145,145,0,1,0,1,0
48718,55085,445,0,0,drop,66,66,0,1,0,1,0
48719,55083,445,0,0,drop,66,66,0,1,0,1,0
48720,45941,23388,0,0,deny,60,60,0,1,0,1,0
48721,51026,37450,0,0,deny,62,62,0,1,0,1,0
48722,60750,42707,0,0,deny,62,62,0,1,0,1,0
48723,55082,445,0,0,drop,66,66,0,1,0,1,0
48724,54730,445,0,0,drop,70,70,0,1,0,1,0
48725,56078,22,0,0,deny,60,60,0,1,0,1,0
48726,60772,36829,0,0,deny,62,62,0,1,0,1,0
48727,11677,44847,0,0,deny,146,146,0,1,0,1,0
48728,59685,445,0,0,drop,70,70,0,1,0,1,0
48729,57038,53,13307,53,allow,735,88,647,2,30,1,1
48730,64017,53,51575,53,allow,202,103,99,2,30,1,1
48731,57452,53,64588,53,allow,774,101,673,2,30,1,1
48732,56677,53,25915,53,allow,286,103,183,4,48,2,2
48733,55630,43736,23766,43736,allow,70,70,0,2,8,2,0
48734,60435,80,6093,80,allow,1155,781,374,10,15,6,4
48735,27005,27015,44800,27015,allow,858,126,732,2,30,1,1
48736,37138,80,13348,80,allow,1658,1344,314,10,16,5,5
48737,60413,43555,1703,43555,allow,70,70,0,1,5,1,0
48738,57614,80,57614,80,allow,470276,8994,461282,388,25,75,313
48739,60407,443,16001,443,allow,7298,1737,5561,21,79,11,10
48740,60408,443,33443,443,allow,7282,1596,5686,21,79,11,10
48741,49754,80,3257,80,allow,1793,634,1159,11,15,6,5
48742,51920,443,50819,443,allow,98155,20830,77325,151,103,70,81
48743,56820,19562,44411,19562,allow,316,136,180,6,6,3,3
48744,57617,80,57617,80,allow,542818,11392,531426,466,25,106,360
48745,65477,53,60369,53,allow,182,93,89,2,31,1,1
48746,51921,443,16602,443,allow,7970,4154,3816,39,102,23,16
48747,64711,53,44473,53,allow,206,105,101,2,31,1,1
48748,48064,443,60858,443,allow,7358,2661,4697,22,17,11,11
48749,56952,53,7156,53,allow,186,95,91,2,30,1,1
48750,49733,443,55919,443,allow,7673,1637,6036,31,23,16,15
48751,49379,53,1311,53,allow,198,101,97,2,30,1,1
48752,50166,80,59884,80,allow,2181,849,1332,14,97,7,7
48753,51111,80,36793,80,allow,1614,1300,314,10,15,5,5
48754,56200,53,9546,53,allow,206,105,101,2,30,1,1
48755,53979,80,42117,80,allow,64091,62467,1624,61,16,48,13
48756,56769,53,28212,53,allow,182,93,89,2,30,1,1
48757,39039,443,4727,443,allow,572,292,280,9,32,5,4
48758,6881,34190,52438,34190,allow,509,150,359,2,1200,1,1
48759,50774,443,8773,443,allow,6074,4349,1725,22,361,11,11
48760,54996,80,15340,80,allow,1979,826,1153,13,17,9,4
48761,58996,443,63733,443,allow,4979,1505,3474,21,40,11,10
48762,60400,443,24179,443,allow,7073,1556,5517,21,80,11,10
48763,45409,80,10508,80,allow,1155,781,374,10,15,6,4
48764,36404,443,36404,443,allow,4651,1744,2907,19,28,11,8
48765,63981,53,63404,53,allow,198,101,97,2,30,1,1
48766,51829,46209,37314,46209,allow,70,70,0,2,6,2,0
48767,51272,12210,19987,12210,allow,70,70,0,2,8,2,0
48768,56340,53,20646,53,allow,780,104,676,2,30,1,1
48769,57615,80,57615,80,allow,126266,7980,118286,126,25,37,89
48770,47193,443,47193,443,allow,4555,1648,2907,19,30,11,8
48771,54994,53,46934,53,allow,747,90,657,2,30,1,1
48772,49750,80,55648,80,allow,1788,628,1160,11,15,6,5
48773,64439,53,21739,53,allow,198,101,97,2,30,1,1
48774,56907,53,30481,53,allow,186,95,91,2,30,1,1
48775,16994,53,0,0,allow,300,90,210,2,30,1,1
48776,49270,53,41673,53,allow,735,88,647,2,30,1,1
48777,45232,53,0,0,allow,82,82,0,1,31,1,0
48778,50428,443,32117,443,allow,9844,4554,5290,24,92,13,11
48779,34366,53,0,0,allow,82,82,0,1,31,1,0
48780,50265,48982,51729,48982,allow,480,149,331,2,1200,1,1
48781,49601,53,30079,53,allow,88,88,0,1,31,1,0
48782,49323,53,32529,53,allow,204,104,100,2,31,1,1
48783,64071,53,30972,53,allow,188,96,92,2,31,1,1
48784,64756,53,52664,53,allow,190,97,93,2,31,1,1
48785,52254,443,36907,443,allow,13640,2316,11324,24,136,10,14
48786,49905,53,43598,53,allow,176,90,86,2,31,1,1
48787,49926,53,49666,53,allow,176,90,86,2,31,1,1
48788,55487,53,20467,53,allow,198,101,97,2,31,1,1
48789,63962,53,53078,53,allow,188,96,92,2,31,1,1
48790,27005,27016,39937,27016,allow,914,126,788,2,31,1,1
48791,49349,53,29426,53,allow,182,93,89,2,31,1,1
48792,49282,53,46163,53,allow,172,88,84,2,31,1,1
48793,27005,27022,10825,27022,allow,890,126,764,2,31,1,1
48794,64484,53,55455,53,allow,168,86,82,2,31,1,1
48795,49365,443,8370,443,allow,3598,1145,2453,15,120,7,8
48796,50265,65535,43978,65535,allow,222,132,90,4,1210,3,1
48797,1046,48817,0,0,deny,62,62,0,1,0,1,0
48798,52633,30188,0,0,deny,66,66,0,1,0,1,0
48799,54720,445,0,0,drop,70,70,0,1,0,1,0
48800,54719,445,0,0,drop,70,70,0,1,0,1,0
48801,59679,445,0,0,drop,70,70,0,1,0,1,0
48802,59676,445,0,0,drop,70,70,0,1,0,1,0
48803,54716,445,0,0,drop,70,70,0,1,0,1,0
48804,54717,445,0,0,drop,70,70,0,1,0,1,0
48805,20894,51505,0,0,deny,62,62,0,1,0,1,0
48806,54713,445,0,0,drop,70,70,0,1,0,1,0
48807,50316,37965,0,0,deny,66,66,0,1,0,1,0
48808,55070,445,0,0,drop,66,66,0,1,0,1,0
48809,56834,53,25406,53,allow,178,94,84,2,30,1,1
48810,26795,443,14434,443,allow,21804,16558,5246,43,21,24,19
48811,60891,443,59680,443,allow,4895,3822,1073,24,49,13,11
48812,23089,48817,0,0,deny,62,62,0,1,0,1,0
48813,1024,6881,0,0,deny,146,146,0,1,0,1,0
48814,62029,36237,0,0,deny,66,66,0,1,0,1,0
48815,55063,445,0,0,drop,66,66,0,1,0,1,0
48816,54707,445,0,0,drop,70,70,0,1,0,1,0
48817,43260,41615,0,0,deny,145,145,0,1,0,1,0
48818,59663,445,0,0,drop,70,70,0,1,0,1,0
48819,26408,64147,0,0,deny,66,66,0,1,0,1,0
48820,26502,64147,0,0,deny,62,62,0,1,0,1,0
48821,63456,37965,0,0,deny,62,62,0,1,0,1,0
48822,43104,26467,0,0,deny,62,62,0,1,0,1,0
48823,58811,53976,0,0,deny,62,62,0,1,0,1,0
48824,55061,445,0,0,drop,66,66,0,1,0,1,0
48825,54700,445,0,0,drop,70,70,0,1,0,1,0
48826,58562,57587,0,0,deny,66,66,0,1,0,1,0
48827,54698,445,0,0,drop,70,70,0,1,0,1,0
48828,52095,56079,0,0,deny,62,62,0,1,0,1,0
48829,55054,445,0,0,drop,66,66,0,1,0,1,0
48830,26494,26467,0,0,deny,62,62,0,1,0,1,0
48831,55043,445,0,0,drop,66,66,0,1,0,1,0
48832,8239,37965,0,0,deny,146,146,0,1,0,1,0
48833,50280,57470,0,0,deny,78,78,0,1,0,1,0
48834,54693,445,0,0,drop,70,70,0,1,0,1,0
48835,54692,445,0,0,drop,70,70,0,1,0,1,0
48836,5774,37965,0,0,deny,66,66,0,1,0,1,0
48837,54688,445,0,0,drop,70,70,0,1,0,1,0
48838,63030,2222,0,0,deny,66,66,0,1,0,1,0
48839,59651,445,0,0,drop,70,70,0,1,0,1,0
48840,59653,445,0,0,drop,70,70,0,1,0,1,0
48841,59652,445,0,0,drop,70,70,0,1,0,1,0
48842,64266,53,27142,53,allow,168,86,82,2,30,1,1
48843,49555,53,21166,53,allow,199,102,97,2,30,1,1
48844,57290,53,54259,53,allow,178,94,84,2,30,1,1
48845,41232,443,32307,443,allow,1807,1048,759,16,25,8,8
48846,49732,443,42008,443,allow,27125,14251,12874,99,23,57,42
48847,60397,443,49717,443,allow,7643,1678,5965,21,80,11,10
48848,60403,443,3192,443,allow,5567,1589,3978,20,80,11,9
48849,15930,53,15930,53,allow,244,98,146,2,31,1,1
48850,55636,25569,50876,25569,allow,320,140,180,6,6,3,3
48851,49731,443,14153,443,allow,13155,3815,9340,29,24,13,16
48852,60413,443,19866,443,allow,9398,2320,7078,24,77,13,11
48853,60396,443,5888,443,allow,5964,1586,4378,19,80,10,9
48854,50152,80,46738,80,allow,731402,17622,713780,600,97,116,484
48855,64439,53,36450,53,allow,199,102,97,2,30,1,1
48856,55927,53,41588,53,allow,720,94,626,2,29,1,1
48857,54431,443,24894,443,allow,9398,2027,7371,33,270,14,19
48858,41234,443,28858,443,allow,1741,1048,693,15,25,8,7
48859,60368,443,34243,443,allow,6041,1830,4211,21,82,10,11
48860,57095,53,1337,53,allow,211,110,101,2,29,1,1
48861,60393,443,31011,443,allow,8049,1805,6244,23,81,12,11
48862,49734,443,18197,443,allow,7548,1543,6005,22,18,12,10
48863,60369,443,26606,443,allow,6052,1841,4211,21,82,10,11
48864,60370,443,62763,443,allow,6045,1834,4211,21,82,10,11
48865,60389,443,56749,443,allow,8166,1734,6432,23,81,12,11
48866,51837,37610,19513,37610,allow,316,136,180,6,5,3,3
48867,55271,53,23423,53,allow,168,86,82,2,30,1,1
48868,46403,443,21158,443,allow,6035,1758,4277,27,1169,15,12
48869,54518,7000,54518,7000,allow,3518,1951,1567,15,15,8,7
48870,51443,443,35232,443,allow,322,66,256,6,16,2,4
48871,63129,47117,14419,47117,allow,574,448,126,10,25,8,2
48872,51919,443,36228,443,allow,17595,8241,9354,80,106,43,37
48873,36692,443,41344,443,allow,996,526,470,15,30,8,7
48874,54653,6881,28676,6881,allow,658,412,246,9,15,5,4
48875,65300,53,17594,53,allow,329,88,241,4,50,2,2
48876,49175,443,3024,443,allow,4429,2593,1836,34,1126,18,16
48877,27005,27015,14590,27015,allow,901,126,775,2,30,1,1
48878,64695,53,52435,53,allow,193,102,91,2,30,1,1
48879,64711,53,17611,53,allow,211,110,101,2,30,1,1
48880,55773,53,34274,53,allow,199,102,97,2,30,1,1
48881,49905,53,29720,53,allow,180,94,86,2,30,1,1
48882,51816,27721,15774,27721,allow,70,70,0,1,5,1,0
48883,57613,80,57613,80,allow,349583,9149,340434,298,25,62,236
48884,45239,443,9489,443,allow,11147,3412,7735,36,458,20,16
48885,33409,53,6047,53,allow,241272,234761,6511,2872,89,2833,39
48886,6437,53,6437,53,allow,229,90,139,2,30,1,1
48887,65477,53,61765,53,allow,183,94,89,2,30,1,1
48888,55487,53,40739,53,allow,199,102,97,2,30,1,1
48889,49747,53,62194,53,allow,355,102,253,2,30,1,1
48890,57207,53,1251,53,allow,195,102,93,2,30,1,1
48891,64105,53,18897,53,allow,182,86,96,2,30,1,1
48892,64017,53,3169,53,allow,209,110,99,2,30,1,1
48893,60415,40829,46260,40829,allow,70,70,0,1,5,1,0
48894,51441,443,28224,443,allow,322,66,256,6,16,2,4
48895,64266,53,43619,53,allow,168,86,82,2,30,1,1
48896,49751,80,48363,80,allow,1876,998,878,12,15,7,5
48897,2437,53,2437,53,allow,229,90,139,2,30,1,1
48898,49602,53,63187,53,allow,178,94,84,2,30,1,1
48899,9708,53,0,0,allow,304,94,210,2,30,1,1
48900,49981,53,37329,53,allow,438,180,258,6,30,3,3
48901,56769,53,53195,53,allow,183,94,89,2,30,1,1
48902,64439,53,3142,53,allow,199,102,97,2,30,1,1
48903,49555,53,37709,53,allow,199,102,97,2,30,1,1
48904,57290,53,13860,53,allow,178,94,84,2,30,1,1
48905,49602,53,1592,53,allow,178,94,84,2,30,1,1
48906,56945,53,62206,53,allow,180,94,86,2,30,1,1
48907,43937,123,21193,123,allow,184,94,90,2,30,1,1
48908,64538,53,37074,53,allow,194,102,92,2,30,1,1
48909,64482,53,15277,53,allow,196,102,94,2,30,1,1
48910,55538,53,48787,53,allow,195,102,93,2,30,1,1
48911,55773,53,61209,53,allow,199,102,97,2,30,1,1
48912,47905,443,5382,443,allow,172,172,0,2,5,2,0
48913,52143,443,25458,443,allow,712,452,260,8,25,4,4
48914,64017,53,64345,53,allow,325,103,222,4,45,2,2
48915,65213,53,54852,53,allow,298,94,204,2,30,1,1
48916,55859,53,59697,53,allow,210,110,100,2,30,1,1
48917,64695,53,11927,53,allow,193,102,91,2,30,1,1
48918,56677,53,32244,53,allow,286,103,183,4,48,2,2
48919,60414,52559,6876,52559,allow,70,70,0,1,5,1,0
48920,57616,80,57616,80,allow,266789,7684,259105,234,25,54,180
48921,56677,53,36331,53,allow,286,103,183,4,48,2,2
48922,63981,53,13175,53,allow,199,102,97,2,29,1,1
48923,60502,443,31971,443,allow,416,210,206,7,28,4,3
48924,23725,80,23725,80,allow,1100980,31101,1069879,1210,19,462,748
48925,50307,80,5299,80,allow,2840,1750,1090,13,82,7,6
48926,55171,53,9139,53,allow,199,102,97,2,29,1,1
48927,65460,53,21678,53,allow,387,102,285,2,29,1,1
48928,65117,53,55253,53,allow,542,100,442,4,51,2,2
48929,41236,443,52117,443,allow,1807,1048,759,16,25,8,8
48930,56769,53,31740,53,allow,183,94,89,2,30,1,1
48931,50059,443,43913,443,allow,8205,2989,5216,42,115,21,21
48932,60412,443,58640,443,allow,7353,1573,5780,21,78,11,10
48933,64128,53,50271,53,allow,606,182,424,6,71,3,3
48934,34733,80,35506,80,allow,1056,682,374,10,15,6,4
48935,60353,80,51111,80,allow,1679,1269,410,8,15,5,3
48936,65159,53,58481,53,allow,500,204,296,6,75,3,3
48937,55271,53,59088,53,allow,168,86,82,2,29,1,1
48938,27005,37569,24512,37569,allow,880,126,754,2,30,1,1
48939,64482,53,47729,53,allow,196,102,94,2,30,1,1
48940,56773,53,53330,53,allow,183,94,89,2,29,1,1
48941,49263,53,54586,53,allow,178,94,84,2,30,1,1
48942,45863,53,45863,53,allow,229,90,139,2,30,1,1
48943,49464,53,1533,53,allow,213,102,111,2,30,1,1
48944,65477,53,57278,53,allow,183,94,89,2,30,1,1
48945,56945,53,11659,53,allow,180,94,86,2,30,1,1
48946,64711,53,46738,53,allow,211,110,101,2,30,1,1
48947,49198,443,22902,443,allow,533813,25885,507928,678,50,308,370
48948,57207,53,55086,53,allow,195,102,93,2,30,1,1
48949,49926,53,63439,53,allow,180,94,86,2,30,1,1
48950,64484,53,23929,53,allow,86,86,0,1,30,1,0
48951,48155,443,36559,443,allow,7395,1514,5881,26,225,11,15
48952,35796,443,15213,443,allow,664348,23858,640490,757,119,292,465
48953,36834,80,37812,80,allow,12993,6920,6073,22,20,13,9
48954,5588,5588,0,0,allow,3354,1792,1562,46,194,23,23
48955,49268,53,5165,53,allow,353,118,235,2,30,1,1
48956,55859,53,29640,53,allow,210,110,100,2,30,1,1
48957,50006,53,55896,53,allow,378,94,284,2,30,1,1
48958,65187,53,19736,53,allow,392,86,306,2,30,1,1
48959,56200,53,42161,53,allow,211,110,101,2,30,1,1
48960,65477,53,48091,53,allow,183,94,89,2,30,1,1
48961,56618,443,31063,443,allow,3096,1882,1214,19,16,10,9
48962,57618,80,57618,80,allow,265909,7294,258615,235,25,55,180
48963,50116,22,50116,22,allow,152,66,86,2,10,1,1
48964,57384,443,63051,443,allow,546,280,266,9,28,5,4
48965,57591,443,27521,443,allow,2614,1689,925,18,20,10,8
48966,55312,53,35283,53,allow,438,180,258,6,30,3,3
48967,55066,53,27707,53,allow,180,94,86,2,30,1,1
48968,64538,53,57273,53,allow,194,102,92,2,30,1,1
48969,56945,53,12864,53,allow,180,94,86,2,30,1,1
48970,54973,53,3418,53,allow,308,102,206,2,30,1,1
48971,64642,53,54204,53,allow,751,94,657,2,30,1,1
48972,50642,53,37858,53,allow,775,102,673,2,30,1,1
48973,64017,53,52336,53,allow,209,110,99,2,30,1,1
48974,49317,53,48476,53,allow,166,86,80,2,30,1,1
48975,49905,53,25136,53,allow,180,94,86,2,30,1,1
48976,55093,53,0,0,allow,318,86,232,2,30,1,1
48977,55538,53,14832,53,allow,195,102,93,2,30,1,1
48978,49349,53,14349,53,allow,183,94,89,2,30,1,1
48979,64711,53,26786,53,allow,211,110,101,2,30,1,1
48980,20388,53,20388,53,allow,203,82,121,2,30,1,1
48981,49323,53,60402,53,allow,210,110,100,2,31,1,1
48982,64808,53,34038,53,allow,239,94,145,2,30,1,1
48983,55487,53,60324,53,allow,199,102,97,2,31,1,1
48984,16403,16384,56995,16384,allow,556,256,300,10,31,5,5
48985,64071,53,28084,53,allow,424,104,320,4,31,2,2
48986,53654,53,13764,53,allow,523,85,438,4,31,2,2
48987,64347,53,32269,53,allow,193,102,91,2,30,1,1
48988,49160,12176,2844,12176,allow,852,150,702,4,1200,2,2
48989,56834,53,6671,53,allow,178,94,84,2,31,1,1
48990,27005,27014,60254,27014,allow,879,126,753,2,31,1,1
48991,17750,27517,53975,27517,allow,491,150,341,2,1200,1,1
48992,50182,443,50182,443,allow,12509,1447,11062,28,122,16,12
48993,51238,443,29233,443,allow,8034,2584,5450,39,16,23,16
48994,52776,80,21861,80,allow,432,240,192,8,101,5,3
48995,48009,443,46874,443,allow,4015,1813,2202,17,256,9,8
48996,35672,443,33861,443,allow,938,576,362,14,27,9,5
48997,47450,443,22297,443,allow,162,102,60,2,5,1,1
48998,51239,443,46781,443,allow,9649,4615,5034,42,16,24,18
48999,50018,80,3941,80,allow,825,685,140,6,33,4,2
49000,56806,46903,25071,46903,allow,3060,1569,1491,12,17,7,5
49001,50973,80,57219,80,allow,314164,13077,301087,356,25,144,212
49002,37253,443,5340,443,allow,6840,1556,5284,32,26,17,15
49003,51807,10920,61477,10920,allow,70,70,0,1,5,1,0
49004,49926,53,15614,53,allow,180,94,86,2,30,1,1
49005,55038,445,0,0,drop,66,66,0,1,0,1,0
49006,55030,445,0,0,drop,66,66,0,1,0,1,0
49007,55034,445,0,0,drop,66,66,0,1,0,1,0
49008,55036,445,0,0,drop,66,66,0,1,0,1,0
49009,55035,445,0,0,drop,66,66,0,1,0,1,0
49010,55033,445,0,0,drop,66,66,0,1,0,1,0
49011,55037,445,0,0,drop,66,66,0,1,0,1,0
49012,55031,445,0,0,drop,66,66,0,1,0,1,0
49013,54687,445,0,0,drop,70,70,0,1,0,1,0
49014,57564,56205,0,0,deny,66,66,0,1,0,1,0
49015,60350,51505,0,0,deny,66,66,0,1,0,1,0
49016,60312,57470,0,0,deny,74,74,0,1,0,1,0
49017,49616,30188,0,0,deny,66,66,0,1,0,1,0
49018,56785,39004,0,0,deny,145,145,0,1,0,1,0
49019,42252,33303,0,0,deny,60,60,0,1,0,1,0
49020,41346,30188,0,0,deny,62,62,0,1,0,1,0
49021,54682,445,0,0,drop,70,70,0,1,0,1,0
49022,48706,23393,0,0,deny,60,60,0,1,0,1,0
49023,59649,445,0,0,drop,70,70,0,1,0,1,0
49024,59637,445,0,0,drop,70,70,0,1,0,1,0
49025,59635,445,0,0,drop,70,70,0,1,0,1,0
49026,55018,445,0,0,drop,66,66,0,1,0,1,0
49027,55015,445,0,0,drop,66,66,0,1,0,1,0
49028,55016,445,0,0,drop,66,66,0,1,0,1,0
49029,36566,37965,0,0,deny,62,62,0,1,0,1,0
49030,58038,51505,0,0,deny,146,146,0,1,0,1,0
49031,59634,445,0,0,drop,70,70,0,1,0,1,0
49032,53459,37807,0,0,deny,62,62,0,1,0,1,0
49033,13643,22114,0,0,deny,146,146,0,1,0,1,0
49034,56582,37965,0,0,deny,66,66,0,1,0,1,0
49035,17579,57470,0,0,deny,62,62,0,1,0,1,0
49036,59631,445,0,0,drop,70,70,0,1,0,1,0
49037,45964,2228,0,0,deny,60,60,0,1,0,1,0
49038,59630,445,0,0,drop,70,70,0,1,0,1,0
49039,59624,445,0,0,drop,70,70,0,1,0,1,0
49040,59622,445,0,0,drop,70,70,0,1,0,1,0
49041,54669,445,0,0,drop,70,70,0,1,0,1,0
49042,54666,445,0,0,drop,70,70,0,1,0,1,0
49043,58485,40740,0,0,deny,145,145,0,1,0,1,0
49044,42865,55839,0,0,deny,137,137,0,1,0,1,0
49045,43916,21,0,0,deny,60,60,0,1,0,1,0
49046,10639,11392,0,0,deny,62,62,0,1,0,1,0
49047,25469,57470,0,0,deny,62,62,0,1,0,1,0
49048,65518,5710,0,0,deny,62,62,0,1,0,1,0
49049,59612,445,0,0,drop,70,70,0,1,0,1,0
49050,59610,445,0,0,drop,70,70,0,1,0,1,0
49051,59609,445,0,0,drop,70,70,0,1,0,1,0
49052,48676,53392,0,0,deny,60,60,0,1,0,1,0
49053,54661,445,0,0,drop,70,70,0,1,0,1,0
49054,44849,46478,0,0,deny,74,74,0,1,0,1,0
49055,54660,445,0,0,drop,70,70,0,1,0,1,0
49056,51920,30188,0,0,deny,62,62,0,1,0,1,0
49057,57649,6881,0,0,deny,146,146,0,1,0,1,0
49058,54658,445,0,0,drop,70,70,0,1,0,1,0
49059,53774,51505,0,0,deny,66,66,0,1,0,1,0
49060,11023,51505,0,0,deny,66,66,0,1,0,1,0
49061,2425,23117,0,0,deny,62,62,0,1,0,1,0
49062,54996,445,0,0,drop,66,66,0,1,0,1,0
49063,34936,30188,0,0,deny,66,66,0,1,0,1,0
49064,59606,445,0,0,drop,70,70,0,1,0,1,0
49065,59604,445,0,0,drop,70,70,0,1,0,1,0
49066,52929,1433,0,0,deny,60,60,0,1,0,1,0
49067,52837,35440,0,0,deny,66,66,0,1,0,1,0
49068,54651,445,0,0,drop,70,70,0,1,0,1,0
49069,6666,8888,0,0,deny,60,60,0,1,0,1,0
49070,52111,44847,0,0,deny,62,62,0,1,0,1,0
49071,0,0,0,0,deny,98,98,0,1,0,1,0
49072,52929,1433,0,0,deny,60,60,0,1,0,1,0
49073,34808,22114,0,0,deny,66,66,0,1,0,1,0
49074,54649,445,0,0,drop,70,70,0,1,0,1,0
49075,54648,445,0,0,drop,70,70,0,1,0,1,0
49076,13581,51505,0,0,deny,62,62,0,1,0,1,0
49077,54988,445,0,0,drop,66,66,0,1,0,1,0
49078,54647,445,0,0,drop,70,70,0,1,0,1,0
49079,54196,11392,0,0,deny,66,66,0,1,0,1,0
49080,54646,445,0,0,drop,70,70,0,1,0,1,0
49081,41562,123,0,0,deny,234,234,0,1,0,1,0
49082,54642,445,0,0,drop,70,70,0,1,0,1,0
49083,54643,445,0,0,drop,70,70,0,1,0,1,0
49084,54986,445,0,0,drop,66,66,0,1,0,1,0
49085,59592,445,0,0,drop,70,70,0,1,0,1,0
49086,59589,445,0,0,drop,70,70,0,1,0,1,0
49087,59588,445,0,0,drop,70,70,0,1,0,1,0
49088,59583,445,0,0,drop,70,70,0,1,0,1,0
49089,54984,445,0,0,drop,66,66,0,1,0,1,0
49090,52696,21247,0,0,deny,66,66,0,1,0,1,0
49091,54628,445,0,0,drop,70,70,0,1,0,1,0
49092,54627,445,0,0,drop,70,70,0,1,0,1,0
49093,54624,445,0,0,drop,70,70,0,1,0,1,0
49094,54618,445,0,0,drop,70,70,0,1,0,1,0
49095,54617,445,0,0,drop,70,70,0,1,0,1,0
49096,59563,56205,0,0,deny,66,66,0,1,0,1,0
49097,59581,445,0,0,drop,70,70,0,1,0,1,0
49098,46901,26672,0,0,deny,60,60,0,1,0,1,0
49099,19875,30170,0,0,deny,145,145,0,1,0,1,0
49100,59576,445,0,0,drop,70,70,0,1,0,1,0
49101,59574,445,0,0,drop,70,70,0,1,0,1,0
49102,59572,445,0,0,drop,70,70,0,1,0,1,0
49103,24174,57470,0,0,deny,62,62,0,1,0,1,0
49104,54977,445,0,0,drop,66,66,0,1,0,1,0
49105,52177,25320,0,0,deny,66,66,0,1,0,1,0
49106,54973,445,0,0,drop,66,66,0,1,0,1,0
49107,54968,445,0,0,drop,66,66,0,1,0,1,0
49108,54970,445,0,0,drop,66,66,0,1,0,1,0
49109,62549,53733,0,0,deny,66,66,0,1,0,1,0
49110,54967,445,0,0,drop,66,66,0,1,0,1,0
49111,54964,445,0,0,drop,66,66,0,1,0,1,0
49112,54965,445,0,0,drop,66,66,0,1,0,1,0
49113,6037,43890,0,0,deny,70,70,0,1,0,1,0
49114,4515,37807,0,0,deny,62,62,0,1,0,1,0
49115,54606,445,0,0,drop,70,70,0,1,0,1,0
49116,55201,22114,0,0,deny,62,62,0,1,0,1,0
49117,17453,35440,0,0,deny,66,66,0,1,0,1,0
49118,43047,80,45126,80,allow,2088,472,1616,15,155,3,12
49119,27005,27015,61856,27015,allow,888,126,762,2,30,1,1
49120,58805,80,4161,80,allow,1702,1388,314,10,16,5,5
49121,55622,33342,17108,33342,allow,70,70,0,1,5,1,0
49122,52912,53,52912,53,allow,237,91,146,2,32,1,1
49123,53624,7370,56004,7370,allow,70,70,0,1,5,1,0
49124,60325,80,16267,80,allow,3697,2062,1635,16,61,9,7
49125,38820,80,32872,80,allow,1150,613,537,10,16,6,4
49126,64367,443,15536,443,allow,4741,1306,3435,26,300,14,12
49127,44949,443,16538,443,allow,4093,2830,1263,21,24,11,10
49128,59210,80,59210,80,allow,1990,833,1157,10,21,6,4
49129,57396,443,25332,443,allow,9318,3350,5968,31,140,14,17
49130,37896,443,37896,443,allow,4704,1797,2907,19,30,11,8
49131,51810,33776,47745,33776,allow,66,66,0,1,5,1,0
49132,64366,443,7841,443,allow,6205,1316,4889,27,301,14,13
49133,42567,80,40138,80,allow,2161,1178,983,16,17,10,6
49134,42811,80,59018,80,allow,1114,534,580,12,16,7,5
49135,60330,80,20724,80,allow,374,192,182,7,61,4,3
49136,60329,80,45049,80,allow,374,192,182,7,61,4,3
49137,52673,80,57831,80,allow,23776,1372,22404,35,112,15,20
49138,53073,80,1603,80,allow,2594,1200,1394,16,17,10,6
49139,60327,80,34206,80,allow,2125,1159,966,13,61,7,6
49140,51811,20740,15988,20740,allow,66,66,0,1,5,1,0
49141,57490,80,59652,80,allow,1614,1300,314,10,15,5,5
49142,49883,443,6647,443,allow,17238,4435,12803,32,103,15,17
49143,42172,443,15822,443,allow,7071,1908,5163,29,944,14,15
49144,45816,443,45816,443,allow,4430,1523,2907,19,27,11,8
49145,58757,5222,20717,5222,allow,3815,2065,1750,37,309,19,18
49146,52774,80,57936,80,allow,432,240,192,8,101,5,3
49147,52772,80,28043,80,allow,2501,1085,1416,15,108,8,7
49148,55620,20795,41932,20795,allow,70,70,0,1,5,1,0
49149,48865,443,7956,443,allow,12824,2604,10220,46,255,20,26
49150,42022,80,12678,80,allow,31196,607,30589,29,500,5,24
49151,61732,443,11286,443,allow,8655,2300,6355,24,21,12,12
49152,53121,8986,30082,8986,allow,70,70,0,1,5,1,0
49153,49225,53,55909,53,allow,295,101,194,4,49,2,2
49154,57647,80,36132,80,allow,1530,1216,314,10,15,5,5
49155,51806,49530,42413,49530,allow,66,66,0,1,5,1,0
49156,35405,53,35405,53,allow,217,87,130,2,30,1,1
49157,64368,443,54903,443,allow,4741,1306,3435,26,300,14,12
49158,64347,53,36083,53,allow,186,95,91,2,30,1,1
49159,57207,53,13941,53,allow,190,97,93,2,30,1,1
49160,43676,80,43895,80,allow,2132,997,1135,14,20,8,6
49161,51402,443,14600,443,allow,7788,2581,5207,39,70,19,20
49162,64091,80,64091,80,allow,2244,1505,739,11,146,6,5
49163,36417,443,64743,443,allow,8611,2046,6565,31,394,10,21
49164,52775,80,57119,80,allow,432,240,192,8,101,5,3
49165,49104,80,61237,80,allow,1638,1324,314,10,15,5,5
49166,60328,80,20117,80,allow,2006,1095,911,11,61,6,5
49167,53614,8999,9856,8999,allow,928,541,387,8,17,5,3
49168,51825,25501,11280,25501,allow,70,70,0,2,9,2,0
49169,60326,80,6892,80,allow,3697,2062,1635,16,61,9,7
49170,51813,63933,44889,63933,allow,66,66,0,1,5,1,0
49171,41924,53,41924,53,allow,237,91,146,2,33,1,1
49172,39322,443,56925,443,allow,7450,2503,4947,21,977,11,10
49173,57944,80,62722,80,allow,1718,1404,314,11,15,6,5
49174,53632,58037,54997,58037,allow,70,70,0,1,5,1,0
49175,43154,80,38984,80,allow,139303,9065,130238,210,20,120,90
49176,28331,53,28331,53,allow,213,87,126,2,30,1,1
49177,27005,27015,11957,27015,allow,901,126,775,2,30,1,1
49178,27005,27015,54928,27015,allow,882,126,756,2,30,1,1
49179,65530,53,49940,53,allow,96,96,0,1,30,1,0
49180,56834,53,36228,53,allow,172,88,84,2,30,1,1
49181,49919,443,28097,443,allow,4534,909,3625,16,32,8,8
49182,33087,53,33087,53,allow,228,97,131,2,31,1,1
49183,34246,53,34246,53,allow,217,87,130,2,31,1,1
49184,13980,53,13980,53,allow,213,87,126,2,31,1,1
49185,37965,62918,1138,62918,allow,489,149,340,2,1200,1,1
49186,443,30054,0,0,allow,60,60,0,1,91,1,0
49187,44783,443,27769,443,allow,4173582,66515,4107067,3494,129,510,2984
49188,53580,443,57283,443,allow,4669,2251,2418,14,137,7,7
49189,59845,44847,0,0,deny,66,66,0,1,0,1,0
49190,34176,51505,0,0,deny,146,146,0,1,0,1,0
49191,59568,445,0,0,drop,70,70,0,1,0,1,0
49192,59570,445,0,0,drop,70,70,0,1,0,1,0
49193,59569,445,0,0,drop,70,70,0,1,0,1,0
49194,443,1340,0,0,deny,85,85,0,1,0,1,0
49195,54962,445,0,0,drop,66,66,0,1,0,1,0
49196,55539,57470,0,0,deny,66,66,0,1,0,1,0
49197,59563,445,0,0,drop,70,70,0,1,0,1,0
49198,54958,445,0,0,drop,66,66,0,1,0,1,0
49199,54955,445,0,0,drop,66,66,0,1,0,1,0
49200,62414,50584,0,0,deny,62,62,0,1,0,1,0
49201,65355,443,1822,443,allow,3563945,186679,3377266,4424,723,1877,2547
49202,57015,80,50968,80,allow,1348,844,504,13,255,8,5
49203,49282,53,64879,53,allow,178,94,84,2,30,1,1
49204,27005,27015,20017,27015,allow,882,126,756,2,30,1,1
49205,49282,53,56718,53,allow,178,94,84,2,30,1,1
49206,54602,445,0,0,drop,70,70,0,1,0,1,0
49207,54954,445,0,0,drop,66,66,0,1,0,1,0
49208,11677,56205,0,0,deny,62,62,0,1,0,1,0
49209,48016,57470,0,0,deny,62,62,0,1,0,1,0
49210,49479,56205,0,0,deny,66,66,0,1,0,1,0
49211,54592,445,0,0,drop,70,70,0,1,0,1,0
49212,54593,445,0,0,drop,70,70,0,1,0,1,0
49213,47700,51505,0,0,deny,66,66,0,1,0,1,0
49214,54588,445,0,0,drop,70,70,0,1,0,1,0
49215,54590,445,0,0,drop,70,70,0,1,0,1,0
49216,59557,445,0,0,drop,70,70,0,1,0,1,0
49217,54586,445,0,0,drop,70,70,0,1,0,1,0
49218,59549,445,0,0,drop,70,70,0,1,0,1,0
49219,59546,445,0,0,drop,70,70,0,1,0,1,0
49220,2541,51505,0,0,deny,66,66,0,1,0,1,0
49221,64990,55442,0,0,deny,66,66,0,1,0,1,0
49222,1024,57470,0,0,deny,62,62,0,1,0,1,0
49223,54579,445,0,0,drop,70,70,0,1,0,1,0
49224,56542,443,7908,443,allow,3701,1521,2180,19,7,10,9
49225,62152,56205,0,0,deny,66,66,0,1,0,1,0
49226,1024,50265,0,0,deny,62,62,0,1,0,1,0
49227,63194,50265,0,0,deny,66,66,0,1,0,1,0
49228,46362,35440,0,0,deny,66,66,0,1,0,1,0
49229,55032,62413,0,0,deny,62,62,0,1,0,1,0
49230,16474,50584,0,0,deny,146,146,0,1,0,1,0
49231,61962,53733,0,0,deny,62,62,0,1,0,1,0
49232,54935,445,0,0,drop,66,66,0,1,0,1,0
49233,59535,445,0,0,drop,70,70,0,1,0,1,0
49234,21348,22,0,0,deny,60,60,0,1,0,1,0
49235,13985,34159,0,0,deny,66,66,0,1,0,1,0
49236,54572,445,0,0,drop,70,70,0,1,0,1,0
49237,54932,445,0,0,drop,66,66,0,1,0,1,0
49238,54569,445,0,0,drop,70,70,0,1,0,1,0
49239,30179,57470,0,0,deny,60,60,0,1,0,1,0
49240,62337,44847,0,0,deny,62,62,0,1,0,1,0
49241,54926,445,0,0,drop,66,66,0,1,0,1,0
49242,54566,445,0,0,drop,70,70,0,1,0,1,0
49243,59262,5228,3053,5228,allow,7054,2076,4978,32,5115,11,21
49244,49867,443,24010,443,allow,7461,2841,4620,19,103,11,8
49245,40363,80,1315,80,allow,3566,1637,1929,18,81,11,7
49246,5236,35120,49591,35120,allow,23369,64,23305,65,31,2,63
49247,63243,53,40178,53,allow,330,228,102,3,33,2,1
49248,51812,15279,41054,15279,allow,70,70,0,1,4,1,0
49249,51809,52528,58895,52528,allow,70,70,0,1,4,1,0
49250,53629,51413,42166,51413,allow,70,70,0,1,4,1,0
49251,46392,443,48556,443,allow,232,172,60,3,5,2,1
49252,52731,80,58843,80,allow,1029,567,462,10,17,6,4
49253,64695,53,40312,53,allow,193,102,91,2,29,1,1
49254,55950,443,51183,443,allow,6490,1789,4701,30,95,16,14
49255,60146,53,47250,53,allow,218,78,140,2,30,1,1
49256,61682,80,36902,80,allow,1804,884,920,12,49,6,6
49257,54536,80,14992,80,allow,4096,3455,641,13,15,8,5
49258,53644,58085,31937,58085,allow,70,70,0,2,7,2,0
49259,6881,50321,40130,50321,allow,238,118,120,2,1199,1,1
49260,52777,80,21198,80,allow,432,240,192,8,100,5,3
49261,49225,53,59832,53,allow,295,101,194,4,49,2,2
49262,64617,53,31755,53,allow,389,102,287,4,33,2,2
49263,51409,443,49977,443,allow,394,70,324,7,31,2,5
49264,55301,443,54571,443,allow,9881,1486,8395,22,200,12,10
49265,51815,28665,10000,28665,allow,70,70,0,1,4,1,0
49266,51827,48432,37555,48432,allow,164,70,94,2,4,1,1
49267,51814,55393,29283,55393,allow,70,70,0,1,4,1,0
49268,49926,53,46406,53,allow,333,90,243,4,41,2,2
49269,57207,53,1667,53,allow,195,102,93,2,29,1,1
49270,49905,53,31462,53,allow,180,94,86,2,29,1,1
49271,49323,53,50782,53,allow,210,110,100,2,29,1,1
49272,46860,53,42204,53,allow,447,101,346,4,29,2,2
49273,62155,53,41278,53,allow,263,86,177,2,29,1,1
49274,55995,53,32542,53,allow,329,118,211,2,30,1,1
49275,55242,443,59852,443,allow,214,140,74,4,15,3,1
49276,57311,53,54078,53,allow,211,102,109,2,30,1,1
49277,51948,443,29548,443,allow,4876,2559,2317,32,56,18,14
49278,53239,443,22787,443,allow,982624,22331,960293,976,137,293,683
49279,56654,443,29055,443,allow,18544,4402,14142,31,191,14,17
49280,49343,53,20254,53,allow,478,106,372,4,48,2,2
49281,46140,443,48726,443,allow,172,172,0,2,5,2,0
49282,27005,27015,32214,27015,allow,878,126,752,2,30,1,1
49283,33197,443,9055,443,allow,1067,650,417,10,27,6,4
49284,49267,53,55057,53,allow,209,94,115,2,30,1,1
49285,46269,123,16380,123,allow,184,94,90,2,30,1,1
49286,36690,443,36517,443,allow,1520,1058,462,12,29,8,4
49287,51947,443,7702,443,allow,3893,2046,1847,29,56,16,13
49288,64329,53,19539,53,allow,281,110,171,2,30,1,1
49289,65530,53,53494,53,allow,194,102,92,2,30,1,1
49290,41943,443,27053,443,allow,8385,3143,5242,35,98,18,17
49291,57643,80,14145,80,allow,172,172,0,2,5,2,0
49292,45020,443,48024,443,allow,10427,2928,7499,34,106,16,18
49293,56076,80,28614,80,allow,5055,3100,1955,34,17,28,6
49294,60504,443,51319,443,allow,1875,1165,710,13,28,7,6
49295,49225,53,22731,53,allow,295,101,194,4,48,2,2
49296,64912,53,22829,53,allow,258,102,156,2,30,1,1
49297,27005,27001,29327,27001,allow,883,126,757,2,30,1,1
49298,55949,443,10704,443,allow,21852,2269,19583,48,95,23,25
49299,60717,443,21678,443,allow,61464,11538,49926,87,32,41,46
49300,63550,80,63550,80,allow,1232,481,751,10,15,5,5
49301,60087,443,43883,443,allow,5470,3223,2247,43,172,22,21
49302,41619,443,17467,443,allow,188529,10173,178356,248,256,93,155
49303,52406,443,64172,443,allow,13978,8842,5136,46,52,26,20
49304,60821,443,28093,443,allow,16554,7445,9109,49,255,24,25
49305,6881,6881,9262,6881,allow,501,150,351,2,1200,1,1
49306,52698,80,54306,80,allow,8280,5678,2602,25,111,14,11
49307,51808,46390,34181,46390,allow,70,70,0,1,4,1,0
49308,9823,53,9823,53,allow,244,98,146,2,32,1,1
49309,53630,64745,36069,64745,allow,70,70,0,1,4,1,0
49310,39423,80,38195,80,allow,78,78,0,1,4,1,0
49311,49317,53,7671,53,allow,657,187,470,6,72,3,3
49312,53626,33194,63366,33194,allow,70,70,0,1,4,1,0
49313,51826,58925,42484,58925,allow,70,70,0,2,9,2,0
49314,56393,443,8306,443,allow,25779,3436,22343,42,109,19,23
49315,50056,27018,38815,27018,allow,468,390,78,5,29,4,1
49316,56403,443,13577,443,allow,1710,976,734,16,81,8,8
49317,65356,443,39597,443,allow,3122508,193850,2928658,4050,681,1740,2310
49318,64071,53,46762,53,allow,194,102,92,2,29,1,1
49319,53628,50514,36687,50514,allow,70,70,0,1,4,1,0
49320,57938,443,57938,443,allow,27787,5566,22221,60,47,31,29
49321,64772,53,16557,53,allow,416,107,309,4,29,2,2
49322,55621,28144,63708,28144,allow,70,70,0,1,5,1,0
49323,63960,53,46740,53,allow,228,110,118,2,29,1,1
49324,64347,53,53125,53,allow,193,102,91,2,29,1,1
49325,64756,53,60471,53,allow,195,102,93,2,30,1,1
49326,55487,53,48616,53,allow,199,102,97,2,29,1,1
49327,41813,443,58792,443,allow,33072,3479,29593,71,98,38,33
49328,55639,53,39796,53,allow,292,102,190,2,29,1,1
49329,65374,443,10199,443,allow,629017,29841,599176,758,162,331,427
49330,55762,53,29389,53,allow,249,94,155,2,29,1,1
49331,43460,80,58949,80,allow,23394,1667,21727,38,18,20,18
49332,56834,53,24622,53,allow,178,94,84,2,29,1,1
49333,64538,53,8098,53,allow,194,102,92,2,29,1,1
49334,60716,443,27537,443,allow,31452,6667,24785,54,32,29,25
49335,53252,443,33448,443,allow,41435,6615,34820,85,193,46,39
49336,35517,443,27389,443,allow,130,70,60,3,5,2,1
49337,40242,443,42973,443,allow,7407,2516,4891,37,32,19,18
49338,49282,53,14515,53,allow,178,94,84,2,30,1,1
49339,55379,53,3403,53,allow,358,102,256,2,30,1,1
49340,56679,53,5371,53,allow,216,102,114,2,30,1,1
49341,64756,53,21500,53,allow,195,102,93,2,30,1,1
49342,56424,53,14436,53,allow,306,94,212,2,30,1,1
49343,27005,4444,11098,4444,allow,881,126,755,2,30,1,1
49344,53864,443,31491,443,allow,3124,1556,1568,21,275,11,10
49345,65373,443,38852,443,allow,3104883,106687,2998196,3406,190,1320,2086
49346,49225,53,32550,53,allow,295,101,194,4,49,2,2
49347,49323,53,9705,53,allow,210,110,100,2,30,1,1
49348,54511,53,42780,53,allow,304,86,218,2,30,1,1
49349,49601,53,32118,53,allow,178,94,84,2,30,1,1
49350,64756,53,35378,53,allow,195,102,93,2,30,1,1
49351,65083,53,18755,53,allow,198,94,104,2,30,1,1
49352,49631,53,32416,53,allow,323,102,221,2,30,1,1
49353,44037,5223,40215,5223,allow,5096,1030,4066,25,1751,9,16
49354,33409,53,54982,53,allow,79268,76966,2302,936,88,923,13
49355,27005,27015,38552,27015,allow,876,126,750,2,31,1,1
49356,63822,14382,65355,14382,allow,66,66,0,2,8,2,0
49357,54322,443,16940,443,allow,14649,11393,3256,49,99,22,27
49358,27005,27015,18205,27015,allow,888,126,762,3,32,2,1
49359,27005,27016,42584,27016,allow,1010,252,758,4,33,3,1
49360,37576,443,21717,443,allow,11777,4005,7772,35,44,15,20
49361,53124,52917,46926,52917,allow,70,70,0,2,8,2,0
49362,56538,443,26463,443,allow,8490,2953,5537,27,569,15,12
49363,63263,57470,0,0,deny,66,66,0,1,0,1,0
49364,60312,57470,0,0,deny,74,74,0,1,0,1,0
49365,54564,445,0,0,drop,70,70,0,1,0,1,0
49366,54922,445,0,0,drop,66,66,0,1,0,1,0
49367,34422,64147,0,0,deny,145,145,0,1,0,1,0
49368,10427,50584,0,0,deny,146,146,0,1,0,1,0
49369,27641,39004,0,0,deny,62,62,0,1,0,1,0
49370,58497,39004,0,0,deny,66,66,0,1,0,1,0
49371,54560,445,0,0,drop,70,70,0,1,0,1,0
49372,54559,445,0,0,drop,70,70,0,1,0,1,0
49373,5729,22114,0,0,deny,62,62,0,1,0,1,0
49374,59524,445,0,0,drop,70,70,0,1,0,1,0
49375,59526,445,0,0,drop,70,70,0,1,0,1,0
49376,59523,445,0,0,drop,70,70,0,1,0,1,0
49377,54903,445,0,0,drop,66,66,0,1,0,1,0
49378,54906,445,0,0,drop,66,66,0,1,0,1,0
49379,54909,445,0,0,drop,66,66,0,1,0,1,0
49380,54910,445,0,0,drop,66,66,0,1,0,1,0
49381,54905,445,0,0,drop,66,66,0,1,0,1,0
49382,54904,445,0,0,drop,66,66,0,1,0,1,0
49383,54908,445,0,0,drop,66,66,0,1,0,1,0
49384,54902,445,0,0,drop,66,66,0,1,0,1,0
49385,42732,57470,0,0,deny,62,62,0,1,0,1,0
49386,54554,445,0,0,drop,70,70,0,1,0,1,0
49387,59518,445,0,0,drop,70,70,0,1,0,1,0
49388,59514,445,0,0,drop,70,70,0,1,0,1,0
49389,59507,445,0,0,drop,70,70,0,1,0,1,0
49390,52459,5555,0,0,deny,60,60,0,1,0,1,0
49391,53835,62413,0,0,deny,146,146,0,1,0,1,0
49392,45060,37965,0,0,deny,62,62,0,1,0,1,0
49393,6999,11119,0,0,deny,143,143,0,1,0,1,0
49394,54888,445,0,0,drop,66,66,0,1,0,1,0
49395,54889,445,0,0,drop,66,66,0,1,0,1,0
49396,54887,445,0,0,drop,66,66,0,1,0,1,0
49397,43916,21,0,0,deny,60,60,0,1,0,1,0
49398,59506,445,0,0,drop,70,70,0,1,0,1,0
49399,37988,64147,0,0,deny,66,66,0,1,0,1,0
49400,1080,8391,0,0,deny,66,66,0,1,0,1,0
49401,54541,445,0,0,drop,70,70,0,1,0,1,0
49402,58213,37807,0,0,deny,66,66,0,1,0,1,0
49403,59504,445,0,0,drop,70,70,0,1,0,1,0
49404,64379,37965,0,0,deny,66,66,0,1,0,1,0
49405,44849,46478,0,0,deny,74,74,0,1,0,1,0
49406,59502,445,0,0,drop,70,70,0,1,0,1,0
49407,59500,445,0,0,drop,70,70,0,1,0,1,0
49408,59498,445,0,0,drop,70,70,0,1,0,1,0
49409,54538,445,0,0,drop,70,70,0,1,0,1,0
49410,57410,37965,0,0,deny,66,66,0,1,0,1,0
49411,56544,443,50945,443,allow,3413,1537,1876,19,7,10,9
49412,63998,21247,0,0,deny,62,62,0,1,0,1,0
49413,58681,36829,0,0,deny,70,70,0,1,0,1,0
49414,59696,57470,0,0,deny,62,62,0,1,0,1,0
49415,46670,51505,0,0,deny,62,62,0,1,0,1,0
49416,50914,51505,0,0,deny,66,66,0,1,0,1,0
49417,60550,50584,0,0,deny,146,146,0,1,0,1,0
49418,6572,23,0,0,deny,60,60,0,1,0,1,0
49419,54533,445,0,0,drop,70,70,0,1,0,1,0
49420,54532,445,0,0,drop,70,70,0,1,0,1,0
49421,59486,445,0,0,drop,70,70,0,1,0,1,0
49422,59481,445,0,0,drop,70,70,0,1,0,1,0
49423,59482,445,0,0,drop,70,70,0,1,0,1,0
49424,54530,445,0,0,drop,70,70,0,1,0,1,0
49425,57982,64147,0,0,deny,66,66,0,1,0,1,0
49426,20108,64147,0,0,deny,66,66,0,1,0,1,0
49427,56440,56205,0,0,deny,62,62,0,1,0,1,0
49428,59994,11446,0,0,deny,66,66,0,1,0,1,0
49429,64878,26467,0,0,deny,62,62,0,1,0,1,0
49430,1162,57470,0,0,deny,62,62,0,1,0,1,0
49431,54523,445,0,0,drop,70,70,0,1,0,1,0
49432,54867,445,0,0,drop,66,66,0,1,0,1,0
49433,58226,52848,0,0,deny,145,145,0,1,0,1,0
49434,59478,445,0,0,drop,70,70,0,1,0,1,0
49435,59476,445,0,0,drop,70,70,0,1,0,1,0
49436,60627,51050,0,0,deny,62,62,0,1,0,1,0
49437,54521,445,0,0,drop,70,70,0,1,0,1,0
49438,22714,30188,0,0,deny,62,62,0,1,0,1,0
49439,54520,445,0,0,drop,70,70,0,1,0,1,0
49440,46901,26672,0,0,deny,60,60,0,1,0,1,0
49441,54519,445,0,0,drop,70,70,0,1,0,1,0
49442,54518,445,0,0,drop,70,70,0,1,0,1,0
49443,50227,57470,0,0,deny,62,62,0,1,0,1,0
49444,54516,445,0,0,drop,70,70,0,1,0,1,0
49445,54860,445,0,0,drop,66,66,0,1,0,1,0
49446,54858,445,0,0,drop,66,66,0,1,0,1,0
49447,59465,445,0,0,drop,70,70,0,1,0,1,0
49448,59459,445,0,0,drop,70,70,0,1,0,1,0
49449,59456,445,0,0,drop,70,70,0,1,0,1,0
49450,59454,445,0,0,drop,70,70,0,1,0,1,0
49451,54500,445,0,0,drop,70,70,0,1,0,1,0
49452,54855,445,0,0,drop,66,66,0,1,0,1,0
49453,54499,445,0,0,drop,70,70,0,1,0,1,0
49454,54497,445,0,0,drop,70,70,0,1,0,1,0
49455,14252,35993,0,0,deny,66,66,0,1,0,1,0
49456,54490,445,0,0,drop,70,70,0,1,0,1,0
49457,54489,445,0,0,drop,70,70,0,1,0,1,0
49458,57470,54343,65136,54343,allow,330,330,0,6,1200,6,0
49459,62888,53,0,0,allow,193,78,115,2,30,1,1
49460,38602,443,28302,443,allow,130,70,60,3,5,2,1
49461,26461,80,26461,80,allow,490,264,226,8,32,5,3
49462,53142,443,26091,443,allow,4962,887,4075,15,28,9,6
49463,51216,443,25956,443,allow,4540,1056,3484,19,17,11,8
49464,29647,53,29647,53,allow,197,76,121,2,30,1,1
49465,37751,53,37751,53,allow,194,87,107,2,30,1,1
49466,47595,33435,0,0,allow,106,106,0,1,60,1,0
49467,27005,27015,19502,27015,allow,880,126,754,2,30,1,1
49468,49907,443,59724,443,allow,5895,728,5167,16,47,8,8
49469,57598,80,57598,80,allow,1810,821,989,10,20,6,4
49470,57286,443,36985,443,allow,134,60,74,3,10,2,1
49471,26458,80,26458,80,allow,490,264,226,8,32,5,3
49472,27005,27017,57092,27017,allow,900,126,774,2,30,1,1
49473,63955,53,0,0,allow,219,81,138,2,30,1,1
49474,38914,80,38914,80,allow,2993,1469,1524,13,20,8,5
49475,26459,80,26459,80,allow,490,264,226,8,32,5,3
49476,26449,80,26449,80,allow,642,338,304,10,33,6,4
49477,63804,52520,44580,52520,allow,66,66,0,1,5,1,0
49478,60410,18359,27575,18359,allow,1759,820,939,18,16,8,10
49479,53016,443,53016,443,allow,4787,1880,2907,19,27,11,8
49480,49902,443,13295,443,allow,7456,1591,5865,32,54,15,17
49481,50668,443,5052,443,allow,2881,642,2239,13,135,6,7
49482,43809,443,45485,443,allow,9842,2961,6881,31,19,16,15
49483,26460,80,26460,80,allow,490,264,226,8,32,5,3
49484,51213,443,22292,443,allow,6333,2018,4315,25,17,15,10
49485,34672,53,34672,53,allow,213,87,126,2,30,1,1
49486,38947,443,49748,443,allow,16499,9522,6977,44,364,22,22
49487,53143,443,21953,443,allow,4962,887,4075,15,28,9,6
49488,38795,40042,2140,40042,allow,142,80,62,2,31,1,1
49489,62005,80,62005,80,allow,11822,1162,10660,22,20,11,11
49490,60393,443,18640,443,allow,3371,2029,1342,16,360,8,8
49491,41405,443,41405,443,allow,4565,1658,2907,19,29,11,8
49492,56793,14902,9937,14902,allow,264,70,194,4,19,1,3
49493,64785,80,45125,80,allow,2107,1131,976,13,97,7,6
49494,64776,80,31533,80,allow,4502,1072,3430,15,98,7,8
49495,63803,41439,24865,41439,allow,66,66,0,1,5,1,0
49496,50667,80,50667,80,allow,15686,1227,14459,24,20,11,13
49497,49742,80,32579,80,allow,103346,1476,101870,87,17,16,71
49498,58131,53,58131,53,allow,194,87,107,2,30,1,1
49499,64779,80,26888,80,allow,82972,2084,80888,85,98,26,59
49500,49906,443,34595,443,allow,159116,5586,153530,191,47,77,114
49501,27005,27015,17073,27015,allow,886,126,760,2,30,1,1
49502,26452,80,26452,80,allow,642,338,304,10,33,6,4
49503,53822,80,58040,80,allow,1655,1341,314,10,15,5,5
49504,56532,443,17749,443,allow,8381,2848,5533,26,572,14,12
49505,27471,53,27471,53,allow,237,91,146,2,32,1,1
49506,47050,443,20550,443,allow,10868,2200,8668,32,44,14,18
49507,26462,80,26462,80,allow,490,264,226,8,32,5,3
49508,49744,80,34902,80,allow,1111,749,362,9,15,5,4
49509,40146,53,0,0,allow,300,86,214,2,30,1,1
49510,1575,53,0,0,allow,254,86,168,2,30,1,1
49511,50284,80,36535,80,allow,8269,1423,6846,20,75,10,10
49512,38350,80,18584,80,allow,1678,1364,314,10,16,5,5
49513,63955,53,0,0,allow,219,81,138,2,30,1,1
49514,64790,443,44733,443,allow,15810,7525,8285,35,97,18,17
49515,27005,27015,42167,27015,allow,869,126,743,2,30,1,1
49516,64799,443,56278,443,allow,1671,1004,667,16,76,8,8
49517,33923,443,55200,443,allow,4472,1666,2806,13,121,6,7
49518,51509,24855,0,0,allow,66,66,0,1,90,1,0
49519,57869,443,47551,443,allow,11947,2436,9511,19,121,9,10
49520,57679,443,27474,443,allow,6568,2770,3798,20,121,10,10
49521,48817,51634,48817,51634,allow,480,149,331,2,1200,1,1
49522,25085,30188,0,0,deny,62,62,0,1,0,1,0
49523,63724,23,0,0,deny,60,60,0,1,0,1,0
49524,45964,3111,0,0,deny,60,60,0,1,0,1,0
49525,59449,445,0,0,drop,70,70,0,1,0,1,0
49526,59448,445,0,0,drop,70,70,0,1,0,1,0
49527,59447,445,0,0,drop,70,70,0,1,0,1,0
49528,59444,445,0,0,drop,70,70,0,1,0,1,0
49529,54849,445,0,0,drop,66,66,0,1,0,1,0
49530,54845,445,0,0,drop,66,66,0,1,0,1,0
49531,54844,445,0,0,drop,66,66,0,1,0,1,0
49532,54846,445,0,0,drop,66,66,0,1,0,1,0
49533,33706,23,0,0,deny,60,60,0,1,0,1,0
49534,55440,443,52938,443,allow,6622,859,5763,18,15,10,8
49535,51209,443,1552,443,allow,11983,2674,9309,51,17,29,22
49536,64797,53,45567,53,allow,216,102,114,2,30,1,1
49537,54638,36829,0,0,deny,146,146,0,1,0,1,0
49538,41025,38191,0,0,deny,157,157,0,1,0,1,0
49539,53043,51050,0,0,deny,66,66,0,1,0,1,0
49540,54839,445,0,0,drop,66,66,0,1,0,1,0
49541,54838,445,0,0,drop,66,66,0,1,0,1,0
49542,54837,445,0,0,drop,66,66,0,1,0,1,0
49543,54478,445,0,0,drop,70,70,0,1,0,1,0
49544,58022,8080,0,0,deny,60,60,0,1,0,1,0
49545,51197,57470,0,0,deny,66,66,0,1,0,1,0
49546,52526,30188,0,0,deny,66,66,0,1,0,1,0
49547,34731,22114,0,0,deny,62,62,0,1,0,1,0
49548,60970,20541,0,0,deny,66,66,0,1,0,1,0
49549,59442,445,0,0,drop,70,70,0,1,0,1,0
49550,59440,445,0,0,drop,70,70,0,1,0,1,0
49551,10166,44847,0,0,deny,62,62,0,1,0,1,0
49552,57860,51505,0,0,deny,62,62,0,1,0,1,0
49553,54832,445,0,0,drop,66,66,0,1,0,1,0
49554,59435,445,0,0,drop,70,70,0,1,0,1,0
49555,51742,30317,0,0,deny,66,66,0,1,0,1,0
49556,54830,445,0,0,drop,66,66,0,1,0,1,0
49557,54472,445,0,0,drop,70,70,0,1,0,1,0
49558,54829,445,0,0,drop,66,66,0,1,0,1,0
49559,54827,445,0,0,drop,66,66,0,1,0,1,0
49560,54826,445,0,0,drop,66,66,0,1,0,1,0
49561,61808,18375,0,0,deny,66,66,0,1,0,1,0
49562,54463,445,0,0,drop,70,70,0,1,0,1,0
49563,54461,445,0,0,drop,70,70,0,1,0,1,0
49564,54458,445,0,0,drop,70,70,0,1,0,1,0
49565,54457,445,0,0,drop,70,70,0,1,0,1,0
49566,54455,445,0,0,drop,70,70,0,1,0,1,0
49567,43584,26543,0,0,deny,156,156,0,1,0,1,0
49568,32071,51221,0,0,deny,62,62,0,1,0,1,0
49569,53928,15503,0,0,deny,62,62,0,1,0,1,0
49570,59430,445,0,0,drop,70,70,0,1,0,1,0
49571,62011,57354,0,0,deny,159,159,0,1,0,1,0
49572,59422,445,0,0,drop,70,70,0,1,0,1,0
49573,59423,445,0,0,drop,70,70,0,1,0,1,0
49574,34348,22114,0,0,deny,62,62,0,1,0,1,0
49575,1694,30188,0,0,deny,62,62,0,1,0,1,0
49576,64294,64147,0,0,deny,146,146,0,1,0,1,0
49577,54817,445,0,0,drop,66,66,0,1,0,1,0
49578,59745,53635,0,0,deny,66,66,0,1,0,1,0
49579,30179,57470,0,0,deny,60,60,0,1,0,1,0
49580,31384,56205,0,0,deny,62,62,0,1,0,1,0
49581,54450,445,0,0,drop,70,70,0,1,0,1,0
49582,28624,23,0,0,deny,60,60,0,1,0,1,0
49583,59210,8168,0,0,deny,66,66,0,1,0,1,0
49584,45472,8168,0,0,deny,62,62,0,1,0,1,0
49585,45155,53,0,0,allow,226,86,140,2,29,1,1
49586,54775,443,18687,443,allow,12150,2950,9200,35,341,17,18
49587,26448,80,26448,80,allow,642,338,304,10,32,6,4
49588,26451,80,26451,80,allow,642,338,304,10,32,6,4
49589,64571,443,18253,443,allow,9155,2109,7046,27,31,15,12
49590,54525,443,38089,443,allow,3766,1654,2112,10,120,5,5
49591,49637,53,40941,53,allow,255,102,153,2,30,1,1
49592,26450,80,26450,80,allow,642,338,304,10,32,6,4
49593,56539,443,36962,443,allow,8335,2802,5533,26,567,14,12
49594,60758,40010,38736,40010,allow,316,136,180,6,5,3,3
49595,55117,443,14752,443,allow,1350,689,661,14,18,8,6
49596,39599,443,45420,443,allow,1352,691,661,14,18,8,6
49597,39597,443,19827,443,allow,1350,689,661,14,18,8,6
49598,56826,53,57035,53,allow,94,94,0,1,29,1,0
49599,64288,53,63361,53,allow,229,110,119,2,29,1,1
49600,64937,53,3891,53,allow,360,118,242,2,30,1,1
49601,65263,53,26647,53,allow,356,88,268,4,55,2,2
49602,57886,53,57886,53,allow,216,90,126,2,29,1,1
49603,55437,443,17546,443,allow,6622,859,5763,18,15,10,8
49604,42954,443,44795,443,allow,6813,2515,4298,30,58,16,14
49605,55984,53,2333,53,allow,216,102,114,2,30,1,1
49606,62122,53,41697,53,allow,179,86,93,2,30,1,1
49607,50863,443,18214,443,allow,1501,590,911,12,26,6,6
49608,56808,54393,38896,54393,allow,70,70,0,1,5,1,0
49609,55438,443,39653,443,allow,6686,923,5763,19,15,11,8
49610,64793,80,12166,80,allow,508,256,252,9,77,5,4
49611,51206,443,30642,443,allow,12274,2677,9597,51,17,29,22
49612,51698,80,35267,80,allow,15609,1298,14311,26,75,14,12
49613,49504,443,14991,443,allow,18746,2976,15770,32,32,12,20
49614,42286,443,57060,443,allow,6021,1249,4772,20,23,11,9
49615,33446,80,33446,80,allow,1753,833,920,10,20,6,4
49616,45963,443,45963,443,allow,4592,1685,2907,19,27,11,8
49617,49903,443,42458,443,allow,8078,1511,6567,30,54,14,16
49618,56585,443,49312,443,allow,7157,2183,4974,22,16,12,10
49619,56599,53,21288,53,allow,258,110,148,2,30,1,1
49620,27005,27015,45773,27015,allow,899,126,773,2,30,1,1
49621,42286,5228,46877,5228,allow,3489,1598,1891,25,631,7,18
49622,54664,443,62017,443,allow,175780,7700,168080,196,36,78,118
49623,60769,443,3938,443,allow,7639,2051,5588,33,120,17,16
49624,50862,443,25283,443,allow,1501,590,911,12,26,6,6
49625,64767,80,54344,80,allow,3199,988,2211,14,99,7,7
49626,49743,80,24003,80,allow,2981,473,2508,9,16,5,4
49627,63800,80,60637,80,allow,314,192,122,6,15,4,2
49628,51939,80,10449,80,allow,103732,4081,99651,128,61,55,73
49629,53077,80,56021,80,allow,1352,625,727,8,75,5,3
49630,49744,53,4877,53,allow,211,102,109,2,30,1,1
49631,56529,443,43021,443,allow,266757,6935,259822,274,19,97,177
49632,60896,443,6271,443,allow,14819,8197,6622,47,45,26,21
49633,38554,443,64744,443,allow,5021,1030,3991,16,30,9,7
49634,56819,37372,7815,37372,allow,70,70,0,1,5,1,0
49635,49741,80,28243,80,allow,1149,412,737,8,17,5,3
49636,55525,53,40797,53,allow,210,102,108,2,30,1,1
49637,57470,51413,59920,51413,allow,528,528,0,9,1199,9,0
49638,42465,443,2367,443,allow,4885,895,3990,16,29,9,7
49639,51205,443,62572,443,allow,8857,2827,6030,52,17,29,23
49640,55115,443,23390,443,allow,1348,687,661,14,18,8,6
49641,47795,443,48531,443,allow,8708,3949,4759,22,21,11,11
49642,39303,80,19010,80,allow,3198,1493,1705,18,80,11,7
49643,61686,80,38395,80,allow,4004,1513,2491,20,47,10,10
49644,63823,51558,34606,51558,allow,66,66,0,2,7,2,0
49645,56623,80,56144,80,allow,234,234,0,4,12,4,0
49646,63953,53,20506,53,allow,426,89,337,4,49,2,2
49647,51207,443,64631,443,allow,12171,2763,9408,53,17,30,23
49648,64800,80,8529,80,allow,508,256,252,9,75,5,4
49649,49917,443,56620,443,allow,5899,732,5167,16,41,8,8
49650,57198,80,57198,80,allow,6738,909,5829,14,20,7,7
49651,49912,443,43170,443,allow,2048821,56490,1992331,2082,44,522,1560
49652,63729,80,63729,80,allow,7324,1017,6307,16,20,8,8
49653,57909,80,57909,80,allow,2648,921,1727,12,20,7,5
49654,55444,443,64554,443,allow,13284,3562,9722,38,26,21,17
49655,55627,26192,42431,26192,allow,70,70,0,2,8,2,0
49656,51167,80,51167,80,allow,1502,817,685,10,20,6,4
49657,60641,443,61674,443,allow,34758,2573,32185,50,320,21,29
49658,52491,53,62857,53,allow,289,86,203,2,30,1,1
49659,53613,11309,52250,11309,allow,492,306,186,8,16,5,3
49660,47732,80,47732,80,allow,9621,1618,8003,19,20,10,9
49661,37902,123,60994,123,allow,184,94,90,2,30,1,1
49662,59792,80,59792,80,allow,33435,1694,31741,43,20,18,25
49663,27005,27013,56795,27013,allow,879,126,753,2,30,1,1
49664,60314,80,12778,80,allow,1498,539,959,10,77,6,4
49665,60890,443,16222,443,allow,5089,4217,872,23,47,13,10
49666,51407,443,40522,443,allow,25490,8419,17071,54,48,30,24
49667,51211,443,40776,443,allow,7638,2405,5233,44,17,25,19
49668,52076,443,51633,443,allow,24299,8382,15917,69,93,35,34
49669,55626,63805,65310,63805,allow,70,70,0,2,8,2,0
49670,51941,80,19964,80,allow,82496,3881,78615,104,61,47,57
49671,51938,80,6039,80,allow,82321,4061,78260,109,61,50,59
49672,51940,80,62105,80,allow,278312,9722,268590,323,61,135,188
49673,38922,80,38922,80,allow,20984,1380,19604,34,15,18,16
49674,27005,27015,48788,27015,allow,913,126,787,2,30,1,1
49675,65320,53,12285,53,allow,227,110,117,2,30,1,1
49676,50861,443,62102,443,allow,1501,590,911,12,26,6,6
49677,51210,443,30801,443,allow,8248,2460,5788,45,17,26,19
49678,49905,80,54689,80,allow,1173,672,501,8,31,5,3
49679,55617,53,58686,53,allow,196,94,102,2,30,1,1
49680,28699,53,53419,53,allow,278,86,192,2,30,1,1
49681,64232,53,50382,53,allow,258,110,148,2,30,1,1
49682,49928,53,15390,53,allow,243,102,141,2,30,1,1
49683,44847,2499,58207,2499,allow,502,150,352,2,1200,1,1
49684,55877,56036,49566,56036,allow,469,150,319,2,1200,1,1
49685,6882,42505,24055,42505,allow,207,118,89,2,1200,1,1
49686,48337,443,44874,443,allow,227876,8050,219826,236,36,83,153
49687,51208,443,57276,443,allow,8886,2767,6119,52,17,28,24
49688,51422,3027,51422,3027,allow,156,156,0,3,8,3,0
49689,56586,443,35077,443,allow,7110,2183,4927,22,16,12,10
49690,46653,443,4259,443,allow,4037,1058,2979,12,120,6,6
49691,47388,443,44848,443,allow,2897,728,2169,10,121,5,5
49692,57314,443,14727,443,allow,134,60,74,3,6,2,1
49693,57310,443,42139,443,allow,134,60,74,3,6,2,1
49694,63817,50808,9849,50808,allow,66,66,0,2,8,2,0
49695,49534,80,31376,80,allow,1702,611,1091,8,30,4,4
49696,65474,53,12902,53,allow,198,94,104,2,30,1,1
49697,57311,443,59894,443,allow,134,60,74,3,6,2,1
49698,57309,443,42080,443,allow,134,60,74,3,6,2,1
49699,63731,26467,0,0,deny,66,66,0,1,0,1,0
49700,6881,6881,0,0,deny,146,146,0,1,0,1,0
49701,54807,445,0,0,drop,66,66,0,1,0,1,0
49702,59407,445,0,0,drop,70,70,0,1,0,1,0
49703,54442,445,0,0,drop,70,70,0,1,0,1,0
49704,60602,15503,0,0,deny,62,62,0,1,0,1,0
49705,54440,445,0,0,drop,70,70,0,1,0,1,0
49706,54804,445,0,0,drop,66,66,0,1,0,1,0
49707,51620,56205,0,0,deny,66,66,0,1,0,1,0
49708,41447,64147,0,0,deny,62,62,0,1,0,1,0
49709,51996,35440,0,0,deny,66,66,0,1,0,1,0
49710,51424,30188,0,0,deny,66,66,0,1,0,1,0
49711,54436,445,0,0,drop,70,70,0,1,0,1,0
49712,54434,445,0,0,drop,70,70,0,1,0,1,0
49713,54797,445,0,0,drop,66,66,0,1,0,1,0
49714,64240,50584,0,0,deny,66,66,0,1,0,1,0
49715,54794,445,0,0,drop,66,66,0,1,0,1,0
49716,28839,30188,0,0,deny,146,146,0,1,0,1,0
49717,60000,80,0,0,deny,60,60,0,1,0,1,0
49718,54858,51505,0,0,deny,66,66,0,1,0,1,0
49719,65068,23,0,0,deny,60,60,0,1,0,1,0
49720,45941,23386,0,0,deny,60,60,0,1,0,1,0
49721,54997,26467,0,0,deny,62,62,0,1,0,1,0
49722,54430,445,0,0,drop,70,70,0,1,0,1,0
49723,17811,23,0,0,deny,60,60,0,1,0,1,0
49724,54429,445,0,0,drop,70,70,0,1,0,1,0
49725,55986,26467,0,0,deny,66,66,0,1,0,1,0
49726,1070,26467,0,0,deny,62,62,0,1,0,1,0
49727,1026,57866,0,0,deny,146,146,0,1,0,1,0
49728,64940,26467,0,0,deny,62,62,0,1,0,1,0
49729,59397,445,0,0,drop,70,70,0,1,0,1,0
49730,59396,445,0,0,drop,70,70,0,1,0,1,0
49731,59395,445,0,0,drop,70,70,0,1,0,1,0
49732,5664,36237,0,0,deny,66,66,0,1,0,1,0
49733,17873,23117,0,0,deny,66,66,0,1,0,1,0
49734,54780,445,0,0,drop,66,66,0,1,0,1,0
49735,54776,445,0,0,drop,66,66,0,1,0,1,0
49736,54779,445,0,0,drop,66,66,0,1,0,1,0
49737,54781,445,0,0,drop,66,66,0,1,0,1,0
49738,54782,445,0,0,drop,66,66,0,1,0,1,0
49739,54774,445,0,0,drop,66,66,0,1,0,1,0
49740,54778,445,0,0,drop,66,66,0,1,0,1,0
49741,54775,445,0,0,drop,66,66,0,1,0,1,0
49742,15922,44847,0,0,deny,66,66,0,1,0,1,0
49743,54424,445,0,0,drop,70,70,0,1,0,1,0
49744,57853,64147,0,0,deny,66,66,0,1,0,1,0
49745,52741,24211,0,0,deny,66,66,0,1,0,1,0
49746,57339,50584,0,0,deny,62,62,0,1,0,1,0
49747,60129,55442,0,0,deny,66,66,0,1,0,1,0
49748,52699,26467,0,0,deny,62,62,0,1,0,1,0
49749,8239,37965,0,0,deny,146,146,0,1,0,1,0
49750,1024,64147,0,0,deny,62,62,0,1,0,1,0
49751,53490,62413,0,0,deny,66,66,0,1,0,1,0
49752,58966,30188,0,0,deny,66,66,0,1,0,1,0
49753,59394,445,0,0,drop,70,70,0,1,0,1,0
49754,59389,445,0,0,drop,70,70,0,1,0,1,0
49755,59390,445,0,0,drop,70,70,0,1,0,1,0
49756,51740,37965,0,0,deny,66,66,0,1,0,1,0
49757,443,23133,0,0,deny,97,97,0,1,0,1,0
49758,54760,445,0,0,drop,66,66,0,1,0,1,0
49759,54761,445,0,0,drop,66,66,0,1,0,1,0
49760,54759,445,0,0,drop,66,66,0,1,0,1,0
49761,59377,445,0,0,drop,70,70,0,1,0,1,0
49762,54411,445,0,0,drop,70,70,0,1,0,1,0
49763,43584,24748,0,0,deny,156,156,0,1,0,1,0
49764,43584,24748,0,0,deny,156,156,0,1,0,1,0
49765,59459,37807,0,0,deny,66,66,0,1,0,1,0
49766,43584,24748,0,0,deny,156,156,0,1,0,1,0
49767,42414,50939,0,0,deny,148,148,0,1,0,1,0
49768,43584,24748,0,0,deny,156,156,0,1,0,1,0
49769,43584,24748,0,0,deny,156,156,0,1,0,1,0
49770,49690,50265,0,0,deny,62,62,0,1,0,1,0
49771,13907,57470,0,0,deny,66,66,0,1,0,1,0
49772,43584,24748,0,0,deny,156,156,0,1,0,1,0
49773,59375,445,0,0,drop,70,70,0,1,0,1,0
49774,39524,10104,0,0,deny,137,137,0,1,0,1,0
49775,61457,21247,0,0,deny,62,62,0,1,0,1,0
49776,54408,445,0,0,drop,70,70,0,1,0,1,0
49777,0,0,0,0,deny,156,156,0,2,0,2,0
49778,0,0,0,0,deny,156,156,0,2,0,2,0
49779,0,0,0,0,deny,156,156,0,2,0,2,0
49780,0,0,0,0,deny,156,156,0,2,0,2,0
49781,0,0,0,0,allow,124,64,60,2,0,1,1
49782,0,0,0,0,allow,320,320,0,5,0,5,0
49783,59374,445,0,0,drop,70,70,0,1,0,1,0
49784,59370,445,0,0,drop,70,70,0,1,0,1,0
49785,59373,445,0,0,drop,70,70,0,1,0,1,0
49786,34999,25864,0,0,deny,74,74,0,1,0,1,0
49787,50624,26467,0,0,deny,66,66,0,1,0,1,0
49788,17027,1,0,0,deny,62,62,0,1,0,1,0
49789,56966,35440,0,0,deny,66,66,0,1,0,1,0
49790,60133,1,0,0,deny,66,66,0,1,0,1,0
49791,54742,50584,0,0,deny,66,66,0,1,0,1,0
49792,50419,26467,0,0,deny,66,66,0,1,0,1,0
49793,54403,445,0,0,drop,70,70,0,1,0,1,0
49794,57768,37965,0,0,deny,66,66,0,1,0,1,0
49795,54402,445,0,0,drop,70,70,0,1,0,1,0
49796,54400,445,0,0,drop,70,70,0,1,0,1,0
49797,59358,445,0,0,drop,70,70,0,1,0,1,0
49798,59356,445,0,0,drop,70,70,0,1,0,1,0
49799,59353,445,0,0,drop,70,70,0,1,0,1,0
49800,3803,51505,0,0,deny,66,66,0,1,0,1,0
49801,55600,22,0,0,deny,60,60,0,1,0,1,0
49802,44854,26467,0,0,deny,62,62,0,1,0,1,0
49803,46901,26672,0,0,deny,60,60,0,1,0,1,0
49804,50027,21247,0,0,deny,62,62,0,1,0,1,0
49805,54109,36829,0,0,deny,62,62,0,1,0,1,0
49806,6889,45850,0,0,reset-both,143,143,0,1,0,1,0
49807,54393,445,0,0,drop,70,70,0,1,0,1,0
49808,35843,51505,0,0,deny,146,146,0,1,0,1,0
49809,52076,44847,0,0,deny,62,62,0,1,0,1,0
49810,54391,445,0,0,drop,70,70,0,1,0,1,0
49811,54739,445,0,0,drop,66,66,0,1,0,1,0
49812,45964,2666,0,0,deny,60,60,0,1,0,1,0
49813,49677,64147,0,0,deny,62,62,0,1,0,1,0
49814,59350,445,0,0,drop,70,70,0,1,0,1,0
49815,59347,445,0,0,drop,70,70,0,1,0,1,0
49816,1046,48817,0,0,deny,62,62,0,1,0,1,0
49817,54786,30188,0,0,deny,66,66,0,1,0,1,0
49818,54390,445,0,0,drop,70,70,0,1,0,1,0
49819,49497,443,3660,443,allow,8816,4876,3940,23,31,12,11
49820,50987,10086,44124,10086,allow,217,157,60,2,5,1,1
49821,51540,3389,51540,3389,allow,4425,2641,1784,21,33,12,9
49822,35356,53,0,0,allow,82,82,0,1,30,1,0
49823,41028,80,41028,80,allow,100182,8294,91888,137,127,69,68
49824,33992,53,33992,53,allow,79,79,0,1,30,1,0
49825,53017,80,53017,80,allow,184725,5028,179697,217,25,75,142
49826,53019,80,53019,80,allow,181759,5146,176613,216,25,77,139
49827,53298,443,6587,443,allow,5601,1187,4414,24,80,13,11
49828,44960,80,44960,80,allow,4372,2093,2279,16,19,10,6
49829,12677,53,12677,53,allow,234,93,141,2,30,1,1
49830,33992,53,33992,53,allow,462,158,304,4,30,2,2
49831,27005,27015,49303,27015,allow,868,126,742,2,30,1,1
49832,54405,53,0,0,allow,174,79,95,2,30,1,1
49833,38038,443,62435,443,allow,6180,3550,2630,27,272,13,14
49834,65410,443,49825,443,allow,2494,1643,851,17,25,9,8
49835,34245,443,35232,443,allow,11441,6765,4676,40,792,19,21
49836,51221,52423,24107,52423,allow,322,149,173,2,1201,1,1
49837,15503,3082,40195,3082,allow,480,149,331,2,1200,1,1
49838,39213,443,39213,443,allow,4378,1471,2907,19,29,11,8
49839,53020,80,53020,80,allow,134273,4066,130207,163,22,59,104
49840,37965,51413,23143,51413,allow,2020,1090,930,18,1200,15,3
49841,50116,22,50116,22,allow,184,120,64,4,10,3,1
49842,49290,443,20906,443,allow,1629306,22920,1606386,1339,116,262,1077
49843,54998,80,32299,80,allow,2814,2440,374,13,16,7,6
49844,23397,53,23397,53,allow,234,93,141,2,30,1,1
49845,34028,443,55750,443,allow,7804,2108,5696,24,32,14,10
49846,53640,28937,48559,28937,allow,70,70,0,2,8,2,0
49847,58714,53,58714,53,allow,197,76,121,2,30,1,1
49848,52280,995,52280,995,allow,142,78,64,2,5,1,1
49849,57470,29500,37295,29500,allow,2772,2772,0,43,2311,43,0
49850,50584,19051,19819,19051,allow,300,300,0,3,1200,3,0
49851,65286,3389,65286,3389,allow,3424,1710,1714,16,31,8,8
49852,53297,443,55944,443,allow,5600,1187,4413,24,80,13,11
49853,53018,80,53018,80,allow,182677,4908,177769,213,25,73,140
49854,60418,39537,32602,39537,allow,70,70,0,2,8,2,0
49855,10101,443,13897,443,allow,7563,1536,6027,26,316,14,12
49856,49624,443,56067,443,allow,6440,1965,4475,22,36,12,10
49857,27005,27017,63290,27017,allow,917,126,791,2,30,1,1
49858,27005,27015,7639,27015,allow,919,126,793,2,30,1,1
49859,50584,12948,3713,12948,allow,346,161,185,2,1200,1,1
49860,46573,50584,0,0,deny,66,66,0,1,0,1,0
49861,52633,30188,0,0,deny,66,66,0,1,0,1,0
49862,39313,37965,0,0,deny,62,62,0,1,0,1,0
49863,54389,445,0,0,drop,70,70,0,1,0,1,0
49864,54388,445,0,0,drop,70,70,0,1,0,1,0
49865,53770,64147,0,0,deny,66,66,0,1,0,1,0
49866,54386,445,0,0,drop,70,70,0,1,0,1,0
49867,54385,445,0,0,drop,70,70,0,1,0,1,0
49868,40082,2222,0,0,deny,60,60,0,1,0,1,0
49869,1025,35447,0,0,deny,62,62,0,1,0,1,0
49870,45908,33330,0,0,deny,60,60,0,1,0,1,0
49871,54731,445,0,0,drop,66,66,0,1,0,1,0
49872,65476,443,36901,443,allow,93073,4939,88134,111,16,45,66
49873,52286,995,52286,995,allow,146,82,64,2,5,1,1
49874,37965,30982,7359,30982,allow,528,528,0,9,1199,9,0
49875,55746,53,18233,53,allow,302,84,218,4,46,2,2
49876,43757,3389,43757,3389,allow,3910,1805,2105,20,18,12,8
49877,64326,53,53148,53,allow,323,107,216,4,38,2,2
49878,57315,443,25232,443,allow,134,60,74,3,5,2,1
49879,64723,53,23544,53,allow,677,198,479,6,68,3,3
49880,56476,53,63647,53,allow,239,94,145,2,30,1,1
49881,59470,443,18542,443,allow,3726,688,3038,14,119,7,7
49882,33811,443,49179,443,allow,17406,8237,9169,53,165,21,32
49883,50840,80,15901,80,allow,268155,6485,261670,281,25,97,184
49884,56276,443,43498,443,allow,71414,17145,54269,194,292,91,103
49885,63820,27441,36322,27441,allow,66,66,0,2,7,2,0
49886,40165,443,53877,443,allow,232,172,60,3,5,2,1
49887,65207,443,12429,443,allow,8188,2769,5419,22,611,12,10
49888,63819,18445,64902,18445,allow,66,66,0,2,7,2,0
49889,35357,53,47462,53,allow,291,86,205,2,29,1,1
49890,50977,80,13754,80,allow,45483,4137,41346,68,21,36,32
49891,50975,80,19286,80,allow,24781,3304,21477,43,21,24,19
49892,61674,443,44305,443,allow,6117,1224,4893,21,50,12,9
49893,56596,53,31877,53,allow,350,94,256,2,30,1,1
49894,63816,2073,29145,2073,allow,66,66,0,2,7,2,0
49895,64494,53,52141,53,allow,337,110,227,2,29,1,1
49896,57312,443,4774,443,allow,134,60,74,3,5,2,1
49897,27005,27015,22389,27015,allow,879,126,753,2,30,1,1
49898,48817,10528,48817,10528,allow,2736,1992,744,37,1580,25,12
49899,50584,8622,56694,8622,allow,166,166,0,1,1200,1,0
49900,49501,443,9020,443,allow,15456,2581,12875,28,31,10,18
49901,49475,53,49996,53,allow,243,110,133,2,30,1,1
49902,34922,443,21368,443,allow,8093,2068,6025,23,360,11,12
49903,60715,443,1663,443,allow,1716,1136,580,15,30,9,6
49904,56441,80,25376,80,allow,130,70,60,2,15,1,1
49905,51981,80,47640,80,allow,48165,2605,45560,63,15,31,32
49906,55190,443,14814,443,allow,12801,4250,8551,40,118,21,19
49907,65475,443,62261,443,allow,429726,12570,417156,440,16,154,286
49908,60416,55998,61754,55998,allow,70,70,0,2,8,2,0
49909,53314,443,30512,443,allow,12053,6627,5426,47,1043,26,21
49910,5235,34592,6891,34592,allow,247495,256,247239,361,49,5,356
49911,57093,80,11310,80,allow,130,70,60,2,15,1,1
49912,50584,26433,35868,26433,allow,166,166,0,1,1200,1,0
49913,49450,53,42470,53,allow,330,118,212,2,30,1,1
49914,50584,12754,22956,12754,allow,161,161,0,2,1200,2,0
49915,27005,27015,50537,27015,allow,878,126,752,2,30,1,1
49916,50978,80,49892,80,allow,81390,4223,77167,103,21,49,54
49917,36754,7,13340,7,allow,138,78,60,2,5,1,1
49918,56428,80,32588,80,allow,17247,1619,15628,26,25,11,15
49919,53292,443,45740,443,allow,4028,2584,1444,18,80,10,8
49920,4780,443,25705,443,allow,1191,692,499,12,40,7,5
49921,51952,80,54561,80,allow,1263,640,623,12,45,7,5
49922,57340,3333,57340,3333,allow,24544,10921,13623,171,1095,89,82
49923,37769,80,60461,80,allow,1213,471,742,10,255,6,4
49924,51951,80,24462,80,allow,1265,642,623,12,45,7,5
49925,59106,443,57756,443,allow,7398,2209,5189,23,35,11,12
49926,49404,53,39531,53,allow,253,102,151,2,30,1,1
49927,27005,27018,24466,27018,allow,882,126,756,2,30,1,1
49928,27005,27015,30434,27015,allow,877,126,751,2,30,1,1
49929,27005,27444,25309,27444,allow,893,126,767,2,30,1,1
49930,56579,53,36844,53,allow,288,94,194,2,30,1,1
49931,50584,6881,16713,6881,allow,166,166,0,1,1200,1,0
49932,49597,80,42235,80,allow,130,70,60,2,15,1,1
49933,50414,443,29700,443,allow,1346,918,428,10,25,6,4
49934,50974,80,38911,80,allow,181877,8980,172897,207,22,87,120
49935,49920,443,45165,443,allow,8888,2265,6623,18,15,9,9
49936,49218,443,48762,443,allow,8929,3316,5613,38,255,18,20
49937,57425,443,11895,443,allow,16413,6367,10046,60,17,28,32
49938,60417,55100,30057,55100,allow,258,70,188,4,8,2,2
49939,63814,12906,64380,12906,allow,66,66,0,2,7,2,0
49940,63818,19291,56455,19291,allow,66,66,0,2,7,2,0
49941,53641,16605,38186,16605,allow,70,70,0,2,7,2,0
49942,57319,443,43757,443,allow,134,60,74,3,5,2,1
49943,57313,443,59852,443,allow,134,60,74,3,5,2,1
49944,45566,443,9859,443,allow,570475,25559,544916,712,32,341,371
49945,46092,443,17410,443,allow,130,70,60,2,15,1,1
49946,45079,80,36951,80,allow,233914,10359,223555,294,442,136,158
49947,63670,11648,33474,11648,allow,4501,3174,1327,26,61,16,10
49948,64539,53,23141,53,allow,712,214,498,6,44,3,3
49949,63813,53455,26592,53455,allow,66,66,0,2,7,2,0
49950,57328,443,39932,443,allow,134,60,74,3,4,2,1
49951,52285,995,52285,995,allow,146,82,64,2,5,1,1
49952,49414,53,44484,53,allow,561,112,449,4,53,2,2
49953,33932,443,50545,443,allow,54451,2603,51848,70,16,30,40
49954,61361,443,55767,443,allow,9604,5021,4583,29,86,15,14
49955,63994,53,4398,53,allow,225,110,115,2,30,1,1
49956,63980,443,5737,443,allow,5237,2844,2393,14,135,7,7
49957,58194,443,27436,443,allow,3108,1047,2061,14,136,7,7
49958,43976,80,46864,80,allow,130,70,60,2,15,1,1
49959,37805,443,7210,443,allow,9481,3482,5999,58,16,29,29
49960,51944,80,27996,80,allow,2120,1080,1040,17,55,10,7
49961,44164,443,64667,443,allow,280,140,140,5,130,3,2
49962,50584,1191,3170,1191,allow,161,161,0,2,1200,2,0
49963,53373,443,1651,443,allow,8557,1755,6802,28,35,14,14
49964,47902,443,46766,443,allow,2420,1462,958,18,170,10,8
49965,51950,80,41291,80,allow,1268,645,623,12,45,7,5
49966,50584,6881,12157,6881,allow,166,166,0,1,1200,1,0
49967,50584,6889,8974,6889,allow,166,166,0,1,1200,1,0
49968,55981,80,16434,80,allow,824,469,355,9,360,5,4
49969,35122,80,19351,80,allow,130,70,60,2,15,1,1
49970,53244,53,53244,53,allow,217,82,135,2,32,1,1
49971,50976,80,37762,80,allow,3030,1372,1658,13,21,8,5
49972,55979,53,61976,53,allow,275,110,165,2,30,1,1
49973,64731,53,27701,53,allow,403,142,261,2,30,1,1
49974,55060,123,26864,123,allow,184,94,90,2,30,1,1
49975,51434,443,45613,443,allow,12291742,358717,11933025,12485,181,3846,8639
49976,37000,443,57961,443,allow,280,140,140,5,130,3,2
49977,60980,443,25213,443,allow,134,60,74,3,6,2,1
49978,48070,443,9695,443,allow,10240,2295,7945,38,121,20,18
49979,49135,443,9255,443,allow,2529,1230,1299,17,16,9,8
49980,48344,443,40212,443,allow,232,172,60,3,5,2,1
49981,51508,443,54920,443,allow,98292,24468,73824,179,52,81,98
49982,56930,53,11324,53,allow,297,94,203,2,30,1,1
49983,49292,53,63112,53,allow,323,94,229,2,31,1,1
49984,50209,1688,49264,1688,allow,70,70,0,2,8,2,0
49985,63796,60557,4607,60557,allow,70,70,0,1,5,1,0
49986,51515,443,8850,443,allow,16287,13303,2984,49,38,26,23
49987,5753,65473,0,0,deny,146,146,0,1,0,1,0
49988,59943,37807,0,0,deny,62,62,0,1,0,1,0
49989,54730,445,0,0,drop,66,66,0,1,0,1,0
49990,59328,445,0,0,drop,70,70,0,1,0,1,0
49991,54370,445,0,0,drop,70,70,0,1,0,1,0
49992,51166,31573,0,0,deny,66,66,0,1,0,1,0
49993,54369,445,0,0,drop,70,70,0,1,0,1,0
49994,54366,445,0,0,drop,70,70,0,1,0,1,0
49995,59320,445,0,0,drop,70,70,0,1,0,1,0
49996,59317,445,0,0,drop,70,70,0,1,0,1,0
49997,59315,445,0,0,drop,70,70,0,1,0,1,0
49998,54359,445,0,0,drop,70,70,0,1,0,1,0
49999,54360,445,0,0,drop,70,70,0,1,0,1,0
50000,62029,36237,0,0,deny,66,66,0,1,0,1,0
50001,54728,445,0,0,drop,66,66,0,1,0,1,0
50002,33453,64147,0,0,deny,62,62,0,1,0,1,0
50003,49177,54532,0,0,deny,60,60,0,1,0,1,0
50004,59301,445,0,0,drop,70,70,0,1,0,1,0
50005,43104,26467,0,0,deny,62,62,0,1,0,1,0
50006,20576,37965,0,0,deny,62,62,0,1,0,1,0
50007,443,43775,0,0,deny,97,97,0,1,0,1,0
50008,55933,64097,0,0,deny,62,62,0,1,0,1,0
50009,59297,445,0,0,drop,70,70,0,1,0,1,0
50010,59296,445,0,0,drop,70,70,0,1,0,1,0
50011,59295,445,0,0,drop,70,70,0,1,0,1,0
50012,38358,22300,0,0,deny,60,60,0,1,0,1,0
50013,54721,445,0,0,drop,66,66,0,1,0,1,0
50014,54348,445,0,0,drop,70,70,0,1,0,1,0
50015,7104,23,0,0,deny,60,60,0,1,0,1,0
50016,17226,35440,0,0,deny,62,62,0,1,0,1,0
50017,54717,445,0,0,drop,66,66,0,1,0,1,0
50018,54716,445,0,0,drop,66,66,0,1,0,1,0
50019,54712,445,0,0,drop,66,66,0,1,0,1,0
50020,9377,56205,0,0,deny,66,66,0,1,0,1,0
50021,7749,36237,0,0,deny,62,62,0,1,0,1,0
50022,54711,445,0,0,drop,66,66,0,1,0,1,0
50023,54710,445,0,0,drop,66,66,0,1,0,1,0
50024,54709,445,0,0,drop,66,66,0,1,0,1,0
50025,47652,51505,0,0,deny,62,62,0,1,0,1,0
50026,63586,46824,0,0,deny,62,62,0,1,0,1,0
50027,1054,15503,0,0,deny,62,62,0,1,0,1,0
50028,4269,26672,0,0,deny,60,60,0,1,0,1,0
50029,59292,445,0,0,drop,70,70,0,1,0,1,0
50030,59287,445,0,0,drop,70,70,0,1,0,1,0
50031,59286,445,0,0,drop,70,70,0,1,0,1,0
50032,50254,44847,0,0,deny,62,62,0,1,0,1,0
50033,54343,445,0,0,drop,70,70,0,1,0,1,0
50034,54706,445,0,0,drop,66,66,0,1,0,1,0
50035,39540,37965,0,0,deny,66,66,0,1,0,1,0
50036,59285,445,0,0,drop,70,70,0,1,0,1,0
50037,56173,37807,0,0,deny,62,62,0,1,0,1,0
50038,54702,445,0,0,drop,66,66,0,1,0,1,0
50039,49982,37965,0,0,deny,66,66,0,1,0,1,0
50040,53406,50584,0,0,deny,62,62,0,1,0,1,0
50041,54701,445,0,0,drop,66,66,0,1,0,1,0
50042,54700,445,0,0,drop,66,66,0,1,0,1,0
50043,49716,5900,0,0,deny,60,60,0,1,0,1,0
50044,30179,57470,0,0,deny,60,60,0,1,0,1,0
50045,54334,445,0,0,drop,70,70,0,1,0,1,0
50046,54335,445,0,0,drop,70,70,0,1,0,1,0
50047,43194,32480,0,0,deny,145,145,0,1,0,1,0
50048,54698,445,0,0,drop,66,66,0,1,0,1,0
50049,54332,445,0,0,drop,70,70,0,1,0,1,0
50050,54331,445,0,0,drop,70,70,0,1,0,1,0
50051,54327,445,0,0,drop,70,70,0,1,0,1,0
50052,58264,44847,0,0,deny,66,66,0,1,0,1,0
50053,59277,445,0,0,drop,70,70,0,1,0,1,0
50054,59273,445,0,0,drop,70,70,0,1,0,1,0
50055,59270,445,0,0,drop,70,70,0,1,0,1,0
50056,52361,23718,0,0,deny,66,66,0,1,0,1,0
50057,54321,445,0,0,drop,70,70,0,1,0,1,0
50058,54687,445,0,0,drop,66,66,0,1,0,1,0
50059,12221,81,0,0,deny,60,60,0,1,0,1,0
50060,43916,21,0,0,deny,60,60,0,1,0,1,0
50061,64339,18375,0,0,deny,62,62,0,1,0,1,0
50062,54314,445,0,0,drop,70,70,0,1,0,1,0
50063,54679,445,0,0,drop,66,66,0,1,0,1,0
50064,54312,445,0,0,drop,70,70,0,1,0,1,0
50065,51051,22,51051,22,deny,327,140,187,4,0,2,2
50066,59257,445,0,0,drop,70,70,0,1,0,1,0
50067,34936,30188,0,0,deny,66,66,0,1,0,1,0
50068,3559,30188,0,0,deny,66,66,0,1,0,1,0
50069,18246,64097,0,0,deny,66,66,0,1,0,1,0
50070,7992,64147,0,0,deny,62,62,0,1,0,1,0
50071,55921,43890,0,0,deny,66,66,0,1,0,1,0
50072,52217,22114,0,0,deny,62,62,0,1,0,1,0
50073,59790,44847,0,0,deny,62,62,0,1,0,1,0
50074,54676,445,0,0,drop,66,66,0,1,0,1,0
50075,54308,445,0,0,drop,70,70,0,1,0,1,0
50076,54306,445,0,0,drop,70,70,0,1,0,1,0
50077,23089,48817,0,0,deny,62,62,0,1,0,1,0
50078,54670,445,0,0,drop,66,66,0,1,0,1,0
50079,41298,51050,0,0,deny,62,62,0,1,0,1,0
50080,33822,57470,0,0,deny,66,66,0,1,0,1,0
50081,54666,445,0,0,drop,66,66,0,1,0,1,0
50082,54302,445,0,0,drop,70,70,0,1,0,1,0
50083,63542,15503,0,0,deny,62,62,0,1,0,1,0
50084,54301,445,0,0,drop,70,70,0,1,0,1,0
50085,57131,35776,0,0,deny,145,145,0,1,0,1,0
50086,63092,46776,0,0,deny,78,78,0,1,0,1,0
50087,63772,35440,0,0,deny,62,62,0,1,0,1,0
50088,64877,37450,0,0,deny,62,62,0,1,0,1,0
50089,58721,51505,0,0,deny,66,66,0,1,0,1,0
50090,53774,51505,0,0,deny,66,66,0,1,0,1,0
50091,49255,44847,0,0,deny,66,66,0,1,0,1,0
50092,59248,445,0,0,drop,70,70,0,1,0,1,0
50093,59246,445,0,0,drop,70,70,0,1,0,1,0
50094,59245,445,0,0,drop,70,70,0,1,0,1,0
50095,54651,445,0,0,drop,66,66,0,1,0,1,0
50096,54647,445,0,0,drop,66,66,0,1,0,1,0
50097,54652,445,0,0,drop,66,66,0,1,0,1,0
50098,54648,445,0,0,drop,66,66,0,1,0,1,0
50099,54649,445,0,0,drop,66,66,0,1,0,1,0
50100,54653,445,0,0,drop,66,66,0,1,0,1,0
50101,54650,445,0,0,drop,66,66,0,1,0,1,0
50102,54654,445,0,0,drop,66,66,0,1,0,1,0
50103,10639,11392,0,0,deny,62,62,0,1,0,1,0
50104,54296,445,0,0,drop,70,70,0,1,0,1,0
50105,49805,64147,0,0,deny,62,62,0,1,0,1,0
50106,53178,26467,0,0,deny,62,62,0,1,0,1,0
50107,33362,50584,0,0,deny,146,146,0,1,0,1,0
50108,0,0,0,0,allow,244,244,0,2,0,2,0
50109,0,0,0,0,allow,156,156,0,2,0,2,0
50110,52643,36237,0,0,deny,66,66,0,1,0,1,0
50111,63456,37965,0,0,deny,62,62,0,1,0,1,0
50112,59232,445,0,0,drop,70,70,0,1,0,1,0
50113,59229,445,0,0,drop,70,70,0,1,0,1,0
50114,59230,445,0,0,drop,70,70,0,1,0,1,0
50115,61838,37965,0,0,deny,66,66,0,1,0,1,0
50116,54196,11392,0,0,deny,66,66,0,1,0,1,0
50117,54632,445,0,0,drop,66,66,0,1,0,1,0
50118,54633,445,0,0,drop,66,66,0,1,0,1,0
50119,54631,445,0,0,drop,66,66,0,1,0,1,0
50120,36080,26467,0,0,deny,62,62,0,1,0,1,0
50121,54283,445,0,0,drop,70,70,0,1,0,1,0
50122,59227,445,0,0,drop,70,70,0,1,0,1,0
50123,80,37649,0,0,deny,60,60,0,1,0,1,0
50124,52696,21247,0,0,deny,66,66,0,1,0,1,0
50125,41346,30188,0,0,deny,62,62,0,1,0,1,0
50126,57632,7302,0,0,deny,146,146,0,1,0,1,0
50127,54280,445,0,0,drop,70,70,0,1,0,1,0
50128,59225,445,0,0,drop,70,70,0,1,0,1,0
50129,59220,445,0,0,drop,70,70,0,1,0,1,0
50130,59216,445,0,0,drop,70,70,0,1,0,1,0
50131,59214,445,0,0,drop,70,70,0,1,0,1,0
50132,6666,44818,0,0,deny,60,60,0,1,0,1,0
50133,59563,56205,0,0,deny,66,66,0,1,0,1,0
50134,30578,55783,0,0,deny,145,145,0,1,0,1,0
50135,1511,3389,0,0,deny,60,60,0,1,0,1,0
50136,22904,56205,0,0,deny,62,62,0,1,0,1,0
50137,54276,445,0,0,drop,70,70,0,1,0,1,0
50138,54274,445,0,0,drop,70,70,0,1,0,1,0
50139,62549,53733,0,0,deny,66,66,0,1,0,1,0
50140,54272,445,0,0,drop,70,70,0,1,0,1,0
50141,1033,35440,0,0,deny,146,146,0,1,0,1,0
50142,30114,65151,0,0,deny,60,60,0,1,0,1,0
50143,10151,1042,12380,1042,allow,490,149,341,2,1200,1,1
50144,41027,80,41027,80,allow,18224,2763,15461,29,126,14,15
50145,41030,80,41030,80,allow,80261,4766,75495,91,126,35,56
50146,27005,27015,43696,27015,allow,876,126,750,2,30,1,1
50147,49289,443,60908,443,allow,3890599,46254,3844345,3173,116,609,2564
50148,60312,80,47441,80,allow,2390,532,1858,11,75,6,5
50149,49535,80,31379,80,allow,1548,847,701,10,16,5,5
50150,50767,80,50767,80,allow,30767,854,29913,38,15,13,25
50151,53016,80,53016,80,allow,265868,5026,260842,277,24,75,202
50152,37981,80,45214,80,allow,1572,755,817,11,15,6,5
50153,56002,53,0,0,allow,213,88,125,2,30,1,1
50154,23916,53,23916,53,allow,224,88,136,2,30,1,1
50155,39932,443,25651,443,allow,8309,4385,3924,26,121,12,14
50156,33006,80,33006,80,allow,6582,886,5696,15,16,7,8
50157,65239,53,65239,53,allow,231,90,141,2,30,1,1
50158,3181,53,3181,53,allow,214,97,117,2,30,1,1
50159,58611,53,0,0,allow,172,78,94,2,30,1,1
50160,57700,53,0,0,allow,300,90,210,2,30,1,1
50161,49233,8080,49233,8080,allow,2602,846,1756,13,136,7,6
50162,49023,5223,36604,5223,allow,139,139,0,1,5,1,0
50163,49536,80,12566,80,allow,4544,3602,942,15,15,8,7
50164,44912,443,31289,443,allow,414,140,274,7,26,3,4
50165,57674,53,0,0,allow,195,79,116,2,30,1,1
50166,64172,53,0,0,allow,174,79,95,2,30,1,1
50167,13699,53,13699,53,allow,194,87,107,2,30,1,1
50168,58217,53,0,0,allow,266,85,181,2,30,1,1
50169,57240,53,0,0,allow,230,87,143,2,30,1,1
50170,58120,53,58120,53,allow,825,99,726,2,30,1,1
50171,51091,53,51091,53,allow,243,96,147,2,30,1,1
50172,55866,53,45530,53,allow,732,89,643,2,30,1,1
50173,52763,53,0,0,allow,296,87,209,2,30,1,1
50174,30960,45703,22089,45703,allow,330,330,0,6,3609,6,0
50175,41029,80,41029,80,allow,12386,2651,9735,24,126,12,12
50176,45336,443,30419,443,allow,2312,1382,930,19,28,11,8
50177,43969,7000,43969,7000,allow,3370,1595,1775,16,15,9,7
50178,51969,80,41756,80,allow,7304882,206543,7098339,7398,37,2677,4721
50179,54908,53,0,0,allow,174,79,95,2,30,1,1
50180,63799,13835,56478,13835,allow,66,66,0,1,5,1,0
50181,44395,443,50721,443,allow,18921,10848,8073,49,401,20,29
50182,42040,5228,65521,5228,allow,3467,1977,1490,29,3742,14,15
50183,48786,80,30638,80,allow,1834,1520,314,14,15,9,5
50184,59468,80,3821,80,allow,1594,1280,314,10,15,5,5
50185,45337,443,2595,443,allow,2312,1382,930,19,24,11,8
50186,23333,53,23333,53,allow,215,80,135,2,33,1,1
50187,56077,80,50993,80,allow,5302,704,4598,14,18,8,6
50188,49225,8080,49225,8080,allow,43790,20134,23656,73,400,45,28
50189,51972,80,28549,80,allow,7001170,112187,6888983,6101,29,1546,4555
50190,63797,47784,45642,47784,allow,66,66,0,1,5,1,0
50191,49845,53,0,0,allow,206,83,123,2,30,1,1
50192,61452,53,0,0,allow,223,89,134,2,30,1,1
50193,49235,8080,49235,8080,allow,2600,844,1756,13,136,7,6
50194,25251,53,25251,53,allow,231,90,141,2,30,1,1
50195,42008,53,0,0,allow,82,82,0,1,30,1,0
50196,42891,53,42891,53,allow,224,88,136,2,30,1,1
50197,59891,53,0,0,allow,248,75,173,2,30,1,1
50198,1955,53,1955,53,allow,216,89,127,2,30,1,1
50199,27005,27017,10381,27017,allow,600,126,474,2,30,1,1
50200,22633,53,0,0,allow,300,90,210,2,30,1,1
50201,52033,443,12817,443,allow,9609,3239,6370,25,143,12,13
50202,41032,80,41032,80,allow,11428,2250,9178,22,126,11,11
50203,59208,445,0,0,drop,70,70,0,1,0,1,0
50204,59207,445,0,0,drop,70,70,0,1,0,1,0
50205,59203,445,0,0,drop,70,70,0,1,0,1,0
50206,28229,51505,0,0,deny,146,146,0,1,0,1,0
50207,59845,44847,0,0,deny,66,66,0,1,0,1,0
50208,24174,57470,0,0,deny,62,62,0,1,0,1,0
50209,17453,35440,0,0,deny,66,66,0,1,0,1,0
50210,55539,57470,0,0,deny,66,66,0,1,0,1,0
50211,80,53945,0,0,deny,60,60,0,1,0,1,0
50212,54265,445,0,0,drop,70,70,0,1,0,1,0
50213,54263,445,0,0,drop,70,70,0,1,0,1,0
50214,2541,51505,0,0,deny,66,66,0,1,0,1,0
50215,61415,443,64279,443,allow,6143,1796,4347,21,21,11,10
50216,38028,443,50090,443,allow,8805,1300,7505,23,30,12,11
50217,64378,53,28947,53,allow,273,94,179,2,30,1,1
50218,41901,443,21025,443,allow,5586,1404,4182,17,212,10,7
50219,57304,443,45886,443,allow,134,60,74,3,5,2,1
50220,48706,23393,0,0,deny,60,60,0,1,0,1,0
50221,54612,445,0,0,drop,66,66,0,1,0,1,0
50222,46679,64147,0,0,deny,62,62,0,1,0,1,0
50223,54262,445,0,0,drop,70,70,0,1,0,1,0
50224,59200,445,0,0,drop,70,70,0,1,0,1,0
50225,59198,445,0,0,drop,70,70,0,1,0,1,0
50226,54261,445,0,0,drop,70,70,0,1,0,1,0
50227,54260,445,0,0,drop,70,70,0,1,0,1,0
50228,28498,36237,0,0,deny,146,146,0,1,0,1,0
50229,54254,445,0,0,drop,70,70,0,1,0,1,0
50230,54256,445,0,0,drop,70,70,0,1,0,1,0
50231,48706,23393,0,0,deny,60,60,0,1,0,1,0
50232,49177,54532,0,0,deny,60,60,0,1,0,1,0
50233,51558,37965,0,0,deny,72,72,0,1,0,1,0
50234,56906,50584,0,0,deny,146,146,0,1,0,1,0
50235,54605,445,0,0,drop,66,66,0,1,0,1,0
50236,54242,445,0,0,drop,70,70,0,1,0,1,0
50237,54241,445,0,0,deny,70,70,0,1,0,1,0
50238,54235,445,0,0,drop,70,70,0,1,0,1,0
50239,54232,445,0,0,drop,70,70,0,1,0,1,0
50240,54231,445,0,0,drop,70,70,0,1,0,1,0
50241,54602,445,0,0,drop,66,66,0,1,0,1,0
50242,65115,50584,0,0,deny,62,62,0,1,0,1,0
50243,59186,445,0,0,drop,70,70,0,1,0,1,0
50244,2394,43890,0,0,deny,62,62,0,1,0,1,0
50245,22683,39210,0,0,deny,60,60,0,1,0,1,0
50246,443,56858,0,0,deny,85,85,0,1,0,1,0
50247,52643,15941,0,0,deny,66,66,0,1,0,1,0
50248,59181,445,0,0,drop,70,70,0,1,0,1,0
50249,59180,445,0,0,drop,70,70,0,1,0,1,0
50250,59177,445,0,0,drop,70,70,0,1,0,1,0
50251,21145,11392,0,0,deny,146,146,0,1,0,1,0
50252,54600,445,0,0,drop,66,66,0,1,0,1,0
50253,49479,56205,0,0,deny,66,66,0,1,0,1,0
50254,34134,30188,0,0,deny,62,62,0,1,0,1,0
50255,50280,57470,0,0,deny,78,78,0,1,0,1,0
50256,64835,53,44115,53,allow,371,126,245,2,30,1,1
50257,39228,53,7632,53,allow,199,94,105,2,30,1,1
50258,45218,443,18311,443,allow,16297,12965,3332,54,193,30,24
50259,53013,80,53013,80,allow,258732,4788,253944,268,25,71,197
50260,3440,7000,3440,7000,allow,3127,676,2451,15,19,7,8
50261,63798,16357,31313,16357,allow,70,70,0,1,4,1,0
50262,49533,80,42327,80,allow,8220,849,7371,13,28,5,8
50263,63795,52376,52814,52376,allow,70,70,0,1,4,1,0
50264,36788,443,36788,443,allow,4555,1648,2907,19,29,11,8
50265,40236,443,44776,443,allow,4945,1401,3544,21,25,11,10
50266,51522,443,24413,443,allow,8517,2719,5798,24,360,12,12
50267,55684,53,0,0,allow,219,86,133,2,29,1,1
50268,52837,53,0,0,allow,86,86,0,1,29,1,0
50269,35187,443,44307,443,allow,27553,21226,6327,57,216,31,26
50270,50211,53,50211,53,allow,217,90,127,2,29,1,1
50271,50491,53,0,0,allow,183,86,97,2,29,1,1
50272,56969,53,53086,53,allow,196,94,102,2,29,1,1
50273,14237,53,14237,53,allow,245,98,147,2,29,1,1
50274,65191,53,21889,53,allow,196,94,102,2,29,1,1
50275,58126,443,22478,443,allow,3179,954,2225,10,120,5,5
50276,57426,66,63838,66,allow,70,70,0,1,5,1,0
50277,56804,33375,57101,33375,allow,70,70,0,1,5,1,0
50278,49710,53,2087,53,allow,179,94,85,2,30,1,1
50279,27005,27019,52593,27019,allow,1007,252,755,4,32,3,1
50280,51433,443,11382,443,allow,194,70,124,3,11,1,2
50281,49234,8080,49234,8080,allow,2604,848,1756,13,136,7,6
50282,5588,5588,0,0,allow,3354,1792,1562,46,192,23,23
50283,59752,443,56734,443,allow,2233,1237,996,18,75,9,9
50284,56592,53,8567,53,allow,262,94,168,2,30,1,1
50285,52189,443,26207,443,allow,4688,3009,1679,33,80,17,16
50286,54136,80,22556,80,allow,25148,5233,19915,39,71,21,18
50287,34535,443,2952,443,allow,74325,3719,70606,98,200,44,54
50288,49416,443,60402,443,allow,625995,31468,594527,722,199,256,466
50289,49710,53,37323,53,allow,179,94,85,2,30,1,1
50290,50265,43974,25412,43974,allow,132,132,0,3,1200,3,0
50291,52763,53,0,0,allow,641,87,554,2,30,1,1
50292,53310,443,4749,443,allow,2253,1403,850,15,121,9,6
50293,56818,45179,49960,45179,allow,70,70,0,1,5,1,0
50294,61421,443,24287,443,allow,7206,1897,5309,20,21,11,9
50295,52071,443,56996,443,allow,8232,3997,4235,21,16,11,10
50296,49562,53,45656,53,allow,380,90,290,4,48,2,2
50297,60756,40010,4489,40010,allow,316,136,180,6,6,3,3
50298,42776,443,39063,443,allow,4353,687,3666,14,25,8,6
50299,37082,443,41934,443,allow,2419,1461,958,18,170,10,8
50300,56235,53,15523,53,allow,199,94,105,2,30,1,1
50301,27005,27222,42780,27222,allow,890,126,764,2,30,1,1
50302,65200,53,35834,53,allow,290,102,188,2,30,1,1
50303,41031,80,41031,80,allow,2791,1259,1532,13,125,7,6
50304,58830,28678,13686,28678,allow,1806,1806,0,22,224,22,0
50305,60240,443,63324,443,allow,4310,2523,1787,42,120,24,18
50306,53318,80,64678,80,allow,1536,982,554,10,76,6,4
50307,54246,80,56298,80,allow,506,292,214,8,16,5,3
50308,56622,80,24066,80,allow,234,234,0,4,12,4,0
50309,60411,58131,27448,58131,allow,70,70,0,1,5,1,0
50310,53716,443,15837,443,allow,70,70,0,1,5,1,0
50311,39059,443,37868,443,allow,3221,1299,1922,15,19,9,6
50312,42777,443,6253,443,allow,4353,687,3666,14,25,8,6
50313,50827,443,28235,443,allow,166814,93487,73327,620,4017,312,308
50314,49493,443,39689,443,allow,9692,6055,3637,21,30,11,10
50315,43776,7000,43776,7000,allow,3174,1617,1557,17,18,9,8
50316,50121,443,39430,443,allow,29425,9485,19940,54,35,27,27
50317,53120,49860,25192,49860,allow,70,70,0,1,5,1,0
50318,58346,443,42517,443,allow,5571,1518,4053,22,614,13,9
50319,49434,53,30404,53,allow,326,134,192,2,30,1,1
50320,65009,53,56985,53,allow,737,94,643,2,30,1,1
50321,51789,443,60352,443,allow,6218,4326,1892,31,124,17,14
50322,27005,27017,61483,27017,allow,878,126,752,2,30,1,1
50323,27005,27333,2413,27333,allow,890,126,764,2,30,1,1
50324,52734,443,39307,443,allow,257777,12962,244815,347,41,162,185
50325,27005,27015,17359,27015,allow,878,126,752,2,30,1,1
50326,60412,12965,9031,12965,allow,70,70,0,1,5,1,0
50327,51432,443,60618,443,allow,194,70,124,3,11,1,2
50328,60013,443,65408,443,allow,145369,7769,137600,224,21,106,118
50329,55368,443,50740,443,allow,8551,2955,5596,28,423,15,13
50330,53319,443,19200,443,allow,2246,1396,850,15,117,9,6
50331,50567,443,27568,443,allow,198,120,78,4,15,3,1
50332,49881,53,28793,53,allow,395,102,293,2,30,1,1
50333,50265,2710,57990,2710,allow,320,320,0,6,1200,6,0
50334,57470,17984,5691,17984,allow,402,132,270,6,1209,3,3
50335,35844,443,58126,443,allow,5196,1875,3321,45,5922,12,33
50336,60384,443,3369,443,allow,4315,928,3387,16,15,10,6
50337,32777,443,20717,443,allow,8080,2049,6031,23,255,12,11
50338,55624,80,8124,80,allow,70,70,0,2,8,2,0
50339,51447,443,8869,443,allow,202,70,132,3,11,1,2
50340,52729,443,62575,443,allow,9026,3447,5579,50,45,26,24
50341,50122,443,3201,443,allow,15217,5689,9528,52,35,27,25
50342,50705,21,33829,21,allow,2222,983,1239,27,18,13,14
50343,49849,53,48086,53,allow,325,126,199,2,30,1,1
50344,53707,53,63109,53,allow,86,86,0,1,30,1,0
50345,63990,53,19922,53,allow,270,94,176,2,30,1,1
50346,45743,8765,60687,8765,allow,336,150,186,6,89,3,3
50347,27005,27111,57650,27111,allow,893,126,767,2,30,1,1
50348,27005,27015,50781,27015,allow,881,126,755,2,30,1,1
50349,49266,443,52610,443,allow,183,70,113,2,120,1,1
50350,37965,63402,11159,63402,allow,2118,858,1260,28,1283,14,14
50351,59157,443,21885,443,allow,7139,3570,3569,22,166,11,11
50352,57470,52217,58146,52217,allow,1969,730,1239,19,1199,10,9
50353,52741,443,63085,443,allow,85011,4398,80613,113,26,52,61
50354,53981,53,31166,53,allow,199,94,105,2,31,1,1
50355,40967,443,61086,443,allow,1786,172,1614,7,121,3,4
50356,52745,443,60430,443,allow,19919,2270,17649,38,26,21,17
50357,52743,443,59107,443,allow,1547,960,587,14,26,8,6
50358,52742,443,24275,443,allow,69884,4367,65517,96,26,44,52
50359,52098,5228,3628,5228,allow,3117,1602,1515,31,66,16,15
50360,56652,80,44398,80,allow,9012,4718,4294,43,81,21,22
50361,53201,443,8091,443,allow,3907,2251,1656,16,321,8,8
50362,59329,53,2601,53,allow,199,94,105,2,30,1,1
50363,43531,53,58732,53,allow,199,94,105,2,30,1,1
50364,4269,26672,0,0,deny,60,60,0,1,0,1,0
50365,35722,30188,0,0,deny,146,146,0,1,0,1,0
50366,51525,35440,0,0,deny,66,66,0,1,0,1,0
50367,59174,445,0,0,drop,70,70,0,1,0,1,0
50368,45941,23386,0,0,deny,60,60,0,1,0,1,0
50369,61223,37965,0,0,deny,66,66,0,1,0,1,0
50370,57676,64147,0,0,deny,70,70,0,1,0,1,0
50371,3436,46783,0,0,deny,145,145,0,1,0,1,0
50372,45941,23386,0,0,deny,60,60,0,1,0,1,0
50373,1866,51505,0,0,deny,62,62,0,1,0,1,0
50374,54220,445,0,0,drop,70,70,0,1,0,1,0
50375,59170,445,0,0,drop,70,70,0,1,0,1,0
50376,59168,445,0,0,drop,70,70,0,1,0,1,0
50377,59166,445,0,0,drop,70,70,0,1,0,1,0
50378,54593,445,0,0,drop,66,66,0,1,0,1,0
50379,30179,57470,0,0,deny,60,60,0,1,0,1,0
50380,54587,445,0,0,drop,66,66,0,1,0,1,0
50381,54588,445,0,0,drop,66,66,0,1,0,1,0
50382,54586,445,0,0,drop,66,66,0,1,0,1,0
50383,13985,34159,0,0,deny,66,66,0,1,0,1,0
50384,54583,445,0,0,drop,66,66,0,1,0,1,0
50385,54582,445,0,0,drop,66,66,0,1,0,1,0
50386,54580,445,0,0,drop,66,66,0,1,0,1,0
50387,50369,50584,0,0,deny,62,62,0,1,0,1,0
50388,59430,50584,0,0,deny,66,66,0,1,0,1,0
50389,54216,445,0,0,deny,70,70,0,1,0,1,0
50390,59164,445,0,0,drop,70,70,0,1,0,1,0
50391,59162,445,0,0,drop,70,70,0,1,0,1,0
50392,59159,445,0,0,drop,70,70,0,1,0,1,0
50393,57289,31573,0,0,deny,62,62,0,1,0,1,0
50394,54577,445,0,0,drop,66,66,0,1,0,1,0
50395,51909,6881,0,0,deny,62,62,0,1,0,1,0
50396,59157,445,0,0,drop,70,70,0,1,0,1,0
50397,54575,445,0,0,drop,66,66,0,1,0,1,0
50398,54205,445,0,0,drop,70,70,0,1,0,1,0
50399,54206,445,0,0,drop,70,70,0,1,0,1,0
50400,54204,445,0,0,drop,70,70,0,1,0,1,0
50401,54201,445,0,0,drop,70,70,0,1,0,1,0
50402,54573,445,0,0,drop,66,66,0,1,0,1,0
50403,54572,445,0,0,drop,66,66,0,1,0,1,0
50404,54200,445,0,0,drop,70,70,0,1,0,1,0
50405,50360,35440,0,0,deny,62,62,0,1,0,1,0
50406,54570,445,0,0,drop,66,66,0,1,0,1,0
50407,14070,62413,0,0,deny,62,62,0,1,0,1,0
50408,28221,37965,0,0,deny,62,62,0,1,0,1,0
50409,25304,64147,0,0,deny,146,146,0,1,0,1,0
50410,59149,445,0,0,drop,70,70,0,1,0,1,0
50411,59146,445,0,0,drop,70,70,0,1,0,1,0
50412,55898,443,55898,443,deny,1850,431,1419,5,0,3,2
50413,59139,445,0,0,drop,70,70,0,1,0,1,0
50414,45673,30188,0,0,deny,62,62,0,1,0,1,0
50415,54194,445,0,0,drop,70,70,0,1,0,1,0
50416,21534,42246,0,0,deny,66,66,0,1,0,1,0
50417,54559,445,0,0,drop,66,66,0,1,0,1,0
50418,54186,445,0,0,drop,70,70,0,1,0,1,0
50419,42332,22114,0,0,deny,66,66,0,1,0,1,0
50420,54183,445,0,0,drop,70,70,0,1,0,1,0
50421,54551,445,0,0,drop,66,66,0,1,0,1,0
50422,59129,445,0,0,drop,70,70,0,1,0,1,0
50423,49485,11392,0,0,deny,62,62,0,1,0,1,0
50424,61323,23117,0,0,deny,62,62,0,1,0,1,0
50425,54180,445,0,0,drop,70,70,0,1,0,1,0
50426,45941,23388,0,0,deny,60,60,0,1,0,1,0
50427,54178,445,0,0,drop,70,70,0,1,0,1,0
50428,54549,445,0,0,drop,66,66,0,1,0,1,0
50429,63092,46776,0,0,deny,78,78,0,1,0,1,0
50430,55396,26467,0,0,deny,62,62,0,1,0,1,0
50431,54174,445,0,0,drop,70,70,0,1,0,1,0
50432,54540,445,0,0,drop,66,66,0,1,0,1,0
50433,54539,445,0,0,drop,66,66,0,1,0,1,0
50434,64880,9694,0,0,deny,66,66,0,1,0,1,0
50435,28345,11392,0,0,deny,62,62,0,1,0,1,0
50436,54173,445,0,0,drop,70,70,0,1,0,1,0
50437,13441,57470,0,0,deny,62,62,0,1,0,1,0
50438,57410,37965,0,0,deny,66,66,0,1,0,1,0
50439,20108,64147,0,0,deny,66,66,0,1,0,1,0
50440,54168,445,0,0,drop,70,70,0,1,0,1,0
50441,59122,445,0,0,drop,70,70,0,1,0,1,0
50442,59118,445,0,0,drop,70,70,0,1,0,1,0
50443,59117,445,0,0,drop,70,70,0,1,0,1,0
50444,3911,50584,0,0,deny,62,62,0,1,0,1,0
50445,54518,445,0,0,drop,66,66,0,1,0,1,0
50446,54520,445,0,0,drop,66,66,0,1,0,1,0
50447,54524,445,0,0,drop,66,66,0,1,0,1,0
50448,54521,445,0,0,drop,66,66,0,1,0,1,0
50449,54526,445,0,0,drop,66,66,0,1,0,1,0
50450,54525,445,0,0,drop,66,66,0,1,0,1,0
50451,54523,445,0,0,drop,66,66,0,1,0,1,0
50452,54519,445,0,0,drop,66,66,0,1,0,1,0
50453,57431,15503,0,0,deny,62,62,0,1,0,1,0
50454,56440,56205,0,0,deny,62,62,0,1,0,1,0
50455,42798,26467,0,0,deny,62,62,0,1,0,1,0
50456,60423,35440,0,0,deny,146,146,0,1,0,1,0
50457,60152,26467,0,0,deny,62,62,0,1,0,1,0
50458,31978,57470,0,0,deny,60,60,0,1,0,1,0
50459,22714,30188,0,0,deny,62,62,0,1,0,1,0
50460,80,9918,0,0,deny,60,60,0,1,0,1,0
50461,46495,4607,0,0,deny,60,60,0,1,0,1,0
50462,19875,30170,0,0,deny,145,145,0,1,0,1,0
50463,59112,445,0,0,drop,70,70,0,1,0,1,0
50464,59109,445,0,0,drop,70,70,0,1,0,1,0
50465,59101,445,0,0,drop,70,70,0,1,0,1,0
50466,54155,445,0,0,drop,70,70,0,1,0,1,0
50467,54505,445,0,0,drop,66,66,0,1,0,1,0
50468,54504,445,0,0,drop,66,66,0,1,0,1,0
50469,54503,445,0,0,drop,66,66,0,1,0,1,0
50470,57545,35440,0,0,deny,66,66,0,1,0,1,0
50471,54152,445,0,0,drop,70,70,0,1,0,1,0
50472,59100,445,0,0,drop,70,70,0,1,0,1,0
50473,9106,53,9106,53,allow,227,89,138,2,30,1,1
50474,52052,80,64577,80,allow,2188,593,1595,11,16,5,6
50475,45184,80,27181,80,allow,1718,1404,314,11,15,6,5
50476,27005,27015,57619,27015,allow,902,126,776,2,30,1,1
50477,48753,80,48753,80,allow,19937,2162,17775,36,24,19,17
50478,52737,443,14623,443,allow,32774,3629,29145,52,26,27,25
50479,51803,33973,32167,33973,allow,66,66,0,1,5,1,0
50480,41543,443,55490,443,allow,234,234,0,4,12,4,0
50481,53616,44166,57712,44166,allow,70,70,0,1,5,1,0
50482,55196,443,1122,443,allow,13568,2119,11449,35,316,17,18
50483,37183,443,43656,443,allow,9631,4184,5447,33,271,17,16
50484,56590,53,0,0,allow,82,82,0,1,30,1,0
50485,2939,53,2939,53,allow,200,90,110,2,30,1,1
50486,18105,53,18105,53,allow,216,98,118,2,30,1,1
50487,52740,443,65500,443,allow,168753,7954,160799,212,26,95,117
50488,46232,53,46232,53,allow,194,87,107,2,30,1,1
50489,35185,3389,35185,3389,allow,3424,1710,1714,16,33,8,8
50490,52886,443,7611,443,allow,26307,17595,8712,52,498,29,23
50491,53536,443,47086,443,allow,7901,3483,4418,24,30,13,11
50492,58771,443,59212,443,allow,5750,1163,4587,25,258,13,12
50493,52738,443,34014,443,allow,56339,3530,52809,79,26,39,40
50494,51818,43942,37942,43942,allow,258,70,188,4,8,2,2
50495,53615,867,2680,867,allow,70,70,0,1,5,1,0
50496,45632,443,51632,443,allow,55844,3452,52392,85,255,38,47
50497,52480,443,40106,443,allow,7103,2432,4671,18,76,10,8
50498,30960,45701,51481,45701,allow,330,330,0,6,3609,6,0
50499,34417,53,11898,53,allow,168,78,90,2,30,1,1
50500,40296,80,40296,80,allow,1032410,43358,989052,1356,72,591,765
50501,40907,443,19035,443,allow,7183,1824,5359,27,316,14,13
50502,52064,80,49794,80,allow,2125,709,1416,11,16,5,6
50503,58115,53,48692,53,allow,578,286,292,9,15,5,4
50504,35156,8635,35156,8635,allow,138,78,60,2,5,1,1
50505,63807,38976,18542,38976,allow,66,66,0,2,8,2,0
50506,42731,443,42301,443,allow,6131,1399,4732,20,983,10,10
50507,49290,443,44950,443,allow,4783,2366,2417,16,203,8,8
50508,51548,80,33223,80,allow,1654,1340,314,11,15,6,5
50509,63809,45193,55784,45193,allow,66,66,0,2,8,2,0
50510,50393,8080,50393,8080,allow,378,180,198,7,31,4,3
50511,52476,443,35367,443,allow,7787,3056,4731,19,87,10,9
50512,52739,443,43890,443,allow,25048,2850,22198,45,26,23,22
50513,52963,80,22153,80,allow,1600,581,1019,10,15,6,4
50514,55276,80,42794,80,allow,1594,1280,314,10,15,5,5
50515,45335,443,8948,443,allow,2814,1454,1360,23,28,12,11
50516,49528,443,34727,443,allow,5968,985,4983,17,28,8,9
50517,27005,27013,37862,27013,allow,869,126,743,2,30,1,1
50518,30906,53,30906,53,allow,227,89,138,2,30,1,1
50519,7539,53,7539,53,allow,194,87,107,2,30,1,1
50520,35311,443,37900,443,allow,6584,1945,4639,14,120,7,7
50521,56987,443,32142,443,allow,3800,1324,2476,14,136,7,7
50522,52773,443,22036,443,allow,19594,11977,7617,48,100,25,23
50523,59097,445,0,0,drop,70,70,0,1,0,1,0
50524,53833,26467,0,0,deny,66,66,0,1,0,1,0
50525,14694,443,0,0,deny,60,60,0,1,0,1,0
50526,59093,445,0,0,drop,70,70,0,1,0,1,0
50527,59091,445,0,0,drop,70,70,0,1,0,1,0
50528,59089,445,0,0,drop,70,70,0,1,0,1,0
50529,46576,23718,0,0,deny,66,66,0,1,0,1,0
50530,53168,44847,0,0,deny,146,146,0,1,0,1,0
50531,9605,57470,0,0,deny,62,62,0,1,0,1,0
50532,11133,51505,0,0,deny,66,66,0,1,0,1,0
50533,54148,445,0,0,drop,70,70,0,1,0,1,0
50534,53650,64147,0,0,deny,62,62,0,1,0,1,0
50535,58343,23718,0,0,deny,66,66,0,1,0,1,0
50536,54146,445,0,0,drop,70,70,0,1,0,1,0
50537,45964,2666,0,0,deny,60,60,0,1,0,1,0
50538,58564,50432,0,0,deny,66,66,0,1,0,1,0
50539,10448,14914,0,0,deny,143,143,0,1,0,1,0
50540,54144,445,0,0,drop,70,70,0,1,0,1,0
50541,54819,443,59534,443,allow,3429,1188,2241,13,134,6,7
50542,47711,443,57619,443,allow,11793,7188,4605,34,128,17,17
50543,65199,53,63329,53,allow,793,207,586,6,59,3,3
50544,57256,5228,53413,5228,allow,7144,1872,5272,36,22,20,16
50545,49212,80,1671,80,allow,1013,566,447,8,134,5,3
50546,51804,31012,28842,31012,allow,70,70,0,1,5,1,0
50547,20,64488,20,50706,allow,624666,17676,606990,671,14,267,404
50548,39916,53,62317,53,allow,168,78,90,2,30,1,1
50549,27005,27016,9591,27016,allow,884,126,758,2,30,1,1
50550,56180,53,56180,53,allow,229,98,131,2,30,1,1
50551,52744,443,47091,443,allow,14838,2048,12790,32,25,18,14
50552,52728,443,50981,443,allow,186399,56439,129960,335,45,170,165
50553,52736,443,12534,443,allow,1217451,39642,1177809,1359,39,539,820
50554,52732,443,31396,443,allow,27467,22472,4995,85,42,45,40
50555,49986,443,61933,443,allow,25918,2247,23671,53,124,26,27
50556,37321,53,37321,53,allow,197,90,107,2,30,1,1
50557,56817,48650,23825,48650,allow,130,70,60,2,5,1,1
50558,57492,443,47894,443,allow,380975,82011,298964,804,171,343,461
50559,37002,443,19218,443,allow,6646,2747,3899,20,134,10,10
50560,23226,53,23226,53,allow,217,82,135,2,33,1,1
50561,56358,443,56358,443,allow,4674,1767,2907,19,29,11,8
50562,42843,53,7011,53,allow,168,78,90,2,30,1,1
50563,50550,53,58594,53,allow,168,78,90,2,30,1,1
50564,10151,53,10151,53,allow,220,90,130,2,30,1,1
50565,56555,443,29813,443,allow,6308,829,5479,18,15,9,9
50566,64221,53,19919,53,allow,262,102,160,2,30,1,1
50567,49761,80,49761,80,allow,2937,703,2234,13,142,6,7
50568,36448,53,11652,53,allow,199,94,105,2,30,1,1
50569,11295,53,11295,53,allow,197,90,107,2,30,1,1
50570,49574,53,2504,53,allow,496,92,404,4,58,2,2
50571,24412,53,24412,53,allow,200,90,110,2,30,1,1
50572,51805,15298,5839,15298,allow,70,70,0,1,5,1,0
50573,59750,443,51830,443,allow,2633,1179,1454,20,74,8,12
50574,49502,443,43578,443,allow,31780,3232,28548,44,29,16,28
50575,65138,53,7886,53,allow,418,94,324,2,30,1,1
50576,19473,58093,47634,58093,allow,460,150,310,2,1200,1,1
50577,59748,443,39145,443,allow,8789,1592,7197,25,75,13,12
50578,6881,40783,51733,40783,allow,509,150,359,2,1199,1,1
50579,34957,80,4367,80,allow,7136,3526,3610,42,1239,21,21
50580,49899,443,2357,443,allow,26284,21857,4427,72,83,39,33
50581,60665,443,60665,443,allow,5715,1432,4283,19,15,9,10
50582,27005,27017,7063,27017,allow,877,126,751,3,31,2,1
50583,27005,27015,62315,27015,allow,1006,252,754,4,32,3,1
50584,57918,443,47624,443,allow,38204,3737,34467,77,95,40,37
50585,61711,443,17336,443,allow,7485,1962,5523,27,95,13,14
50586,52733,443,22448,443,allow,613606,29392,584214,757,42,337,420
50587,63793,48970,37013,48970,allow,70,70,0,1,4,1,0
50588,53123,59228,32782,59228,allow,70,70,0,2,8,2,0
50589,49177,443,60972,443,allow,654956,17062,637894,673,18,244,429
50590,51159,443,36632,443,allow,6405463,157088,6248375,6383,90,2146,4237
50591,52746,443,40862,443,allow,104383,5038,99345,135,25,62,73
50592,47976,443,55009,443,allow,16187,11705,4482,33,159,19,14
50593,52727,443,14385,443,allow,1369,708,661,14,45,8,6
50594,50552,443,41023,443,allow,8311,3156,5155,29,17,16,13
50595,49537,53,41171,53,allow,686,276,410,8,74,4,4
50596,33919,53,58115,53,allow,168,78,90,2,30,1,1
50597,63974,53,33864,53,allow,618,111,507,4,30,2,2
50598,49823,53,39316,53,allow,388,102,286,2,30,1,1
50599,8283,45858,63554,45858,allow,130,70,60,2,30,1,1
50600,55044,53,47229,53,allow,168,78,90,2,30,1,1
50601,27005,27016,25142,27016,allow,883,126,757,2,30,1,1
50602,27005,27015,25382,27015,allow,937,126,811,2,30,1,1
50603,35408,53,57895,53,allow,168,78,90,2,30,1,1
50604,44400,443,34284,443,allow,6576,1937,4639,14,120,7,7
50605,46544,443,31614,443,allow,332590,15084,317506,341,139,89,252
50606,47500,443,47942,443,allow,7464,2375,5089,15,120,7,8
50607,52447,443,48925,443,allow,7980,5952,2028,22,99,12,10
50608,10056,443,53947,443,allow,12677,10470,2207,42,80,23,19
50609,61673,443,54566,443,allow,9218,3728,5490,30,50,16,14
50610,11826,53,11826,53,allow,216,98,118,2,30,1,1
50611,55392,53,63211,53,allow,418,94,324,2,30,1,1
50612,59316,443,4398,443,allow,17547,11857,5690,34,159,20,14
50613,56816,12523,45890,12523,allow,70,70,0,1,5,1,0
50614,46232,53,46232,53,allow,216,90,126,2,30,1,1
50615,27005,49000,39068,49000,allow,887,126,761,2,30,1,1
50616,51836,53,49755,53,allow,168,78,90,2,30,1,1
50617,34565,53,14106,53,allow,168,78,90,2,30,1,1
50618,58785,53,58785,53,allow,216,90,126,2,30,1,1
50619,29413,53,29413,53,allow,217,82,135,2,32,1,1
50620,49760,80,49760,80,allow,613303,16858,596445,666,143,251,415
50621,58794,5222,61380,5222,allow,47445,16812,30633,144,870,65,79
50622,51666,443,15224,443,allow,3256,2213,1043,16,15,8,8
50623,49304,7010,49304,7010,allow,6247,4138,2109,21,15,13,8
50624,27005,27015,28808,27015,allow,873,126,747,2,30,1,1
50625,44901,443,19443,443,allow,11891,6219,5672,35,174,16,19
50626,50584,60395,46252,60395,allow,166,166,0,1,1200,1,0
50627,52183,443,6530,443,allow,3560269,64410,3495859,2930,132,383,2547
50628,45401,443,44939,443,allow,9535,3495,6040,18,121,10,8
50629,50584,56209,14402,56209,allow,166,166,0,1,1200,1,0
50630,27005,31000,35910,31000,allow,898,126,772,2,31,1,1
50631,56962,80,49373,80,allow,8730,5681,3049,21,31,12,9
50632,60505,443,23004,443,allow,1061,727,334,9,26,4,5
50633,50625,80,24486,80,allow,8688,4248,4440,56,131,34,22
50634,49439,443,14852,443,allow,9495,2281,7214,22,78,11,11
50635,49920,443,27141,443,allow,9759,1989,7770,25,16,13,12
50636,49633,443,1902,443,allow,60196,10141,50055,122,33,62,60
50637,57620,443,56080,443,allow,5177,3010,2167,37,83,17,20
50638,55041,80,12804,80,allow,486,240,246,9,35,5,4
50639,56114,53,31669,53,allow,194,86,108,2,30,1,1
50640,15986,8000,14701,8000,allow,274,150,124,4,61,2,2
50641,49437,443,4843,443,allow,9621,2347,7274,24,78,12,12
50642,30472,53,56482,53,allow,223,86,137,2,30,1,1
50643,55046,80,10209,80,allow,2775,1332,1443,12,34,7,5
50644,60173,443,14780,443,allow,7909,3501,4408,19,181,9,10
50645,3578,51505,0,0,deny,62,62,0,1,0,1,0
50646,6881,55839,0,0,deny,139,139,0,1,0,1,0
50647,62386,37965,0,0,deny,62,62,0,1,0,1,0
50648,1162,57470,0,0,deny,62,62,0,1,0,1,0
50649,51197,57470,0,0,deny,66,66,0,1,0,1,0
50650,59080,445,0,0,drop,70,70,0,1,0,1,0
50651,59079,445,0,0,drop,70,70,0,1,0,1,0
50652,59075,445,0,0,drop,70,70,0,1,0,1,0
50653,49177,54532,0,0,deny,60,60,0,1,0,1,0
50654,54137,445,0,0,drop,70,70,0,1,0,1,0
50655,51742,30317,0,0,deny,66,66,0,1,0,1,0
50656,54135,445,0,0,drop,70,70,0,1,0,1,0
50657,9219,32480,0,0,deny,72,72,0,1,0,1,0
50658,59505,53733,0,0,deny,66,66,0,1,0,1,0
50659,54134,445,0,0,drop,70,70,0,1,0,1,0
50660,54133,445,0,0,drop,70,70,0,1,0,1,0
50661,54132,445,0,0,drop,70,70,0,1,0,1,0
50662,52887,37807,0,0,deny,66,66,0,1,0,1,0
50663,54129,445,0,0,drop,70,70,0,1,0,1,0
50664,54128,445,0,0,drop,70,70,0,1,0,1,0
50665,54484,445,0,0,drop,66,66,0,1,0,1,0
50666,59072,445,0,0,drop,70,70,0,1,0,1,0
50667,59070,445,0,0,drop,70,70,0,1,0,1,0
50668,61881,48817,0,0,deny,148,148,0,1,0,1,0
50669,62566,35993,0,0,deny,66,66,0,1,0,1,0
50670,4269,26672,0,0,deny,60,60,0,1,0,1,0
50671,53453,2767,0,0,deny,66,66,0,1,0,1,0
50672,34348,22114,0,0,deny,62,62,0,1,0,1,0
50673,54114,445,0,0,drop,70,70,0,1,0,1,0
50674,54113,445,0,0,drop,70,70,0,1,0,1,0
50675,54109,445,0,0,drop,70,70,0,1,0,1,0
50676,54103,445,0,0,drop,70,70,0,1,0,1,0
50677,54104,445,0,0,drop,70,70,0,1,0,1,0
50678,52064,22114,0,0,deny,62,62,0,1,0,1,0
50679,54475,445,0,0,drop,66,66,0,1,0,1,0
50680,54474,445,0,0,drop,66,66,0,1,0,1,0
50681,59062,445,0,0,drop,70,70,0,1,0,1,0
50682,59053,445,0,0,drop,70,70,0,1,0,1,0
50683,59049,445,0,0,drop,70,70,0,1,0,1,0
50684,59050,445,0,0,drop,70,70,0,1,0,1,0
50685,44538,50584,0,0,deny,146,146,0,1,0,1,0
50686,54471,445,0,0,drop,66,66,0,1,0,1,0
50687,52431,50265,0,0,deny,62,62,0,1,0,1,0
50688,52459,5555,0,0,deny,60,60,0,1,0,1,0
50689,50088,1604,0,0,deny,84,84,0,1,0,1,0
50690,54092,445,0,0,drop,70,70,0,1,0,1,0
50691,23934,41615,0,0,deny,145,145,0,1,0,1,0
50692,23934,41615,0,0,deny,145,145,0,1,0,1,0
50693,15296,37965,0,0,deny,66,66,0,1,0,1,0
50694,59781,56205,0,0,deny,66,66,0,1,0,1,0
50695,11859,64147,0,0,deny,62,62,0,1,0,1,0
50696,48692,57470,0,0,deny,62,62,0,1,0,1,0
50697,59044,445,0,0,drop,70,70,0,1,0,1,0
50698,36908,26467,0,0,deny,62,62,0,1,0,1,0
50699,58486,57470,0,0,deny,66,66,0,1,0,1,0
50700,59042,445,0,0,drop,70,70,0,1,0,1,0
50701,59041,445,0,0,drop,70,70,0,1,0,1,0
50702,59039,445,0,0,drop,70,70,0,1,0,1,0
50703,54464,445,0,0,drop,66,66,0,1,0,1,0
50704,54460,445,0,0,drop,66,66,0,1,0,1,0
50705,54459,445,0,0,drop,66,66,0,1,0,1,0
50706,54456,445,0,0,drop,66,66,0,1,0,1,0
50707,51424,30188,0,0,deny,66,66,0,1,0,1,0
50708,54454,445,0,0,drop,66,66,0,1,0,1,0
50709,54455,445,0,0,drop,66,66,0,1,0,1,0
50710,54452,445,0,0,drop,66,66,0,1,0,1,0
50711,64240,50584,0,0,deny,66,66,0,1,0,1,0
50712,54088,445,0,0,drop,70,70,0,1,0,1,0
50713,6416,22114,0,0,deny,62,62,0,1,0,1,0
50714,62908,21,0,0,deny,60,60,0,1,0,1,0
50715,6712,161,0,0,deny,82,82,0,1,0,1,0
50716,59034,445,0,0,drop,70,70,0,1,0,1,0
50717,59033,445,0,0,drop,70,70,0,1,0,1,0
50718,59030,445,0,0,drop,70,70,0,1,0,1,0
50719,54078,445,0,0,drop,70,70,0,1,0,1,0
50720,54077,445,0,0,drop,70,70,0,1,0,1,0
50721,35460,35440,0,0,deny,62,62,0,1,0,1,0
50722,54450,445,0,0,drop,66,66,0,1,0,1,0
50723,54074,445,0,0,drop,70,70,0,1,0,1,0
50724,54076,445,0,0,drop,70,70,0,1,0,1,0
50725,59029,445,0,0,drop,70,70,0,1,0,1,0
50726,23528,44847,0,0,deny,62,62,0,1,0,1,0
50727,54071,445,0,0,drop,70,70,0,1,0,1,0
50728,54446,445,0,0,drop,66,66,0,1,0,1,0
50729,54445,445,0,0,drop,66,66,0,1,0,1,0
50730,54443,445,0,0,drop,66,66,0,1,0,1,0
50731,64066,23718,0,0,deny,66,66,0,1,0,1,0
50732,46478,64147,0,0,deny,62,62,0,1,0,1,0
50733,54442,445,0,0,drop,66,66,0,1,0,1,0
50734,57131,31061,0,0,deny,145,145,0,1,0,1,0
50735,63221,53436,0,0,deny,62,62,0,1,0,1,0
50736,59459,37807,0,0,deny,66,66,0,1,0,1,0
50737,33324,42873,0,0,deny,62,62,0,1,0,1,0
50738,41447,64147,0,0,deny,62,62,0,1,0,1,0
50739,57853,64147,0,0,deny,66,66,0,1,0,1,0
50740,59021,445,0,0,drop,70,70,0,1,0,1,0
50741,54065,445,0,0,drop,70,70,0,1,0,1,0
50742,26084,36237,0,0,deny,62,62,0,1,0,1,0
50743,59013,445,0,0,drop,70,70,0,1,0,1,0
50744,59012,445,0,0,drop,70,70,0,1,0,1,0
50745,60162,53436,0,0,deny,66,66,0,1,0,1,0
50746,63092,46776,0,0,deny,78,78,0,1,0,1,0
50747,54432,445,0,0,drop,66,66,0,1,0,1,0
50748,54058,445,0,0,drop,70,70,0,1,0,1,0
50749,61701,44847,0,0,deny,66,66,0,1,0,1,0
50750,54057,445,0,0,drop,70,70,0,1,0,1,0
50751,6015,23,0,0,deny,60,60,0,1,0,1,0
50752,1384,44847,0,0,deny,66,66,0,1,0,1,0
50753,3377,50584,0,0,deny,66,66,0,1,0,1,0
50754,54423,445,0,0,drop,66,66,0,1,0,1,0
50755,54051,445,0,0,drop,70,70,0,1,0,1,0
50756,59001,445,0,0,drop,70,70,0,1,0,1,0
50757,50624,26467,0,0,deny,66,66,0,1,0,1,0
50758,54050,445,0,0,drop,70,70,0,1,0,1,0
50759,44855,58414,0,0,deny,146,146,0,1,0,1,0
50760,45941,23386,0,0,deny,60,60,0,1,0,1,0
50761,54420,445,0,0,drop,66,66,0,1,0,1,0
50762,50804,1,0,0,deny,62,62,0,1,0,1,0
50763,57500,37965,0,0,deny,62,62,0,1,0,1,0
50764,54046,445,0,0,drop,70,70,0,1,0,1,0
50765,57325,37965,0,0,deny,62,62,0,1,0,1,0
50766,17027,1,0,0,deny,62,62,0,1,0,1,0
50767,60133,1,0,0,deny,66,66,0,1,0,1,0
50768,10006,64147,0,0,deny,62,62,0,1,0,1,0
50769,54413,445,0,0,drop,66,66,0,1,0,1,0
50770,51674,51505,0,0,deny,66,66,0,1,0,1,0
50771,54045,445,0,0,drop,70,70,0,1,0,1,0
50772,54410,445,0,0,drop,66,66,0,1,0,1,0
50773,56966,35440,0,0,deny,66,66,0,1,0,1,0
50774,53779,51505,0,0,deny,66,66,0,1,0,1,0
50775,62737,64147,0,0,deny,66,66,0,1,0,1,0
50776,45964,5333,0,0,deny,60,60,0,1,0,1,0
50777,54040,445,0,0,drop,70,70,0,1,0,1,0
50778,31978,57470,0,0,deny,60,60,0,1,0,1,0
50779,61520,23718,0,0,deny,62,62,0,1,0,1,0
50780,51026,37450,0,0,deny,66,66,0,1,0,1,0
50781,58992,445,0,0,drop,70,70,0,1,0,1,0
50782,58991,445,0,0,drop,70,70,0,1,0,1,0
50783,58989,445,0,0,drop,70,70,0,1,0,1,0
50784,443,64347,0,0,deny,131,131,0,1,0,1,0
50785,51192,15503,0,0,deny,66,66,0,1,0,1,0
50786,10319,42707,0,0,deny,62,62,0,1,0,1,0
50787,54392,445,0,0,drop,66,66,0,1,0,1,0
50788,54395,445,0,0,drop,66,66,0,1,0,1,0
50789,54397,445,0,0,drop,66,66,0,1,0,1,0
50790,54398,445,0,0,drop,66,66,0,1,0,1,0
50791,54394,445,0,0,drop,66,66,0,1,0,1,0
50792,54393,445,0,0,drop,66,66,0,1,0,1,0
50793,54396,445,0,0,drop,66,66,0,1,0,1,0
50794,54390,445,0,0,drop,66,66,0,1,0,1,0
50795,60750,42707,0,0,deny,66,66,0,1,0,1,0
50796,64940,26467,0,0,deny,62,62,0,1,0,1,0
50797,50419,26467,0,0,deny,66,66,0,1,0,1,0
50798,46573,50584,0,0,deny,66,66,0,1,0,1,0
50799,54786,30188,0,0,deny,66,66,0,1,0,1,0
50800,65454,61600,0,0,deny,66,66,0,1,0,1,0
50801,53608,1024,20573,1024,allow,70,70,0,1,5,1,0
50802,53126,443,10677,443,allow,6668,2026,4642,15,120,8,7
50803,53599,47783,42378,47783,allow,618,432,186,9,17,6,3
50804,58429,443,42456,443,allow,10588,1664,8924,29,631,11,18
50805,27005,27016,53095,27016,allow,889,126,763,3,31,2,1
50806,27997,80,36977,80,allow,3683,591,3092,11,45,6,5
50807,56944,80,48541,80,allow,214,140,74,4,30,3,1
50808,53612,1032,48115,1032,allow,130,70,60,2,6,1,1
50809,60413,43555,44163,43555,allow,70,70,0,2,8,2,0
50810,33640,53,0,0,allow,138,69,69,2,30,1,1
50811,63755,17866,46456,17866,allow,2568,1944,624,20,29,13,7
50812,44731,443,63210,443,allow,4920,2738,2182,33,259,16,17
50813,61189,443,61189,443,allow,1092,645,447,10,34,6,4
50814,27186,53,27186,53,allow,821,97,724,2,30,1,1
50815,19557,53,19557,53,allow,194,87,107,2,30,1,1
50816,39148,443,64587,443,allow,6818,1800,5018,30,271,16,14
50817,63991,443,63991,443,allow,4597,1690,2907,19,28,11,8
50818,53072,443,53072,443,allow,49826,37097,12729,66,163,40,26
50819,34600,443,63857,443,allow,7950,1925,6025,26,66,14,12
50820,49529,443,17894,443,allow,9047,1436,7611,22,27,10,12
50821,51821,28306,23516,28306,allow,316,136,180,6,6,3,3
50822,53597,42845,3911,42845,allow,678,492,186,10,18,7,3
50823,39328,80,5790,80,allow,78,78,0,1,5,1,0
50824,53609,38060,54791,38060,allow,70,70,0,1,5,1,0
50825,51823,15843,1473,15843,allow,70,70,0,1,5,1,0
50826,49616,443,57635,443,allow,7238,2601,4637,20,17,10,10
50827,52267,443,8782,443,allow,24712,9272,15440,65,136,34,31
50828,56644,443,7171,443,allow,12924,3689,9235,31,82,17,14
50829,49352,443,43143,443,allow,2118582,46411,2072171,2066,90,617,1449
50830,21133,43408,64774,43408,allow,480,149,331,2,1200,1,1
50831,40599,443,12842,443,allow,89724,81316,8408,148,404,69,79
50832,10088,443,42389,443,allow,7243,1860,5383,26,330,14,12
50833,55038,443,26774,443,allow,4424,876,3548,15,35,8,7
50834,24961,53,24961,53,allow,215,80,135,2,33,1,1
50835,1431,53,1431,53,allow,215,80,135,2,32,1,1
50836,54144,443,15023,443,allow,2227,1018,1209,17,16,8,9
50837,27996,80,2657,80,allow,2058,589,1469,10,45,6,4
50838,46280,443,46280,443,allow,4754,1847,2907,19,26,11,8
50839,49485,443,26234,443,allow,49823,7236,42587,56,29,20,36
50840,55813,443,55813,443,allow,4543,1636,2907,19,29,11,8
50841,30728,53,30728,53,allow,196,88,108,2,30,1,1
50842,30227,3386,30227,3386,allow,146,60,86,2,30,1,1
50843,27005,27015,31216,27015,allow,939,126,813,2,30,1,1
50844,55765,443,54125,443,allow,4660,1915,2745,23,120,12,11
50845,27005,27017,14487,27017,allow,882,126,756,2,31,1,1
50846,36939,80,43312,80,allow,5733,3036,2697,25,235,9,16
50847,41270,443,43404,443,allow,14659,5023,9636,46,400,14,32
50848,30960,45700,20531,45700,allow,330,330,0,6,3609,6,0
50849,27005,27018,60808,27018,allow,881,126,755,2,31,1,1
50850,49237,443,19934,443,allow,8293,4179,4114,22,128,11,11
50851,54693,30188,0,0,deny,62,62,0,1,0,1,0
50852,54146,5900,0,0,deny,60,60,0,1,0,1,0
50853,58981,445,0,0,drop,70,70,0,1,0,1,0
50854,58980,445,0,0,drop,70,70,0,1,0,1,0
50855,58973,445,0,0,drop,70,70,0,1,0,1,0
50856,51544,34476,0,0,deny,137,137,0,1,0,1,0
50857,4961,62741,0,0,deny,66,66,0,1,0,1,0
50858,4447,35440,0,0,deny,66,66,0,1,0,1,0
50859,60772,36829,0,0,deny,66,66,0,1,0,1,0
50860,50316,37965,0,0,deny,66,66,0,1,0,1,0
50861,54024,445,0,0,drop,70,70,0,1,0,1,0
50862,54377,445,0,0,drop,66,66,0,1,0,1,0
50863,64315,53,11433,53,allow,322,102,220,2,30,1,1
50864,51816,27721,33144,27721,allow,70,70,0,2,8,2,0
50865,60798,443,60798,443,allow,1092,645,447,10,34,6,4
50866,49765,53,55989,53,allow,233,102,131,2,30,1,1
50867,33247,443,33617,443,allow,7527,2435,5092,16,120,8,8
50868,48163,443,22836,443,allow,20124,12085,8039,54,385,29,25
50869,55047,80,59301,80,allow,306,180,126,6,32,4,2
50870,44095,443,27127,443,allow,6109,3363,2746,60,615,33,27
50871,48467,80,55817,80,allow,1113,534,579,12,15,7,5
50872,56960,80,32758,80,allow,6363,3790,2573,16,30,10,6
50873,64184,443,64184,443,allow,4561,1654,2907,19,28,11,8
50874,49504,443,22336,443,allow,62,62,0,1,5,1,0
50875,56958,80,27013,80,allow,9535,3968,5567,21,30,12,9
50876,48279,8080,0,0,allow,368,156,212,5,13,3,2
50877,55037,443,19621,443,allow,10640,3171,7469,28,45,15,13
50878,56445,53,50550,53,allow,353,110,243,4,46,2,2
50879,56966,80,60389,80,allow,214,140,74,4,30,3,1
50880,56939,80,26245,80,allow,194,128,66,4,31,3,1
50881,54437,443,40534,443,allow,716056,89267,626789,952,300,368,584
50882,55042,80,32886,80,allow,306,180,126,6,34,4,2
50883,56815,50510,55664,50510,allow,70,70,0,1,5,1,0
50884,56813,37092,33767,37092,allow,70,70,0,1,5,1,0
50885,35400,443,23133,443,allow,11083,4080,7003,38,40,14,24
50886,55213,53,60229,53,allow,238,94,144,2,30,1,1
50887,35685,123,34944,123,allow,184,94,90,2,30,1,1
50888,53669,80,61903,80,allow,1119,665,454,12,15,7,5
50889,55043,80,21312,80,allow,306,180,126,6,34,4,2
50890,64067,53,26067,53,allow,331,102,229,2,30,1,1
50891,49506,443,26865,443,allow,18260,2912,15348,30,28,11,19
50892,60415,40829,35259,40829,allow,70,70,0,2,8,2,0
50893,54859,443,24991,443,allow,6677,1006,5671,19,26,11,8
50894,49998,53,11230,53,allow,467,90,377,4,39,2,2
50895,60709,443,60709,443,allow,1092,645,447,10,34,6,4
50896,42898,443,46834,443,allow,4999,2845,2154,41,87,22,19
50897,49921,80,16260,80,allow,1126,609,517,11,15,6,5
50898,56788,443,35911,443,allow,22508,1965,20543,32,17,13,19
50899,49922,80,11141,80,allow,1126,609,517,11,15,6,5
50900,50249,443,46250,443,allow,6125,1674,4451,22,81,11,11
50901,63218,22,63218,22,allow,9001,4087,4914,59,39,27,32
50902,56965,80,39996,80,allow,526,304,222,8,30,5,3
50903,49923,80,28185,80,allow,1126,609,517,11,15,6,5
50904,57929,53,0,0,allow,294,86,208,2,30,1,1
50905,50419,80,4719,80,allow,350,350,0,1,120,1,0
50906,64349,53,48163,53,allow,392,102,290,2,30,1,1
50907,55209,53,33482,53,allow,196,102,94,2,33,1,1
50908,57353,443,50919,443,allow,70,70,0,1,5,1,0
50909,54287,443,5975,443,allow,250,190,60,2,5,1,1
50910,60891,443,53303,443,allow,204,70,134,4,25,2,2
50911,49860,53,13520,53,allow,550,129,421,4,57,2,2
50912,37991,443,14336,443,allow,8365,3018,5347,31,271,15,16
50913,64379,53,61307,53,allow,333,94,239,2,30,1,1
50914,64506,53,36287,53,allow,184,86,98,2,30,1,1
50915,60731,80,1160,80,allow,5911,4727,1184,20,16,11,9
50916,55040,80,41951,80,allow,486,240,246,9,34,5,4
50917,55044,80,26880,80,allow,306,180,126,6,34,4,2
50918,49326,443,20775,443,allow,9303,2551,6752,33,16,18,15
50919,53131,443,19273,443,allow,10705,5303,5402,36,650,16,20
50920,56963,80,25455,80,allow,6974,3906,3068,19,30,11,8
50921,55619,42873,30146,42873,allow,422,140,282,6,16,3,3
50922,42520,443,59710,443,allow,6795,2090,4705,27,21,15,12
50923,56959,80,53934,80,allow,15752,5736,10016,28,30,14,14
50924,56961,80,26352,80,allow,5885,3796,2089,16,30,10,6
50925,56899,443,29729,443,allow,29904,3111,26793,68,164,35,33
50926,53607,51631,46867,51631,allow,70,70,0,1,4,1,0
50927,60409,44739,64818,44739,allow,70,70,0,1,5,1,0
50928,56814,56255,27834,56255,allow,70,70,0,1,5,1,0
50929,53605,13468,43310,13468,allow,70,70,0,1,4,1,0
50930,56800,1,46367,1,allow,70,70,0,1,5,1,0
50931,49897,443,63900,443,allow,113036,13164,99872,191,144,89,102
50932,51824,53021,41842,53021,allow,70,70,0,1,5,1,0
50933,58858,443,49748,443,allow,208,60,148,4,10,2,2
50934,56955,80,64782,80,allow,214,140,74,4,30,3,1
50935,60407,8106,10620,8106,allow,2541,1158,1383,19,16,9,10
50936,48697,5222,62184,5222,allow,8355,4135,4220,79,616,41,38
50937,41184,53,29887,53,allow,168,78,90,2,30,1,1
50938,50564,443,39683,443,allow,8182,1488,6694,23,133,13,10
50939,64102,53,25876,53,allow,274,94,180,2,29,1,1
50940,64353,53,31104,53,allow,225,102,123,2,29,1,1
50941,54807,443,9391,443,allow,10078,2210,7868,36,120,19,17
50942,33461,443,33205,443,allow,8366,3900,4466,19,120,10,9
50943,64162,53,14611,53,allow,225,110,115,2,30,1,1
50944,6881,6881,30399,6881,allow,238,118,120,2,1199,1,1
50945,60414,52559,64596,52559,allow,70,70,0,2,8,2,0
50946,51801,33531,13546,33531,allow,70,70,0,1,5,1,0
50947,51800,63796,15243,63796,allow,70,70,0,1,5,1,0
50948,60377,443,48988,443,allow,8588,2020,6568,20,76,10,10
50949,48905,80,43588,80,allow,1868,1374,494,12,15,7,5
50950,20957,53,20957,53,allow,216,90,126,2,30,1,1
50951,27005,27015,5485,27015,allow,889,126,763,2,30,1,1
50952,27005,27020,57425,27020,allow,890,126,764,2,30,1,1
50953,18102,53,59095,53,allow,223,86,137,2,30,1,1
50954,27005,27016,11653,27016,allow,876,126,750,3,31,2,1
50955,49924,80,4925,80,allow,1126,609,517,11,15,6,5
50956,60875,443,60875,443,allow,1092,645,447,10,34,6,4
50957,60721,443,60721,443,allow,1092,645,447,10,34,6,4
50958,56621,80,4891,80,allow,234,234,0,4,12,4,0
50959,51798,37020,7892,37020,allow,70,70,0,1,5,1,0
50960,53119,58118,18768,58118,allow,70,70,0,1,5,1,0
50961,56946,80,58825,80,allow,214,140,74,4,30,3,1
50962,56945,80,24790,80,allow,214,140,74,4,30,3,1
50963,43086,443,19069,443,allow,6496,2026,4470,20,16,12,8
50964,27005,30000,59167,30000,allow,913,126,787,2,30,1,1
50965,49774,53,40062,53,allow,234,102,132,2,30,1,1
50966,50875,53,21370,53,allow,78,78,0,1,30,1,0
50967,60031,443,5116,443,allow,350,210,140,6,15,4,2
50968,51943,53,57117,53,allow,200,86,114,2,30,1,1
50969,39435,443,17310,443,allow,2403265,93626,2309639,2795,243,1103,1692
50970,63941,53,9002,53,allow,228,94,134,2,30,1,1
50971,52245,443,44464,443,allow,7488,2474,5014,23,3600,12,11
50972,43595,443,60251,443,allow,31194,5024,26170,44,121,18,26
50973,47823,443,63568,443,allow,9842,2224,7618,20,122,10,10
50974,56970,443,2688,443,allow,20635942,626393,20009549,21680,138,6969,14711
50975,6881,6881,43994,6881,allow,502,150,352,2,1200,1,1
50976,52478,443,31557,443,allow,7985,2085,5900,18,121,8,10
50977,49919,443,15575,443,allow,16012,2097,13915,33,16,15,18
50978,41311,443,64855,443,allow,70,70,0,1,5,1,0
50979,58930,443,53896,443,allow,70,70,0,1,5,1,0
50980,50188,80,44459,80,allow,1746,780,966,19,56,7,12
50981,53668,80,20063,80,allow,1173,665,508,13,16,7,6
50982,57545,443,29665,443,allow,25540,8247,17293,187,574,79,108
50983,49178,2710,40497,2710,allow,70,70,0,1,5,1,0
50984,54376,445,0,0,drop,66,66,0,1,0,1,0
50985,54375,445,0,0,drop,66,66,0,1,0,1,0
50986,58971,445,0,0,drop,70,70,0,1,0,1,0
50987,57768,37965,0,0,deny,66,66,0,1,0,1,0
50988,58969,445,0,0,drop,70,70,0,1,0,1,0
50989,54019,445,0,0,drop,70,70,0,1,0,1,0
50990,58968,445,0,0,drop,70,70,0,1,0,1,0
50991,58962,445,0,0,drop,70,70,0,1,0,1,0
50992,58959,445,0,0,drop,70,70,0,1,0,1,0
50993,59943,37807,0,0,deny,62,62,0,1,0,1,0
50994,54018,445,0,0,drop,70,70,0,1,0,1,0
50995,49177,54532,0,0,deny,60,60,0,1,0,1,0
50996,47762,36180,0,0,deny,146,146,0,1,0,1,0
50997,58811,53976,0,0,deny,66,66,0,1,0,1,0
50998,54016,445,0,0,drop,70,70,0,1,0,1,0
50999,1025,35447,0,0,deny,62,62,0,1,0,1,0
51000,58562,57587,0,0,deny,66,66,0,1,0,1,0
51001,43611,50939,0,0,deny,145,145,0,1,0,1,0
51002,52095,56079,0,0,deny,66,66,0,1,0,1,0
51003,47652,51505,0,0,deny,62,62,0,1,0,1,0
51004,58952,445,0,0,drop,70,70,0,1,0,1,0
51005,58950,445,0,0,drop,70,70,0,1,0,1,0
51006,58946,445,0,0,drop,70,70,0,1,0,1,0
51007,4269,26672,0,0,deny,60,60,0,1,0,1,0
51008,54009,445,0,0,drop,70,70,0,1,0,1,0
51009,27153,992,0,0,deny,60,60,0,1,0,1,0
51010,50280,57470,0,0,deny,78,78,0,1,0,1,0
51011,33305,54532,0,0,deny,60,60,0,1,0,1,0
51012,39313,37965,0,0,deny,62,62,0,1,0,1,0
51013,54007,445,0,0,drop,70,70,0,1,0,1,0
51014,39540,37965,0,0,deny,66,66,0,1,0,1,0
51015,48706,23393,0,0,deny,60,60,0,1,0,1,0
51016,5774,37965,0,0,deny,66,66,0,1,0,1,0
51017,54006,445,0,0,drop,70,70,0,1,0,1,0
51018,54005,445,0,0,drop,70,70,0,1,0,1,0
51019,54004,445,0,0,drop,70,70,0,1,0,1,0
51020,54002,445,0,0,drop,70,70,0,1,0,1,0
51021,53999,445,0,0,drop,70,70,0,1,0,1,0
51022,54355,445,0,0,drop,66,66,0,1,0,1,0
51023,58944,445,0,0,drop,70,70,0,1,0,1,0
51024,58941,445,0,0,drop,70,70,0,1,0,1,0
51025,58264,44847,0,0,deny,66,66,0,1,0,1,0
51026,53986,445,0,0,drop,70,70,0,1,0,1,0
51027,53985,445,0,0,drop,70,70,0,1,0,1,0
51028,53976,445,0,0,drop,70,70,0,1,0,1,0
51029,53975,445,0,0,drop,70,70,0,1,0,1,0
51030,62907,21,0,0,deny,60,60,0,1,0,1,0
51031,58751,9571,0,0,deny,62,62,0,1,0,1,0
51032,16948,990,0,0,deny,60,60,0,1,0,1,0
51033,54348,445,0,0,drop,66,66,0,1,0,1,0
51034,6712,161,0,0,deny,82,82,0,1,0,1,0
51035,12232,41864,0,0,deny,139,139,0,1,0,1,0
51036,54345,445,0,0,drop,66,66,0,1,0,1,0
51037,58934,445,0,0,drop,70,70,0,1,0,1,0
51038,64586,50584,0,0,deny,146,146,0,1,0,1,0
51039,58924,445,0,0,drop,70,70,0,1,0,1,0
51040,58923,445,0,0,drop,70,70,0,1,0,1,0
51041,58922,445,0,0,drop,70,70,0,1,0,1,0
51042,54342,445,0,0,drop,66,66,0,1,0,1,0
51043,3559,30188,0,0,deny,66,66,0,1,0,1,0
51044,50522,443,53720,443,allow,460,394,66,4,0,3,1
51045,43688,22114,0,0,deny,62,62,0,1,0,1,0
51046,53964,445,0,0,drop,70,70,0,1,0,1,0
51047,63586,46824,0,0,deny,62,62,0,1,0,1,0
51048,18246,64097,0,0,deny,66,66,0,1,0,1,0
51049,45941,23386,0,0,deny,60,60,0,1,0,1,0
51050,55921,43890,0,0,deny,66,66,0,1,0,1,0
51051,58917,445,0,0,drop,70,70,0,1,0,1,0
51052,55225,11392,0,0,deny,62,62,0,1,0,1,0
51053,58914,445,0,0,drop,70,70,0,1,0,1,0
51054,58910,445,0,0,drop,70,70,0,1,0,1,0
51055,58912,445,0,0,drop,70,70,0,1,0,1,0
51056,10265,64147,0,0,deny,62,62,0,1,0,1,0
51057,54336,445,0,0,drop,66,66,0,1,0,1,0
51058,52160,1,0,0,deny,145,145,0,1,0,1,0
51059,54330,445,0,0,drop,66,66,0,1,0,1,0
51060,54332,445,0,0,drop,66,66,0,1,0,1,0
51061,54328,445,0,0,drop,66,66,0,1,0,1,0
51062,43611,32480,0,0,deny,109,109,0,1,0,1,0
51063,53960,445,0,0,drop,70,70,0,1,0,1,0
51064,54324,445,0,0,drop,66,66,0,1,0,1,0
51065,54323,445,0,0,drop,66,66,0,1,0,1,0
51066,54325,445,0,0,drop,66,66,0,1,0,1,0
51067,52726,56205,0,0,deny,62,62,0,1,0,1,0
51068,63205,9571,0,0,deny,62,62,0,1,0,1,0
51069,41298,51050,0,0,deny,62,62,0,1,0,1,0
51070,19697,26296,0,0,deny,159,159,0,1,0,1,0
51071,26494,26467,0,0,deny,62,62,0,1,0,1,0
51072,53950,445,0,0,drop,70,70,0,1,0,1,0
51073,53949,445,0,0,drop,70,70,0,1,0,1,0
51074,53945,445,0,0,drop,70,70,0,1,0,1,0
51075,53948,445,0,0,drop,70,70,0,1,0,1,0
51076,59377,9319,0,0,deny,62,62,0,1,0,1,0
51077,58909,445,0,0,drop,70,70,0,1,0,1,0
51078,58906,445,0,0,drop,70,70,0,1,0,1,0
51079,53944,445,0,0,drop,70,70,0,1,0,1,0
51080,58902,445,0,0,drop,70,70,0,1,0,1,0
51081,54320,445,0,0,drop,66,66,0,1,0,1,0
51082,58901,445,0,0,drop,70,70,0,1,0,1,0
51083,51920,30188,0,0,deny,66,66,0,1,0,1,0
51084,42241,11392,0,0,deny,62,62,0,1,0,1,0
51085,54318,445,0,0,drop,66,66,0,1,0,1,0
51086,50116,22,0,0,deny,60,60,0,1,0,1,0
51087,54315,445,0,0,drop,66,66,0,1,0,1,0
51088,54314,445,0,0,drop,66,66,0,1,0,1,0
51089,54313,445,0,0,drop,66,66,0,1,0,1,0
51090,26480,64147,0,0,deny,62,62,0,1,0,1,0
51091,2425,23117,0,0,deny,66,66,0,1,0,1,0
51092,53938,445,0,0,drop,70,70,0,1,0,1,0
51093,58893,445,0,0,drop,70,70,0,1,0,1,0
51094,49255,44847,0,0,deny,66,66,0,1,0,1,0
51095,13285,29892,0,0,deny,145,145,0,1,0,1,0
51096,13285,29892,0,0,deny,145,145,0,1,0,1,0
51097,58891,445,0,0,drop,70,70,0,1,0,1,0
51098,58888,445,0,0,drop,70,70,0,1,0,1,0
51099,21892,15503,0,0,deny,62,62,0,1,0,1,0
51100,53930,445,0,0,drop,70,70,0,1,0,1,0
51101,52111,44847,0,0,deny,66,66,0,1,0,1,0
51102,53928,445,0,0,drop,70,70,0,1,0,1,0
51103,61234,48817,0,0,deny,106,106,0,1,0,1,0
51104,38320,51505,0,0,deny,66,66,0,1,0,1,0
51105,54304,445,0,0,drop,66,66,0,1,0,1,0
51106,61838,37965,0,0,deny,66,66,0,1,0,1,0
51107,13581,51505,0,0,deny,66,66,0,1,0,1,0
51108,53924,445,0,0,drop,70,70,0,1,0,1,0
51109,15959,56205,0,0,deny,62,62,0,1,0,1,0
51110,53922,445,0,0,drop,70,70,0,1,0,1,0
51111,54294,445,0,0,drop,66,66,0,1,0,1,0
51112,58879,445,0,0,drop,70,70,0,1,0,1,0
51113,53918,445,0,0,drop,70,70,0,1,0,1,0
51114,31978,57470,0,0,deny,60,60,0,1,0,1,0
51115,54292,445,0,0,drop,66,66,0,1,0,1,0
51116,21173,37965,0,0,deny,62,62,0,1,0,1,0
51117,53917,445,0,0,drop,70,70,0,1,0,1,0
51118,5357,32468,0,0,deny,62,62,0,1,0,1,0
51119,52177,25320,0,0,deny,66,66,0,1,0,1,0
51120,1026,64147,0,0,deny,145,145,0,1,0,1,0
51121,54285,445,0,0,drop,66,66,0,1,0,1,0
51122,1024,5529,0,0,deny,146,146,0,1,0,1,0
51123,54278,445,0,0,drop,66,66,0,1,0,1,0
51124,1067,51221,0,0,deny,62,62,0,1,0,1,0
51125,6037,43890,0,0,deny,74,74,0,1,0,1,0
51126,57504,44847,0,0,deny,66,66,0,1,0,1,0
51127,27005,27017,65015,27017,allow,880,126,754,2,30,1,1
51128,37096,443,16174,443,allow,130,70,60,2,15,1,1
51129,64570,443,7059,443,allow,24984,2042,22942,41,32,19,22
51130,49486,443,60567,443,allow,4160,1015,3145,16,28,8,8
51131,49527,443,43125,443,allow,5968,985,4983,17,26,8,9
51132,53624,7370,12914,7370,allow,70,70,0,2,8,2,0
51133,53632,58037,4206,58037,allow,70,70,0,2,8,2,0
51134,55622,33342,63556,33342,allow,70,70,0,2,8,2,0
51135,53012,80,53012,80,allow,278027,5087,272940,288,22,76,212
51136,37182,80,39276,80,allow,1638,1324,314,10,16,5,5
51137,50604,443,50604,443,allow,4716,1809,2907,19,30,11,8
51138,49498,443,53084,443,allow,4172,1018,3154,16,27,8,8
51139,54125,443,54125,443,allow,65572,14874,50698,92,84,48,44
51140,55691,443,55691,443,allow,165616,8760,156856,199,82,79,120
51141,20520,53,20520,53,allow,215,80,135,2,32,1,1
51142,55620,20795,23864,20795,allow,70,70,0,2,8,2,0
51143,64797,80,54604,80,allow,378,192,186,7,71,4,3
51144,54124,443,54124,443,allow,105609,16179,89430,150,84,79,71
51145,47750,443,44039,443,allow,70,70,0,1,5,1,0
51146,39630,443,32291,443,allow,70,70,0,1,5,1,0
51147,47871,443,47202,443,allow,70,70,0,1,5,1,0
51148,56515,443,56741,443,allow,5083,969,4114,18,32,10,8
51149,56973,443,43404,443,allow,22953,5010,17943,38,123,14,24
51150,27005,27015,35469,27015,allow,886,126,760,2,30,1,1
51151,40603,443,49368,443,allow,9462,6402,3060,32,394,11,21
51152,49512,443,31852,443,allow,7626,1741,5885,35,256,17,18
51153,54711,443,57738,443,allow,7169,2405,4764,18,135,10,8
51154,51813,63933,50803,63933,allow,70,70,0,2,8,2,0
51155,38557,443,3043,443,allow,70,70,0,1,5,1,0
51156,51819,59208,38763,59208,allow,70,70,0,1,5,1,0
51157,56968,80,38598,80,allow,2273,1511,762,7,29,4,3
51158,43029,443,37384,443,allow,6053,1321,4732,19,980,9,10
51159,53121,8986,41857,8986,allow,70,70,0,2,8,2,0
51160,34203,443,27925,443,allow,33068,2556,30512,48,81,21,27
51161,49526,443,23120,443,allow,6032,1049,4983,18,26,9,9
51162,61168,443,61168,443,allow,4599,1692,2907,19,29,11,8
51163,1183,53,1183,53,allow,213,79,134,2,33,1,1
51164,49859,80,22070,80,allow,1644,1324,320,10,15,5,5
51165,58477,443,37357,443,allow,10026,5706,4320,20,120,10,10
51166,55619,443,51009,443,allow,13144,7075,6069,33,161,16,17
51167,56514,443,14098,443,allow,5084,969,4115,18,32,10,8
51168,51817,54601,57265,54601,allow,316,136,180,6,7,3,3
51169,54121,443,54121,443,allow,184574,24037,160537,209,84,87,122
51170,54114,443,54114,443,allow,171467,27550,143917,220,85,108,112
51171,27930,53,0,0,allow,222,82,140,2,30,1,1
51172,54122,443,54122,443,allow,186718,24971,161747,253,84,127,126
51173,59240,53,59240,53,allow,194,87,107,2,30,1,1
51174,6881,6881,7756,6881,allow,501,150,351,2,1200,1,1
51175,55201,22114,0,0,deny,66,66,0,1,0,1,0
51176,9104,26296,0,0,deny,157,157,0,1,0,1,0
51177,53912,445,0,0,drop,70,70,0,1,0,1,0
51178,58865,445,0,0,drop,70,70,0,1,0,1,0
51179,58862,445,0,0,drop,70,70,0,1,0,1,0
51180,58861,445,0,0,drop,70,70,0,1,0,1,0
51181,61481,443,1524,443,allow,23229,1880,21349,46,80,21,25
51182,3254,3389,3254,3389,allow,3790,1685,2105,18,17,10,8
51183,53626,33194,41822,33194,allow,70,70,0,2,7,2,0
51184,53629,51413,13341,51413,allow,70,70,0,2,7,2,0
51185,55996,53,10816,53,allow,168,86,82,2,30,1,1
51186,55431,443,58607,443,allow,999955,25445,974510,1003,171,325,678
51187,39446,443,32219,443,allow,1647482,62713,1584769,1898,219,744,1154
51188,63788,80,49704,80,allow,314,192,122,6,15,4,2
51189,49636,443,28958,443,allow,50297,4871,45426,86,31,40,46
51190,27005,27016,25389,27016,allow,1006,252,754,4,32,3,1
51191,51403,443,50805,443,allow,190,70,120,4,8,2,2
51192,52438,443,56919,443,allow,70,70,0,1,4,1,0
51193,57160,53,20461,53,allow,255,110,145,2,29,1,1
51194,39596,53,5876,53,allow,168,78,90,2,30,1,1
51195,64700,53,35656,53,allow,239,86,153,2,29,1,1
51196,65404,53,47407,53,allow,334,226,108,3,29,2,1
51197,62724,443,47821,443,allow,87797,47766,40031,754,453,303,451
51198,52409,443,39608,443,allow,1369,708,661,14,24,8,6
51199,55429,443,27216,443,allow,343735,15691,328044,423,171,179,244
51200,50469,443,24709,443,allow,3049,1569,1480,17,19,10,7
51201,50460,443,36423,443,allow,5572,4252,1320,18,34,11,7
51202,56519,80,41989,80,allow,370,222,148,6,32,4,2
51203,52405,53,59064,53,allow,168,78,90,2,30,1,1
51204,46972,443,1778,443,allow,45264,4281,40983,59,120,24,35
51205,37965,4546,34269,4546,allow,3957,2324,1633,51,1720,29,22
51206,56351,53,2881,53,allow,195,102,93,2,30,1,1
51207,49494,443,9142,443,allow,4168,1018,3150,16,27,8,8
51208,55996,53,61146,53,allow,196,86,110,2,30,1,1
51209,49511,443,56126,443,allow,1200,623,577,13,27,6,7
51210,60192,53,4239,53,allow,236,94,142,2,30,1,1
51211,56259,53,56259,53,allow,244,98,146,2,32,1,1
51212,41472,443,2469,443,allow,4500,2769,1731,29,80,14,15
51213,49531,443,58024,443,allow,8107,2474,5633,24,25,12,12
51214,56452,53,0,0,allow,82,82,0,2,40,2,0
51215,50456,80,33099,80,allow,4473,3398,1075,14,34,8,6
51216,52410,443,38111,443,allow,128802,48896,79906,237,24,121,116
51217,49495,443,17412,443,allow,12452,10841,1611,26,27,14,12
51218,55428,443,63993,443,allow,74784,4781,70003,122,171,55,67
51219,56502,443,5913,443,allow,5414,1010,4404,17,33,9,8
51220,42804,443,52813,443,allow,8113,1626,6487,24,21,14,10
51221,52411,443,20618,443,allow,9428,3770,5658,54,24,28,26
51222,50454,80,32603,80,allow,4185,3618,567,14,34,8,6
51223,36682,443,16201,443,allow,4590,3104,1486,25,95,14,11
51224,55980,123,7764,123,allow,184,94,90,2,30,1,1
51225,50453,80,44692,80,allow,5978,3592,2386,15,34,8,7
51226,56584,53,11866,53,allow,214,102,112,2,30,1,1
51227,56977,53,42818,53,allow,273,102,171,2,30,1,1
51228,53392,53,29793,53,allow,164,78,86,2,31,1,1
51229,49522,443,12494,443,allow,3090,1796,1294,19,26,10,9
51230,49477,443,54783,443,allow,1332,876,456,11,27,6,5
51231,49532,80,7798,80,allow,4577,3951,626,11,25,6,5
51232,51815,28665,41311,28665,allow,70,70,0,2,7,2,0
51233,55621,28144,20259,28144,allow,70,70,0,2,8,2,0
51234,59789,443,5705,443,allow,6695,2021,4674,23,45,11,12
51235,49518,80,62849,80,allow,11011,7675,3336,21,26,11,10
51236,50229,80,35977,80,allow,1743,979,764,13,81,7,6
51237,54123,443,54123,443,allow,79652,20710,58942,112,84,58,54
51238,41064,80,41064,80,allow,2118,1493,625,9,82,6,3
51239,49637,443,18252,443,allow,50296,4666,45630,90,31,43,47
51240,64907,53,16767,53,allow,211,102,109,2,30,1,1
51241,27005,27017,4799,27017,allow,883,126,757,2,30,1,1
51242,63464,443,28849,443,allow,3120,976,2144,13,135,6,7
51243,56258,443,7050,443,allow,3325,1067,2258,13,135,6,7
51244,56351,53,53304,53,allow,195,102,93,2,33,1,1
51245,51796,48779,32373,48779,allow,70,70,0,1,5,1,0
51246,50471,80,51148,80,allow,1658,1247,411,8,15,5,3
51247,50631,443,5471,443,allow,4158,1021,3137,15,26,8,7
51248,55430,443,62629,443,allow,805321,15163,790158,752,171,204,548
51249,56513,443,40120,443,allow,4989,1014,3975,16,32,9,7
51250,49508,443,35365,443,allow,4151,1015,3136,16,27,8,8
51251,49491,443,28351,443,allow,1627,884,743,12,27,6,6
51252,64778,53,20977,53,allow,269,110,159,2,30,1,1
51253,34671,53,40615,53,allow,168,78,90,2,30,1,1
51254,49988,53,19025,53,allow,214,102,112,2,30,1,1
51255,27005,27015,3616,27015,allow,887,126,761,2,30,1,1
51256,60180,53,36445,53,allow,225,110,115,2,30,1,1
51257,53628,50514,20883,50514,allow,70,70,0,2,7,2,0
51258,36516,443,59096,443,allow,70,70,0,1,4,1,0
51259,64609,53,8196,53,allow,404,95,309,4,43,2,2
51260,40848,8434,40848,8434,allow,156,156,0,3,8,3,0
51261,51814,55393,12935,55393,allow,70,70,0,2,7,2,0
51262,42469,80,53240,80,allow,2169,1419,750,10,15,6,4
51263,51518,443,15866,443,allow,38155,33545,4610,79,26,42,37
51264,49496,443,45834,443,allow,15404,11220,4184,29,27,16,13
51265,48713,80,47813,80,allow,1767,751,1016,10,15,6,4
51266,44417,53,0,0,allow,82,82,0,2,40,2,0
51267,51501,443,62787,443,allow,10861,5281,5580,65,49,33,32
51268,53630,64745,62898,64745,allow,70,70,0,2,7,2,0
51269,64488,53,54282,53,allow,356,98,258,4,35,2,2
51270,50461,443,58774,443,allow,5440,4368,1072,19,34,11,8
51271,54972,80,43170,80,allow,1074,691,383,12,66,7,5
51272,62883,53,56502,53,allow,205,86,119,2,29,1,1
51273,48883,53,16845,53,allow,168,78,90,2,30,1,1
51274,53600,8999,29889,8999,allow,492,306,186,8,15,5,3
51275,49489,443,60116,443,allow,1627,884,743,12,27,6,6
51276,65087,53,63765,53,allow,230,110,120,2,30,1,1
51277,64979,53,11759,53,allow,254,102,152,2,30,1,1
51278,65072,53,64909,53,allow,338,110,228,2,29,1,1
51279,57470,6881,50879,6881,allow,1806,726,1080,24,2426,12,12
51280,45563,443,24709,443,allow,1022491,42917,979574,1099,36,416,683
51281,61480,443,37591,443,allow,5716,1341,4375,29,80,16,13
51282,51820,53738,52497,53738,allow,70,70,0,1,5,1,0
51283,50455,80,38947,80,allow,4395,3599,796,15,34,8,7
51284,49490,443,58298,443,allow,1627,884,743,12,27,6,6
51285,50265,37083,2868,37083,allow,490,150,340,2,1200,1,1
51286,51797,30712,27964,30712,allow,70,70,0,1,5,1,0
51287,50465,80,35475,80,allow,8499,2011,6488,17,21,8,9
51288,50447,80,50342,80,allow,67694,29654,38040,85,37,40,45
51289,60889,443,46801,443,allow,9959,2430,7529,27,46,16,11
51290,30127,53,30127,53,allow,197,90,107,2,30,1,1
51291,63925,53,47553,53,allow,388,134,254,2,30,1,1
51292,49713,53,41539,53,allow,233,94,139,2,30,1,1
51293,65037,53,14259,53,allow,243,94,149,2,30,1,1
51294,49509,443,19603,443,allow,4091,1015,3076,15,27,8,7
51295,49507,443,13013,443,allow,4151,1015,3136,16,27,8,8
51296,49500,443,37954,443,allow,1197,620,577,13,27,6,7
51297,53103,443,15301,443,allow,130,70,60,2,15,1,1
51298,65340,53,10565,53,allow,226,102,124,2,30,1,1
51299,65102,53,16634,53,allow,210,102,108,2,30,1,1
51300,59052,53,10639,53,allow,504,110,394,2,30,1,1
51301,17750,58572,62694,58572,allow,150,150,0,1,1200,1,0
51302,56816,53,22918,53,allow,233,94,139,2,30,1,1
51303,57470,27232,13855,27232,allow,4212,2724,1488,57,2411,33,24
51304,49503,443,6313,443,allow,20565,2848,17717,31,27,10,21
51305,56940,80,20270,80,allow,2925,1480,1445,11,30,7,4
51306,65209,53,17107,53,allow,212,102,110,2,30,1,1
51307,56707,53,58987,53,allow,199,94,105,2,30,1,1
51308,44550,80,64720,80,allow,3577,1983,1594,18,153,9,9
51309,37307,443,33957,443,allow,9563,2336,7227,25,15,14,11
51310,56599,443,36954,443,allow,348780,9144,339636,358,32,123,235
51311,48658,443,56881,443,allow,6799,4474,2325,38,85,20,18
51312,60755,40010,18324,40010,allow,316,136,180,6,7,3,3
51313,51558,37965,0,0,deny,72,72,0,1,0,1,0
51314,54266,445,0,0,drop,66,66,0,1,0,1,0
51315,54269,445,0,0,drop,66,66,0,1,0,1,0
51316,54264,445,0,0,drop,66,66,0,1,0,1,0
51317,54267,445,0,0,drop,66,66,0,1,0,1,0
51318,54268,445,0,0,drop,66,66,0,1,0,1,0
51319,54263,445,0,0,drop,66,66,0,1,0,1,0
51320,54262,445,0,0,drop,66,66,0,1,0,1,0
51321,54261,445,0,0,drop,66,66,0,1,0,1,0
51322,36080,26467,0,0,deny,62,62,0,1,0,1,0
51323,62414,50584,0,0,deny,66,66,0,1,0,1,0
51324,11677,56205,0,0,deny,66,66,0,1,0,1,0
51325,60147,25198,0,0,deny,148,148,0,1,0,1,0
51326,18950,50584,0,0,deny,146,146,0,1,0,1,0
51327,18950,50584,0,0,deny,62,62,0,1,0,1,0
51328,47700,51505,0,0,deny,66,66,0,1,0,1,0
51329,53899,445,0,0,drop,70,70,0,1,0,1,0
51330,8191,51221,0,0,deny,62,62,0,1,0,1,0
51331,11385,48543,0,0,deny,145,145,0,1,0,1,0
51332,43260,41615,0,0,deny,145,145,0,1,0,1,0
51333,53894,445,0,0,drop,70,70,0,1,0,1,0
51334,58853,445,0,0,drop,70,70,0,1,0,1,0
51335,58851,445,0,0,drop,70,70,0,1,0,1,0
51336,58850,445,0,0,drop,70,70,0,1,0,1,0
51337,54248,445,0,0,drop,66,66,0,1,0,1,0
51338,54247,445,0,0,drop,66,66,0,1,0,1,0
51339,54246,445,0,0,drop,66,66,0,1,0,1,0
51340,52643,15941,0,0,deny,66,66,0,1,0,1,0
51341,24450,48817,0,0,deny,157,157,0,1,0,1,0
51342,55032,62413,0,0,deny,66,66,0,1,0,1,0
51343,2394,43890,0,0,deny,62,62,0,1,0,1,0
51344,62152,56205,0,0,deny,66,66,0,1,0,1,0
51345,443,1785,0,0,deny,97,97,0,1,0,1,0
51346,55248,67,0,0,deny,60,60,0,1,0,1,0
51347,53890,445,0,0,drop,70,70,0,1,0,1,0
51348,61962,53733,0,0,deny,66,66,0,1,0,1,0
51349,7286,51221,0,0,deny,62,62,0,1,0,1,0
51350,58841,445,0,0,drop,70,70,0,1,0,1,0
51351,55157,7302,0,0,deny,66,66,0,1,0,1,0
51352,58840,445,0,0,drop,70,70,0,1,0,1,0
51353,58839,445,0,0,drop,70,70,0,1,0,1,0
51354,58835,445,0,0,drop,70,70,0,1,0,1,0
51355,57473,23,0,0,deny,60,60,0,1,0,1,0
51356,51525,35440,0,0,deny,66,66,0,1,0,1,0
51357,53886,445,0,0,drop,70,70,0,1,0,1,0
51358,50280,57470,0,0,deny,78,78,0,1,0,1,0
51359,33305,54532,0,0,deny,60,60,0,1,0,1,0
51360,1024,57470,0,0,deny,62,62,0,1,0,1,0
51361,61223,37965,0,0,deny,66,66,0,1,0,1,0
51362,59201,51221,0,0,deny,62,62,0,1,0,1,0
51363,62337,44847,0,0,deny,66,66,0,1,0,1,0
51364,43129,15503,0,0,deny,62,62,0,1,0,1,0
51365,6931,55108,0,0,deny,139,139,0,1,0,1,0
51366,50031,44847,0,0,deny,70,70,0,1,0,1,0
51367,59430,50584,0,0,deny,66,66,0,1,0,1,0
51368,63263,57470,0,0,deny,66,66,0,1,0,1,0
51369,50562,37965,0,0,deny,62,62,0,1,0,1,0
51370,53879,445,0,0,drop,70,70,0,1,0,1,0
51371,1880,57470,0,0,deny,146,146,0,1,0,1,0
51372,58824,445,0,0,drop,70,70,0,1,0,1,0
51373,58822,445,0,0,drop,70,70,0,1,0,1,0
51374,58818,445,0,0,drop,70,70,0,1,0,1,0
51375,53877,445,0,0,drop,70,70,0,1,0,1,0
51376,53876,445,0,0,drop,70,70,0,1,0,1,0
51377,53875,445,0,0,drop,70,70,0,1,0,1,0
51378,53874,445,0,0,drop,70,70,0,1,0,1,0
51379,53872,445,0,0,drop,70,70,0,1,0,1,0
51380,53870,445,0,0,drop,70,70,0,1,0,1,0
51381,5729,22114,0,0,deny,66,66,0,1,0,1,0
51382,22904,56205,0,0,deny,62,62,0,1,0,1,0
51383,22904,56205,0,0,deny,146,146,0,1,0,1,0
51384,1880,57470,0,0,deny,146,146,0,1,0,1,0
51385,54223,445,0,0,drop,66,66,0,1,0,1,0
51386,64175,56502,0,0,deny,66,66,0,1,0,1,0
51387,32007,1212,0,0,deny,145,145,0,1,0,1,0
51388,58815,445,0,0,drop,70,70,0,1,0,1,0
51389,58814,445,0,0,drop,70,70,0,1,0,1,0
51390,53856,445,0,0,drop,70,70,0,1,0,1,0
51391,53855,445,0,0,drop,70,70,0,1,0,1,0
51392,53853,445,0,0,drop,70,70,0,1,0,1,0
51393,53845,445,0,0,drop,70,70,0,1,0,1,0
51394,53846,445,0,0,drop,70,70,0,1,0,1,0
51395,52112,26467,0,0,deny,66,66,0,1,0,1,0
51396,80,44459,0,0,deny,66,66,0,1,0,1,0
51397,17640,55442,0,0,deny,62,62,0,1,0,1,0
51398,45673,30188,0,0,deny,62,62,0,1,0,1,0
51399,54991,36829,0,0,deny,62,62,0,1,0,1,0
51400,54218,445,0,0,drop,66,66,0,1,0,1,0
51401,25015,64147,0,0,deny,66,66,0,1,0,1,0
51402,42732,57470,0,0,deny,62,62,0,1,0,1,0
51403,42332,22114,0,0,deny,66,66,0,1,0,1,0
51404,54217,445,0,0,drop,66,66,0,1,0,1,0
51405,58801,445,0,0,drop,70,70,0,1,0,1,0
51406,47030,81,0,0,deny,60,60,0,1,0,1,0
51407,58800,445,0,0,drop,70,70,0,1,0,1,0
51408,58795,445,0,0,drop,70,70,0,1,0,1,0
51409,58792,445,0,0,drop,70,70,0,1,0,1,0
51410,53834,445,0,0,drop,70,70,0,1,0,1,0
51411,54214,445,0,0,drop,66,66,0,1,0,1,0
51412,45060,37965,0,0,deny,62,62,0,1,0,1,0
51413,21213,23,0,0,deny,60,60,0,1,0,1,0
51414,64379,37965,0,0,deny,66,66,0,1,0,1,0
51415,58790,445,0,0,drop,70,70,0,1,0,1,0
51416,58786,445,0,0,drop,70,70,0,1,0,1,0
51417,58785,445,0,0,drop,70,70,0,1,0,1,0
51418,58782,445,0,0,drop,70,70,0,1,0,1,0
51419,51745,57470,0,0,deny,145,145,0,1,0,1,0
51420,15341,23,0,0,deny,60,60,0,1,0,1,0
51421,48676,53392,0,0,deny,60,60,0,1,0,1,0
51422,54206,445,0,0,drop,66,66,0,1,0,1,0
51423,53830,445,0,0,drop,70,70,0,1,0,1,0
51424,34134,30188,0,0,deny,62,62,0,1,0,1,0
51425,54204,445,0,0,drop,66,66,0,1,0,1,0
51426,54202,445,0,0,drop,66,66,0,1,0,1,0
51427,54199,445,0,0,drop,66,66,0,1,0,1,0
51428,63998,21247,0,0,deny,66,66,0,1,0,1,0
51429,58681,36829,0,0,deny,74,74,0,1,0,1,0
51430,16319,44847,0,0,deny,146,146,0,1,0,1,0
51431,54197,445,0,0,drop,66,66,0,1,0,1,0
51432,54198,445,0,0,drop,66,66,0,1,0,1,0
51433,54196,445,0,0,drop,66,66,0,1,0,1,0
51434,42034,28189,0,0,deny,62,62,0,1,0,1,0
51435,53820,445,0,0,drop,70,70,0,1,0,1,0
51436,53819,445,0,0,drop,70,70,0,1,0,1,0
51437,63598,64147,0,0,deny,66,66,0,1,0,1,0
51438,53817,445,0,0,drop,70,70,0,1,0,1,0
51439,53816,445,0,0,drop,70,70,0,1,0,1,0
51440,64880,9694,0,0,deny,66,66,0,1,0,1,0
51441,53813,445,0,0,drop,70,70,0,1,0,1,0
51442,58779,445,0,0,drop,70,70,0,1,0,1,0
51443,58778,445,0,0,drop,70,70,0,1,0,1,0
51444,58777,445,0,0,drop,70,70,0,1,0,1,0
51445,0,0,0,0,allow,152,78,74,2,0,1,1
51446,54191,445,0,0,drop,66,66,0,1,0,1,0
51447,58773,445,0,0,drop,70,70,0,1,0,1,0
51448,54189,445,0,0,drop,66,66,0,1,0,1,0
51449,57982,64147,0,0,deny,66,66,0,1,0,1,0
51450,54188,445,0,0,drop,66,66,0,1,0,1,0
51451,54187,445,0,0,drop,66,66,0,1,0,1,0
51452,54184,445,0,0,drop,66,66,0,1,0,1,0
51453,53807,445,0,0,drop,70,70,0,1,0,1,0
51454,3911,50584,0,0,deny,62,62,0,1,0,1,0
51455,59696,57470,0,0,deny,62,62,0,1,0,1,0
51456,32007,26543,0,0,deny,145,145,0,1,0,1,0
51457,58765,445,0,0,drop,70,70,0,1,0,1,0
51458,60627,51050,0,0,deny,66,66,0,1,0,1,0
51459,65501,26467,0,0,deny,62,62,0,1,0,1,0
51460,58764,445,0,0,drop,70,70,0,1,0,1,0
51461,58759,445,0,0,drop,70,70,0,1,0,1,0
51462,53800,445,0,0,drop,70,70,0,1,0,1,0
51463,53799,445,0,0,drop,70,70,0,1,0,1,0
51464,32096,55108,0,0,deny,139,139,0,1,0,1,0
51465,31978,57470,0,0,deny,60,60,0,1,0,1,0
51466,60875,50584,0,0,deny,62,62,0,1,0,1,0
51467,55396,26467,0,0,deny,62,62,0,1,0,1,0
51468,53833,26467,0,0,deny,66,66,0,1,0,1,0
51469,50227,57470,0,0,deny,66,66,0,1,0,1,0
51470,54176,445,0,0,drop,66,66,0,1,0,1,0
51471,53794,445,0,0,drop,70,70,0,1,0,1,0
51472,60294,30188,0,0,deny,62,62,0,1,0,1,0
51473,53792,445,0,0,drop,70,70,0,1,0,1,0
51474,58074,11392,0,0,deny,62,62,0,1,0,1,0
51475,61323,23117,0,0,deny,62,62,0,1,0,1,0
51476,45964,5333,0,0,deny,60,60,0,1,0,1,0
51477,54166,445,0,0,drop,66,66,0,1,0,1,0
51478,58747,445,0,0,drop,70,70,0,1,0,1,0
51479,25085,30188,0,0,deny,66,66,0,1,0,1,0
51480,53788,445,0,0,deny,70,70,0,1,0,1,0
51481,3564,57470,0,0,deny,62,62,0,1,0,1,0
51482,46576,23718,0,0,deny,66,66,0,1,0,1,0
51483,34095,53,34095,53,allow,243,104,139,2,30,1,1
51484,28121,443,57798,443,allow,9075,2662,6413,34,462,16,18
51485,56645,443,5860,443,allow,32966,3481,29485,49,80,21,28
51486,33784,443,3722,443,allow,2378,1126,1252,14,979,7,7
51487,46859,15000,30674,15000,allow,130,70,60,2,6,1,1
51488,51811,20740,61529,20740,allow,70,70,0,2,8,2,0
51489,36241,443,45879,443,allow,7768,3776,3992,21,132,11,10
51490,35012,443,7162,443,allow,1461,980,481,11,25,7,4
51491,27005,27016,47379,27016,allow,882,126,756,2,30,1,1
51492,59543,443,39979,443,allow,7358,2661,4697,22,17,11,11
51493,27005,52013,29857,52013,allow,252,252,0,3,32,3,0
51494,63804,52520,33916,52520,allow,66,66,0,2,8,2,0
51495,36445,443,53718,443,allow,78,78,0,1,5,1,0
51496,44320,443,45352,443,allow,1657,1128,529,15,35,9,6
51497,56642,443,26637,443,allow,27108,2396,24712,40,80,18,22
51498,49283,6881,34041,6881,allow,803,617,186,6,16,3,3
51499,51035,443,33243,443,allow,2227,1018,1209,17,16,8,9
51500,58104,443,9408,443,allow,2396,1144,1252,14,979,7,7
51501,65257,53,65257,53,allow,176,78,98,2,30,1,1
51502,64253,53,64253,53,allow,288,83,205,2,30,1,1
51503,64607,443,37548,443,allow,3182,1568,1614,8,120,4,4
51504,53011,80,53011,80,allow,349769,6527,343242,368,22,100,268
51505,49710,53,26259,53,allow,89,89,0,1,30,1,0
51506,47272,443,40986,443,allow,6318,1025,5293,17,35,9,8
51507,63803,41439,2152,41439,allow,66,66,0,2,8,2,0
51508,35105,5222,32302,5222,allow,1964,919,1045,20,16,10,10
51509,59830,443,59830,443,allow,21205,1711,19494,32,1806,11,21
51510,55618,45341,56428,45341,allow,70,70,0,1,5,1,0
51511,53627,1099,28999,1099,allow,320,140,180,6,7,3,3
51512,10570,53,10570,53,allow,215,80,135,2,32,1,1
51513,49282,6881,35216,6881,allow,709,523,186,6,16,3,3
51514,53366,53,53366,53,allow,237,98,139,2,30,1,1
51515,49891,443,42695,443,allow,8211,3683,4528,27,623,14,13
51516,59177,53,0,0,allow,619,76,543,2,30,1,1
51517,47257,443,58413,443,allow,64727,10981,53746,91,141,36,55
51518,57470,44667,49855,44667,allow,480,149,331,2,1200,1,1
51519,47595,33434,0,0,allow,106,106,0,1,60,1,0
51520,56643,443,30724,443,allow,8167,1980,6187,22,80,12,10
51521,43113,443,54317,443,allow,3083,1817,1266,18,15,8,10
51522,27005,27015,11588,27015,allow,1019,252,767,4,32,3,1
51523,54444,443,57397,443,allow,9802,2594,7208,25,360,10,15
51524,9402,53,9402,53,allow,237,91,146,2,32,1,1
51525,48668,7275,13487,7275,allow,276,70,206,5,32,2,3
51526,38168,443,45970,443,allow,6136,1404,4732,20,979,10,10
51527,60405,64722,55660,64722,allow,70,70,0,1,5,1,0
51528,59177,53,0,0,allow,426,152,274,4,30,2,2
51529,57709,53,57709,53,allow,265,111,154,2,30,1,1
51530,27988,40012,43574,40012,allow,253,190,63,2,30,1,1
51531,27005,27014,39253,27014,allow,882,126,756,2,30,1,1
51532,27005,27016,26467,27016,allow,885,126,759,2,30,1,1
51533,64755,443,45264,443,allow,23561,3667,19894,40,121,19,21
51534,10920,53,0,0,allow,266,85,181,2,31,1,1
51535,44399,443,14238,443,allow,11367,9355,2012,32,395,13,19
51536,6882,6889,19915,6889,allow,492,150,342,2,1200,1,1
51537,57470,6882,62846,6882,allow,528,528,0,9,1200,9,0
51538,59766,443,36182,443,allow,508206,39212,468994,748,192,296,452
51539,51086,443,36949,443,allow,11749,5336,6413,32,153,18,14
51540,33965,443,58848,443,allow,31008,10449,20559,69,130,31,38
51541,42744,443,24894,443,allow,224178,118713,105465,333,140,162,171
51542,37965,47686,60898,47686,allow,480,149,331,2,1200,1,1
51543,42898,43890,0,0,deny,62,62,0,1,0,1,0
51544,54164,445,0,0,drop,66,66,0,1,0,1,0
51545,53786,445,0,0,drop,70,70,0,1,0,1,0
51546,6666,401,0,0,deny,60,60,0,1,0,1,0
51547,60319,23,0,0,deny,60,60,0,1,0,1,0
51548,52356,55442,0,0,deny,62,62,0,1,0,1,0
51549,58564,50432,0,0,deny,66,66,0,1,0,1,0
51550,64878,26467,0,0,deny,62,62,0,1,0,1,0
51551,58343,23718,0,0,deny,66,66,0,1,0,1,0
51552,54155,445,0,0,drop,66,66,0,1,0,1,0
51553,21399,35440,0,0,deny,146,146,0,1,0,1,0
51554,54149,445,0,0,drop,66,66,0,1,0,1,0
51555,60406,64337,21894,64337,allow,70,70,0,1,5,1,0
51556,51628,443,16414,443,allow,8084,2509,5575,36,195,19,17
51557,52667,443,52477,443,allow,4797,2794,2003,20,271,11,9
51558,53626,443,63196,443,allow,10520,3200,7320,29,38,16,13
51559,58147,443,65421,443,allow,8365,2826,5539,27,693,15,12
51560,41292,443,17156,443,allow,7644,1098,6546,19,35,10,9
51561,48681,80,45826,80,allow,918,461,457,9,15,6,3
51562,58182,443,50635,443,allow,15327,8305,7022,49,137,24,25
51563,60404,37869,1264,37869,allow,164,70,94,2,5,1,1
51564,41295,443,40323,443,allow,7661,1115,6546,19,35,10,9
51565,39317,443,31071,443,allow,2045,1025,1020,17,80,9,8
51566,49778,53,5798,53,allow,319,98,221,4,53,2,2
51567,56947,53,0,0,allow,86,86,0,1,29,1,0
51568,64099,53,12065,53,allow,227,110,117,2,30,1,1
51569,47091,443,62680,443,allow,3543,1570,1973,18,120,9,9
51570,60752,28080,10717,28080,allow,70,70,0,1,5,1,0
51571,27454,53,27454,53,allow,244,98,146,2,32,1,1
51572,51812,15279,9004,15279,allow,70,70,0,2,8,2,0
51573,51270,48061,22070,48061,allow,70,70,0,1,5,1,0
51574,5588,5588,0,0,allow,3354,1792,1562,46,192,23,23
51575,40498,443,31302,443,allow,9807,2542,7265,47,19,24,23
51576,27005,27018,12355,27018,allow,879,126,753,2,30,1,1
51577,64219,53,37826,53,allow,264,102,162,2,30,1,1
51578,64596,53,15356,53,allow,215,86,129,2,30,1,1
51579,56808,54393,51587,54393,allow,70,70,0,2,8,2,0
51580,35670,443,58907,443,allow,295458,11828,283630,339,185,137,202
51581,51794,53911,18093,53911,allow,70,70,0,1,5,1,0
51582,10051,443,38650,443,allow,11412,1763,9649,27,110,13,14
51583,55708,443,3177,443,allow,10710,4573,6137,53,3376,31,22
51584,49176,443,46832,443,allow,2802,1902,900,22,1118,12,10
51585,50632,443,47511,443,allow,4158,1021,3137,15,26,8,7
51586,39423,80,5862,80,allow,234,234,0,4,12,4,0
51587,64667,53,24129,53,allow,353,118,235,2,30,1,1
51588,46034,53,59880,53,allow,168,78,90,2,30,1,1
51589,49510,443,46546,443,allow,1012,495,517,10,26,4,6
51590,63652,443,53205,443,allow,51005,2084,48921,61,120,22,39
51591,36410,53,36410,53,allow,268,114,154,2,30,1,1
51592,49518,53,34801,53,allow,213,102,111,2,30,1,1
51593,51788,443,22272,443,allow,3679,1712,1967,14,135,7,7
51594,27005,27016,18663,27016,allow,892,126,766,2,30,1,1
51595,56620,80,60684,80,allow,234,234,0,4,12,4,0
51596,49316,53,52712,53,allow,338,102,236,2,30,1,1
51597,27005,27016,43090,27016,allow,878,126,752,2,30,1,1
51598,51795,60258,28772,60258,allow,70,70,0,1,5,1,0
51599,56792,42155,44462,42155,allow,70,70,0,1,5,1,0
51600,49180,53,47398,53,allow,402,102,300,2,30,1,1
51601,63062,53,18913,53,allow,70,70,0,1,30,1,0
51602,50867,443,9876,443,allow,2782,1480,1302,17,15,9,8
51603,41294,443,46411,443,allow,7595,1115,6480,18,35,10,8
51604,49020,80,13819,80,allow,3422,2088,1334,18,152,9,9
51605,39487,80,41504,80,allow,1403,651,752,10,15,6,4
51606,37965,54371,6962,54371,allow,132,132,0,3,1199,3,0
51607,55849,443,27388,443,allow,5944,1501,4443,27,163,13,14
51608,56145,3389,56145,3389,allow,4286,2261,2025,20,17,11,9
51609,51654,80,36290,80,allow,170875,6864,164011,255,35,93,162
51610,60408,55557,8506,55557,allow,70,70,0,1,5,1,0
51611,49402,80,31803,80,allow,405,285,120,5,15,3,2
51612,57419,443,3080,443,allow,9224,2381,6843,29,19,14,15
51613,56791,11500,23499,11500,allow,70,70,0,1,5,1,0
51614,38761,123,12089,123,allow,184,94,90,2,30,1,1
51615,56810,33957,19531,33957,allow,70,70,0,1,5,1,0
51616,64370,53,62116,53,allow,399,102,297,4,54,2,2
51617,64075,53,49394,53,allow,352,86,266,4,36,2,2
51618,65194,53,62268,53,allow,298,102,196,2,29,1,1
51619,54891,80,41573,80,allow,1222,782,440,11,15,6,5
51620,54160,53,34866,53,allow,199,94,105,2,29,1,1
51621,10053,443,28179,443,allow,1832,1113,719,18,110,10,8
51622,27005,27015,45197,27015,allow,881,126,755,2,30,1,1
51623,64893,53,31080,53,allow,232,102,130,2,30,1,1
51624,57432,443,39026,443,allow,2714,336,2378,10,120,5,5
51625,58568,53,2690,53,allow,294,86,208,2,30,1,1
51626,59030,443,52271,443,allow,10079,2210,7869,36,120,19,17
51627,34325,80,9980,80,allow,2243,1115,1128,14,152,7,7
51628,51660,80,21356,80,allow,52002,2984,49018,77,35,35,42
51629,61981,443,61981,443,allow,4533,1626,2907,19,29,11,8
51630,60755,443,57914,443,allow,61151,2474,58677,61,25,16,45
51631,65474,443,34045,443,allow,355358,10960,344398,369,16,131,238
51632,51791,56116,24331,56116,allow,70,70,0,1,5,1,0
51633,51221,47391,14393,47391,allow,323,150,173,2,1203,1,1
51634,56723,53,3556,53,allow,198,94,104,2,30,1,1
51635,33255,443,24023,443,allow,7579,3093,4486,25,21,14,11
51636,51793,12210,25465,12210,allow,70,70,0,1,5,1,0
51637,64276,53,2055,53,allow,436,89,347,4,42,2,2
51638,51499,443,54241,443,allow,1610,1073,537,14,15,8,6
51639,10031,443,14432,443,allow,34551,3731,30820,54,112,23,31
51640,36877,443,64698,443,allow,9787,2382,7405,17,120,7,10
51641,60022,443,9132,443,allow,6906,1458,5448,24,16,14,10
51642,10052,443,12703,443,allow,1832,1113,719,18,110,10,8
51643,64649,53,33149,53,allow,225,102,123,2,30,1,1
51644,50471,53,24459,53,allow,168,78,90,2,30,1,1
51645,44847,6881,11410,6881,allow,502,150,352,2,1200,1,1
51646,47450,443,63060,443,allow,9950,4684,5266,26,306,12,14
51647,63787,18318,22110,18318,allow,70,70,0,1,5,1,0
51648,53602,12395,5014,12395,allow,70,70,0,1,5,1,0
51649,63585,443,56391,443,allow,123421,11745,111676,267,125,108,159
51650,54130,53,45665,53,allow,168,78,90,2,30,1,1
51651,63786,50091,41625,50091,allow,70,70,0,1,5,1,0
51652,1024,57470,0,0,deny,62,62,0,1,0,1,0
51653,53782,445,0,0,drop,70,70,0,1,0,1,0
51654,18632,51505,0,0,deny,66,66,0,1,0,1,0
51655,41037,55839,0,0,deny,157,157,0,1,0,1,0
51656,5690,23,0,0,deny,60,60,0,1,0,1,0
51657,58736,445,0,0,drop,70,70,0,1,0,1,0
51658,58734,445,0,0,drop,70,70,0,1,0,1,0
51659,58733,445,0,0,drop,70,70,0,1,0,1,0
51660,29203,26467,0,0,deny,62,62,0,1,0,1,0
51661,54141,445,0,0,drop,66,66,0,1,0,1,0
51662,54139,445,0,0,drop,66,66,0,1,0,1,0
51663,54138,445,0,0,drop,66,66,0,1,0,1,0
51664,54140,445,0,0,drop,66,66,0,1,0,1,0
51665,54137,445,0,0,drop,66,66,0,1,0,1,0
51666,54136,445,0,0,drop,66,66,0,1,0,1,0
51667,54135,445,0,0,drop,66,66,0,1,0,1,0
51668,54133,445,0,0,drop,66,66,0,1,0,1,0
51669,59505,53733,0,0,deny,66,66,0,1,0,1,0
51670,27064,51221,0,0,deny,72,72,0,1,0,1,0
51671,60683,5900,0,0,deny,60,60,0,1,0,1,0
51672,9219,32480,0,0,deny,72,72,0,1,0,1,0
51673,61808,18375,0,0,deny,66,66,0,1,0,1,0
51674,20012,311,0,0,deny,60,60,0,1,0,1,0
51675,52887,37807,0,0,deny,66,66,0,1,0,1,0
51676,53769,445,0,0,drop,70,70,0,1,0,1,0
51677,53453,2767,0,0,deny,66,66,0,1,0,1,0
51678,32071,51221,0,0,deny,66,66,0,1,0,1,0
51679,62566,35993,0,0,deny,66,66,0,1,0,1,0
51680,6881,26296,0,0,deny,146,146,0,1,0,1,0
51681,53766,445,0,0,drop,70,70,0,1,0,1,0
51682,50280,57470,0,0,deny,78,78,0,1,0,1,0
51683,33305,54532,0,0,deny,60,60,0,1,0,1,0
51684,59745,53635,0,0,deny,66,66,0,1,0,1,0
51685,58729,445,0,0,drop,70,70,0,1,0,1,0
51686,58728,445,0,0,drop,70,70,0,1,0,1,0
51687,58727,445,0,0,drop,70,70,0,1,0,1,0
51688,60152,26467,0,0,deny,62,62,0,1,0,1,0
51689,2949,57470,0,0,deny,66,66,0,1,0,1,0
51690,54121,445,0,0,drop,66,66,0,1,0,1,0
51691,54120,445,0,0,drop,66,66,0,1,0,1,0
51692,54119,445,0,0,drop,66,66,0,1,0,1,0
51693,30765,56205,0,0,deny,66,66,0,1,0,1,0
51694,4127,26467,0,0,deny,62,62,0,1,0,1,0
51695,53928,15503,0,0,deny,62,62,0,1,0,1,0
51696,53761,445,0,0,drop,70,70,0,1,0,1,0
51697,58716,445,0,0,drop,70,70,0,1,0,1,0
51698,60602,15503,0,0,deny,66,66,0,1,0,1,0
51699,53760,445,0,0,drop,70,70,0,1,0,1,0
51700,45941,23388,0,0,deny,60,60,0,1,0,1,0
51701,37876,23,0,0,deny,60,60,0,1,0,1,0
51702,41561,23,0,0,deny,60,60,0,1,0,1,0
51703,53758,445,0,0,drop,70,70,0,1,0,1,0
51704,58713,445,0,0,drop,70,70,0,1,0,1,0
51705,58705,445,0,0,drop,70,70,0,1,0,1,0
51706,58703,445,0,0,drop,70,70,0,1,0,1,0
51707,58701,445,0,0,drop,70,70,0,1,0,1,0
51708,15296,37965,0,0,deny,66,66,0,1,0,1,0
51709,51996,35440,0,0,deny,66,66,0,1,0,1,0
51710,50820,57470,0,0,deny,62,62,0,1,0,1,0
51711,48692,57470,0,0,deny,62,62,0,1,0,1,0
51712,53751,445,0,0,drop,70,70,0,1,0,1,0
51713,53749,445,0,0,drop,70,70,0,1,0,1,0
51714,58694,445,0,0,drop,70,70,0,1,0,1,0
51715,58695,445,0,0,drop,70,70,0,1,0,1,0
51716,58691,445,0,0,drop,70,70,0,1,0,1,0
51717,42798,26467,0,0,deny,62,62,0,1,0,1,0
51718,54997,26467,0,0,deny,66,66,0,1,0,1,0
51719,53748,445,0,0,drop,70,70,0,1,0,1,0
51720,49842,7302,0,0,deny,62,62,0,1,0,1,0
51721,25565,34677,0,0,deny,60,60,0,1,0,1,0
51722,53747,445,0,0,drop,70,70,0,1,0,1,0
51723,60805,5900,0,0,deny,60,60,0,1,0,1,0
51724,53746,445,0,0,drop,70,70,0,1,0,1,0
51725,57478,7302,0,0,deny,62,62,0,1,0,1,0
51726,53740,445,0,0,drop,70,70,0,1,0,1,0
51727,53741,445,0,0,drop,70,70,0,1,0,1,0
51728,50067,64147,0,0,deny,62,62,0,1,0,1,0
51729,7275,9524,0,0,deny,66,66,0,1,0,1,0
51730,23528,44847,0,0,deny,62,62,0,1,0,1,0
51731,64066,23718,0,0,deny,66,66,0,1,0,1,0
51732,3541,22114,0,0,deny,62,62,0,1,0,1,0
51733,11859,64147,0,0,deny,62,62,0,1,0,1,0
51734,53728,445,0,0,drop,70,70,0,1,0,1,0
51735,53727,445,0,0,drop,70,70,0,1,0,1,0
51736,53722,445,0,0,drop,70,70,0,1,0,1,0
51737,54096,445,0,0,drop,66,66,0,1,0,1,0
51738,53718,445,0,0,drop,70,70,0,1,0,1,0
51739,53717,445,0,0,drop,70,70,0,1,0,1,0
51740,22357,6004,0,0,deny,62,62,0,1,0,1,0
51741,58686,445,0,0,drop,70,70,0,1,0,1,0
51742,58685,445,0,0,drop,70,70,0,1,0,1,0
51743,6666,6379,0,0,deny,60,60,0,1,0,1,0
51744,52741,24211,0,0,deny,66,66,0,1,0,1,0
51745,63221,53436,0,0,deny,62,62,0,1,0,1,0
51746,60162,53436,0,0,deny,66,66,0,1,0,1,0
51747,49001,48817,0,0,deny,160,160,0,1,0,1,0
51748,35319,51505,0,0,deny,146,146,0,1,0,1,0
51749,33793,23,0,0,deny,60,60,0,1,0,1,0
51750,38763,30188,0,0,deny,146,146,0,1,0,1,0
51751,48488,50584,0,0,deny,146,146,0,1,0,1,0
51752,64756,11392,0,0,deny,146,146,0,1,0,1,0
51753,50878,53733,0,0,deny,62,62,0,1,0,1,0
51754,54091,445,0,0,drop,66,66,0,1,0,1,0
51755,1024,64147,0,0,deny,62,62,0,1,0,1,0
51756,40547,24051,0,0,deny,74,74,0,1,0,1,0
51757,58468,57587,0,0,deny,66,66,0,1,0,1,0
51758,54089,445,0,0,drop,66,66,0,1,0,1,0
51759,57339,50584,0,0,deny,66,66,0,1,0,1,0
51760,53706,445,0,0,drop,70,70,0,1,0,1,0
51761,58678,445,0,0,drop,70,70,0,1,0,1,0
51762,4000,44847,0,0,deny,66,66,0,1,0,1,0
51763,58671,445,0,0,drop,70,70,0,1,0,1,0
51764,58668,445,0,0,drop,70,70,0,1,0,1,0
51765,58665,445,0,0,drop,70,70,0,1,0,1,0
51766,45964,2225,0,0,deny,60,60,0,1,0,1,0
51767,48020,7484,0,0,deny,60,60,0,1,0,1,0
51768,54086,445,0,0,drop,66,66,0,1,0,1,0
51769,3377,50584,0,0,deny,66,66,0,1,0,1,0
51770,61457,21247,0,0,deny,66,66,0,1,0,1,0
51771,46093,32661,0,0,deny,74,74,0,1,0,1,0
51772,0,0,0,0,allow,480,244,236,4,0,2,2
51773,49690,50265,0,0,deny,66,66,0,1,0,1,0
51774,58660,445,0,0,drop,70,70,0,1,0,1,0
51775,53702,445,0,0,drop,70,70,0,1,0,1,0
51776,58238,23,0,0,deny,60,60,0,1,0,1,0
51777,58658,445,0,0,drop,70,70,0,1,0,1,0
51778,58656,445,0,0,drop,70,70,0,1,0,1,0
51779,58654,445,0,0,drop,70,70,0,1,0,1,0
51780,51413,25864,0,0,deny,72,72,0,1,0,1,0
51781,54078,445,0,0,drop,66,66,0,1,0,1,0
51782,54073,445,0,0,drop,66,66,0,1,0,1,0
51783,54075,445,0,0,drop,66,66,0,1,0,1,0
51784,54074,445,0,0,drop,66,66,0,1,0,1,0
51785,53692,445,0,0,drop,70,70,0,1,0,1,0
51786,53693,445,0,0,drop,70,70,0,1,0,1,0
51787,39895,26467,0,0,deny,62,62,0,1,0,1,0
51788,26799,50584,0,0,deny,62,62,0,1,0,1,0
51789,53688,445,0,0,drop,70,70,0,1,0,1,0
51790,53689,445,0,0,drop,70,70,0,1,0,1,0
51791,54070,445,0,0,drop,66,66,0,1,0,1,0
51792,54069,445,0,0,drop,66,66,0,1,0,1,0
51793,54067,445,0,0,drop,66,66,0,1,0,1,0
51794,53685,445,0,0,drop,70,70,0,1,0,1,0
51795,54062,49813,0,0,deny,62,62,0,1,0,1,0
51796,26560,26467,0,0,deny,66,66,0,1,0,1,0
51797,51244,30228,0,0,deny,100,100,0,1,0,1,0
51798,53779,51505,0,0,deny,66,66,0,1,0,1,0
51799,52447,43890,0,0,deny,62,62,0,1,0,1,0
51800,58652,445,0,0,drop,70,70,0,1,0,1,0
51801,58649,445,0,0,drop,70,70,0,1,0,1,0
51802,58646,445,0,0,drop,70,70,0,1,0,1,0
51803,54064,445,0,0,drop,66,66,0,1,0,1,0
51804,58645,445,0,0,drop,70,70,0,1,0,1,0
51805,54061,445,0,0,drop,66,66,0,1,0,1,0
51806,44854,26467,0,0,deny,62,62,0,1,0,1,0
51807,51026,37450,0,0,deny,66,66,0,1,0,1,0
51808,19875,30170,0,0,deny,145,145,0,1,0,1,0
51809,54060,445,0,0,drop,66,66,0,1,0,1,0
51810,54059,445,0,0,drop,66,66,0,1,0,1,0
51811,53680,445,0,0,drop,70,70,0,1,0,1,0
51812,54057,445,0,0,drop,66,66,0,1,0,1,0
51813,8999,57099,0,0,deny,146,146,0,1,0,1,0
51814,50027,21247,0,0,deny,66,66,0,1,0,1,0
51815,10319,42707,0,0,deny,62,62,0,1,0,1,0
51816,8999,59353,0,0,deny,146,146,0,1,0,1,0
51817,54109,36829,0,0,deny,66,66,0,1,0,1,0
51818,39868,55839,0,0,deny,137,137,0,1,0,1,0
51819,24972,27262,0,0,deny,60,60,0,1,0,1,0
51820,60750,42707,0,0,deny,66,66,0,1,0,1,0
51821,52076,44847,0,0,deny,66,66,0,1,0,1,0
51822,49677,64147,0,0,deny,62,62,0,1,0,1,0
51823,53672,445,0,0,drop,70,70,0,1,0,1,0
51824,44934,443,47157,443,allow,416,210,206,7,24,4,3
51825,61666,80,7138,80,allow,16580,1400,15180,33,48,15,18
51826,46983,443,17844,443,allow,2809,1884,925,19,25,11,8
51827,63571,443,39273,443,allow,1882441,60775,1821666,2129,129,795,1334
51828,55877,27906,5770,27906,allow,480,149,331,2,1200,1,1
51829,38133,53,38133,53,allow,194,87,107,2,30,1,1
51830,44564,22,44564,22,allow,5130,2103,3027,28,21,16,12
51831,51496,443,43516,443,allow,416,210,206,7,15,4,3
51832,59952,53,59952,53,allow,215,80,135,2,32,1,1
51833,52375,80,39641,80,allow,78,78,0,1,5,1,0
51834,35608,443,36107,443,allow,8530,2685,5845,25,100,15,10
51835,40763,443,27693,443,allow,15679,4305,11374,32,43,17,15
51836,59762,443,29034,443,allow,382,164,218,2,31,1,1
51837,63529,53,63529,53,allow,217,91,126,2,30,1,1
51838,56118,53,56118,53,allow,233,91,142,2,30,1,1
51839,60939,53,60939,53,allow,237,91,146,2,32,1,1
51840,58638,445,0,0,drop,70,70,0,1,0,1,0
51841,53670,445,0,0,drop,70,70,0,1,0,1,0
51842,54600,6881,0,0,deny,62,62,0,1,0,1,0
51843,58634,445,0,0,drop,70,70,0,1,0,1,0
51844,58631,445,0,0,drop,70,70,0,1,0,1,0
51845,35460,35440,0,0,deny,62,62,0,1,0,1,0
51846,22327,53,22327,53,allow,237,91,146,2,32,1,1
51847,43319,53,43319,53,allow,237,91,146,2,32,1,1
51848,49238,53,49238,53,allow,235,90,145,2,32,1,1
51849,53622,61393,55834,61393,allow,320,140,180,6,7,3,3
51850,55689,443,55689,443,allow,177498,9805,167693,244,80,119,125
51851,55690,443,55690,443,allow,14768,2185,12583,32,80,13,19
51852,59761,53,13611,53,allow,569,164,405,2,31,1,1
51853,56766,41605,18996,41605,allow,1639,460,1179,8,30,4,4
51854,7231,53,7231,53,allow,215,80,135,2,33,1,1
51855,38655,443,22510,443,allow,498,210,288,8,26,4,4
51856,43601,80,43601,80,allow,1252,539,713,10,20,5,5
51857,37052,53,37052,53,allow,259,104,155,2,30,1,1
51858,27005,27016,44583,27016,allow,898,126,772,3,31,2,1
51859,1165,53,1165,53,allow,196,88,108,2,30,1,1
51860,51810,33776,19037,33776,allow,70,70,0,2,8,2,0
51861,58887,80,17469,80,allow,1493,765,728,10,90,6,4
51862,47521,53,9404,53,allow,198,93,105,2,30,1,1
51863,44808,443,1785,443,allow,22366,9583,12783,50,37,25,25
51864,38867,53,38867,53,allow,213,79,134,2,32,1,1
51865,35055,80,30586,80,allow,3650999,83941,3567058,3541,21,1184,2357
51866,64645,443,28393,443,allow,7752,4399,3353,34,159,17,17
51867,35609,443,52136,443,allow,9225,2759,6466,27,100,16,11
51868,47821,53,47821,53,allow,228,97,131,2,30,1,1
51869,45846,443,47275,443,allow,2227,1018,1209,17,15,8,9
51870,51998,80,30634,80,allow,52288,7809,44479,105,37,40,65
51871,57824,443,57824,443,allow,4669,1762,2907,19,30,11,8
51872,55688,443,55688,443,allow,115875,6637,109238,158,80,71,87
51873,55693,443,55693,443,allow,23467,2707,20760,45,80,21,24
51874,50422,53,50422,53,allow,194,87,107,2,30,1,1
51875,57925,443,19196,443,allow,43126,33414,9712,214,220,108,106
51876,36037,53,7009,53,allow,198,93,105,2,30,1,1
51877,36649,53,5716,53,allow,198,93,105,2,30,1,1
51878,59831,53,14617,53,allow,198,93,105,2,30,1,1
51879,34158,53,34158,53,allow,217,87,130,2,30,1,1
51880,49465,443,48053,443,allow,2894,725,2169,10,121,5,5
51881,48808,443,13852,443,allow,8192,2071,6121,23,361,10,13
51882,56568,5228,36431,5228,allow,2387,1435,952,16,3600,8,8
51883,49160,13917,61966,13917,allow,150,150,0,1,1201,1,0
51884,59477,443,16193,443,allow,7825,4076,3749,19,121,10,9
51885,5786,53,5786,53,allow,213,87,126,2,31,1,1
51886,48817,61613,48817,61613,allow,490,149,341,2,1200,1,1
51887,38238,443,28773,443,allow,33229,5348,27881,55,125,26,29
51888,53770,64147,0,0,deny,66,66,0,1,0,1,0
51889,53665,445,0,0,drop,70,70,0,1,0,1,0
51890,54047,445,0,0,drop,66,66,0,1,0,1,0
51891,57325,37965,0,0,deny,62,62,0,1,0,1,0
51892,50316,37965,0,0,deny,66,66,0,1,0,1,0
51893,53664,445,0,0,drop,70,70,0,1,0,1,0
51894,60772,36829,0,0,deny,66,66,0,1,0,1,0
51895,20576,37965,0,0,deny,62,62,0,1,0,1,0
51896,33324,42873,0,0,deny,62,62,0,1,0,1,0
51897,51166,31573,0,0,deny,66,66,0,1,0,1,0
51898,5223,11387,0,0,deny,66,66,0,1,0,1,0
51899,42532,22114,0,0,deny,62,62,0,1,0,1,0
51900,27005,27018,46285,27018,allow,895,126,769,2,30,1,1
51901,37759,53,3026,53,allow,199,94,105,2,30,1,1
51902,34286,53,18958,53,allow,199,94,105,2,30,1,1
51903,63586,443,51785,443,allow,12760,2205,10555,39,122,21,18
51904,53268,80,36603,80,allow,2960,1928,1032,13,75,8,5
51905,51497,443,10165,443,allow,350,210,140,6,14,4,2
51906,49904,53,31561,53,allow,217,94,123,2,29,1,1
51907,48620,53,31132,53,allow,199,94,105,2,29,1,1
51908,33849,53,34954,53,allow,336,231,105,3,30,2,1
51909,50777,53,12522,53,allow,199,94,105,2,30,1,1
51910,55443,443,53890,443,allow,12806,2828,9978,55,2983,24,31
51911,55528,443,24685,443,allow,7845,1860,5985,24,81,14,10
51912,65473,443,51323,443,allow,91831,4379,87452,101,15,37,64
51913,55454,53,34563,53,allow,321,105,216,4,40,2,2
51914,57470,10714,2677,10714,allow,132,132,0,3,1199,3,0
51915,2267,53,36345,53,allow,468,320,148,5,49,3,2
51916,53601,30160,62732,30160,allow,70,70,0,1,4,1,0
51917,53595,28976,64230,28976,allow,492,306,186,8,15,5,3
51918,43674,53,36130,53,allow,199,94,105,2,30,1,1
51919,36394,443,63478,443,allow,6485,1692,4793,23,170,13,10
51920,49918,443,5366,443,allow,3291,1714,1577,18,16,11,7
51921,60473,8765,52424,8765,allow,1370,750,620,21,329,11,10
51922,47050,53,14793,53,allow,199,94,105,2,30,1,1
51923,53793,53,24147,53,allow,213,78,135,2,30,1,1
51924,27005,27018,55202,27018,allow,881,126,755,2,30,1,1
51925,27005,27025,27504,27025,allow,895,126,769,2,30,1,1
51926,51808,46390,6189,46390,allow,70,70,0,2,8,2,0
51927,60751,20010,62533,20010,allow,70,70,0,1,5,1,0
51928,55329,443,18522,443,allow,9458,2227,7231,23,15,12,11
51929,40501,443,64068,443,allow,6517,1812,4705,21,255,11,10
51930,44948,443,65427,443,allow,4792,3072,1720,31,80,16,15
51931,63957,53,57529,53,allow,211,102,109,2,30,1,1
51932,47824,53,65037,53,allow,199,94,105,2,30,1,1
51933,57415,53,16994,53,allow,223,86,137,2,30,1,1
51934,58601,53,45683,53,allow,198,86,112,2,30,1,1
51935,50864,443,25636,443,allow,6391,1285,5106,19,15,10,9
51936,64294,53,36421,53,allow,329,118,211,2,30,1,1
51937,60287,53,47078,53,allow,215,86,129,2,30,1,1
51938,58415,443,47391,443,allow,145249,142210,3039,143,185,106,37
51939,43039,53,37075,53,allow,241,78,163,2,30,1,1
51940,64752,53,43912,53,allow,210,94,116,2,30,1,1
51941,55080,53,5647,53,allow,330,86,244,2,30,1,1
51942,59764,53,23530,53,allow,304,86,218,2,30,1,1
51943,25758,53,25758,53,allow,198,90,108,2,30,1,1
51944,64753,443,41377,443,allow,145226,5591,139635,164,120,58,106
51945,56740,443,56740,443,allow,41851,2810,39041,66,45,31,35
51946,53594,27639,27513,27639,allow,552,306,246,9,15,5,4
51947,64280,53,51701,53,allow,211,94,117,2,30,1,1
51948,56738,443,56738,443,allow,48740,2961,45779,73,46,33,40
51949,51790,46839,56676,46839,allow,70,70,0,1,5,1,0
51950,58600,443,58600,443,allow,4396,1489,2907,19,26,11,8
51951,59765,443,22401,443,allow,571,166,405,2,30,1,1
51952,64019,53,58991,53,allow,267,94,173,2,30,1,1
51953,62023,53,10426,53,allow,301,102,199,2,30,1,1
51954,57138,443,50278,443,allow,498,210,288,8,26,4,4
51955,63967,53,14948,53,allow,283,97,186,4,36,2,2
51956,63589,443,25041,443,allow,19134,2422,16712,49,120,22,27
51957,53192,80,30945,80,allow,814,335,479,10,15,5,5
51958,42960,443,37505,443,allow,5057,2448,2609,27,544,12,15
51959,53603,53796,21410,53796,allow,70,70,0,1,4,1,0
51960,44805,443,37165,443,allow,6975,2168,4807,20,15,11,9
51961,42705,80,6053,80,allow,1222,782,440,11,15,6,5
51962,51448,80,39374,80,allow,214,140,74,4,15,3,1
51963,51689,53,28477,53,allow,198,86,112,2,29,1,1
51964,34798,53,14935,53,allow,199,94,105,2,30,1,1
51965,57149,53,45353,53,allow,222,86,136,2,30,1,1
51966,57423,443,2574,443,allow,10222,4415,5807,26,15,11,15
51967,50061,443,34942,443,allow,4819,2004,2815,22,80,11,11
51968,44947,443,36944,443,allow,6359,4441,1918,33,80,17,16
51969,27005,27016,63808,27016,allow,879,126,753,2,30,1,1
51970,57952,443,57780,443,allow,480591,8786,471805,442,46,102,340
51971,55321,443,9589,443,allow,9462,2297,7165,23,15,13,10
51972,27005,27015,32826,27015,allow,880,126,754,2,30,1,1
51973,56508,80,35273,80,allow,318,192,126,6,30,4,2
51974,27005,27015,45042,27015,allow,878,126,752,2,30,1,1
51975,123,123,22929,123,allow,184,94,90,2,29,1,1
51976,61559,53,9585,53,allow,376,86,290,2,29,1,1
51977,55784,53,34530,53,allow,199,94,105,2,29,1,1
51978,42895,53,15137,53,allow,168,78,90,2,30,1,1
51979,59766,53,33803,53,allow,512,166,346,2,30,1,1
51980,59752,443,12592,443,allow,304,86,218,2,30,1,1
51981,59751,53,11335,53,allow,304,86,218,2,30,1,1
51982,47478,443,52438,443,allow,4019,1462,2557,21,120,11,10
51983,35195,443,32117,443,allow,3672,1259,2413,16,120,8,8
51984,57347,443,40026,443,allow,3889,1296,2593,11,120,6,5
51985,55763,443,52551,443,allow,48162,46496,1666,59,136,39,20
51986,1462,41599,5098,41599,allow,70,70,0,1,5,1,0
51987,56932,80,33047,80,allow,8325,5642,2683,16,28,9,7
51988,56878,443,56878,443,allow,27657,5506,22151,58,46,30,28
51989,39484,80,6764,80,allow,1403,651,752,10,16,6,4
51990,64449,53,61840,53,allow,197,94,103,2,30,1,1
51991,53792,53,47522,53,allow,224,86,138,2,30,1,1
51992,55454,53,16777,53,allow,168,78,90,2,30,1,1
51993,53791,53,53567,53,allow,260,86,174,2,30,1,1
51994,56739,443,56739,443,allow,94524,4465,90059,126,45,56,70
51995,55692,443,55692,443,allow,7516,1498,6018,25,79,11,14
51996,58511,53,45280,53,allow,302,86,216,2,30,1,1
51997,49762,53,13712,53,allow,335,142,193,2,30,1,1
51998,59763,443,40613,443,allow,304,86,218,2,30,1,1
51999,57344,443,60771,443,allow,3872,1641,2231,14,125,6,8
52000,51809,52528,62433,52528,allow,70,70,0,2,8,2,0
52001,41464,443,7904,443,allow,3978,2714,1264,24,83,13,11
52002,60318,123,6592,123,allow,184,94,90,2,30,1,1
52003,45937,53,13210,53,allow,241,78,163,2,30,1,1
52004,43382,53,39674,53,allow,86,86,0,1,30,1,0
52005,40151,443,46330,443,allow,80789,5008,75781,92,128,33,59
52006,52239,443,55922,443,allow,6564,3283,3281,19,140,10,9
52007,60308,443,63284,443,allow,2622412,144918,2477494,3052,316,1078,1974
52008,15503,36501,26789,36501,allow,323,150,173,2,1201,1,1
52009,37635,443,29591,443,allow,4266,1768,2498,18,121,8,10
52010,63798,16357,18681,16357,allow,66,66,0,2,8,2,0
52011,58616,80,39662,80,allow,1056,682,374,10,15,6,4
52012,49720,443,3612,443,allow,180777,5704,175073,204,105,67,137
52013,64989,53,60666,53,allow,214,102,112,2,30,1,1
52014,53789,53,10128,53,allow,167,78,89,2,30,1,1
52015,45237,53,45237,53,allow,235,90,145,2,33,1,1
52016,61075,53,61075,53,allow,244,98,146,2,32,1,1
52017,63795,52376,47084,52376,allow,66,66,0,2,8,2,0
52018,51787,35661,9669,35661,allow,70,70,0,1,5,1,0
52019,53442,443,20405,443,allow,10500,2835,7665,34,114,14,20
52020,49914,53,31140,53,allow,215,86,129,2,30,1,1
52021,49863,53,59500,53,allow,200,86,114,2,30,1,1
52022,59755,443,15018,443,allow,448,166,282,2,30,1,1
52023,14697,8000,26641,8000,allow,212,150,62,2,31,1,1
52024,64180,53,33989,53,allow,296,91,205,4,55,2,2
52025,63796,60557,39305,60557,allow,66,66,0,2,8,2,0
52026,64858,53,1882,53,allow,227,102,125,2,30,1,1
52027,64468,53,38719,53,allow,259,118,141,2,30,1,1
52028,53660,445,0,0,drop,70,70,0,1,0,1,0
52029,54038,445,0,0,drop,66,66,0,1,0,1,0
52030,58624,445,0,0,drop,70,70,0,1,0,1,0
52031,53659,445,0,0,drop,70,70,0,1,0,1,0
52032,35749,18375,0,0,deny,146,146,0,1,0,1,0
52033,58811,53976,0,0,deny,66,66,0,1,0,1,0
52034,54035,445,0,0,drop,66,66,0,1,0,1,0
52035,21420,44847,0,0,deny,66,66,0,1,0,1,0
52036,27642,23,0,0,deny,60,60,0,1,0,1,0
52037,58562,57587,0,0,deny,66,66,0,1,0,1,0
52038,54029,445,0,0,drop,66,66,0,1,0,1,0
52039,53654,445,0,0,drop,70,70,0,1,0,1,0
52040,7749,36237,0,0,deny,66,66,0,1,0,1,0
52041,52095,56079,0,0,deny,66,66,0,1,0,1,0
52042,49982,37965,0,0,deny,66,66,0,1,0,1,0
52043,54021,445,0,0,drop,66,66,0,1,0,1,0
52044,34234,993,0,0,deny,60,60,0,1,0,1,0
52045,34233,993,0,0,deny,60,60,0,1,0,1,0
52046,52860,9694,0,0,deny,62,62,0,1,0,1,0
52047,49950,23,0,0,deny,60,60,0,1,0,1,0
52048,51244,42416,0,0,deny,100,100,0,1,0,1,0
52049,50254,44847,0,0,deny,66,66,0,1,0,1,0
52050,33453,64147,0,0,deny,62,62,0,1,0,1,0
52051,33305,54532,0,0,deny,60,60,0,1,0,1,0
52052,50280,57470,0,0,deny,78,78,0,1,0,1,0
52053,18415,37965,0,0,deny,62,62,0,1,0,1,0
52054,56173,37807,0,0,deny,66,66,0,1,0,1,0
52055,5774,37965,0,0,deny,66,66,0,1,0,1,0
52056,57500,37965,0,0,deny,62,62,0,1,0,1,0
52057,65203,30188,0,0,deny,66,66,0,1,0,1,0
52058,53476,5900,0,0,deny,60,60,0,1,0,1,0
52059,52459,5555,0,0,deny,60,60,0,1,0,1,0
52060,58609,445,0,0,drop,70,70,0,1,0,1,0
52061,58606,445,0,0,drop,70,70,0,1,0,1,0
52062,58605,445,0,0,drop,70,70,0,1,0,1,0
52063,59592,37965,0,0,deny,62,62,0,1,0,1,0
52064,53406,50584,0,0,deny,66,66,0,1,0,1,0
52065,20004,48817,0,0,deny,146,146,0,1,0,1,0
52066,54013,445,0,0,drop,66,66,0,1,0,1,0
52067,54011,445,0,0,drop,66,66,0,1,0,1,0
52068,54012,445,0,0,drop,66,66,0,1,0,1,0
52069,54010,445,0,0,drop,66,66,0,1,0,1,0
52070,54009,445,0,0,drop,66,66,0,1,0,1,0
52071,54007,445,0,0,drop,66,66,0,1,0,1,0
52072,54006,445,0,0,drop,66,66,0,1,0,1,0
52073,54005,445,0,0,drop,66,66,0,1,0,1,0
52074,22583,9822,0,0,deny,62,62,0,1,0,1,0
52075,53641,445,0,0,drop,70,70,0,1,0,1,0
52076,8999,52290,0,0,deny,146,146,0,1,0,1,0
52077,53469,44847,0,0,deny,62,62,0,1,0,1,0
52078,51244,50432,0,0,deny,100,100,0,1,0,1,0
52079,10822,48817,0,0,deny,140,140,0,1,0,1,0
52080,53638,445,0,0,drop,70,70,0,1,0,1,0
52081,6712,5632,0,0,deny,60,60,0,1,0,1,0
52082,54703,23,0,0,deny,60,60,0,1,0,1,0
52083,55600,22,0,0,deny,60,60,0,1,0,1,0
52084,20939,60461,0,0,deny,60,60,0,1,0,1,0
52085,52361,23718,0,0,deny,66,66,0,1,0,1,0
52086,58602,445,0,0,drop,70,70,0,1,0,1,0
52087,58596,445,0,0,drop,70,70,0,1,0,1,0
52088,58594,445,0,0,drop,70,70,0,1,0,1,0
52089,1054,15503,0,0,deny,62,62,0,1,0,1,0
52090,20939,60461,0,0,deny,60,60,0,1,0,1,0
52091,53634,445,0,0,drop,70,70,0,1,0,1,0
52092,53990,445,0,0,drop,66,66,0,1,0,1,0
52093,53992,445,0,0,drop,66,66,0,1,0,1,0
52094,53991,445,0,0,drop,66,66,0,1,0,1,0
52095,19999,30170,0,0,deny,145,145,0,1,0,1,0
52096,53632,445,0,0,drop,70,70,0,1,0,1,0
52097,24812,44847,0,0,deny,146,146,0,1,0,1,0
52098,12608,21247,0,0,deny,66,66,0,1,0,1,0
52099,58587,445,0,0,drop,70,70,0,1,0,1,0
52100,53630,445,0,0,drop,70,70,0,1,0,1,0
52101,64339,18375,0,0,deny,66,66,0,1,0,1,0
52102,30046,15503,0,0,deny,62,62,0,1,0,1,0
52103,58585,445,0,0,drop,70,70,0,1,0,1,0
52104,9377,56205,0,0,deny,66,66,0,1,0,1,0
52105,6886,55839,0,0,deny,139,139,0,1,0,1,0
52106,58576,445,0,0,drop,70,70,0,1,0,1,0
52107,58575,445,0,0,drop,70,70,0,1,0,1,0
52108,58574,445,0,0,drop,70,70,0,1,0,1,0
52109,29424,37807,0,0,deny,62,62,0,1,0,1,0
52110,52217,22114,0,0,deny,66,66,0,1,0,1,0
52111,59790,44847,0,0,deny,66,66,0,1,0,1,0
52112,37589,443,25099,443,allow,499,425,74,4,0,3,1
52113,37590,443,21881,443,allow,499,425,74,4,0,3,1
52114,37592,443,5868,443,allow,499,425,74,4,0,3,1
52115,37588,443,34121,443,allow,499,425,74,4,0,3,1
52116,37591,443,50251,443,allow,499,425,74,4,0,3,1
52117,37585,443,50718,443,allow,499,425,74,4,2,3,1
52118,53178,26467,0,0,deny,62,62,0,1,0,1,0
52119,53623,445,0,0,drop,70,70,0,1,0,1,0
52120,37902,23718,0,0,deny,62,62,0,1,0,1,0
52121,63542,15503,0,0,deny,66,66,0,1,0,1,0
52122,21833,22114,0,0,deny,62,62,0,1,0,1,0
52123,53621,445,0,0,drop,70,70,0,1,0,1,0
52124,53620,445,0,0,drop,70,70,0,1,0,1,0
52125,58568,445,0,0,drop,70,70,0,1,0,1,0
52126,58566,445,0,0,drop,70,70,0,1,0,1,0
52127,58562,445,0,0,drop,70,70,0,1,0,1,0
52128,53619,445,0,0,drop,70,70,0,1,0,1,0
52129,53618,445,0,0,drop,70,70,0,1,0,1,0
52130,53616,445,0,0,drop,70,70,0,1,0,1,0
52131,53614,445,0,0,drop,70,70,0,1,0,1,0
52132,63772,35440,0,0,deny,66,66,0,1,0,1,0
52133,51920,30188,0,0,deny,66,66,0,1,0,1,0
52134,64877,37450,0,0,deny,66,66,0,1,0,1,0
52135,58721,51505,0,0,deny,66,66,0,1,0,1,0
52136,53810,23,0,0,deny,60,60,0,1,0,1,0
52137,53600,445,0,0,drop,70,70,0,1,0,1,0
52138,53599,445,0,0,drop,70,70,0,1,0,1,0
52139,53594,445,0,0,drop,70,70,0,1,0,1,0
52140,53590,445,0,0,drop,70,70,0,1,0,1,0
52141,53589,445,0,0,drop,70,70,0,1,0,1,0
52142,2425,23117,0,0,deny,66,66,0,1,0,1,0
52143,53968,445,0,0,drop,66,66,0,1,0,1,0
52144,58558,445,0,0,drop,70,70,0,1,0,1,0
52145,58559,445,0,0,drop,70,70,0,1,0,1,0
52146,26494,26467,0,0,deny,62,62,0,1,0,1,0
52147,49805,64147,0,0,deny,66,66,0,1,0,1,0
52148,0,0,0,0,allow,320,320,0,5,0,5,0
52149,52643,36237,0,0,deny,66,66,0,1,0,1,0
52150,53578,445,0,0,drop,70,70,0,1,0,1,0
52151,53963,445,0,0,drop,66,66,0,1,0,1,0
52152,52111,44847,0,0,deny,66,66,0,1,0,1,0
52153,13581,51505,0,0,deny,66,66,0,1,0,1,0
52154,53961,445,0,0,drop,66,66,0,1,0,1,0
52155,58549,445,0,0,drop,70,70,0,1,0,1,0
52156,11983,57470,0,0,deny,62,62,0,1,0,1,0
52157,58541,445,0,0,drop,70,70,0,1,0,1,0
52158,58542,445,0,0,drop,70,70,0,1,0,1,0
52159,58536,445,0,0,drop,70,70,0,1,0,1,0
52160,2697,28189,0,0,deny,60,60,0,1,0,1,0
52161,53959,445,0,0,drop,66,66,0,1,0,1,0
52162,5283,56205,0,0,deny,146,146,0,1,0,1,0
52163,53573,445,0,0,drop,70,70,0,1,0,1,0
52164,52743,15503,0,0,deny,66,66,0,1,0,1,0
52165,58533,445,0,0,drop,70,70,0,1,0,1,0
52166,58530,445,0,0,drop,70,70,0,1,0,1,0
52167,58526,445,0,0,drop,70,70,0,1,0,1,0
52168,58528,445,0,0,drop,70,70,0,1,0,1,0
52169,53563,445,0,0,drop,70,70,0,1,0,1,0
52170,53564,445,0,0,drop,70,70,0,1,0,1,0
52171,53951,445,0,0,drop,66,66,0,1,0,1,0
52172,53562,445,0,0,drop,70,70,0,1,0,1,0
52173,53559,445,0,0,drop,70,70,0,1,0,1,0
52174,53557,445,0,0,drop,70,70,0,1,0,1,0
52175,53948,445,0,0,drop,66,66,0,1,0,1,0
52176,53949,445,0,0,drop,66,66,0,1,0,1,0
52177,53947,445,0,0,drop,66,66,0,1,0,1,0
52178,52177,25320,0,0,deny,66,66,0,1,0,1,0
52179,53942,445,0,0,drop,66,66,0,1,0,1,0
52180,53940,445,0,0,drop,66,66,0,1,0,1,0
52181,53939,445,0,0,drop,66,66,0,1,0,1,0
52182,52339,26467,0,0,deny,66,66,0,1,0,1,0
52183,61420,64097,0,0,deny,62,62,0,1,0,1,0
52184,7992,64147,0,0,deny,62,62,0,1,0,1,0
52185,6037,43890,0,0,deny,74,74,0,1,0,1,0
52186,55201,22114,0,0,deny,66,66,0,1,0,1,0
52187,34553,48637,0,0,deny,60,60,0,1,0,1,0
52188,58524,445,0,0,drop,70,70,0,1,0,1,0
52189,58521,445,0,0,drop,70,70,0,1,0,1,0
52190,54862,19000,22196,19000,allow,476,216,260,2,30,1,1
52191,53116,32014,29630,32014,allow,698,320,378,10,17,6,4
52192,42310,443,52115,443,allow,6673,2151,4522,27,125,13,14
52193,27005,27018,58513,27018,allow,888,126,762,2,30,1,1
52194,49721,443,34964,443,allow,65732,3951,61781,102,65,40,62
52195,56809,40641,18349,40641,allow,70,70,0,1,5,1,0
52196,53708,80,59470,80,allow,2434,516,1918,12,76,6,6
52197,10039,443,49424,443,allow,12579,1722,10857,29,171,12,17
52198,49727,443,37710,443,allow,5037,1135,3902,16,18,9,7
52199,20378,53,20378,53,allow,235,90,145,2,32,1,1
52200,59404,53,59404,53,allow,237,91,146,2,32,1,1
52201,51806,49530,21191,49530,allow,70,70,0,2,8,2,0
52202,31132,53,31132,53,allow,227,89,138,2,30,1,1
52203,27005,27020,41783,27020,allow,898,126,772,2,30,1,1
52204,15733,3389,15733,3389,allow,3910,1805,2105,20,19,12,8
52205,62731,443,8633,443,allow,27905,17646,10259,131,308,73,58
52206,49725,443,10242,443,allow,311104,8270,302834,336,18,99,237
52207,58356,443,14561,443,allow,10817,2611,8206,44,135,21,23
52208,49726,443,20489,443,allow,5393,1263,4130,21,18,11,10
52209,63797,47784,12377,47784,allow,66,66,0,2,8,2,0
52210,53010,80,53010,80,allow,210304,4398,205906,225,21,65,160
52211,60888,443,18783,443,allow,7454,3131,4323,23,46,13,10
52212,63799,13835,2064,13835,allow,66,66,0,2,8,2,0
52213,56785,28902,26302,28902,allow,66,66,0,1,5,1,0
52214,59754,53,13358,53,allow,303,85,218,2,30,1,1
52215,45918,443,28786,443,allow,12351,7584,4767,38,48,22,16
52216,49728,443,36312,443,allow,5037,1135,3902,16,18,9,7
52217,10006,80,62598,80,allow,1142,636,506,10,45,6,4
52218,15420,53,15420,53,allow,237,91,146,2,32,1,1
52219,49722,443,49212,443,allow,28376,3058,25318,42,63,17,25
52220,59457,53,59457,53,allow,213,87,126,2,30,1,1
52221,50367,53,22257,53,allow,578,286,292,9,15,5,4
52222,54051,53,54051,53,allow,617,67,550,2,30,1,1
52223,59753,443,43725,443,allow,303,85,218,2,30,1,1
52224,59993,443,5215,443,allow,6452,2146,4306,30,125,14,16
52225,54991,443,64659,443,allow,15109,5866,9243,71,362,29,42
52226,64842,443,46917,443,allow,5467,2738,2729,23,137,11,12
52227,54137,443,48423,443,allow,2573,330,2243,12,136,5,7
52228,58519,445,0,0,drop,70,70,0,1,0,1,0
52229,53937,445,0,0,drop,66,66,0,1,0,1,0
52230,53676,35974,0,0,deny,60,60,0,1,0,1,0
52231,34677,51185,0,0,deny,60,60,0,1,0,1,0
52232,58517,445,0,0,drop,70,70,0,1,0,1,0
52233,49805,6881,0,0,deny,62,62,0,1,0,1,0
52234,53551,445,0,0,drop,70,70,0,1,0,1,0
52235,53933,445,0,0,drop,66,66,0,1,0,1,0
52236,44594,64147,0,0,deny,66,66,0,1,0,1,0
52237,30114,65151,0,0,deny,60,60,0,1,0,1,0
52238,53931,445,0,0,drop,66,66,0,1,0,1,0
52239,53930,445,0,0,drop,66,66,0,1,0,1,0
52240,54575,11392,0,0,deny,66,66,0,1,0,1,0
52241,56986,2310,0,0,deny,159,159,0,1,0,1,0
52242,18950,50584,0,0,deny,62,62,0,1,0,1,0
52243,53928,445,0,0,drop,66,66,0,1,0,1,0
52244,46906,25604,0,0,deny,100,100,0,1,0,1,0
52245,62414,50584,0,0,deny,66,66,0,1,0,1,0
52246,50305,443,65523,443,allow,7725,2029,5696,23,136,13,10
52247,59060,443,38409,443,allow,16775,1879,14896,36,16,17,19
52248,53716,443,47470,443,allow,70,70,0,2,8,2,0
52249,53544,445,0,0,drop,70,70,0,1,0,1,0
52250,53543,445,0,0,deny,70,70,0,1,0,1,0
52251,45908,33330,0,0,deny,60,60,0,1,0,1,0
52252,58510,445,0,0,drop,70,70,0,1,0,1,0
52253,6886,45378,0,0,deny,139,139,0,1,0,1,0
52254,47700,51505,0,0,deny,66,66,0,1,0,1,0
52255,58507,445,0,0,drop,70,70,0,1,0,1,0
52256,58505,445,0,0,drop,70,70,0,1,0,1,0
52257,53538,445,0,0,drop,70,70,0,1,0,1,0
52258,53536,445,0,0,drop,70,70,0,1,0,1,0
52259,53917,445,0,0,drop,66,66,0,1,0,1,0
52260,65115,50584,0,0,deny,66,66,0,1,0,1,0
52261,51682,443,60633,443,allow,5060,2867,2193,26,398,9,17
52262,27005,27017,13207,27017,allow,890,126,764,2,30,1,1
52263,41466,443,58480,443,allow,3356,2158,1198,21,82,11,10
52264,51807,10920,47874,10920,allow,70,70,0,2,8,2,0
52265,56624,53,53106,53,allow,259,118,141,2,29,1,1
52266,49729,443,33717,443,allow,8322,2585,5737,23,16,12,11
52267,65516,53,35992,53,allow,305,89,216,4,41,2,2
52268,49723,443,17483,443,allow,11181,3795,7386,50,20,23,27
52269,61352,443,38180,443,allow,14131,5620,8511,38,216,20,18
52270,46287,443,19273,443,allow,7071,2628,4443,32,23,16,16
52271,49185,53,26156,53,allow,307,94,213,2,29,1,1
52272,64305,53,21382,53,allow,598,196,402,6,71,3,3
52273,50015,53,57649,53,allow,287,94,193,2,29,1,1
52274,59749,443,34617,443,allow,304,86,218,2,29,1,1
52275,31630,53,31630,53,allow,220,90,130,2,30,1,1
52276,49483,53,5607,53,allow,273,94,179,2,30,1,1
52277,59750,53,24886,53,allow,304,86,218,2,29,1,1
52278,51491,443,61886,443,allow,343,163,180,6,15,3,3
52279,52663,443,53022,443,allow,4416,1702,2714,19,126,9,10
52280,49571,443,40326,443,allow,12258,5621,6637,52,286,25,27
52281,50260,53,44495,53,allow,168,86,82,2,30,1,1
52282,53034,53,25305,53,allow,238,94,144,2,30,1,1
52283,41458,443,29775,443,allow,13059,5161,7898,34,84,19,15
52284,56804,33375,39167,33375,allow,70,70,0,2,8,2,0
52285,56735,80,56735,80,allow,2243,1548,695,11,46,7,4
52286,27005,27017,24115,27017,allow,880,126,754,2,30,1,1
52287,12346,53,12346,53,allow,216,98,118,2,30,1,1
52288,41462,443,16265,443,allow,3467,2269,1198,21,82,11,10
52289,60911,53,60911,53,allow,216,90,126,2,30,1,1
52290,49370,53,35451,53,allow,430,85,345,4,54,2,2
52291,49300,53,25911,53,allow,232,86,146,2,30,1,1
52292,27005,27016,26608,27016,allow,880,126,754,2,30,1,1
52293,49192,53,8580,53,allow,212,102,110,2,30,1,1
52294,60412,12965,23315,12965,allow,70,70,0,2,8,2,0
52295,37644,443,35046,443,allow,3886,2516,1370,22,95,12,10
52296,53120,49860,38739,49860,allow,70,70,0,2,8,2,0
52297,57426,66,14765,66,allow,70,70,0,2,8,2,0
52298,60411,58131,51349,58131,allow,70,70,0,2,8,2,0
52299,55434,53,55434,53,allow,198,90,108,2,30,1,1
52300,59859,53,1491,53,allow,218,86,132,2,30,1,1
52301,55514,53,24000,53,allow,216,94,122,2,30,1,1
52302,33534,443,30363,443,allow,4640,1416,3224,18,121,9,9
52303,48018,443,52238,443,allow,1429,1295,134,10,29,8,2
52304,38631,443,46548,443,allow,6231,1151,5080,23,109,13,10
52305,51492,80,15284,80,allow,1517,481,1036,11,15,6,5
52306,49719,443,56556,443,allow,560073,155518,404555,923,110,411,512
52307,60358,443,56425,443,allow,17547,2695,14852,30,76,14,16
52308,38630,443,20829,443,allow,9277,3025,6252,32,109,17,15
52309,49665,53,62694,53,allow,289,99,190,4,35,2,2
52310,53598,40326,59380,40326,allow,70,70,0,1,4,1,0
52311,51788,35787,25759,35787,allow,70,70,0,1,4,1,0
52312,53582,40872,7897,40872,allow,492,306,186,8,16,5,3
52313,52703,443,1986,443,allow,7843,2397,5446,23,256,12,11
52314,51411,443,26944,443,allow,509,329,180,6,8,3,3
52315,56619,80,59686,80,allow,234,234,0,4,12,4,0
52316,59760,53,48696,53,allow,384,166,218,2,29,1,1
52317,59758,443,28743,443,allow,384,166,218,2,29,1,1
52318,35738,80,42244,80,allow,1151,711,440,10,16,5,5
52319,53790,53,7041,53,allow,167,78,89,2,29,1,1
52320,50213,80,50213,80,allow,1723391,21750,1701641,1450,16,326,1124
52321,49917,443,38114,443,allow,7645,2967,4678,23,15,13,10
52322,53707,443,35739,443,allow,7272,930,6342,19,75,9,10
52323,51694,80,56366,80,allow,1307,649,658,8,75,5,3
52324,59748,53,27175,53,allow,304,86,218,2,29,1,1
52325,65116,53,7436,53,allow,220,94,126,2,29,1,1
52326,59759,53,55695,53,allow,384,166,218,2,29,1,1
52327,59757,443,52007,443,allow,384,166,218,2,29,1,1
52328,64065,53,29677,53,allow,270,94,176,2,30,1,1
52329,59756,53,64652,53,allow,571,166,405,2,29,1,1
52330,50877,443,13364,443,allow,7984,2447,5537,41,2904,24,17
52331,27005,27035,7636,27035,allow,891,126,765,2,30,1,1
52332,57326,443,3757,443,allow,64382,9305,55077,101,123,41,60
52333,59747,443,7939,443,allow,304,86,218,2,29,1,1
52334,63951,443,17963,443,allow,6718,3582,3136,18,126,10,8
52335,57812,7635,57812,7635,allow,138,78,60,3,6,2,1
52336,41460,443,23165,443,allow,13890,5926,7964,36,84,20,16
52337,45658,443,10440,443,allow,5359,3152,2207,51,2901,28,23
52338,50260,53,50381,53,allow,196,86,110,2,30,1,1
52339,27005,27016,11664,27016,allow,902,126,776,2,30,1,1
52340,64303,443,22839,443,allow,3205,781,2424,17,135,8,9
52341,49985,443,2510,443,allow,10737,3664,7073,20,137,10,10
52342,51413,443,55199,443,allow,695,575,120,4,6,2,2
52343,58166,53,23423,53,allow,224,94,130,2,30,1,1
52344,63950,443,48115,443,allow,5844,2360,3484,25,127,12,13
52345,26791,443,23053,443,allow,21391,16334,5057,38,20,21,17
52346,45567,443,10380,443,allow,1473,988,485,12,25,7,5
52347,49791,53,7553,53,allow,216,94,122,2,30,1,1
52348,64952,53,2309,53,allow,232,94,138,2,30,1,1
52349,62061,53,49325,53,allow,181,78,103,2,30,1,1
52350,49612,53,33123,53,allow,234,94,140,2,31,1,1
52351,34758,5228,2453,5228,allow,10206,2218,7988,36,4265,18,18
52352,50973,443,10208,443,allow,9525,6135,3390,24,120,13,11
52353,51438,443,45079,443,allow,42419,28515,13904,108,246,53,55
52354,64668,53,24152,53,allow,211,102,109,2,30,1,1
52355,44691,53,43758,53,allow,199,94,105,2,30,1,1
52356,1528,53,1528,53,allow,193,90,103,2,30,1,1
52357,63679,443,51267,443,allow,7987,2092,5895,18,119,8,10
52358,47673,443,27427,443,allow,10372,4341,6031,28,319,15,13
52359,29744,53,29744,53,allow,235,90,145,2,33,1,1
52360,57602,80,57602,80,allow,4226,2910,1316,19,38,10,9
52361,64990,53,21080,53,allow,323,94,229,2,30,1,1
52362,65372,53,52621,53,allow,330,91,239,4,44,2,2
52363,54983,443,42126,443,allow,865636,22536,843100,903,50,309,594
52364,36010,443,44715,443,allow,5689,1505,4184,24,19,13,11
52365,55188,443,45668,443,allow,6649,1556,5093,23,24,13,10
52366,57464,80,18705,80,allow,78,78,0,1,5,1,0
52367,49898,443,53027,443,allow,44110,4769,39341,90,108,46,44
52368,51072,80,39928,80,allow,1299,793,506,12,16,6,6
52369,53532,445,0,0,drop,70,70,0,1,0,1,0
52370,1030,44847,0,0,deny,62,62,0,1,0,1,0
52371,46679,64147,0,0,deny,62,62,0,1,0,1,0
52372,48676,53398,0,0,deny,60,60,0,1,0,1,0
52373,62152,56205,0,0,deny,66,66,0,1,0,1,0
52374,55032,62413,0,0,deny,66,66,0,1,0,1,0
52375,53910,445,0,0,drop,66,66,0,1,0,1,0
52376,16697,64147,0,0,deny,145,145,0,1,0,1,0
52377,12537,28816,0,0,deny,145,145,0,1,0,1,0
52378,53531,445,0,0,drop,70,70,0,1,0,1,0
52379,58495,445,0,0,drop,70,70,0,1,0,1,0
52380,22724,9822,0,0,deny,62,62,0,1,0,1,0
52381,34897,50584,0,0,deny,62,62,0,1,0,1,0
52382,22683,39210,0,0,deny,60,60,0,1,0,1,0
52383,50280,57470,0,0,deny,78,78,0,1,0,1,0
52384,53907,445,0,0,drop,66,66,0,1,0,1,0
52385,1866,51505,0,0,deny,66,66,0,1,0,1,0
52386,57676,64147,0,0,deny,74,74,0,1,0,1,0
52387,53526,445,0,0,drop,70,70,0,1,0,1,0
52388,62337,44847,0,0,deny,66,66,0,1,0,1,0
52389,53901,445,0,0,drop,66,66,0,1,0,1,0
52390,61912,17546,0,0,deny,62,62,0,1,0,1,0
52391,50369,50584,0,0,deny,66,66,0,1,0,1,0
52392,53897,445,0,0,drop,66,66,0,1,0,1,0
52393,63263,57470,0,0,deny,66,66,0,1,0,1,0
52394,1024,57470,0,0,deny,62,62,0,1,0,1,0
52395,443,11266,0,0,deny,124,124,0,1,0,1,0
52396,37008,42707,0,0,deny,62,62,0,1,0,1,0
52397,51909,6881,0,0,deny,66,66,0,1,0,1,0
52398,57289,31573,0,0,deny,66,66,0,1,0,1,0
52399,40500,5618,0,0,reset-both,146,146,0,1,0,1,0
52400,53513,445,0,0,drop,70,70,0,1,0,1,0
52401,58481,445,0,0,drop,70,70,0,1,0,1,0
52402,58477,445,0,0,drop,70,70,0,1,0,1,0
52403,58478,445,0,0,drop,70,70,0,1,0,1,0
52404,50360,35440,0,0,deny,66,66,0,1,0,1,0
52405,53881,445,0,0,drop,66,66,0,1,0,1,0
52406,53884,445,0,0,drop,66,66,0,1,0,1,0
52407,53878,445,0,0,drop,66,66,0,1,0,1,0
52408,53880,445,0,0,drop,66,66,0,1,0,1,0
52409,53882,445,0,0,drop,66,66,0,1,0,1,0
52410,53883,445,0,0,drop,66,66,0,1,0,1,0
52411,53877,445,0,0,drop,66,66,0,1,0,1,0
52412,53879,445,0,0,drop,66,66,0,1,0,1,0
52413,5729,22114,0,0,deny,66,66,0,1,0,1,0
52414,14070,62413,0,0,deny,66,66,0,1,0,1,0
52415,53510,445,0,0,drop,70,70,0,1,0,1,0
52416,17643,50584,0,0,deny,146,146,0,1,0,1,0
52417,58470,445,0,0,drop,70,70,0,1,0,1,0
52418,58468,445,0,0,drop,70,70,0,1,0,1,0
52419,58464,445,0,0,drop,70,70,0,1,0,1,0
52420,53505,445,0,0,drop,70,70,0,1,0,1,0
52421,21534,42246,0,0,deny,66,66,0,1,0,1,0
52422,53504,445,0,0,drop,70,70,0,1,0,1,0
52423,28124,8497,0,0,deny,148,148,0,1,0,1,0
52424,53864,445,0,0,drop,66,66,0,1,0,1,0
52425,53865,445,0,0,drop,66,66,0,1,0,1,0
52426,53862,445,0,0,drop,66,66,0,1,0,1,0
52427,30109,5223,0,0,deny,148,148,0,1,0,1,0
52428,53502,445,0,0,drop,70,70,0,1,0,1,0
52429,443,48120,0,0,deny,97,97,0,1,0,1,0
52430,5223,44091,0,0,deny,220,220,0,1,0,1,0
52431,53105,42707,0,0,deny,66,66,0,1,0,1,0
52432,6712,161,0,0,deny,82,82,0,1,0,1,0
52433,58459,445,0,0,drop,70,70,0,1,0,1,0
52434,80,5101,0,0,deny,78,78,0,1,0,1,0
52435,45410,1,0,0,deny,62,62,0,1,0,1,0
52436,58457,445,0,0,drop,70,70,0,1,0,1,0
52437,49485,11392,0,0,deny,66,66,0,1,0,1,0
52438,58447,445,0,0,drop,70,70,0,1,0,1,0
52439,58449,445,0,0,drop,70,70,0,1,0,1,0
52440,58445,445,0,0,drop,70,70,0,1,0,1,0
52441,64379,37965,0,0,deny,66,66,0,1,0,1,0
52442,45060,37965,0,0,deny,62,62,0,1,0,1,0
52443,53495,445,0,0,drop,70,70,0,1,0,1,0
52444,27446,30188,0,0,deny,66,66,0,1,0,1,0
52445,53493,445,0,0,drop,70,70,0,1,0,1,0
52446,28221,37965,0,0,deny,62,62,0,1,0,1,0
52447,58681,36829,0,0,deny,74,74,0,1,0,1,0
52448,63998,21247,0,0,deny,66,66,0,1,0,1,0
52449,53779,37965,0,0,deny,66,66,0,1,0,1,0
52450,40959,61903,0,0,deny,145,145,0,1,0,1,0
52451,53492,445,0,0,drop,70,70,0,1,0,1,0
52452,53491,445,0,0,drop,70,70,0,1,0,1,0
52453,53490,445,0,0,drop,70,70,0,1,0,1,0
52454,53487,445,0,0,drop,70,70,0,1,0,1,0
52455,53488,445,0,0,drop,70,70,0,1,0,1,0
52456,1660,8696,0,0,deny,62,62,0,1,0,1,0
52457,56946,1,0,0,deny,66,66,0,1,0,1,0
52458,28345,11392,0,0,deny,66,66,0,1,0,1,0
52459,58440,445,0,0,drop,70,70,0,1,0,1,0
52460,58438,445,0,0,drop,70,70,0,1,0,1,0
52461,58435,445,0,0,drop,70,70,0,1,0,1,0
52462,13285,29892,0,0,deny,145,145,0,1,0,1,0
52463,29021,23,0,0,deny,60,60,0,1,0,1,0
52464,57131,7774,0,0,deny,145,145,0,1,0,1,0
52465,1092,57470,0,0,deny,145,145,0,1,0,1,0
52466,14352,8055,0,0,deny,148,148,0,1,0,1,0
52467,53472,445,0,0,drop,70,70,0,1,0,1,0
52468,53470,445,0,0,drop,70,70,0,1,0,1,0
52469,53466,445,0,0,drop,70,70,0,1,0,1,0
52470,57982,64147,0,0,deny,66,66,0,1,0,1,0
52471,53462,445,0,0,drop,70,70,0,1,0,1,0
52472,53461,445,0,0,drop,70,70,0,1,0,1,0
52473,65153,38303,0,0,deny,62,62,0,1,0,1,0
52474,16330,50584,0,0,deny,146,146,0,1,0,1,0
52475,57431,15503,0,0,deny,66,66,0,1,0,1,0
52476,2697,28189,0,0,deny,60,60,0,1,0,1,0
52477,43129,15503,0,0,deny,62,62,0,1,0,1,0
52478,53841,445,0,0,drop,66,66,0,1,0,1,0
52479,58432,445,0,0,drop,70,70,0,1,0,1,0
52480,58430,445,0,0,drop,70,70,0,1,0,1,0
52481,54188,6004,0,0,deny,78,78,0,1,0,1,0
52482,60627,51050,0,0,deny,66,66,0,1,0,1,0
52483,443,64347,0,0,deny,131,131,0,1,0,1,0
52484,59136,50584,0,0,deny,62,62,0,1,0,1,0
52485,53450,445,0,0,drop,70,70,0,1,0,1,0
52486,13441,57470,0,0,deny,62,62,0,1,0,1,0
52487,12471,48817,0,0,deny,62,62,0,1,0,1,0
52488,61736,50584,0,0,deny,66,66,0,1,0,1,0
52489,53835,445,0,0,drop,66,66,0,1,0,1,0
52490,50227,57470,0,0,deny,66,66,0,1,0,1,0
52491,10115,52700,0,0,deny,62,62,0,1,0,1,0
52492,19875,30170,0,0,deny,145,145,0,1,0,1,0
52493,53833,445,0,0,drop,66,66,0,1,0,1,0
52494,42732,57470,0,0,deny,62,62,0,1,0,1,0
52495,58419,445,0,0,drop,70,70,0,1,0,1,0
52496,26528,51221,0,0,deny,78,78,0,1,0,1,0
52497,58416,445,0,0,drop,70,70,0,1,0,1,0
52498,58409,445,0,0,drop,70,70,0,1,0,1,0
52499,58411,445,0,0,drop,70,70,0,1,0,1,0
52500,57545,35440,0,0,deny,66,66,0,1,0,1,0
52501,53829,445,0,0,drop,66,66,0,1,0,1,0
52502,46495,4607,0,0,deny,60,60,0,1,0,1,0
52503,53446,445,0,0,drop,70,70,0,1,0,1,0
52504,10079,443,27678,443,allow,7122,1766,5356,27,331,14,13
52505,59486,80,62432,80,allow,2633,1151,1482,10,32,6,4
52506,47423,80,58553,80,allow,1056,682,374,10,15,6,4
52507,40765,443,6306,443,allow,1093,662,431,10,41,6,4
52508,58446,443,26245,443,allow,111535,9830,101705,141,192,62,79
52509,52405,443,59113,443,allow,10506,2063,8443,31,46,17,14
52510,59082,443,59082,443,allow,6264,1435,4829,21,15,11,10
52511,51803,33973,12809,33973,allow,70,70,0,2,8,2,0
52512,51519,443,51519,443,allow,8680,2323,6357,31,173,13,18
52513,51516,443,51516,443,allow,143921,6996,136925,152,174,42,110
52514,35078,53,22216,53,allow,198,93,105,2,30,1,1
52515,38334,443,30322,443,allow,1864,250,1614,8,121,4,4
52516,27005,27016,44876,27016,allow,887,126,761,2,30,1,1
52517,2946,53,2946,53,allow,240,96,144,2,30,1,1
52518,58151,443,48543,443,allow,6563,1656,4907,22,318,13,9
52519,41597,53,41597,53,allow,213,79,134,2,32,1,1
52520,44933,443,37036,443,allow,8958,1683,7275,24,23,10,14
52521,40766,443,50985,443,allow,1093,662,431,10,41,6,4
52522,61667,80,57155,80,allow,21567,1666,19901,35,46,18,17
52523,5631,80,5631,80,allow,16287,756,15531,23,16,9,14
52524,37661,53,37661,53,allow,237,91,146,2,32,1,1
52525,12934,53,12934,53,allow,237,91,146,2,33,1,1
52526,46785,53,46785,53,allow,230,91,139,2,30,1,1
52527,51410,443,38178,443,allow,13187,6736,6451,22,55,12,10
52528,49914,443,10717,443,allow,10915,2554,8361,33,270,17,16
52529,27005,27019,28419,27019,allow,880,126,754,2,30,1,1
52530,52108,443,27930,443,allow,18735,3452,15283,42,52,22,20
52531,53615,867,16773,867,allow,70,70,0,2,7,2,0
52532,13749,53,13749,53,allow,237,91,146,2,32,1,1
52533,43563,80,9467,80,allow,10597,2910,7687,24,47,14,10
52534,45334,443,8591,443,allow,8798,1667,7131,25,22,14,11
52535,51203,443,62126,443,allow,5737,1829,3908,22,18,13,9
52536,53616,44166,16410,44166,allow,70,70,0,2,7,2,0
52537,65460,80,65460,80,allow,48356,4069,44287,55,48,19,36
52538,65315,53,36671,53,allow,300,99,201,4,30,2,2
52539,65315,53,56097,53,allow,216,110,106,2,30,1,1
52540,60511,443,60511,443,allow,4658,1751,2907,19,30,11,8
52541,57605,80,57605,80,allow,36471,5174,31297,57,38,23,34
52542,57604,80,57604,80,allow,16101,4026,12075,35,38,16,19
52543,57601,80,57601,80,allow,25872,4400,21472,41,38,16,25
52544,57819,443,40837,443,allow,6161,925,5236,18,28,10,8
52545,53611,58508,47899,58508,allow,320,140,180,6,7,3,3
52546,62820,53,62820,53,allow,237,91,146,2,33,1,1
52547,38364,15000,10224,15000,allow,130,70,60,2,5,1,1
52548,35481,443,52517,443,allow,6804,1473,5331,33,258,15,18
52549,54235,443,28529,443,allow,4665,2167,2498,23,16,12,11
52550,9786,53,9786,53,allow,230,91,139,2,30,1,1
52551,44823,53,0,0,allow,82,82,0,1,30,1,0
52552,56351,53,9188,53,allow,190,97,93,2,30,1,1
52553,60750,53,24428,53,allow,198,93,105,2,30,1,1
52554,49751,53,48975,53,allow,232,92,140,2,30,1,1
52555,51407,443,24262,443,allow,22626,10213,12413,35,57,20,15
52556,17295,18242,0,0,allow,66,66,0,1,90,1,0
52557,56274,443,23756,443,allow,3093,868,2225,10,120,5,5
52558,34756,443,27102,443,allow,100090,8304,91786,135,127,50,85
52559,50803,443,27237,443,allow,25297,10467,14830,51,362,27,24
52560,64609,53,57916,53,allow,146,75,71,2,31,1,1
52561,60039,53,37317,53,allow,312,82,230,2,31,1,1
52562,38501,53,38501,53,allow,233,91,142,2,31,1,1
52563,50435,80,14382,80,allow,672,70,602,11,392,2,9
52564,50706,443,45520,443,allow,13948,10445,3503,25,121,14,11
52565,30960,45694,42221,45694,allow,330,330,0,6,3610,6,0
52566,34910,443,51247,443,allow,18452,11429,7023,39,64,23,16
52567,47605,443,46505,443,allow,12572,3471,9101,34,363,14,20
52568,9849,53,9849,53,allow,219,87,132,2,31,1,1
52569,27005,27018,47282,27018,allow,891,126,765,2,31,1,1
52570,27005,27017,53290,27017,allow,881,126,755,2,31,1,1
52571,37330,53,37330,53,allow,237,91,146,2,31,1,1
52572,57470,61803,17706,61803,allow,792,792,0,13,1200,13,0
52573,10151,55051,56267,55051,allow,468,149,319,2,1200,1,1
52574,51582,48817,0,0,deny,66,66,0,1,0,1,0
52575,18357,51180,0,0,deny,62,62,0,1,0,1,0
52576,34553,48637,0,0,deny,60,60,0,1,0,1,0
52577,59481,41182,0,0,deny,62,62,0,1,0,1,0
52578,53436,445,0,0,drop,70,70,0,1,0,1,0
52579,53437,445,0,0,drop,70,70,0,1,0,1,0
52580,53676,35974,0,0,deny,60,60,0,1,0,1,0
52581,34677,51185,0,0,deny,60,60,0,1,0,1,0
52582,58404,445,0,0,drop,70,70,0,1,0,1,0
52583,53431,445,0,0,drop,70,70,0,1,0,1,0
52584,53433,445,0,0,drop,70,70,0,1,0,1,0
52585,11133,51505,0,0,deny,66,66,0,1,0,1,0
52586,58402,445,0,0,drop,70,70,0,1,0,1,0
52587,58401,445,0,0,drop,70,70,0,1,0,1,0
52588,58398,445,0,0,drop,70,70,0,1,0,1,0
52589,60480,57470,0,0,deny,62,62,0,1,0,1,0
52590,53429,445,0,0,drop,70,70,0,1,0,1,0
52591,9605,57470,0,0,deny,62,62,0,1,0,1,0
52592,53823,445,0,0,drop,66,66,0,1,0,1,0
52593,53650,64147,0,0,deny,66,66,0,1,0,1,0
52594,53819,445,0,0,drop,66,66,0,1,0,1,0
52595,53818,445,0,0,drop,66,66,0,1,0,1,0
52596,53816,445,0,0,drop,66,66,0,1,0,1,0
52597,3578,51505,0,0,deny,66,66,0,1,0,1,0
52598,42379,443,23086,443,allow,6598,1506,5092,22,305,12,10
52599,27005,27015,63716,27015,allow,889,126,763,2,30,1,1
52600,63782,6969,48433,6969,allow,70,70,0,1,5,1,0
52601,57603,80,57603,80,allow,4373,2985,1388,21,37,11,10
52602,53118,56839,2314,56839,allow,70,70,0,1,4,1,0
52603,49156,53,13189,53,allow,199,94,105,2,29,1,1
52604,65234,5228,52749,5228,allow,4149,2263,1886,46,708,23,23
52605,63996,53,49603,53,allow,252,102,150,2,30,1,1
52606,47046,80,21371,80,allow,1114,534,580,12,15,7,5
52607,57906,443,24320,443,allow,2725,1564,1161,19,124,10,9
52608,60001,443,64771,443,allow,10580,2487,8093,28,16,16,12
52609,57908,443,7958,443,allow,1648,1017,631,18,124,10,8
52610,49916,443,14101,443,allow,2970,1793,1177,20,15,12,8
52611,57139,443,39822,443,allow,2162,1317,845,16,25,9,7
52612,57907,443,20224,443,allow,1584,953,631,17,124,9,8
52613,41508,53,41508,53,allow,244,98,146,2,32,1,1
52614,56351,53,4846,53,allow,195,102,93,2,32,1,1
52615,57268,443,5467,443,allow,1617,1073,544,16,15,9,7
52616,3591,53,3591,53,allow,235,90,145,2,32,1,1
52617,50386,443,59778,443,allow,1346,918,428,10,26,6,4
52618,33171,443,48753,443,allow,6509,973,5536,17,25,10,7
52619,63793,48970,37925,48970,allow,66,66,0,2,7,2,0
52620,53596,56732,3415,56732,allow,70,70,0,1,4,1,0
52621,15164,53,15164,53,allow,217,82,135,2,31,1,1
52622,53619,11513,10996,11513,allow,320,140,180,6,6,3,3
52623,63463,53,56932,53,allow,199,86,113,2,29,1,1
52624,51786,37832,29443,37832,allow,70,70,0,1,5,1,0
52625,49708,53,19621,53,allow,212,94,118,2,29,1,1
52626,49340,53,43709,53,allow,94,94,0,1,30,1,0
52627,6881,33969,15980,33969,allow,509,150,359,2,1200,1,1
52628,27005,27015,12555,27015,allow,887,126,761,2,30,1,1
52629,27005,27017,49070,27017,allow,883,126,757,2,30,1,1
52630,60900,53,31593,53,allow,181,86,95,2,30,1,1
52631,51521,443,51521,443,allow,138679,4142,134537,141,173,33,108
52632,51518,443,51518,443,allow,15967,3046,12921,39,173,15,24
52633,60403,60092,40292,60092,allow,70,70,0,1,5,1,0
52634,38759,443,24886,443,allow,7878,1531,6347,36,257,16,20
52635,54984,443,11572,443,allow,68519,3801,64718,93,31,40,53
52636,54979,443,32141,443,allow,643217,29500,613717,787,53,338,449
52637,53788,53,27955,53,allow,213,78,135,2,30,1,1
52638,61167,443,24525,443,allow,27000,11646,15354,176,640,82,94
52639,27005,52013,16949,52013,allow,901,126,775,2,30,1,1
52640,55921,443,55921,443,allow,4510,1603,2907,19,27,11,8
52641,27005,27015,11118,27015,allow,881,126,755,2,30,1,1
52642,38119,443,46487,443,allow,1820,1101,719,18,16,10,8
52643,57253,443,15843,443,allow,8613,2377,6236,41,17,23,18
52644,55826,53,63992,53,allow,168,86,82,2,30,1,1
52645,6754,443,21695,443,allow,13520,2288,11232,43,192,19,24
52646,51520,443,51520,443,allow,53075,3609,49466,74,173,25,49
52647,64872,53,23783,53,allow,323,94,229,2,30,1,1
52648,49915,443,34488,443,allow,7648,2967,4681,23,15,13,10
52649,51573,53,28199,53,allow,212,86,126,2,30,1,1
52650,27005,27018,42119,27018,allow,881,126,755,2,30,1,1
52651,27005,27015,38522,27015,allow,878,126,752,2,30,1,1
52652,2745,53,2745,53,allow,244,98,146,2,32,1,1
52653,58610,53,58610,53,allow,244,98,146,2,32,1,1
52654,56708,443,38081,443,allow,9634,3110,6524,26,138,11,15
52655,40799,443,51690,443,allow,21024,14637,6387,46,271,26,20
52656,63230,443,3094,443,allow,1309,670,639,16,127,9,7
52657,51804,31012,6657,31012,allow,70,70,0,2,8,2,0
52658,55616,42929,13566,42929,allow,70,70,0,1,5,1,0
52659,61347,443,30207,443,allow,5589,2260,3329,36,217,17,19
52660,45455,443,59423,443,allow,17237,2632,14605,34,420,18,16
52661,63224,443,7611,443,allow,1373,734,639,17,155,10,7
52662,57807,80,6054,80,allow,1013,566,447,8,162,5,3
52663,57421,80,60577,80,allow,4507,2978,1529,13,15,6,7
52664,50017,80,11643,80,allow,827,687,140,6,32,4,2
52665,53586,44515,38182,44515,allow,678,432,246,10,15,6,4
52666,36762,443,46444,443,allow,560,280,280,9,25,5,4
52667,53592,23578,9676,23578,allow,70,70,0,1,4,1,0
52668,51805,15298,11456,15298,allow,70,70,0,2,8,2,0
52669,57606,80,57606,80,allow,11536,3264,8272,29,37,15,14
52670,57909,443,27742,443,allow,2653,1558,1095,18,124,10,8
52671,57590,443,26107,443,allow,2614,1689,925,18,19,10,8
52672,49324,443,52610,443,allow,6147,943,5204,17,16,9,8
52673,5588,5588,0,0,allow,3354,1792,1562,46,194,23,23
52674,38285,443,16953,443,allow,6872,1815,5057,22,318,13,9
52675,49377,443,17002,443,allow,11627,4670,6957,37,155,16,21
52676,62049,443,63135,443,allow,9526,1375,8151,24,125,12,12
52677,65043,53,7870,53,allow,213,94,119,2,29,1,1
52678,44125,5222,56837,5222,allow,6329,3447,2882,67,841,34,33
52679,60229,443,63035,443,allow,8297,1280,7017,15,135,7,8
52680,57343,53,10133,53,allow,214,86,128,2,29,1,1
52681,61879,53,34841,53,allow,207,86,121,2,29,1,1
52682,65219,53,25255,53,allow,229,102,127,2,29,1,1
52683,27005,27015,11891,27015,allow,885,126,759,2,30,1,1
52684,8892,443,11185,443,allow,8106,1626,6480,31,341,11,20
52685,53629,443,53629,443,allow,4620,1713,2907,19,30,11,8
52686,51517,443,51517,443,allow,153968,7663,146305,170,173,43,127
52687,55826,53,27290,53,allow,86,86,0,2,34,2,0
52688,51785,33253,63010,33253,allow,70,70,0,1,5,1,0
52689,65315,53,22076,53,allow,216,110,106,2,30,1,1
52690,53581,12169,27472,12169,allow,492,306,186,8,15,5,3
52691,62705,443,33676,443,allow,178,118,60,2,15,1,1
52692,56007,53,0,0,allow,86,86,0,1,30,1,0
52693,65315,53,30606,53,allow,216,110,106,2,30,1,1
52694,65394,53,54686,53,allow,230,94,136,2,30,1,1
52695,32299,40014,29367,40014,allow,280,182,98,2,30,1,1
52696,44059,53,51061,53,allow,199,94,105,2,30,1,1
52697,53585,43611,54963,43611,allow,612,306,306,10,15,5,5
52698,62050,443,9772,443,allow,2139,1140,999,15,124,9,6
52699,19629,53,19629,53,allow,244,98,146,2,33,1,1
52700,50116,22,50116,22,allow,66,66,0,1,5,1,0
52701,56807,18177,32535,18177,allow,70,70,0,1,5,1,0
52702,51648,80,37574,80,allow,974005,25912,948093,1003,32,361,642
52703,34527,443,29221,443,allow,480624,56231,424393,860,196,427,433
52704,64755,53,11546,53,allow,339,134,205,2,30,1,1
52705,55252,53,15058,53,allow,212,102,110,2,30,1,1
52706,52784,443,37799,443,allow,16022,3217,12805,25,138,11,14
52707,55966,443,15279,443,allow,9006,2048,6958,36,121,18,18
52708,52403,443,54910,443,allow,8811,3668,5143,26,126,13,13
52709,52170,443,6811,443,allow,11716,7393,4323,47,146,21,26
52710,65157,53,24624,53,allow,209,102,107,2,31,1,1
52711,56667,53,23608,53,allow,168,86,82,2,31,1,1
52712,42309,443,23092,443,allow,7295,1469,5826,30,360,9,21
52713,49815,443,13935,443,allow,8614049,176366,8437683,7757,202,1608,6149
52714,62470,443,10717,443,allow,38402253,1191239,37211014,39088,243,12126,26962
52715,58439,443,54279,443,allow,2659,1417,1242,19,276,9,10
52716,57470,31112,14070,31112,allow,132,132,0,3,1199,3,0
52717,57470,41315,64435,41315,allow,792,792,0,13,1199,13,0
52718,6881,12388,2664,12388,allow,216,118,98,2,1199,1,1
52719,33434,5228,15468,5228,allow,12979,2808,10171,46,648,21,25
52720,6881,7005,9518,7005,allow,118,118,0,1,1200,1,0
52721,63228,443,36281,443,allow,3749,2597,1152,25,134,15,10
52722,60754,40010,30483,40010,allow,316,136,180,6,6,3,3
52723,2138,53,2138,53,allow,235,90,145,2,34,1,1
52724,34873,443,26122,443,allow,236097,12185,223912,307,32,125,182
52725,36793,80,35918,80,allow,156726,8626,148100,206,32,104,102
52726,36789,80,36658,80,allow,129896,7448,122448,172,32,87,85
52727,58415,443,33034,443,allow,560,280,280,9,30,5,4
52728,56934,80,1586,80,allow,486,280,206,8,26,5,3
52729,26177,53,26177,53,allow,220,90,130,2,30,1,1
52730,63963,53,44790,53,allow,212,102,110,2,30,1,1
52731,63225,443,50090,443,allow,4882,2412,2470,32,155,16,16
52732,53618,1025,19237,1025,allow,320,140,180,6,7,3,3
52733,36792,80,39617,80,allow,152694,8416,144278,200,32,101,99
52734,49923,53,15331,53,allow,199,94,105,2,30,1,1
52735,53787,53,59844,53,allow,224,86,138,2,30,1,1
52736,64255,53,2166,53,allow,332,102,230,2,30,1,1
52737,56443,53,9982,53,allow,168,86,82,2,31,1,1
52738,63233,443,64284,443,allow,1373,734,639,17,125,10,7
52739,63229,443,6765,443,allow,1373,734,639,17,134,10,7
52740,53607,51631,7980,51631,allow,70,70,0,2,8,2,0
52741,56933,80,47498,80,allow,486,280,206,8,26,5,3
52742,51173,443,13645,443,allow,13772,1738,12034,26,31,12,14
52743,65153,53,10346,53,allow,241,118,123,2,30,1,1
52744,53813,445,0,0,drop,66,66,0,1,0,1,0
52745,53814,445,0,0,drop,66,66,0,1,0,1,0
52746,53811,445,0,0,drop,66,66,0,1,0,1,0
52747,9246,35440,0,0,deny,62,62,0,1,0,1,0
52748,62386,37965,0,0,deny,66,66,0,1,0,1,0
52749,11464,37965,0,0,deny,62,62,0,1,0,1,0
52750,57860,51505,0,0,deny,66,66,0,1,0,1,0
52751,7931,30170,0,0,deny,146,146,0,1,0,1,0
52752,53423,445,0,0,drop,70,70,0,1,0,1,0
52753,58397,445,0,0,drop,70,70,0,1,0,1,0
52754,58395,445,0,0,drop,70,70,0,1,0,1,0
52755,58393,445,0,0,drop,70,70,0,1,0,1,0
52756,17009,53733,0,0,deny,62,62,0,1,0,1,0
52757,53809,445,0,0,drop,66,66,0,1,0,1,0
52758,51010,22114,0,0,deny,146,146,0,1,0,1,0
52759,58389,445,0,0,drop,70,70,0,1,0,1,0
52760,43260,41615,0,0,deny,145,145,0,1,0,1,0
52761,57789,30188,0,0,deny,62,62,0,1,0,1,0
52762,49174,50584,0,0,deny,146,146,0,1,0,1,0
52763,53806,445,0,0,drop,66,66,0,1,0,1,0
52764,53804,445,0,0,drop,66,66,0,1,0,1,0
52765,53803,445,0,0,drop,66,66,0,1,0,1,0
52766,6881,6881,0,0,deny,146,146,0,1,0,1,0
52767,53800,445,0,0,drop,66,66,0,1,0,1,0
52768,53416,445,0,0,drop,70,70,0,1,0,1,0
52769,53415,445,0,0,drop,70,70,0,1,0,1,0
52770,61808,18375,0,0,deny,66,66,0,1,0,1,0
52771,2323,23117,0,0,deny,62,62,0,1,0,1,0
52772,58382,445,0,0,drop,70,70,0,1,0,1,0
52773,22587,30188,0,0,deny,62,62,0,1,0,1,0
52774,32071,51221,0,0,deny,66,66,0,1,0,1,0
52775,53409,445,0,0,drop,70,70,0,1,0,1,0
52776,58376,445,0,0,drop,70,70,0,1,0,1,0
52777,58374,445,0,0,drop,70,70,0,1,0,1,0
52778,53408,445,0,0,drop,70,70,0,1,0,1,0
52779,59696,57470,0,0,deny,62,62,0,1,0,1,0
52780,50280,57470,0,0,deny,78,78,0,1,0,1,0
52781,48676,53395,0,0,deny,60,60,0,1,0,1,0
52782,53790,445,0,0,drop,66,66,0,1,0,1,0
52783,52064,22114,0,0,deny,66,66,0,1,0,1,0
52784,53404,445,0,0,drop,70,70,0,1,0,1,0
52785,36586,5900,0,0,deny,60,60,0,1,0,1,0
52786,59745,53635,0,0,deny,66,66,0,1,0,1,0
52787,47910,7461,0,0,deny,60,60,0,1,0,1,0
52788,53403,445,0,0,drop,70,70,0,1,0,1,0
52789,13943,22,0,0,deny,60,60,0,1,0,1,0
52790,53782,445,0,0,drop,66,66,0,1,0,1,0
52791,58361,445,0,0,drop,70,70,0,1,0,1,0
52792,30765,56205,0,0,deny,66,66,0,1,0,1,0
52793,59781,56205,0,0,deny,66,66,0,1,0,1,0
52794,56307,52700,0,0,deny,66,66,0,1,0,1,0
52795,53779,445,0,0,drop,66,66,0,1,0,1,0
52796,53398,445,0,0,drop,70,70,0,1,0,1,0
52797,7308,50584,0,0,deny,62,62,0,1,0,1,0
52798,60602,15503,0,0,deny,66,66,0,1,0,1,0
52799,53928,15503,0,0,deny,62,62,0,1,0,1,0
52800,51996,35440,0,0,deny,66,66,0,1,0,1,0
52801,58305,51180,0,0,deny,66,66,0,1,0,1,0
52802,53773,445,0,0,drop,66,66,0,1,0,1,0
52803,12530,35440,0,0,deny,62,62,0,1,0,1,0
52804,53768,445,0,0,drop,66,66,0,1,0,1,0
52805,6416,22114,0,0,deny,66,66,0,1,0,1,0
52806,26400,44847,0,0,deny,146,146,0,1,0,1,0
52807,31112,50584,0,0,deny,62,62,0,1,0,1,0
52808,60196,53,0,0,deny,88,88,0,1,0,1,0
52809,17581,23,0,0,deny,60,60,0,1,0,1,0
52810,42898,43890,0,0,deny,62,62,0,1,0,1,0
52811,53385,445,0,0,drop,70,70,0,1,0,1,0
52812,59378,50584,0,0,deny,62,62,0,1,0,1,0
52813,6666,2222,0,0,deny,60,60,0,1,0,1,0
52814,24534,50584,0,0,deny,146,146,0,1,0,1,0
52815,58352,445,0,0,drop,70,70,0,1,0,1,0
52816,58350,445,0,0,drop,70,70,0,1,0,1,0
52817,58349,445,0,0,drop,70,70,0,1,0,1,0
52818,53754,445,0,0,drop,66,66,0,1,0,1,0
52819,53757,445,0,0,drop,66,66,0,1,0,1,0
52820,53755,445,0,0,drop,66,66,0,1,0,1,0
52821,53756,445,0,0,drop,66,66,0,1,0,1,0
52822,53753,445,0,0,drop,66,66,0,1,0,1,0
52823,53751,445,0,0,drop,66,66,0,1,0,1,0
52824,53752,445,0,0,drop,66,66,0,1,0,1,0
52825,53749,445,0,0,drop,66,66,0,1,0,1,0
52826,53382,445,0,0,drop,70,70,0,1,0,1,0
52827,65250,22114,0,0,deny,62,62,0,1,0,1,0
52828,54155,64147,0,0,deny,66,66,0,1,0,1,0
52829,52431,50265,0,0,deny,62,62,0,1,0,1,0
52830,52973,23,0,0,deny,60,60,0,1,0,1,0
52831,44121,23,0,0,deny,60,60,0,1,0,1,0
52832,22357,6004,0,0,deny,62,62,0,1,0,1,0
52833,63547,37965,0,0,deny,66,66,0,1,0,1,0
52834,52741,24211,0,0,deny,66,66,0,1,0,1,0
52835,26084,36237,0,0,deny,66,66,0,1,0,1,0
52836,53377,445,0,0,drop,70,70,0,1,0,1,0
52837,53376,445,0,0,drop,70,70,0,1,0,1,0
52838,15530,49718,0,0,deny,146,146,0,1,0,1,0
52839,58348,445,0,0,drop,70,70,0,1,0,1,0
52840,58342,445,0,0,drop,70,70,0,1,0,1,0
52841,58339,445,0,0,drop,70,70,0,1,0,1,0
52842,53374,445,0,0,drop,70,70,0,1,0,1,0
52843,57339,50584,0,0,deny,66,66,0,1,0,1,0
52844,53737,445,0,0,drop,66,66,0,1,0,1,0
52845,53736,445,0,0,drop,66,66,0,1,0,1,0
52846,53734,445,0,0,drop,66,66,0,1,0,1,0
52847,61701,44847,0,0,deny,66,66,0,1,0,1,0
52848,58331,445,0,0,drop,70,70,0,1,0,1,0
52849,8999,57470,0,0,deny,146,146,0,1,0,1,0
52850,51725,56205,0,0,deny,62,62,0,1,0,1,0
52851,58330,445,0,0,drop,70,70,0,1,0,1,0
52852,55255,37965,0,0,deny,146,146,0,1,0,1,0
52853,58327,445,0,0,drop,70,70,0,1,0,1,0
52854,58328,445,0,0,drop,70,70,0,1,0,1,0
52855,58321,445,0,0,drop,70,70,0,1,0,1,0
52856,46478,64147,0,0,deny,62,62,0,1,0,1,0
52857,53367,445,0,0,drop,70,70,0,1,0,1,0
52858,0,0,0,0,deny,98,98,0,1,0,1,0
52859,0,0,0,0,deny,98,98,0,1,0,1,0
52860,0,0,0,0,deny,98,98,0,1,0,1,0
52861,0,0,0,0,deny,98,98,0,1,0,1,0
52862,0,0,0,0,allow,134,64,70,2,0,1,1
52863,53365,445,0,0,drop,70,70,0,1,0,1,0
52864,49690,50265,0,0,deny,66,66,0,1,0,1,0
52865,61457,21247,0,0,deny,66,66,0,1,0,1,0
52866,36908,26467,0,0,deny,62,62,0,1,0,1,0
52867,53364,445,0,0,drop,70,70,0,1,0,1,0
52868,51192,15503,0,0,deny,66,66,0,1,0,1,0
52869,53363,445,0,0,drop,70,70,0,1,0,1,0
52870,51413,25864,0,0,deny,72,72,0,1,0,1,0
52871,53362,445,0,0,drop,70,70,0,1,0,1,0
52872,53357,445,0,0,drop,70,70,0,1,0,1,0
52873,53356,445,0,0,drop,70,70,0,1,0,1,0
52874,51674,51505,0,0,deny,66,66,0,1,0,1,0
52875,2697,28189,0,0,deny,60,60,0,1,0,1,0
52876,26799,50584,0,0,deny,62,62,0,1,0,1,0
52877,52103,53733,0,0,deny,62,62,0,1,0,1,0
52878,58312,445,0,0,drop,70,70,0,1,0,1,0
52879,58311,445,0,0,drop,70,70,0,1,0,1,0
52880,58307,445,0,0,drop,70,70,0,1,0,1,0
52881,53344,445,0,0,drop,70,70,0,1,0,1,0
52882,53343,445,0,0,drop,70,70,0,1,0,1,0
52883,53341,445,0,0,drop,70,70,0,1,0,1,0
52884,53334,445,0,0,drop,70,70,0,1,0,1,0
52885,53333,445,0,0,drop,70,70,0,1,0,1,0
52886,61520,23718,0,0,deny,66,66,0,1,0,1,0
52887,58396,22114,0,0,deny,66,66,0,1,0,1,0
52888,27147,22114,0,0,deny,62,62,0,1,0,1,0
52889,50027,21247,0,0,deny,66,66,0,1,0,1,0
52890,54109,36829,0,0,deny,66,66,0,1,0,1,0
52891,56119,46824,0,0,deny,62,62,0,1,0,1,0
52892,53714,445,0,0,drop,66,66,0,1,0,1,0
52893,58298,445,0,0,drop,70,70,0,1,0,1,0
52894,58295,445,0,0,drop,70,70,0,1,0,1,0
52895,52076,44847,0,0,deny,66,66,0,1,0,1,0
52896,53322,445,0,0,drop,70,70,0,1,0,1,0
52897,50804,1,0,0,deny,62,62,0,1,0,1,0
52898,34553,48637,0,0,deny,60,60,0,1,0,1,0
52899,4041,23,0,0,deny,60,60,0,1,0,1,0
52900,43600,443,57317,443,allow,172272,14401,157871,254,418,100,154
52901,54501,80,17667,80,allow,254,128,126,5,16,3,2
52902,53899,443,60991,443,allow,21288,10113,11175,107,31,51,56
52903,49468,443,51693,443,allow,6940,1302,5638,20,119,10,10
52904,56169,53,17161,53,allow,916,86,830,2,30,1,1
52905,57236,53,14592,53,allow,748,95,653,2,30,1,1
52906,52016,80,31831,80,allow,19693,1957,17736,49,32,23,26
52907,58145,1433,58145,1433,allow,60,60,0,2,5,2,0
52908,31362,23,31362,23,allow,60,60,0,1,5,1,0
52909,53608,1024,52758,1024,allow,70,70,0,2,8,2,0
52910,33570,443,59571,443,allow,81954,13611,68343,174,34,79,95
52911,49469,443,50617,443,allow,6416,1302,5114,20,119,10,10
52912,34038,5222,46652,5222,allow,2853,1289,1564,30,1555,12,18
52913,51317,443,51634,443,allow,59889,7472,52417,83,145,32,51
52914,53617,1056,21327,1056,allow,320,140,180,6,6,3,3
52915,42566,443,31210,443,allow,10127,4193,5934,30,24,17,13
52916,55030,80,10323,80,allow,2954,671,2283,12,15,7,5
52917,49629,53,19594,53,allow,916,86,830,2,30,1,1
52918,60464,53,0,0,allow,180,82,98,2,30,1,1
52919,48906,80,50980,80,allow,2544,1681,863,12,185,7,5
52920,39292,80,43537,80,allow,1655,1341,314,10,16,5,5
52921,36839,80,35799,80,allow,10345,6823,3522,25,25,14,11
52922,39804,443,42042,443,allow,56980,4095,52885,90,256,37,53
52923,42510,53,42510,53,allow,237,91,146,2,32,1,1
52924,53609,38060,12354,38060,allow,70,70,0,2,8,2,0
52925,56805,1,17140,1,allow,70,70,0,1,5,1,0
52926,51784,34568,52434,34568,allow,66,66,0,1,5,1,0
52927,36497,80,36497,80,allow,7594,863,6731,18,21,8,10
52928,50438,53,48155,53,allow,295,101,194,4,31,2,2
52929,27005,27016,9043,27016,allow,881,126,755,2,30,1,1
52930,27005,27015,8409,27015,allow,897,126,771,2,30,1,1
52931,56103,443,24314,443,allow,22293,16437,5856,51,30,27,24
52932,59312,443,40068,443,allow,233778,8502,225276,276,34,109,167
52933,49737,443,48877,443,allow,35419,29471,5948,42,31,27,15
52934,34990,80,36946,80,allow,1534,996,538,10,35,6,4
52935,57022,80,30750,80,allow,77115,5003,72112,110,35,56,54
52936,52014,80,24294,80,allow,30427,2131,28296,66,32,25,41
52937,33568,443,55064,443,allow,9180,2197,6983,36,34,20,16
52938,36823,80,35585,80,allow,3335,2735,600,12,30,7,5
52939,57392,443,57392,443,allow,4729,1822,2907,19,27,11,8
52940,33569,443,28286,443,allow,9032,2162,6870,34,34,18,16
52941,64572,443,16176,443,allow,24918,2042,22876,40,16,19,21
52942,35149,53,35149,53,allow,235,90,145,2,32,1,1
52943,34424,443,13536,443,allow,8277,2394,5883,31,316,16,15
52944,56443,53,2207,53,allow,168,86,82,2,30,1,1
52945,56667,53,46013,53,allow,168,86,82,2,30,1,1
52946,53150,80,13371,80,allow,2398,2024,374,12,15,6,6
52947,33576,443,52498,443,allow,170319,23354,146965,283,34,121,162
52948,46492,443,13641,443,allow,11163,3642,7521,25,30,14,11
52949,36810,80,28528,80,allow,18460,3166,15294,34,32,18,16
52950,52694,80,51604,80,allow,1960,1366,594,12,34,7,5
52951,60936,443,44472,443,allow,4621,3079,1542,24,52,13,11
52952,56102,443,1329,443,allow,8577,3450,5127,23,30,13,10
52953,58993,443,16211,443,allow,1437,736,701,15,28,7,8
52954,51908,443,56072,443,allow,8481,1976,6505,23,25,13,10
52955,35501,53,35501,53,allow,213,79,134,2,33,1,1
52956,51949,80,39415,80,allow,5106,766,4340,16,45,9,7
52957,45204,53,45204,53,allow,237,91,146,2,33,1,1
52958,35554,443,35554,443,allow,4378,1471,2907,19,28,11,8
52959,62791,443,22999,443,allow,17411,8921,8490,98,291,41,57
52960,53860,443,53373,443,allow,8712,2293,6419,26,315,13,13
52961,11826,53,11826,53,allow,237,91,146,2,33,1,1
52962,52018,80,20950,80,allow,1660,791,869,11,32,6,5
52963,56202,53,30224,53,allow,916,86,830,2,30,1,1
52964,55736,53,0,0,allow,338,70,268,2,30,1,1
52965,47722,80,12273,80,allow,1720,1406,314,10,15,5,5
52966,43473,53,43473,53,allow,220,100,120,2,30,1,1
52967,55736,53,0,0,allow,623,70,553,2,30,1,1
52968,34111,53,34111,53,allow,213,87,126,2,30,1,1
52969,27005,27015,8429,27015,allow,882,126,756,2,30,1,1
52970,26900,27017,21825,27017,allow,422,164,258,6,31,3,3
52971,56940,443,47279,443,allow,5147,2613,2534,19,137,10,9
52972,26900,27017,60597,27017,allow,422,164,258,6,31,3,3
52973,5938,18721,0,0,allow,60,60,0,1,91,1,0
52974,42820,443,51976,443,allow,25721,8999,16722,38,121,18,20
52975,51282,443,3652,443,allow,4933,2248,2685,14,135,7,7
52976,64971,53,0,0,allow,229,85,144,2,31,1,1
52977,50226,443,45230,443,allow,7726,4613,3113,21,137,11,10
52978,45538,5228,21561,5228,allow,2372,1452,920,16,3600,8,8
52979,62737,64147,0,0,deny,66,66,0,1,0,1,0
52980,65454,61600,0,0,deny,66,66,0,1,0,1,0
52981,49677,64147,0,0,deny,62,62,0,1,0,1,0
52982,53676,35974,0,0,deny,60,60,0,1,0,1,0
52983,34677,51185,0,0,deny,60,60,0,1,0,1,0
52984,54693,30188,0,0,deny,66,66,0,1,0,1,0
52985,53770,64147,0,0,deny,66,66,0,1,0,1,0
52986,53707,445,0,0,drop,66,66,0,1,0,1,0
52987,1049,54369,0,0,deny,62,62,0,1,0,1,0
52988,4447,35440,0,0,deny,66,66,0,1,0,1,0
52989,53705,445,0,0,drop,66,66,0,1,0,1,0
52990,10006,64147,0,0,deny,62,62,0,1,0,1,0
52991,27005,27015,48748,27015,allow,894,126,768,2,30,1,1
52992,63967,53,11149,53,allow,195,102,93,2,30,1,1
52993,41051,443,30990,443,allow,37711,4074,33637,69,32,31,38
52994,45254,443,27475,443,allow,8328,2592,5736,35,34,18,17
52995,36776,80,31947,80,allow,16274,9170,7104,34,32,19,15
52996,34883,443,14501,443,allow,51393,3538,47855,70,30,29,41
52997,48067,443,48553,443,allow,12648,5285,7363,58,32,27,31
52998,49466,443,64942,443,allow,4562,2466,2096,20,119,11,9
52999,58361,443,12659,443,allow,7297,2046,5251,22,29,13,9
53000,36790,80,59682,80,allow,191737,8302,183435,205,31,79,126
53001,49672,80,61052,80,allow,3874260,98179,3776081,4003,1072,1479,2524
53002,49464,443,43565,443,allow,4555,2472,2083,20,119,11,9
53003,36791,80,9992,80,allow,196328,10952,185376,244,31,117,127
53004,52415,443,32301,443,allow,2007,1152,855,14,15,8,6
53005,37738,443,1957,443,allow,6470,1931,4539,27,32,14,13
53006,43675,80,34710,80,allow,1676620,41953,1634667,1725,25,636,1089
53007,36765,80,13699,80,allow,2272,1679,593,10,34,6,4
53008,36533,443,27150,443,allow,10488,4495,5993,38,32,20,18
53009,34710,53,34710,53,allow,244,98,146,2,33,1,1
53010,49467,443,18409,443,allow,4564,2466,2098,20,119,11,9
53011,46641,8100,13057,8100,allow,78,78,0,1,4,1,0
53012,63235,443,19696,443,allow,1373,734,639,17,96,10,7
53013,63779,12226,30689,12226,allow,70,70,0,1,4,1,0
53014,53605,13468,23024,13468,allow,70,70,0,2,7,2,0
53015,45540,8100,31556,8100,allow,78,78,0,1,4,1,0
53016,49639,53,29692,53,allow,250,102,148,2,29,1,1
53017,49924,443,9177,443,allow,13502,2331,11171,42,194,19,23
53018,62888,53,62888,53,allow,240,98,142,2,29,1,1
53019,34173,53,34173,53,allow,240,98,142,2,29,1,1
53020,56667,53,25410,53,allow,250,86,164,4,29,2,2
53021,49447,53,25197,53,allow,248,102,146,2,29,1,1
53022,64073,53,51133,53,allow,361,86,275,2,30,1,1
53023,55158,53,42446,53,allow,239,102,137,2,30,1,1
53024,59607,443,14075,443,allow,2150,1280,870,18,832,10,8
53025,56543,443,26469,443,allow,245527,10641,234886,322,405,136,186
53026,56663,53,28501,53,allow,215,102,113,2,30,1,1
53027,50097,53,57646,53,allow,199,94,105,2,30,1,1
53028,56997,53,45686,53,allow,168,86,82,2,30,1,1
53029,34469,53,59263,53,allow,226,78,148,2,30,1,1
53030,37918,443,25153,443,allow,6123,860,5263,18,361,9,9
53031,57427,53,45535,53,allow,363,94,269,2,30,1,1
53032,53577,53,0,0,allow,82,82,0,2,40,2,0
53033,60409,44739,34320,44739,allow,70,70,0,2,8,2,0
53034,51798,37020,11736,37020,allow,70,70,0,2,8,2,0
53035,52413,443,50762,443,allow,2114,1152,962,14,15,8,6
53036,54995,443,62942,443,allow,23418,2454,20964,56,197,26,30
53037,41385,53,41385,53,allow,244,98,146,2,34,1,1
53038,58055,80,49869,80,allow,254,128,126,5,15,3,2
53039,41542,23,41542,23,allow,66,66,0,1,5,1,0
53040,56618,80,46340,80,allow,234,234,0,4,12,4,0
53041,51580,53,9399,53,allow,199,94,105,2,30,1,1
53042,56742,53,0,0,allow,82,82,0,2,40,2,0
53043,16224,443,3120,443,allow,7525,1098,6427,22,16,12,10
53044,56048,53,3715,53,allow,296,110,186,2,30,1,1
53045,63777,80,2556,80,allow,314,192,122,6,15,4,2
53046,59723,80,4011,80,allow,613,539,74,7,15,6,1
53047,59165,53,3627,53,allow,320,94,226,2,30,1,1
53048,64609,53,7201,53,allow,168,86,82,2,30,1,1
53049,50466,80,60136,80,allow,1718,1247,471,9,15,5,4
53050,64609,53,19942,53,allow,168,86,82,2,30,1,1
53051,64926,53,31198,53,allow,309,118,191,2,30,1,1
53052,19473,14168,34740,14168,allow,491,150,341,2,1200,1,1
53053,27005,27015,9469,27015,allow,887,126,761,2,30,1,1
53054,55284,53,61340,53,allow,193,102,91,2,30,1,1
53055,49205,80,50738,80,allow,890,411,479,11,15,6,5
53056,54957,80,50979,80,allow,416,210,206,7,15,4,3
53057,51800,63796,36885,63796,allow,70,70,0,2,8,2,0
53058,13956,53,13956,53,allow,244,98,146,2,34,1,1
53059,53117,37529,38733,37529,allow,70,70,0,1,5,1,0
53060,57362,53,47817,53,allow,183,86,97,2,30,1,1
53061,50595,443,32592,443,allow,8981,4625,4356,22,135,11,11
53062,60012,443,58670,443,allow,8127,1796,6331,21,79,12,9
53063,53119,58118,15448,58118,allow,70,70,0,2,8,2,0
53064,45648,80,30446,80,allow,130,70,60,2,15,1,1
53065,59574,443,1442,443,allow,2582500,86854,2495646,2678,84,986,1692
53066,58413,443,5177,443,allow,9371,1936,7435,26,29,14,12
53067,47020,443,34656,443,allow,3545,1817,1728,22,95,11,11
53068,36068,80,51482,80,allow,41269,2915,38354,62,33,32,30
53069,54672,443,53803,443,allow,7210,2267,4943,22,15,12,10
53070,45067,443,54041,443,allow,7794,2844,4950,26,29,16,10
53071,36788,80,9413,80,allow,235873,12126,223747,306,31,154,152
53072,45257,443,55440,443,allow,36062,4663,31399,87,33,41,46
53073,49465,443,16999,443,allow,4555,2472,2083,20,119,11,9
53074,53358,443,35239,443,allow,8626,2839,5787,47,27,24,23
53075,41421,443,56908,443,allow,168930,11361,157569,252,31,101,151
53076,63232,443,26677,443,allow,4496,2346,2150,28,124,15,13
53077,49073,443,18222,443,allow,8960,2497,6463,35,32,19,16
53078,63231,443,12369,443,allow,7124,3843,3281,42,126,20,22
53079,59538,80,28530,80,allow,1895,755,1140,11,14,6,5
53080,56997,53,24700,53,allow,337,107,230,4,34,2,2
53081,58705,80,29021,80,allow,2543,1880,663,12,14,6,6
53082,51801,33531,27515,33531,allow,70,70,0,2,8,2,0
53083,56680,8100,18544,8100,allow,78,78,0,1,4,1,0
53084,48882,443,39008,443,allow,8105,1902,6203,24,26,14,10
53085,14420,80,14420,80,allow,4591,3155,1436,22,45,13,9
53086,40953,443,21244,443,allow,4093,1595,2498,23,15,12,11
53087,55484,443,18380,443,allow,782,428,354,12,25,7,5
53088,16223,443,54966,443,allow,7461,1034,6427,21,16,11,10
53089,49954,443,61436,443,allow,25995,13597,12398,53,186,28,25
53090,63234,443,45160,443,allow,5846,3321,2525,34,96,19,15
53091,46414,80,41611,80,allow,1155,781,374,10,15,6,4
53092,62408,3478,35393,3478,allow,3548,1868,1680,57,87,29,28
53093,64005,53,59576,53,allow,402,125,277,4,37,2,2
53094,64991,53,47067,53,allow,625,192,433,6,46,3,3
53095,65364,53,50447,53,allow,226,110,116,2,29,1,1
53096,55347,443,1685,443,allow,116686,21822,94864,224,186,112,112
53097,64693,53,28781,53,allow,248,102,146,2,30,1,1
53098,27005,27017,1737,27017,allow,891,126,765,2,30,1,1
53099,56443,53,48417,53,allow,250,86,164,4,29,2,2
53100,56667,53,35767,53,allow,168,86,82,2,29,1,1
53101,53786,53,10105,53,allow,260,86,174,2,30,1,1
53102,37916,443,12180,443,allow,6202,872,5330,19,361,9,10
53103,56443,53,60191,53,allow,168,86,82,2,30,1,1
53104,43361,80,14228,80,allow,630,630,0,10,217,10,0
53105,60480,443,16166,443,allow,6511,2810,3701,34,3665,12,22
53106,36886,443,32940,443,allow,2907,1637,1270,20,364,11,9
53107,55427,443,18604,443,allow,9255,2064,7191,43,78,18,25
53108,41631,123,31654,123,allow,184,94,90,2,30,1,1
53109,57991,53,26816,53,allow,220,78,142,2,30,1,1
53110,51176,53,44581,53,allow,236,86,150,2,30,1,1
53111,27005,27015,41826,27015,allow,868,126,742,2,30,1,1
53112,46865,443,9898,443,allow,416,210,206,7,32,4,3
53113,27005,27018,40971,27018,allow,882,126,756,2,30,1,1
53114,40893,443,32829,443,allow,10450,3898,6552,20,135,11,9
53115,60644,5222,7350,5222,allow,9852,2665,7187,60,360,25,35
53116,51764,443,51764,443,allow,4632,1725,2907,19,27,11,8
53117,56800,1,6191,1,allow,70,70,0,2,8,2,0
53118,58962,80,58962,80,allow,22844,1529,21315,39,28,20,19
53119,62783,443,22003,443,allow,28847,16957,11890,144,293,60,84
53120,43872,53,52878,53,allow,199,94,105,2,30,1,1
53121,55072,53,52370,53,allow,168,86,82,2,30,1,1
53122,64609,53,7620,53,allow,250,86,164,4,30,2,2
53123,48458,53,30263,53,allow,168,78,90,2,31,1,1
53124,37917,443,55165,443,allow,6124,860,5264,18,361,9,9
53125,61762,443,14583,443,allow,5975,2713,3262,24,125,12,12
53126,61305,443,56273,443,allow,5399,2711,2688,13,120,7,6
53127,64072,53,31241,53,allow,292,110,182,2,30,1,1
53128,60241,443,21837,443,allow,4512,1810,2702,16,135,7,9
53129,50464,80,22574,80,allow,8453,2011,6442,17,21,8,9
53130,57304,53,22240,53,allow,292,110,182,2,30,1,1
53131,16980,53,16980,53,allow,197,90,107,2,30,1,1
53132,61151,443,65420,443,allow,121129,5559,115570,157,640,51,106
53133,49665,53,45405,53,allow,197,102,95,2,30,1,1
53134,52508,53,51671,53,allow,168,78,90,2,30,1,1
53135,50438,53,55322,53,allow,199,102,97,2,31,1,1
53136,53578,34129,19410,34129,allow,70,70,0,1,5,1,0
53137,25448,23,25448,23,allow,66,66,0,1,5,1,0
53138,50452,80,41109,80,allow,318,192,126,6,29,4,2
53139,39118,443,29645,443,allow,5229,2388,2841,23,367,12,11
53140,64082,53,17005,53,allow,356,97,259,4,58,2,2
53141,58289,445,0,0,drop,70,70,0,1,0,1,0
53142,58305,18375,0,0,deny,62,62,0,1,0,1,0
53143,53318,445,0,0,drop,70,70,0,1,0,1,0
53144,58286,445,0,0,drop,70,70,0,1,0,1,0
53145,58287,445,0,0,drop,70,70,0,1,0,1,0
53146,58284,445,0,0,drop,70,70,0,1,0,1,0
53147,51166,31573,0,0,deny,66,66,0,1,0,1,0
53148,4961,62741,0,0,deny,66,66,0,1,0,1,0
53149,53702,445,0,0,drop,66,66,0,1,0,1,0
53150,53309,445,0,0,drop,70,70,0,1,0,1,0
53151,53308,445,0,0,drop,70,70,0,1,0,1,0
53152,53305,445,0,0,drop,70,70,0,1,0,1,0
53153,53303,445,0,0,drop,70,70,0,1,0,1,0
53154,33174,22,0,0,deny,60,60,0,1,0,1,0
53155,53302,445,0,0,drop,70,70,0,1,0,1,0
53156,46640,8880,0,0,deny,60,60,0,1,0,1,0
53157,58278,445,0,0,drop,70,70,0,1,0,1,0
53158,61221,35440,0,0,deny,66,66,0,1,0,1,0
53159,58273,445,0,0,drop,70,70,0,1,0,1,0
53160,58270,445,0,0,drop,70,70,0,1,0,1,0
53161,58269,445,0,0,drop,70,70,0,1,0,1,0
53162,53696,445,0,0,drop,66,66,0,1,0,1,0
53163,58703,50584,0,0,deny,66,66,0,1,0,1,0
53164,53692,445,0,0,drop,66,66,0,1,0,1,0
53165,53691,445,0,0,drop,66,66,0,1,0,1,0
53166,53687,445,0,0,drop,66,66,0,1,0,1,0
53167,53686,445,0,0,drop,66,66,0,1,0,1,0
53168,53685,445,0,0,drop,66,66,0,1,0,1,0
53169,53683,445,0,0,drop,66,66,0,1,0,1,0
53170,1024,64147,0,0,deny,62,62,0,1,0,1,0
53171,7749,36237,0,0,deny,66,66,0,1,0,1,0
53172,52860,9694,0,0,deny,62,62,0,1,0,1,0
53173,53294,445,0,0,drop,70,70,0,1,0,1,0
53174,60018,64147,0,0,deny,62,62,0,1,0,1,0
53175,59377,9319,0,0,deny,62,62,0,1,0,1,0
53176,58268,445,0,0,drop,70,70,0,1,0,1,0
53177,58265,445,0,0,drop,70,70,0,1,0,1,0
53178,58263,445,0,0,drop,70,70,0,1,0,1,0
53179,56712,46824,0,0,deny,62,62,0,1,0,1,0
53180,53682,445,0,0,drop,66,66,0,1,0,1,0
53181,58260,445,0,0,drop,70,70,0,1,0,1,0
53182,50254,44847,0,0,deny,66,66,0,1,0,1,0
53183,53677,445,0,0,drop,66,66,0,1,0,1,0
53184,53286,445,0,0,drop,70,70,0,1,0,1,0
53185,56173,37807,0,0,deny,66,66,0,1,0,1,0
53186,62071,22114,0,0,deny,62,62,0,1,0,1,0
53187,53676,445,0,0,drop,66,66,0,1,0,1,0
53188,53675,445,0,0,drop,66,66,0,1,0,1,0
53189,53283,445,0,0,drop,70,70,0,1,0,1,0
53190,53673,445,0,0,drop,66,66,0,1,0,1,0
53191,53406,50584,0,0,deny,66,66,0,1,0,1,0
53192,53178,26467,0,0,deny,62,62,0,1,0,1,0
53193,17481,64097,0,0,deny,146,146,0,1,0,1,0
53194,20576,37965,0,0,deny,62,62,0,1,0,1,0
53195,53280,445,0,0,drop,70,70,0,1,0,1,0
53196,49982,37965,0,0,deny,66,66,0,1,0,1,0
53197,25797,30188,0,0,deny,146,146,0,1,0,1,0
53198,62549,64147,0,0,deny,62,62,0,1,0,1,0
53199,53278,445,0,0,drop,70,70,0,1,0,1,0
53200,65203,30188,0,0,deny,66,66,0,1,0,1,0
53201,58253,445,0,0,drop,70,70,0,1,0,1,0
53202,58248,445,0,0,drop,70,70,0,1,0,1,0
53203,58245,445,0,0,drop,70,70,0,1,0,1,0
53204,41410,30188,0,0,deny,146,146,0,1,0,1,0
53205,53274,445,0,0,drop,70,70,0,1,0,1,0
53206,52361,23718,0,0,deny,66,66,0,1,0,1,0
53207,53664,445,0,0,drop,66,66,0,1,0,1,0
53208,5751,64147,0,0,deny,66,66,0,1,0,1,0
53209,53273,445,0,0,drop,70,70,0,1,0,1,0
53210,50535,51505,0,0,deny,62,62,0,1,0,1,0
53211,32491,15503,0,0,deny,66,66,0,1,0,1,0
53212,43688,22114,0,0,deny,66,66,0,1,0,1,0
53213,53654,445,0,0,drop,66,66,0,1,0,1,0
53214,57772,50584,0,0,deny,66,66,0,1,0,1,0
53215,58234,445,0,0,drop,70,70,0,1,0,1,0
53216,58751,9571,0,0,deny,62,62,0,1,0,1,0
53217,25010,30188,0,0,deny,62,62,0,1,0,1,0
53218,9377,56205,0,0,deny,66,66,0,1,0,1,0
53219,53268,445,0,0,drop,70,70,0,1,0,1,0
53220,64339,18375,0,0,deny,66,66,0,1,0,1,0
53221,59728,5900,0,0,deny,60,60,0,1,0,1,0
53222,55225,11392,0,0,deny,66,66,0,1,0,1,0
53223,53652,445,0,0,drop,66,66,0,1,0,1,0
53224,29049,23,0,0,deny,60,60,0,1,0,1,0
53225,1054,15503,0,0,deny,62,62,0,1,0,1,0
53226,63542,15503,0,0,deny,66,66,0,1,0,1,0
53227,10265,64147,0,0,deny,66,66,0,1,0,1,0
53228,52217,22114,0,0,deny,66,66,0,1,0,1,0
53229,59790,44847,0,0,deny,66,66,0,1,0,1,0
53230,52726,56205,0,0,deny,66,66,0,1,0,1,0
53231,53645,445,0,0,drop,66,66,0,1,0,1,0
53232,37902,23718,0,0,deny,62,62,0,1,0,1,0
53233,53639,445,0,0,drop,66,66,0,1,0,1,0
53234,42532,22114,0,0,deny,62,62,0,1,0,1,0
53235,63205,9571,0,0,deny,66,66,0,1,0,1,0
53236,52997,5900,0,0,deny,60,60,0,1,0,1,0
53237,9412,7302,0,0,deny,62,62,0,1,0,1,0
53238,53255,445,0,0,drop,70,70,0,1,0,1,0
53239,63465,56205,0,0,deny,66,66,0,1,0,1,0
53240,64877,37450,0,0,deny,66,66,0,1,0,1,0
53241,63772,35440,0,0,deny,66,66,0,1,0,1,0
53242,17411,43890,0,0,deny,146,146,0,1,0,1,0
53243,15530,49718,0,0,deny,146,146,0,1,0,1,0
53244,42241,11392,0,0,deny,66,66,0,1,0,1,0
53245,58721,51505,0,0,deny,66,66,0,1,0,1,0
53246,53252,445,0,0,drop,70,70,0,1,0,1,0
53247,15005,32480,0,0,deny,145,145,0,1,0,1,0
53248,45941,23386,0,0,deny,60,60,0,1,0,1,0
53249,58224,445,0,0,drop,70,70,0,1,0,1,0
53250,58220,445,0,0,drop,70,70,0,1,0,1,0
53251,58221,445,0,0,drop,70,70,0,1,0,1,0
53252,53628,445,0,0,drop,66,66,0,1,0,1,0
53253,53629,445,0,0,drop,66,66,0,1,0,1,0
53254,53626,445,0,0,drop,66,66,0,1,0,1,0
53255,53623,445,0,0,drop,66,66,0,1,0,1,0
53256,53625,445,0,0,drop,66,66,0,1,0,1,0
53257,53627,445,0,0,drop,66,66,0,1,0,1,0
53258,53624,445,0,0,drop,66,66,0,1,0,1,0
53259,53621,445,0,0,drop,66,66,0,1,0,1,0
53260,63716,23,0,0,deny,60,60,0,1,0,1,0
53261,37597,50584,0,0,deny,66,66,0,1,0,1,0
53262,58445,17500,0,0,deny,66,66,0,1,0,1,0
53263,26921,37965,0,0,deny,62,62,0,1,0,1,0
53264,51617,21247,0,0,deny,66,66,0,1,0,1,0
53265,54343,50584,0,0,deny,62,62,0,1,0,1,0
53266,56474,18375,0,0,deny,62,62,0,1,0,1,0
53267,53247,445,0,0,drop,70,70,0,1,0,1,0
53268,49805,64147,0,0,deny,66,66,0,1,0,1,0
53269,33453,64147,0,0,deny,62,62,0,1,0,1,0
53270,53246,445,0,0,drop,70,70,0,1,0,1,0
53271,2935,64147,0,0,deny,62,62,0,1,0,1,0
53272,12549,50265,0,0,deny,146,146,0,1,0,1,0
53273,53244,445,0,0,drop,70,70,0,1,0,1,0
53274,52643,36237,0,0,deny,66,66,0,1,0,1,0
53275,37587,443,50576,443,allow,499,425,74,4,0,3,1
53276,37586,443,60521,443,allow,499,425,74,4,0,3,1
53277,37584,443,21310,443,allow,499,425,74,4,0,3,1
53278,37581,443,35670,443,allow,499,425,74,4,0,3,1
53279,37582,443,52781,443,allow,499,425,74,4,0,3,1
53280,37583,443,36088,443,allow,499,425,74,4,0,3,1
53281,58217,445,0,0,drop,70,70,0,1,0,1,0
53282,58213,445,0,0,drop,70,70,0,1,0,1,0
53283,58209,445,0,0,drop,70,70,0,1,0,1,0
53284,38358,22300,0,0,deny,60,60,0,1,0,1,0
53285,38320,51505,0,0,deny,66,66,0,1,0,1,0
53286,55770,64147,0,0,deny,66,66,0,1,0,1,0
53287,24471,32167,0,0,deny,60,60,0,1,0,1,0
53288,53609,445,0,0,drop,66,66,0,1,0,1,0
53289,53608,445,0,0,drop,66,66,0,1,0,1,0
53290,53606,445,0,0,drop,66,66,0,1,0,1,0
53291,58202,445,0,0,drop,70,70,0,1,0,1,0
53292,45082,17,0,0,deny,60,60,0,1,0,1,0
53293,2697,28189,0,0,deny,60,60,0,1,0,1,0
53294,16027,22,0,0,deny,60,60,0,1,0,1,0
53295,5222,7493,0,0,deny,66,66,0,1,0,1,0
53296,6853,48543,0,0,deny,148,148,0,1,0,1,0
53297,53237,445,0,0,drop,70,70,0,1,0,1,0
53298,58200,445,0,0,drop,70,70,0,1,0,1,0
53299,58196,445,0,0,drop,70,70,0,1,0,1,0
53300,58198,445,0,0,drop,70,70,0,1,0,1,0
53301,58191,445,0,0,drop,70,70,0,1,0,1,0
53302,53235,445,0,0,drop,70,70,0,1,0,1,0
53303,1024,6881,0,0,deny,146,146,0,1,0,1,0
53304,57283,64147,0,0,deny,66,66,0,1,0,1,0
53305,42252,33303,0,0,deny,60,60,0,1,0,1,0
53306,5223,16383,0,0,deny,66,66,0,1,0,1,0
53307,53234,445,0,0,drop,70,70,0,1,0,1,0
53308,53233,445,0,0,drop,70,70,0,1,0,1,0
53309,53232,445,0,0,drop,70,70,0,1,0,1,0
53310,53226,445,0,0,drop,70,70,0,1,0,1,0
53311,53229,445,0,0,drop,70,70,0,1,0,1,0
53312,31021,35440,0,0,deny,62,62,0,1,0,1,0
53313,5357,32468,0,0,deny,66,66,0,1,0,1,0
53314,53214,445,0,0,drop,70,70,0,1,0,1,0
53315,53212,445,0,0,drop,70,70,0,1,0,1,0
53316,5208,63836,0,0,deny,145,145,0,1,0,1,0
53317,58183,445,0,0,drop,70,70,0,1,0,1,0
53318,58182,445,0,0,drop,70,70,0,1,0,1,0
53319,58177,445,0,0,drop,70,70,0,1,0,1,0
53320,53209,445,0,0,drop,70,70,0,1,0,1,0
53321,57504,44847,0,0,deny,66,66,0,1,0,1,0
53322,53204,445,0,0,drop,70,70,0,1,0,1,0
53323,26900,27017,37776,27017,allow,422,164,258,6,30,3,3
53324,60409,443,2686,443,allow,7925,1878,6047,26,66,12,14
53325,37939,80,33562,80,allow,1616,1302,314,10,15,5,5
53326,53587,32029,40143,32029,allow,70,70,0,1,5,1,0
53327,50230,80,20217,80,allow,2384,952,1432,15,75,8,7
53328,26900,27017,30659,27017,allow,168,82,86,2,30,1,1
53329,55209,53,9446,53,allow,98,98,0,1,30,1,0
53330,49835,53,4982,53,allow,146,75,71,2,30,1,1
53331,56631,443,17729,443,allow,7889,1900,5989,20,16,11,9
53332,53612,1032,47132,1032,allow,130,70,60,3,5,2,1
53333,51782,10637,45950,10637,allow,66,66,0,1,5,1,0
53334,49485,80,52074,80,allow,1155,781,374,10,15,6,4
53335,36907,53,36907,53,allow,237,91,146,2,33,1,1
53336,55207,80,45213,80,allow,1979,1326,653,16,500,10,6
53337,65397,443,12248,443,allow,2494,1643,851,17,25,9,8
53338,49663,53,18877,53,allow,184,80,104,2,30,1,1
53339,55404,53,28730,53,allow,711,87,624,2,30,1,1
53340,57842,53,57842,53,allow,225,87,138,2,30,1,1
53341,14374,443,14374,443,allow,1582,883,699,18,32,10,8
53342,9158,53,9158,53,allow,237,91,146,2,33,1,1
53343,53579,59332,61782,59332,allow,70,70,0,1,5,1,0
53344,26900,27017,15992,27017,allow,422,164,258,6,30,3,3
53345,52010,80,42870,80,allow,29838,2481,27357,56,31,24,32
53346,50227,80,3538,80,allow,1935,895,1040,15,75,8,7
53347,53584,62974,57251,62974,allow,70,70,0,1,5,1,0
53348,51781,43909,49326,43909,allow,66,66,0,1,5,1,0
53349,11295,40002,59394,40002,allow,209,85,124,4,34,2,2
53350,41981,80,51523,80,allow,1556,1236,320,10,15,5,5
53351,26900,27017,35355,27017,allow,422,164,258,6,30,3,3
53352,56632,443,5495,443,allow,7941,1952,5989,20,15,11,9
53353,49665,53,12263,53,allow,194,99,95,2,30,1,1
53354,53580,48066,12026,48066,allow,70,70,0,1,5,1,0
53355,65384,53,58692,53,allow,194,99,95,2,30,1,1
53356,57659,80,4317,80,allow,742,140,602,12,409,3,9
53357,41052,443,41052,443,allow,4596,1689,2907,19,27,11,8
53358,56633,443,38597,443,allow,7889,1900,5989,20,15,11,9
53359,22602,53,22602,53,allow,217,87,130,2,30,1,1
53360,17932,53,17932,53,allow,213,87,126,2,30,1,1
53361,51780,21130,19007,21130,allow,66,66,0,1,5,1,0
53362,51269,36983,59727,36983,allow,70,70,0,1,5,1,0
53363,43884,80,63772,80,allow,1774,1460,314,13,15,8,5
53364,58225,443,29188,443,allow,2484,330,2154,12,135,5,7
53365,62184,443,42085,443,allow,4283,2038,2245,14,135,7,7
53366,30188,1381,10671,1381,allow,324,150,174,2,1200,1,1
53367,47445,443,40456,443,allow,8710,2009,6701,30,395,10,20
53368,48303,53,44805,53,allow,198,93,105,2,31,1,1
53369,57487,443,43988,443,allow,1786,172,1614,7,121,3,4
53370,55028,443,55949,443,allow,6015,3964,2051,32,361,18,14
53371,6882,43825,33329,43825,allow,200,111,89,2,1200,1,1
53372,50265,45599,34078,45599,allow,330,330,0,6,1200,6,0
53373,53203,445,0,0,drop,70,70,0,1,0,1,0
53374,34553,48637,0,0,deny,60,60,0,1,0,1,0
53375,26480,64147,0,0,deny,62,62,0,1,0,1,0
53376,53676,35974,0,0,deny,60,60,0,1,0,1,0
53377,34677,51185,0,0,deny,60,60,0,1,0,1,0
53378,56679,51505,0,0,deny,146,146,0,1,0,1,0
53379,28973,30188,0,0,deny,66,66,0,1,0,1,0
53380,5223,22981,0,0,deny,60,60,0,1,0,1,0
53381,53585,445,0,0,drop,66,66,0,1,0,1,0
53382,53192,445,0,0,drop,70,70,0,1,0,1,0
53383,58175,445,0,0,drop,70,70,0,1,0,1,0
53384,58167,445,0,0,drop,70,70,0,1,0,1,0
53385,32806,7275,9524,7275,allow,1564,560,1004,23,38,9,14
53386,26900,27017,1315,27017,allow,422,164,258,6,30,3,3
53387,64505,53,38734,53,allow,373,126,247,2,30,1,1
53388,62486,53,59489,53,allow,102,102,0,1,30,1,0
53389,56771,53,26360,53,allow,193,102,91,2,31,1,1
53390,40707,443,1072,443,allow,1969,1195,774,18,122,11,7
53391,49178,53,17300,53,allow,348,105,243,4,45,2,2
53392,49178,2710,54926,2710,allow,70,70,0,2,7,2,0
53393,55284,53,36720,53,allow,193,102,91,2,29,1,1
53394,27005,27016,12661,27016,allow,879,126,753,2,30,1,1
53395,65050,53,2914,53,allow,264,102,162,2,30,1,1
53396,33043,443,36029,443,allow,1788,968,820,20,15,11,9
53397,65376,443,34209,443,allow,55500,40540,14960,137,131,72,65
53398,51802,21555,33946,21555,allow,316,136,180,6,6,3,3
53399,65392,443,55705,443,allow,5939,772,5167,17,27,9,8
53400,64849,53,57025,53,allow,340,110,230,2,29,1,1
53401,50459,80,33223,80,allow,1328,917,411,10,28,6,4
53402,64171,53,42919,53,allow,211,102,109,2,29,1,1
53403,50451,80,26551,80,allow,378,192,186,7,28,4,3
53404,49480,53,4215,53,allow,168,78,90,2,29,1,1
53405,27005,27015,45770,27015,allow,874,126,748,2,30,1,1
53406,56760,53,34251,53,allow,216,102,114,2,30,1,1
53407,55593,53,53460,53,allow,102,102,0,1,30,1,0
53408,49291,53,26536,53,allow,277,110,167,2,30,1,1
53409,27005,27015,65142,27015,allow,883,126,757,2,30,1,1
53410,26900,27017,64029,27017,allow,422,164,258,6,30,3,3
53411,26900,27017,21436,27017,allow,422,164,258,6,30,3,3
53412,65460,53,1825,53,allow,177,94,83,2,30,1,1
53413,44443,80,37663,80,allow,1114,534,580,12,16,7,5
53414,49395,53,16625,53,allow,315,90,225,4,32,2,2
53415,52118,443,25040,443,allow,22072,2166,19906,44,49,22,22
53416,27005,27015,60376,27015,allow,878,126,752,2,30,1,1
53417,56426,80,33168,80,allow,17008,1379,15629,22,25,7,15
53418,27005,27017,40278,27017,allow,891,126,765,2,30,1,1
53419,49629,53,59085,53,allow,216,102,114,2,30,1,1
53420,52385,53,0,0,allow,139,70,69,2,30,1,1
53421,56417,53,7039,53,allow,389,126,263,2,30,1,1
53422,51779,49525,20031,49525,allow,70,70,0,1,5,1,0
53423,49865,443,26140,443,allow,5708,1025,4683,16,35,9,7
53424,65384,53,41711,53,allow,197,102,95,2,30,1,1
53425,49661,443,16392,443,allow,9021,2548,6473,38,80,19,19
53426,65276,53,64809,53,allow,195,86,109,2,30,1,1
53427,37581,53,0,0,allow,86,86,0,1,30,1,0
53428,50958,53,61318,53,allow,94,94,0,1,30,1,0
53429,26900,27017,57216,27017,allow,422,164,258,6,30,3,3
53430,49835,53,4123,53,allow,250,86,164,4,30,2,2
53431,50011,53,36525,53,allow,94,94,0,1,30,1,0
53432,26900,27017,59839,27017,allow,422,164,258,6,30,3,3
53433,64477,53,1968,53,allow,272,94,178,2,30,1,1
53434,26900,27017,63924,27017,allow,422,164,258,6,30,3,3
53435,56760,443,12877,443,allow,7894,1671,6223,21,185,11,10
53436,62597,53,18771,53,allow,102,102,0,1,30,1,0
53437,60683,443,28178,443,allow,17071,1532,15539,17,147,3,14
53438,51796,48779,55326,48779,allow,70,70,0,2,8,2,0
53439,56780,48298,2043,48298,allow,264,70,194,4,19,1,3
53440,53482,53,51944,53,allow,168,78,90,2,30,1,1
53441,26900,27017,20527,27017,allow,422,164,258,6,30,3,3
53442,26900,27017,48615,27017,allow,422,164,258,6,30,3,3
53443,57839,53,54040,53,allow,78,78,0,1,30,1,0
53444,49844,53,62050,53,allow,368,118,250,2,30,1,1
53445,44847,6881,46281,6881,allow,150,150,0,1,1200,1,0
53446,50265,12348,24050,12348,allow,858,858,0,14,1200,14,0
53447,50265,28520,23958,28520,allow,132,132,0,3,1200,3,0
53448,27005,27017,59484,27017,allow,882,126,756,2,30,1,1
53449,57028,8080,10225,8080,allow,78,78,0,2,8,2,0
53450,42349,443,27589,443,allow,90562,4227,86335,118,200,49,69
53451,64954,53,8799,53,allow,94,94,0,1,30,1,0
53452,65136,53,1364,53,allow,86,86,0,1,30,1,0
53453,64240,53,21453,53,allow,256,110,146,2,30,1,1
53454,64122,53,64122,53,allow,220,90,130,2,30,1,1
53455,49835,53,23738,53,allow,168,86,82,2,30,1,1
53456,65515,53,35838,53,allow,718,94,624,2,30,1,1
53457,64803,53,39873,53,allow,102,102,0,1,30,1,0
53458,26900,27017,40342,27017,allow,422,164,258,6,30,3,3
53459,55721,53,4903,53,allow,212,94,118,2,30,1,1
53460,37965,32305,6845,32305,allow,1650,1650,0,26,1537,26,0
53461,27005,27016,48371,27016,allow,887,126,761,2,30,1,1
53462,57118,443,64702,443,allow,5133,631,4502,14,15,8,6
53463,53589,40281,44450,40281,allow,70,70,0,1,4,1,0
53464,52641,6881,46429,6881,allow,1162,856,306,10,14,5,5
53465,61158,443,55712,443,allow,12854,2237,10617,47,638,19,28
53466,53606,54476,23615,54476,allow,320,140,180,6,6,3,3
53467,57382,2258,57382,2258,allow,156,156,0,3,8,3,0
53468,53583,15354,45877,15354,allow,70,70,0,1,4,1,0
53469,26900,27017,43419,27017,allow,422,164,258,6,30,3,3
53470,50438,53,8831,53,allow,199,102,97,2,29,1,1
53471,64884,53,48287,53,allow,239,110,129,2,30,1,1
53472,26900,27017,31665,27017,allow,254,82,172,4,30,2,2
53473,59488,443,37367,443,allow,6100,580,5520,17,53,5,12
53474,46864,443,31788,443,allow,5349,1090,4259,18,31,10,8
53475,65460,53,48122,53,allow,177,94,83,2,30,1,1
53476,56568,53,34489,53,allow,102,102,0,1,30,1,0
53477,64146,53,33411,53,allow,273,94,179,2,30,1,1
53478,51646,80,63912,80,allow,1038219,43977,994242,1734,30,616,1118
53479,61580,53,48820,53,allow,275,94,181,2,29,1,1
53480,50438,53,42985,53,allow,199,102,97,2,29,1,1
53481,51467,443,43898,443,allow,186117,12962,173155,249,143,83,166
53482,50639,443,28987,443,allow,15714,2748,12966,58,21,23,35
53483,55209,53,7531,53,allow,196,102,94,2,33,1,1
53484,65472,443,58915,443,allow,460338,13340,446998,472,16,165,307
53485,49855,53,19600,53,allow,916,86,830,2,30,1,1
53486,49706,53,34348,53,allow,258,110,148,2,30,1,1
53487,57398,53,44535,53,allow,202,86,116,2,30,1,1
53488,58472,53,5380,53,allow,86,86,0,1,30,1,0
53489,56463,53,28170,53,allow,368,118,250,2,30,1,1
53490,26900,27017,25587,27017,allow,422,164,258,6,30,3,3
53491,26900,27017,26989,27017,allow,422,164,258,6,30,3,3
53492,26900,27017,65080,27017,allow,422,164,258,6,30,3,3
53493,27005,27015,36150,27015,allow,889,126,763,2,30,1,1
53494,59677,443,25449,443,allow,13551,5488,8063,33,95,16,17
53495,49650,443,63033,443,allow,93063,2948,90115,107,80,30,77
53496,49914,443,22293,443,allow,12190,2075,10115,28,16,14,14
53497,65393,443,57467,443,allow,5121,936,4185,17,27,9,8
53498,54980,443,53564,443,allow,1541965,48559,1493406,1663,51,623,1040
53499,53986,53,15974,53,allow,102,102,0,1,30,1,0
53500,65349,53,10010,53,allow,275,110,165,2,30,1,1
53501,27005,27018,42247,27018,allow,881,126,755,2,30,1,1
53502,27005,27016,2145,27016,allow,883,126,757,2,30,1,1
53503,47147,443,41911,443,allow,5789,952,4837,19,150,10,9
53504,50265,57121,42011,57121,allow,132,132,0,3,1200,3,0
53505,40226,443,40694,443,allow,13853,4638,9215,42,387,21,21
53506,53707,443,35476,443,allow,350,210,140,6,25,4,2
53507,57109,443,58630,443,allow,7170,1436,5734,35,261,19,16
53508,65384,53,35279,53,allow,197,102,95,2,33,1,1
53509,51797,30712,39713,30712,allow,70,70,0,2,8,2,0
53510,51778,60565,33068,60565,allow,70,70,0,1,5,1,0
53511,26900,27017,49635,27017,allow,422,164,258,6,30,3,3
53512,59487,443,5005,443,allow,8702,580,8122,17,53,5,12
53513,49835,53,35014,53,allow,168,86,82,2,30,1,1
53514,26900,27017,34490,27017,allow,422,164,258,6,30,3,3
53515,49501,53,50538,53,allow,229,110,119,2,30,1,1
53516,21133,27613,37990,27613,allow,481,150,331,2,1199,1,1
53517,56192,53,60489,53,allow,177,94,83,2,31,1,1
53518,57470,48096,60784,48096,allow,132,132,0,3,1200,3,0
53519,61744,443,1594,443,allow,3743,1654,2089,10,121,5,5
53520,57470,44822,45311,44822,allow,132,132,0,3,1200,3,0
53521,27761,53,27761,53,allow,832,106,726,2,30,1,1
53522,60546,53,37684,53,allow,199,94,105,2,30,1,1
53523,56801,21916,14491,21916,allow,316,136,180,6,7,3,3
53524,64110,443,18222,443,allow,5060,3367,1693,21,102,12,9
53525,50725,443,41613,443,allow,6593,3522,3071,56,76,33,23
53526,34351,443,4638,443,allow,402051,17714,384337,520,83,228,292
53527,56448,53,42442,53,allow,177,94,83,2,30,1,1
53528,55056,53,32343,53,allow,177,94,83,2,31,1,1
53529,49438,443,63285,443,allow,18773,1492,17281,38,94,11,27
53530,64380,53,9655,53,allow,196,102,94,2,33,1,1
53531,50904,80,18118,80,allow,12289218,202774,12086444,11470,149,2789,8681
53532,61345,21247,0,0,deny,62,62,0,1,0,1,0
53533,45964,5333,0,0,deny,60,60,0,1,0,1,0
53534,25179,62609,0,0,deny,148,148,0,1,0,1,0
53535,53580,445,0,0,drop,66,66,0,1,0,1,0
53536,23795,44847,0,0,deny,146,146,0,1,0,1,0
53537,53188,445,0,0,drop,70,70,0,1,0,1,0
53538,53577,445,0,0,drop,66,66,0,1,0,1,0
53539,58162,445,0,0,drop,70,70,0,1,0,1,0
53540,58154,445,0,0,drop,70,70,0,1,0,1,0
53541,58152,445,0,0,drop,70,70,0,1,0,1,0
53542,58153,445,0,0,drop,70,70,0,1,0,1,0
53543,65115,50584,0,0,deny,66,66,0,1,0,1,0
53544,21173,37965,0,0,deny,62,62,0,1,0,1,0
53545,11816,50584,0,0,deny,62,62,0,1,0,1,0
53546,1030,44847,0,0,deny,62,62,0,1,0,1,0
53547,53575,445,0,0,drop,66,66,0,1,0,1,0
53548,58326,50584,0,0,deny,62,62,0,1,0,1,0
53549,53178,445,0,0,drop,70,70,0,1,0,1,0
53550,53176,445,0,0,drop,70,70,0,1,0,1,0
53551,53173,445,0,0,drop,70,70,0,1,0,1,0
53552,53419,28189,0,0,deny,60,60,0,1,0,1,0
53553,53171,445,0,0,drop,70,70,0,1,0,1,0
53554,55157,7302,0,0,deny,66,66,0,1,0,1,0
53555,34897,50584,0,0,deny,62,62,0,1,0,1,0
53556,58149,445,0,0,drop,70,70,0,1,0,1,0
53557,53207,50265,0,0,deny,66,66,0,1,0,1,0
53558,58145,445,0,0,drop,70,70,0,1,0,1,0
53559,58143,445,0,0,drop,70,70,0,1,0,1,0
53560,58142,445,0,0,drop,70,70,0,1,0,1,0
53561,1866,51505,0,0,deny,66,66,0,1,0,1,0
53562,57676,64147,0,0,deny,74,74,0,1,0,1,0
53563,46679,64147,0,0,deny,62,62,0,1,0,1,0
53564,53568,445,0,0,drop,66,66,0,1,0,1,0
53565,6881,64910,0,0,deny,146,146,0,1,0,1,0
53566,53565,445,0,0,drop,66,66,0,1,0,1,0
53567,53560,445,0,0,drop,66,66,0,1,0,1,0
53568,53559,445,0,0,drop,66,66,0,1,0,1,0
53569,59201,51221,0,0,deny,66,66,0,1,0,1,0
53570,8191,51221,0,0,deny,62,62,0,1,0,1,0
53571,57131,26296,0,0,deny,145,145,0,1,0,1,0
53572,53558,445,0,0,drop,66,66,0,1,0,1,0
53573,53555,445,0,0,drop,66,66,0,1,0,1,0
53574,53557,445,0,0,drop,66,66,0,1,0,1,0
53575,34930,20005,0,0,deny,60,60,0,1,0,1,0
53576,53165,445,0,0,drop,70,70,0,1,0,1,0
53577,53355,23117,0,0,deny,62,62,0,1,0,1,0
53578,50031,44847,0,0,deny,74,74,0,1,0,1,0
53579,443,64347,0,0,deny,131,131,0,1,0,1,0
53580,50369,50584,0,0,deny,66,66,0,1,0,1,0
53581,50562,37965,0,0,deny,66,66,0,1,0,1,0
53582,5223,7851,0,0,deny,66,66,0,1,0,1,0
53583,58137,445,0,0,drop,70,70,0,1,0,1,0
53584,58139,445,0,0,drop,70,70,0,1,0,1,0
53585,58134,445,0,0,drop,70,70,0,1,0,1,0
53586,53551,445,0,0,drop,66,66,0,1,0,1,0
53587,53157,445,0,0,drop,70,70,0,1,0,1,0
53588,58132,445,0,0,drop,70,70,0,1,0,1,0
53589,53156,445,0,0,drop,70,70,0,1,0,1,0
53590,53550,445,0,0,drop,66,66,0,1,0,1,0
53591,51909,6881,0,0,deny,66,66,0,1,0,1,0
53592,57289,31573,0,0,deny,66,66,0,1,0,1,0
53593,54773,50584,0,0,deny,62,62,0,1,0,1,0
53594,62678,57470,0,0,deny,62,62,0,1,0,1,0
53595,53548,445,0,0,drop,66,66,0,1,0,1,0
53596,53547,445,0,0,drop,66,66,0,1,0,1,0
53597,42951,44847,0,0,deny,66,66,0,1,0,1,0
53598,53545,445,0,0,drop,66,66,0,1,0,1,0
53599,50360,35440,0,0,deny,66,66,0,1,0,1,0
53600,53150,445,0,0,drop,70,70,0,1,0,1,0
53601,53166,61600,0,0,deny,62,62,0,1,0,1,0
53602,14070,62413,0,0,deny,66,66,0,1,0,1,0
53603,14260,36829,0,0,deny,62,62,0,1,0,1,0
53604,7285,51221,0,0,deny,66,66,0,1,0,1,0
53605,53149,445,0,0,drop,70,70,0,1,0,1,0
53606,64175,56502,0,0,deny,66,66,0,1,0,1,0
53607,7992,64147,0,0,deny,62,62,0,1,0,1,0
53608,58125,445,0,0,drop,70,70,0,1,0,1,0
53609,58116,445,0,0,drop,70,70,0,1,0,1,0
53610,58117,445,0,0,drop,70,70,0,1,0,1,0
53611,53145,445,0,0,drop,70,70,0,1,0,1,0
53612,55254,50584,0,0,deny,66,66,0,1,0,1,0
53613,17640,55442,0,0,deny,66,66,0,1,0,1,0
53614,53144,445,0,0,drop,70,70,0,1,0,1,0
53615,54991,36829,0,0,deny,66,66,0,1,0,1,0
53616,53536,445,0,0,drop,66,66,0,1,0,1,0
53617,21534,42246,0,0,deny,66,66,0,1,0,1,0
53618,25015,64147,0,0,deny,66,66,0,1,0,1,0
53619,30365,45991,0,0,deny,60,60,0,1,0,1,0
53620,60875,56205,0,0,deny,66,66,0,1,0,1,0
53621,34822,31573,0,0,deny,62,62,0,1,0,1,0
53622,53526,445,0,0,drop,66,66,0,1,0,1,0
53623,53139,445,0,0,drop,70,70,0,1,0,1,0
53624,58108,445,0,0,drop,70,70,0,1,0,1,0
53625,53523,445,0,0,drop,66,66,0,1,0,1,0
53626,49485,11392,0,0,deny,66,66,0,1,0,1,0
53627,51559,26467,0,0,deny,66,66,0,1,0,1,0
53628,53517,445,0,0,drop,66,66,0,1,0,1,0
53629,53506,445,0,0,drop,66,66,0,1,0,1,0
53630,53126,445,0,0,drop,70,70,0,1,0,1,0
53631,3521,6881,0,0,deny,62,62,0,1,0,1,0
53632,28345,11392,0,0,deny,66,66,0,1,0,1,0
53633,53123,445,0,0,drop,70,70,0,1,0,1,0
53634,0,0,0,0,deny,98,98,0,1,0,1,0
53635,0,0,0,0,deny,60,60,0,1,0,1,0
53636,0,0,0,0,allow,156,156,0,2,0,2,0
53637,0,0,0,0,deny,98,98,0,1,0,1,0
53638,0,0,0,0,deny,98,98,0,1,0,1,0
53639,0,0,0,0,allow,244,244,0,2,0,2,0
53640,0,0,0,0,deny,98,98,0,1,0,1,0
53641,42034,28189,0,0,deny,62,62,0,1,0,1,0
53642,64324,37807,0,0,deny,62,62,0,1,0,1,0
53643,58095,445,0,0,drop,70,70,0,1,0,1,0
53644,58092,445,0,0,drop,70,70,0,1,0,1,0
53645,58093,445,0,0,drop,70,70,0,1,0,1,0
53646,5195,64147,0,0,deny,66,66,0,1,0,1,0
53647,53494,445,0,0,drop,66,66,0,1,0,1,0
53648,53496,445,0,0,drop,66,66,0,1,0,1,0
53649,53499,445,0,0,drop,66,66,0,1,0,1,0
53650,53501,445,0,0,drop,66,66,0,1,0,1,0
53651,53497,445,0,0,drop,66,66,0,1,0,1,0
53652,53498,445,0,0,drop,66,66,0,1,0,1,0
53653,53500,445,0,0,drop,66,66,0,1,0,1,0
53654,53495,445,0,0,drop,66,66,0,1,0,1,0
53655,63670,64097,0,0,deny,66,66,0,1,0,1,0
53656,43129,15503,0,0,deny,62,62,0,1,0,1,0
53657,60550,50584,0,0,deny,62,62,0,1,0,1,0
53658,57431,15503,0,0,deny,66,66,0,1,0,1,0
53659,48298,2043,0,0,deny,60,60,0,1,0,1,0
53660,53118,445,0,0,drop,70,70,0,1,0,1,0
53661,52749,64147,0,0,deny,66,66,0,1,0,1,0
53662,53117,445,0,0,drop,70,70,0,1,0,1,0
53663,1025,35447,0,0,deny,62,62,0,1,0,1,0
53664,20057,44847,0,0,deny,62,62,0,1,0,1,0
53665,53115,445,0,0,drop,70,70,0,1,0,1,0
53666,65501,26467,0,0,deny,66,66,0,1,0,1,0
53667,60875,50584,0,0,deny,66,66,0,1,0,1,0
53668,58086,445,0,0,drop,70,70,0,1,0,1,0
53669,58087,445,0,0,drop,70,70,0,1,0,1,0
53670,58082,445,0,0,drop,70,70,0,1,0,1,0
53671,64406,50584,0,0,deny,62,62,0,1,0,1,0
53672,57452,57470,0,0,deny,62,62,0,1,0,1,0
53673,53481,445,0,0,drop,66,66,0,1,0,1,0
53674,53480,445,0,0,drop,66,66,0,1,0,1,0
53675,53479,445,0,0,drop,66,66,0,1,0,1,0
53676,60384,64147,0,0,deny,62,62,0,1,0,1,0
53677,58074,445,0,0,drop,70,70,0,1,0,1,0
53678,53108,445,0,0,drop,70,70,0,1,0,1,0
53679,57545,35440,0,0,deny,66,66,0,1,0,1,0
53680,53106,445,0,0,drop,70,70,0,1,0,1,0
53681,58072,445,0,0,drop,70,70,0,1,0,1,0
53682,26528,51221,0,0,deny,78,78,0,1,0,1,0
53683,58064,445,0,0,drop,70,70,0,1,0,1,0
53684,58063,445,0,0,drop,70,70,0,1,0,1,0
53685,58060,445,0,0,drop,70,70,0,1,0,1,0
53686,53097,443,17057,443,allow,7013,1718,5295,18,326,9,9
53687,53092,443,57966,443,allow,8071,1789,6282,20,326,10,10
53688,53101,443,37557,443,allow,8071,1789,6282,20,326,10,10
53689,47080,80,47080,80,allow,276453,7832,268621,287,165,92,195
53690,56192,53,2949,53,allow,170,87,83,2,30,1,1
53691,55056,53,8605,53,allow,170,87,83,2,30,1,1
53692,58283,443,44449,443,allow,42792,12402,30390,98,370,45,53
53693,51799,58416,38209,58416,allow,316,136,180,6,6,3,3
53694,41328,53,51462,53,allow,198,93,105,2,30,1,1
53695,53100,443,46629,443,allow,8571,1789,6782,20,326,10,10
53696,53130,443,27794,443,allow,7169,1715,5454,18,325,9,9
53697,56630,443,6016,443,allow,7941,1952,5989,20,15,11,9
53698,57205,53,27220,53,allow,711,87,624,2,30,1,1
53699,41520,53,0,0,allow,82,82,0,1,30,1,0
53700,27005,27015,31409,27015,allow,891,126,765,2,31,1,1
53701,53166,80,34843,80,allow,1487,838,649,10,323,6,4
53702,53126,443,9290,443,allow,5604,2738,2866,20,325,10,10
53703,53102,443,30366,443,allow,7149,1719,5430,18,326,9,9
53704,53140,443,26358,443,allow,6401,1225,5176,18,324,9,9
53705,53168,80,46007,80,allow,1501,958,543,10,323,6,4
53706,58974,443,58974,443,allow,6792,1521,5271,18,28,11,7
53707,55618,45341,55864,45341,allow,70,70,0,2,8,2,0
53708,37961,443,21395,443,allow,153,93,60,2,5,1,1
53709,28316,3389,28316,3389,allow,4695,2520,2175,22,19,13,9
53710,37805,443,65176,443,allow,5577,1977,3600,29,56,16,13
53711,45540,443,45540,443,allow,4702,1795,2907,19,28,11,8
53712,64380,53,44055,53,allow,98,98,0,1,30,1,0
53713,58970,80,38149,80,allow,1521,967,554,10,75,6,4
53714,54823,53,13813,53,allow,198,93,105,2,30,1,1
53715,57162,53,0,0,allow,198,91,107,2,30,1,1
53716,29805,53,29805,53,allow,226,89,137,2,30,1,1
53717,52728,80,55587,80,allow,13372,7598,5774,29,555,18,11
53718,35601,80,28025,80,allow,1151,711,440,10,15,5,5
53719,53138,443,15464,443,allow,6760,1346,5414,18,325,9,9
53720,52652,443,14258,443,allow,14511,4628,9883,29,559,15,14
53721,53158,443,6890,443,allow,7427,1517,5910,22,323,11,11
53722,53095,443,22543,443,allow,7014,1719,5295,18,326,9,9
53723,56803,52421,20663,52421,allow,164,70,94,2,5,1,1
53724,39328,80,62636,80,allow,234,234,0,4,12,4,0
53725,41518,443,53815,443,allow,25342,17809,7533,56,80,28,28
53726,51775,57887,37993,57887,allow,66,66,0,1,5,1,0
53727,56628,443,49515,443,allow,7941,1952,5989,20,15,11,9
53728,3669,53,3669,53,allow,825,99,726,2,30,1,1
53729,53085,53,0,0,allow,82,82,0,1,30,1,0
53730,56629,443,57154,443,allow,7889,1900,5989,20,15,11,9
53731,37233,53,50033,53,allow,198,93,105,2,30,1,1
53732,60405,64722,47645,64722,allow,70,70,0,2,8,2,0
53733,20892,53,20892,53,allow,825,99,726,2,30,1,1
53734,53597,53,0,0,allow,233,85,148,2,30,1,1
53735,56750,53,56750,53,allow,217,87,130,2,30,1,1
53736,41772,80,18406,80,allow,738,70,668,12,394,2,10
53737,52335,443,49316,443,allow,5670,2739,2931,18,129,9,9
53738,8933,56205,0,0,deny,62,62,0,1,0,1,0
53739,53105,445,0,0,drop,70,70,0,1,0,1,0
53740,53104,445,0,0,drop,70,70,0,1,0,1,0
53741,60294,30188,0,0,deny,66,66,0,1,0,1,0
53742,53103,445,0,0,drop,70,70,0,1,0,1,0
53743,27010,64147,0,0,deny,62,62,0,1,0,1,0
53744,53097,445,0,0,drop,70,70,0,1,0,1,0
53745,53100,445,0,0,drop,70,70,0,1,0,1,0
53746,9605,57470,0,0,deny,62,62,0,1,0,1,0
53747,11133,51505,0,0,deny,66,66,0,1,0,1,0
53748,13441,57470,0,0,deny,62,62,0,1,0,1,0
53749,12895,37965,0,0,deny,62,62,0,1,0,1,0
53750,58074,11392,0,0,deny,66,66,0,1,0,1,0
53751,48706,23393,0,0,deny,60,60,0,1,0,1,0
53752,53650,64147,0,0,deny,66,66,0,1,0,1,0
53753,43671,37965,0,0,deny,62,62,0,1,0,1,0
53754,52356,55442,0,0,deny,66,66,0,1,0,1,0
53755,3564,57470,0,0,deny,62,62,0,1,0,1,0
53756,42783,53,31772,53,allow,199,94,105,2,30,1,1
53757,39834,53,46672,53,allow,199,94,105,2,30,1,1
53758,51270,48061,59473,48061,allow,70,70,0,2,8,2,0
53759,41295,443,9928,443,allow,1482,988,494,12,26,7,5
53760,3578,51505,0,0,deny,66,66,0,1,0,1,0
53761,53085,445,0,0,drop,70,70,0,1,0,1,0
53762,53083,445,0,0,drop,70,70,0,1,0,1,0
53763,53080,445,0,0,drop,70,70,0,1,0,1,0
53764,53075,445,0,0,drop,70,70,0,1,0,1,0
53765,53074,445,0,0,drop,70,70,0,1,0,1,0
53766,50143,35253,0,0,deny,62,62,0,1,0,1,0
53767,58054,445,0,0,drop,70,70,0,1,0,1,0
53768,58053,445,0,0,drop,70,70,0,1,0,1,0
53769,58049,445,0,0,drop,70,70,0,1,0,1,0
53770,64051,36829,0,0,deny,62,62,0,1,0,1,0
53771,28221,37965,0,0,deny,62,62,0,1,0,1,0
53772,62386,37965,0,0,deny,66,66,0,1,0,1,0
53773,47173,35440,0,0,deny,146,146,0,1,0,1,0
53774,16322,57470,0,0,deny,62,62,0,1,0,1,0
53775,53063,445,0,0,drop,70,70,0,1,0,1,0
53776,58468,37965,0,0,deny,66,66,0,1,0,1,0
53777,53454,445,0,0,drop,66,66,0,1,0,1,0
53778,37646,53,37646,53,allow,832,106,726,2,30,1,1
53779,37066,443,21003,443,allow,2386,1423,963,18,169,10,8
53780,58780,443,38855,443,allow,8661,1687,6974,30,244,16,14
53781,65471,443,32170,443,allow,92569,4939,87630,111,15,45,66
53782,65118,53,14399,53,allow,539,91,448,4,43,2,2
53783,55613,56511,52356,56511,allow,504,318,186,8,15,5,3
53784,63971,53,59567,53,allow,358,94,264,4,45,2,2
53785,55889,53,31264,53,allow,177,94,83,2,29,1,1
53786,56448,53,60650,53,allow,177,94,83,2,29,1,1
53787,52957,80,46330,80,allow,156378,5406,150972,165,383,60,105
53788,64540,53,44077,53,allow,352,107,245,4,37,2,2
53789,60404,37869,39714,37869,allow,258,70,188,4,8,2,2
53790,56799,1,48991,1,allow,316,136,180,6,6,3,3
53791,64407,53,18646,53,allow,232,110,122,2,29,1,1
53792,53115,40693,57479,40693,allow,70,70,0,1,5,1,0
53793,51513,443,33339,443,allow,75323,6054,69269,110,38,52,58
53794,35515,53,6694,53,allow,199,94,105,2,29,1,1
53795,65111,53,60409,53,allow,198,94,104,2,29,1,1
53796,26900,27017,25827,27017,allow,172,86,86,2,29,1,1
53797,49360,53,44969,53,allow,263,102,161,2,29,1,1
53798,49818,53,22415,53,allow,211,102,109,2,29,1,1
53799,52922,443,7305,443,allow,5583,1390,4193,19,15,9,10
53800,19872,53,19872,53,allow,235,90,145,2,32,1,1
53801,51773,23728,8041,23728,allow,70,70,0,1,5,1,0
53802,5588,5588,0,0,allow,3354,1792,1562,46,193,23,23
53803,65064,53,64961,53,allow,197,94,103,2,30,1,1
53804,29606,53,29606,53,allow,216,90,126,2,30,1,1
53805,27005,27015,58465,27015,allow,881,126,755,2,30,1,1
53806,57867,27019,34880,27019,allow,468,390,78,5,30,4,1
53807,64365,53,32131,53,allow,234,94,140,2,30,1,1
53808,53160,80,36074,80,allow,1213,725,488,10,323,6,4
53809,51776,14645,62934,14645,allow,70,70,0,1,5,1,0
53810,60753,40010,14923,40010,allow,316,136,180,6,6,3,3
53811,46263,7700,25323,7700,allow,1440,956,484,15,35,8,7
53812,51793,12210,40752,12210,allow,70,70,0,2,8,2,0
53813,50648,80,8370,80,allow,62,62,0,1,5,1,0
53814,59975,443,17092,443,allow,7875,3100,4775,42,24,22,20
53815,49913,443,1275,443,allow,4275,2222,2053,24,15,14,10
53816,53577,8999,47694,8999,allow,372,186,186,6,15,3,3
53817,56792,42155,2470,42155,allow,70,70,0,2,8,2,0
53818,49662,443,39223,443,allow,2690,1342,1348,23,19,12,11
53819,55056,53,24229,53,allow,177,94,83,2,30,1,1
53820,44498,53,11053,53,allow,168,78,90,2,30,1,1
53821,63966,53,6914,53,allow,214,102,112,2,30,1,1
53822,48165,53,17622,53,allow,199,94,105,2,30,1,1
53823,50838,53,8440,53,allow,70,70,0,1,30,1,0
53824,27005,27015,14961,27015,allow,884,126,758,2,30,1,1
53825,56266,53,6584,53,allow,245,102,143,2,30,1,1
53826,51505,443,46771,443,allow,645662,22326,623336,743,41,299,444
53827,49202,80,38617,80,allow,3223,605,2618,13,15,7,6
53828,33254,443,31595,443,allow,4838,2974,1864,21,17,13,8
53829,27005,27016,2493,27016,allow,895,126,769,2,30,1,1
53830,52932,80,19505,80,allow,4214,1921,2293,18,383,10,8
53831,13514,53,13514,53,allow,244,98,146,2,32,1,1
53832,7447,53,7447,53,allow,244,98,146,2,32,1,1
53833,51791,56116,1472,56116,allow,70,70,0,2,8,2,0
53834,60406,64337,47861,64337,allow,70,70,0,2,8,2,0
53835,42165,443,38543,443,allow,7583,607,6976,18,119,7,11
53836,57790,443,14547,443,allow,6321,3341,2980,19,135,9,10
53837,46762,443,18994,443,allow,565251,13665,551586,542,30,173,369
53838,56405,443,34557,443,allow,6202,1212,4990,27,1197,8,19
53839,27005,27025,44976,27025,allow,893,126,767,2,30,1,1
53840,53490,80,9100,80,allow,2577,1278,1299,14,267,8,6
53841,52732,80,5693,80,allow,23509,14666,8843,70,553,38,32
53842,56791,11500,39420,11500,allow,70,70,0,2,8,2,0
53843,55611,58049,54667,58049,allow,504,318,186,8,15,5,3
53844,28004,443,21121,443,allow,5517,1390,4127,18,15,9,9
53845,26900,27017,23576,27017,allow,340,82,258,5,29,2,3
53846,59756,53,24009,53,allow,211,78,133,2,29,1,1
53847,56970,80,14502,80,allow,1783,841,942,10,20,6,4
53848,27005,27015,4886,27015,allow,876,126,750,2,30,1,1
53849,64481,53,22915,53,allow,386,106,280,4,51,2,2
53850,26900,27017,12614,27017,allow,422,164,258,6,29,3,3
53851,42956,443,56970,443,allow,11435,2668,8767,38,233,14,24
53852,55889,53,19175,53,allow,177,94,83,2,29,1,1
53853,57788,443,31761,443,allow,6400,1327,5073,21,21,13,8
53854,44389,53,44389,53,allow,235,90,145,2,32,1,1
53855,56745,53,50042,53,allow,900,110,790,2,30,1,1
53856,34988,53,12799,53,allow,199,94,105,2,30,1,1
53857,60469,53,22418,53,allow,78,78,0,1,30,1,0
53858,51217,443,21771,443,allow,126,60,66,3,5,2,1
53859,51774,16930,9118,16930,allow,70,70,0,1,5,1,0
53860,49686,443,60868,443,allow,8475,1661,6814,32,76,14,18
53861,46262,123,34977,123,allow,184,94,90,2,30,1,1
53862,49986,53,35150,53,allow,209,94,115,2,30,1,1
53863,60752,28080,38222,28080,allow,70,70,0,2,8,2,0
53864,51268,47662,19145,47662,allow,70,70,0,1,5,1,0
53865,49798,53,59765,53,allow,365,97,268,4,40,2,2
53866,42917,53,23421,53,allow,168,78,90,2,30,1,1
53867,52318,443,6808,443,allow,9453,2797,6656,46,32,25,21
53868,27005,27015,56758,27015,allow,869,126,743,2,30,1,1
53869,27005,27015,46152,27015,allow,875,126,749,2,30,1,1
53870,60281,443,39585,443,allow,63696,4774,58922,83,125,32,51
53871,41476,53,41476,53,allow,235,90,145,2,33,1,1
53872,51794,53911,31763,53911,allow,70,70,0,2,8,2,0
53873,51795,60258,12488,60258,allow,70,70,0,2,8,2,0
53874,56617,80,63909,80,allow,234,234,0,4,12,4,0
53875,49556,443,13898,443,allow,6440,1844,4596,22,141,11,11
53876,8180,53,8180,53,allow,220,90,130,2,30,1,1
53877,64415,53,14789,53,allow,228,102,126,2,30,1,1
53878,56192,53,54480,53,allow,177,94,83,2,30,1,1
53879,64678,53,21797,53,allow,229,110,119,2,30,1,1
53880,27005,27015,19285,27015,allow,892,126,766,2,30,1,1
53881,58805,443,39224,443,allow,9030,2311,6719,24,362,13,11
53882,60408,55557,44331,55557,allow,70,70,0,2,8,2,0
53883,57470,24874,7043,24874,allow,132,132,0,3,1199,3,0
53884,50265,55243,25034,55243,allow,481,150,331,2,1200,1,1
53885,50186,443,39007,443,allow,6440,1603,4837,23,361,11,12
53886,17750,1024,34469,1024,allow,323,150,173,2,1200,1,1
53887,49657,443,29231,443,allow,9039,2175,6864,32,20,17,15
53888,56192,53,12282,53,allow,282,87,195,4,45,2,2
53889,59974,443,48312,443,allow,200862,57949,142913,361,24,172,189
53890,56140,53,23511,53,allow,195,86,109,2,30,1,1
53891,63787,18318,40020,18318,allow,66,66,0,2,8,2,0
53892,53601,30160,44927,30160,allow,70,70,0,2,8,2,0
53893,59980,443,52666,443,allow,345468,18536,326932,432,22,200,232
53894,52763,443,13803,443,allow,256711,14141,242570,367,96,152,215
53895,36025,443,36025,443,allow,4585,1678,2907,19,29,11,8
53896,64973,53,36407,53,allow,257,102,155,2,30,1,1
53897,57096,53,51826,53,allow,177,94,83,2,30,1,1
53898,52921,443,13055,443,allow,5581,1388,4193,19,15,9,10
53899,28003,443,64020,443,allow,5515,1388,4127,18,15,9,9
53900,52412,443,22141,443,allow,11565,5557,6008,52,16,27,25
53901,49743,53,12081,53,allow,636,202,434,6,47,3,3
53902,65511,53,22579,53,allow,545,136,409,4,56,2,2
53903,56363,53,52930,53,allow,212,102,110,2,30,1,1
53904,65209,57866,0,0,deny,62,62,0,1,0,1,0
53905,58043,445,0,0,drop,70,70,0,1,0,1,0
53906,53419,28189,0,0,deny,60,60,0,1,0,1,0
53907,2323,23117,0,0,deny,62,62,0,1,0,1,0
53908,18091,23,0,0,deny,60,60,0,1,0,1,0
53909,6889,40740,0,0,deny,143,143,0,1,0,1,0
53910,58787,23,0,0,deny,60,60,0,1,0,1,0
53911,64940,36237,0,0,deny,62,62,0,1,0,1,0
53912,53059,445,0,0,drop,70,70,0,1,0,1,0
53913,1024,57470,0,0,deny,62,62,0,1,0,1,0
53914,53449,445,0,0,drop,66,66,0,1,0,1,0
53915,53448,445,0,0,drop,66,66,0,1,0,1,0
53916,52064,22114,0,0,deny,66,66,0,1,0,1,0
53917,58036,445,0,0,drop,70,70,0,1,0,1,0
53918,53049,445,0,0,drop,70,70,0,1,0,1,0
53919,53050,445,0,0,drop,70,70,0,1,0,1,0
53920,2923,57470,0,0,deny,66,66,0,1,0,1,0
53921,4127,26467,0,0,deny,66,66,0,1,0,1,0
53922,53044,445,0,0,drop,70,70,0,1,0,1,0
53923,53045,445,0,0,drop,70,70,0,1,0,1,0
53924,58030,445,0,0,drop,70,70,0,1,0,1,0
53925,58027,445,0,0,drop,70,70,0,1,0,1,0
53926,58023,445,0,0,drop,70,70,0,1,0,1,0
53927,53043,445,0,0,drop,70,70,0,1,0,1,0
53928,53447,445,0,0,drop,66,66,0,1,0,1,0
53929,80,37649,0,0,deny,60,60,0,1,0,1,0
53930,59781,56205,0,0,deny,66,66,0,1,0,1,0
53931,6881,59353,0,0,deny,146,146,0,1,0,1,0
53932,6881,29517,0,0,deny,146,146,0,1,0,1,0
53933,58020,445,0,0,drop,70,70,0,1,0,1,0
53934,58017,445,0,0,drop,70,70,0,1,0,1,0
53935,58015,445,0,0,drop,70,70,0,1,0,1,0
53936,58013,445,0,0,drop,70,70,0,1,0,1,0
53937,53439,445,0,0,drop,66,66,0,1,0,1,0
53938,53037,445,0,0,drop,70,70,0,1,0,1,0
53939,53242,37965,0,0,deny,66,66,0,1,0,1,0
53940,53433,445,0,0,drop,66,66,0,1,0,1,0
53941,53432,445,0,0,drop,66,66,0,1,0,1,0
53942,53431,445,0,0,drop,66,66,0,1,0,1,0
53943,80,53945,0,0,deny,60,60,0,1,0,1,0
53944,19747,37965,0,0,deny,62,62,0,1,0,1,0
53945,53427,445,0,0,drop,66,66,0,1,0,1,0
53946,53428,445,0,0,drop,66,66,0,1,0,1,0
53947,53429,445,0,0,drop,66,66,0,1,0,1,0
53948,50067,64147,0,0,deny,66,66,0,1,0,1,0
53949,29203,26467,0,0,deny,62,62,0,1,0,1,0
53950,6416,22114,0,0,deny,66,66,0,1,0,1,0
53951,53029,445,0,0,drop,70,70,0,1,0,1,0
53952,36930,22,36930,22,deny,293,126,167,4,0,2,2
53953,5222,48709,0,0,deny,66,66,0,1,0,1,0
53954,53027,445,0,0,drop,70,70,0,1,0,1,0
53955,58011,445,0,0,drop,70,70,0,1,0,1,0
53956,58010,445,0,0,drop,70,70,0,1,0,1,0
53957,58008,445,0,0,drop,70,70,0,1,0,1,0
53958,53425,445,0,0,drop,66,66,0,1,0,1,0
53959,58004,445,0,0,drop,70,70,0,1,0,1,0
53960,49842,7302,0,0,deny,66,66,0,1,0,1,0
53961,53421,445,0,0,drop,66,66,0,1,0,1,0
53962,57478,7302,0,0,deny,66,66,0,1,0,1,0
53963,50820,57470,0,0,deny,66,66,0,1,0,1,0
53964,17837,62609,0,0,deny,148,148,0,1,0,1,0
53965,53418,445,0,0,drop,66,66,0,1,0,1,0
53966,53419,445,0,0,drop,66,66,0,1,0,1,0
53967,53023,445,0,0,drop,70,70,0,1,0,1,0
53968,63305,62413,0,0,deny,62,62,0,1,0,1,0
53969,53415,445,0,0,drop,66,66,0,1,0,1,0
53970,53021,445,0,0,drop,70,70,0,1,0,1,0
53971,443,64347,0,0,deny,131,131,0,1,0,1,0
53972,3541,22114,0,0,deny,62,62,0,1,0,1,0
53973,53017,445,0,0,drop,70,70,0,1,0,1,0
53974,57996,445,0,0,drop,70,70,0,1,0,1,0
53975,26722,11446,0,0,deny,62,62,0,1,0,1,0
53976,57995,445,0,0,drop,70,70,0,1,0,1,0
53977,57990,445,0,0,drop,70,70,0,1,0,1,0
53978,26084,36237,0,0,deny,66,66,0,1,0,1,0
53979,58468,57587,0,0,deny,66,66,0,1,0,1,0
53980,53016,445,0,0,drop,70,70,0,1,0,1,0
53981,57789,30188,0,0,deny,62,62,0,1,0,1,0
53982,19534,26467,0,0,deny,66,66,0,1,0,1,0
53983,53405,445,0,0,drop,66,66,0,1,0,1,0
53984,50878,53733,0,0,deny,66,66,0,1,0,1,0
53985,27064,51221,0,0,deny,72,72,0,1,0,1,0
53986,61701,44847,0,0,deny,66,66,0,1,0,1,0
53987,49628,35440,0,0,deny,66,66,0,1,0,1,0
53988,19610,9571,0,0,deny,62,62,0,1,0,1,0
53989,443,9986,0,0,deny,66,66,0,1,0,1,0
53990,443,9986,0,0,deny,152,152,0,1,0,1,0
53991,57060,50584,0,0,deny,62,62,0,1,0,1,0
53992,53011,445,0,0,drop,70,70,0,1,0,1,0
53993,53397,445,0,0,drop,66,66,0,1,0,1,0
53994,51725,56205,0,0,deny,62,62,0,1,0,1,0
53995,0,0,0,0,deny,98,98,0,1,0,1,0
53996,0,0,0,0,deny,98,98,0,1,0,1,0
53997,53395,445,0,0,drop,66,66,0,1,0,1,0
53998,1888,51505,0,0,deny,62,62,0,1,0,1,0
53999,52431,50265,0,0,deny,62,62,0,1,0,1,0
54000,25565,30367,0,0,deny,60,60,0,1,0,1,0
54001,65512,44847,0,0,deny,62,62,0,1,0,1,0
54002,53388,445,0,0,drop,66,66,0,1,0,1,0
54003,52998,445,0,0,drop,70,70,0,1,0,1,0
54004,51760,50584,0,0,deny,62,62,0,1,0,1,0
54005,53377,445,0,0,drop,66,66,0,1,0,1,0
54006,51674,51505,0,0,deny,66,66,0,1,0,1,0
54007,23274,50584,0,0,deny,62,62,0,1,0,1,0
54008,59055,11392,0,0,deny,62,62,0,1,0,1,0
54009,54062,49813,0,0,deny,62,62,0,1,0,1,0
54010,52447,43890,0,0,deny,66,66,0,1,0,1,0
54011,52995,445,0,0,drop,70,70,0,1,0,1,0
54012,80,9918,0,0,deny,60,60,0,1,0,1,0
54013,49976,22114,0,0,deny,62,62,0,1,0,1,0
54014,443,52365,0,0,deny,97,97,0,1,0,1,0
54015,36908,26467,0,0,deny,62,62,0,1,0,1,0
54016,57965,445,0,0,drop,70,70,0,1,0,1,0
54017,57967,445,0,0,drop,70,70,0,1,0,1,0
54018,57964,445,0,0,drop,70,70,0,1,0,1,0
54019,53371,445,0,0,drop,66,66,0,1,0,1,0
54020,53372,445,0,0,drop,66,66,0,1,0,1,0
54021,53370,445,0,0,drop,66,66,0,1,0,1,0
54022,53369,445,0,0,drop,66,66,0,1,0,1,0
54023,53368,445,0,0,drop,66,66,0,1,0,1,0
54024,53367,445,0,0,drop,66,66,0,1,0,1,0
54025,53366,445,0,0,drop,66,66,0,1,0,1,0
54026,53365,445,0,0,drop,66,66,0,1,0,1,0
54027,23776,57354,0,0,deny,145,145,0,1,0,1,0
54028,45079,31573,0,0,deny,62,62,0,1,0,1,0
54029,52990,445,0,0,drop,70,70,0,1,0,1,0
54030,57654,35440,0,0,deny,66,66,0,1,0,1,0
54031,52989,445,0,0,drop,70,70,0,1,0,1,0
54032,61520,23718,0,0,deny,66,66,0,1,0,1,0
54033,27147,22114,0,0,deny,62,62,0,1,0,1,0
54034,26528,51221,0,0,deny,78,78,0,1,0,1,0
54035,62776,62413,0,0,deny,62,62,0,1,0,1,0
54036,52987,445,0,0,drop,70,70,0,1,0,1,0
54037,54600,6881,0,0,deny,66,66,0,1,0,1,0
54038,65454,61600,0,0,deny,66,66,0,1,0,1,0
54039,46478,64147,0,0,deny,62,62,0,1,0,1,0
54040,62737,64147,0,0,deny,66,66,0,1,0,1,0
54041,53460,443,38830,443,allow,25079,5739,19340,39,337,18,21
54042,11592,80,11592,80,allow,6967,765,6202,15,16,7,8
54043,55021,443,3999,443,allow,5987,1556,4431,19,47,12,7
54044,57194,53,31354,53,allow,2198,193,2005,6,90,3,3
54045,53009,80,53009,80,allow,378,180,198,7,17,4,3
54046,41625,15000,38798,15000,allow,130,70,60,2,5,1,1
54047,59420,443,62141,443,allow,2854,1732,1122,16,15,8,8
54048,54135,443,36564,443,allow,11065,1394,9671,23,75,13,10
54049,57140,53,16030,53,allow,170,87,83,2,30,1,1
54050,51772,59814,9968,59814,allow,66,66,0,1,5,1,0
54051,52107,443,6381,443,allow,12091,3135,8956,30,49,16,14
54052,58885,15000,9072,15000,allow,138,78,60,2,5,1,1
54053,55584,53,31260,53,allow,184,80,104,2,30,1,1
54054,37444,53,37444,53,allow,213,79,134,2,32,1,1
54055,60017,443,51690,443,allow,134,60,74,3,10,2,1
54056,61467,443,56685,443,allow,130792,4916,125876,161,89,69,92
54057,39336,443,55309,443,allow,7759,4000,3759,23,96,11,12
54058,58259,53,21594,53,allow,578,286,292,9,15,5,4
54059,55540,443,32830,443,allow,10458,5272,5186,24,76,13,11
54060,55786,53,21732,53,allow,170,87,83,2,30,1,1
54061,39611,443,2531,443,allow,78,78,0,1,5,1,0
54062,61469,443,16667,443,allow,6204,1125,5079,23,89,13,10
54063,54137,443,45668,443,allow,10046,1394,8652,22,75,13,9
54064,61493,443,44435,443,allow,5325,1242,4083,23,27,13,10
54065,54134,443,5561,443,allow,10425,1383,9042,23,75,13,10
54066,61494,443,60069,443,allow,14558,2653,11905,33,27,18,15
54067,59419,443,5544,443,allow,2854,1732,1122,16,15,8,8
54068,61462,443,27750,443,allow,6271,1191,5080,24,94,14,10
54069,56360,53,64885,53,allow,711,87,624,2,30,1,1
54070,55800,53,53999,53,allow,711,87,624,2,30,1,1
54071,49685,443,41646,443,allow,8435,1687,6748,30,76,14,16
54072,50564,443,64623,443,allow,1894028,31411,1862617,1579,122,209,1370
54073,54136,443,41489,443,allow,10109,1394,8715,22,75,13,9
54074,2084,7000,2084,7000,allow,3566,1999,1567,16,15,8,8
54075,56626,443,26601,443,allow,7941,1952,5989,20,15,11,9
54076,61465,80,64777,80,allow,17320,9430,7890,67,93,35,32
54077,35053,80,19912,80,allow,71843,2833,69010,83,15,36,47
54078,61468,443,50536,443,allow,6265,1185,5080,24,89,14,10
54079,61464,80,54948,80,allow,366,180,186,7,93,4,3
54080,56627,443,11832,443,allow,7889,1900,5989,20,15,11,9
54081,61461,443,31107,443,allow,9073,2899,6174,36,94,19,17
54082,61466,443,43127,443,allow,6205,1125,5080,23,89,13,10
54083,63793,53,63793,53,allow,237,91,146,2,33,1,1
54084,58994,443,24369,443,allow,204,70,134,4,25,2,2
54085,56625,443,59240,443,allow,7888,1899,5989,20,15,11,9
54086,59418,443,6727,443,allow,2946,1812,1134,16,15,8,8
54087,56624,443,34630,443,allow,7940,1951,5989,20,16,11,9
54088,41335,53,41335,53,allow,825,99,726,2,30,1,1
54089,48720,53,0,0,allow,82,82,0,1,30,1,0
54090,56472,53,0,0,allow,371,77,294,2,30,1,1
54091,65386,443,29589,443,allow,5405,4034,1371,25,43,10,15
54092,48533,443,47218,443,allow,160,69,91,2,121,1,1
54093,13262,53,13262,53,allow,208,94,114,2,31,1,1
54094,36986,53,36986,53,allow,234,93,141,2,31,1,1
54095,5431,53,5431,53,allow,224,88,136,2,31,1,1
54096,7176,53,7176,53,allow,233,91,142,2,31,1,1
54097,5938,47512,0,0,allow,60,60,0,1,90,1,0
54098,55542,53,5269,53,allow,711,87,624,2,31,1,1
54099,52151,53,52151,53,allow,198,89,109,2,31,1,1
54100,11835,53,11835,53,allow,216,88,128,2,31,1,1
54101,27386,53,27386,53,allow,194,87,107,2,31,1,1
54102,52677,53,52677,53,allow,233,91,142,2,31,1,1
54103,56282,53,56282,53,allow,194,87,107,2,31,1,1
54104,55128,53,34503,53,allow,711,87,624,2,31,1,1
54105,50038,53,0,0,allow,275,85,190,2,31,1,1
54106,50038,53,0,0,allow,275,85,190,2,31,1,1
54107,57470,32177,25835,32177,allow,480,149,331,2,1200,1,1
54108,30960,45692,4911,45692,allow,330,330,0,6,3609,6,0
54109,61896,34021,0,0,allow,66,66,0,1,91,1,0
54110,32618,53,32618,53,allow,231,90,141,2,31,1,1
54111,47063,53,47063,53,allow,221,89,132,2,31,1,1
54112,58178,53,58178,53,allow,237,93,144,2,31,1,1
54113,8762,53,8762,53,allow,233,91,142,2,31,1,1
54114,63755,53,63755,53,allow,223,92,131,2,31,1,1
54115,41199,443,15931,443,allow,30604,3050,27554,45,122,18,27
54116,59267,53,59267,53,allow,222,87,135,2,31,1,1
54117,55072,53,31850,53,allow,168,86,82,2,31,1,1
54118,49432,5228,59843,5228,allow,10635,3087,7548,41,3661,22,19
54119,54693,30188,0,0,deny,66,66,0,1,0,1,0
54120,57963,445,0,0,drop,70,70,0,1,0,1,0
54121,57961,445,0,0,drop,70,70,0,1,0,1,0
54122,57956,445,0,0,drop,70,70,0,1,0,1,0
54123,8239,37965,0,0,deny,146,146,0,1,0,1,0
54124,53352,445,0,0,drop,66,66,0,1,0,1,0
54125,53351,445,0,0,drop,66,66,0,1,0,1,0
54126,53349,445,0,0,drop,66,66,0,1,0,1,0
54127,52980,445,0,0,drop,70,70,0,1,0,1,0
54128,4447,35440,0,0,deny,66,66,0,1,0,1,0
54129,57946,445,0,0,drop,70,70,0,1,0,1,0
54130,51192,15503,0,0,deny,66,66,0,1,0,1,0
54131,60751,20010,54269,20010,allow,70,70,0,2,8,2,0
54132,55786,53,23026,53,allow,177,94,83,2,30,1,1
54133,59984,443,19518,443,allow,1527,940,587,14,21,8,6
54134,59982,443,1995,443,allow,1467,880,587,13,21,7,6
54135,53603,53796,63183,53796,allow,70,70,0,2,7,2,0
54136,52978,445,0,0,drop,70,70,0,1,0,1,0
54137,21892,15503,0,0,deny,62,62,0,1,0,1,0
54138,4961,62741,0,0,deny,66,66,0,1,0,1,0
54139,39895,26467,0,0,deny,62,62,0,1,0,1,0
54140,52977,445,0,0,drop,70,70,0,1,0,1,0
54141,57944,445,0,0,drop,70,70,0,1,0,1,0
54142,26800,22,0,0,deny,60,60,0,1,0,1,0
54143,52976,445,0,0,drop,70,70,0,1,0,1,0
54144,52975,445,0,0,drop,70,70,0,1,0,1,0
54145,57943,445,0,0,drop,70,70,0,1,0,1,0
54146,57934,445,0,0,drop,70,70,0,1,0,1,0
54147,57936,445,0,0,drop,70,70,0,1,0,1,0
54148,52971,445,0,0,drop,70,70,0,1,0,1,0
54149,52970,445,0,0,drop,70,70,0,1,0,1,0
54150,61426,64910,0,0,deny,66,66,0,1,0,1,0
54151,50717,9571,0,0,deny,62,62,0,1,0,1,0
54152,21420,44847,0,0,deny,66,66,0,1,0,1,0
54153,42252,33303,0,0,deny,60,60,0,1,0,1,0
54154,52957,445,0,0,drop,70,70,0,1,0,1,0
54155,52956,445,0,0,drop,70,70,0,1,0,1,0
54156,52953,445,0,0,drop,70,70,0,1,0,1,0
54157,443,64347,0,0,deny,60,60,0,1,0,1,0
54158,52945,445,0,0,drop,70,70,0,1,0,1,0
54159,52946,445,0,0,drop,70,70,0,1,0,1,0
54160,55056,53,38233,53,allow,177,94,83,2,29,1,1
54161,49940,53,29743,53,allow,197,94,103,2,29,1,1
54162,56646,53,30377,53,allow,177,94,83,2,30,1,1
54163,51103,80,39889,80,allow,2792,2073,719,15,30,9,6
54164,63786,50091,30767,50091,allow,66,66,0,2,7,2,0
54165,59608,443,1997,443,allow,2149,1277,872,18,829,10,8
54166,53602,12395,26422,12395,allow,70,70,0,2,7,2,0
54167,59981,443,57380,443,allow,180817,9921,170896,241,21,116,125
54168,55462,53,41879,53,allow,194,102,92,2,33,1,1
54169,55417,53,62498,53,allow,198,102,96,2,32,1,1
54170,51975,443,14807,443,allow,29510,15378,14132,76,216,35,41
54171,123,123,55557,123,allow,184,94,90,2,29,1,1
54172,56646,53,16936,53,allow,177,94,83,2,29,1,1
54173,54427,443,64059,443,allow,2878,1252,1626,16,361,9,7
54174,51100,80,29611,80,allow,12300,4454,7846,26,30,13,13
54175,55615,13826,16730,13826,allow,70,70,0,1,5,1,0
54176,27490,53,27490,53,allow,214,82,132,2,33,1,1
54177,49176,443,60169,443,allow,533295,14310,518985,552,18,201,351
54178,61472,443,58092,443,allow,6211,1132,5079,23,88,13,10
54179,58557,443,4317,443,allow,114852,43911,70941,248,69,132,116
54180,42106,443,29417,443,allow,5361,973,4388,18,15,10,8
54181,49752,53,64105,53,allow,193,102,91,2,30,1,1
54182,52407,443,29892,443,allow,1043,556,487,10,16,6,4
54183,60455,443,23230,443,allow,25055,5440,19615,65,84,35,30
54184,2083,7000,2083,7000,allow,3374,1535,1839,16,15,8,8
54185,61833,443,61833,443,allow,80743,4724,76019,101,89,37,64
54186,55041,53,58764,53,allow,234,94,140,2,30,1,1
54187,43677,443,54935,443,allow,30090,19982,10108,77,543,41,36
54188,55614,29731,26252,29731,allow,70,70,0,1,5,1,0
54189,57140,53,49557,53,allow,177,94,83,2,30,1,1
54190,37697,443,26341,443,allow,2071929,56793,2015136,2088,179,685,1403
54191,51771,19103,1964,19103,allow,70,70,0,1,5,1,0
54192,55254,443,12972,443,allow,3257,782,2475,17,140,8,9
54193,50151,53,24855,53,allow,177,94,83,2,30,1,1
54194,61470,443,10942,443,allow,12420,4900,7520,47,88,24,23
54195,52408,443,37575,443,allow,1043,556,487,10,16,6,4
54196,56798,40759,43301,40759,allow,70,70,0,1,5,1,0
54197,61463,443,9374,443,allow,11355,3474,7881,45,93,22,23
54198,42599,443,19054,443,allow,215284,28807,186477,346,129,151,195
54199,55607,17820,29778,17820,allow,504,318,186,8,16,5,3
54200,56569,53,52915,53,allow,94,94,0,1,30,1,0
54201,64537,53,63183,53,allow,718,94,624,2,30,1,1
54202,55610,23383,13424,23383,allow,70,70,0,1,5,1,0
54203,43205,22,43205,22,allow,6957,2330,4627,35,27,17,18
54204,55429,443,25959,443,allow,6292,4834,1458,18,129,11,7
54205,46695,443,28304,443,allow,12787534,288179,12499355,12299,64,4036,8263
54206,44836,443,51394,443,allow,34881,6721,28160,62,46,30,32
54207,2085,7010,2085,7010,allow,3342,1983,1359,16,15,8,8
54208,49724,443,21055,443,allow,4139,511,3628,12,15,6,6
54209,37310,443,2394,443,allow,3950,2949,1001,26,69,15,11
54210,51102,80,31602,80,allow,2794,2075,719,15,30,9,6
54211,50638,443,62460,443,allow,14401,2712,11689,52,19,23,29
54212,55836,53,41454,53,allow,181,94,87,2,33,1,1
54213,49374,53,26610,53,allow,307,102,205,4,35,2,2
54214,49658,443,50327,443,allow,14121,2299,11822,37,19,19,18
54215,56783,21279,24337,21279,allow,70,70,0,1,5,1,0
54216,59983,443,57676,443,allow,158230,9208,149022,214,21,105,109
54217,1462,41599,48660,41599,allow,70,70,0,2,8,2,0
54218,50202,443,56858,443,allow,8415,3119,5296,26,73,9,17
54219,64779,53,46294,53,allow,497,102,395,4,40,2,2
54220,39570,443,58125,443,allow,127970,4968,123002,144,30,53,91
54221,61471,443,26685,443,allow,18168,2973,15195,46,88,21,25
54222,42963,443,15595,443,allow,7681,4711,2970,36,28,17,19
54223,52112,443,29903,443,allow,59796,4486,55310,92,48,45,47
54224,58302,443,37691,443,allow,4611,3176,1435,26,30,15,11
54225,26865,443,47610,443,allow,20959,15902,5057,38,20,21,17
54226,64636,53,42647,53,allow,727,223,504,6,70,3,3
54227,27005,23010,35544,23010,allow,881,126,755,2,29,1,1
54228,49284,53,32626,53,allow,245,102,143,2,29,1,1
54229,49163,36069,48102,36069,allow,5990,5698,292,17,51,14,3
54230,57096,53,50734,53,allow,177,94,83,2,29,1,1
54231,49844,53,30878,53,allow,755,102,653,2,30,1,1
54232,55777,53,11730,53,allow,200,94,106,2,30,1,1
54233,55699,53,21219,53,allow,211,102,109,2,29,1,1
54234,35546,443,6886,443,allow,5198,973,4225,16,17,10,6
54235,49203,53,26385,53,allow,240,94,146,2,29,1,1
54236,55669,53,15322,53,allow,94,94,0,1,29,1,0
54237,55786,53,33325,53,allow,177,94,83,2,30,1,1
54238,57397,53,56026,53,allow,177,94,83,2,31,1,1
54239,65269,53,55640,53,allow,273,134,139,2,30,1,1
54240,65291,53,62097,53,allow,247,118,129,2,30,1,1
54241,49234,53,59585,53,allow,177,94,83,2,30,1,1
54242,23514,53,23514,53,allow,245,98,147,2,30,1,1
54243,49792,443,37527,443,allow,9841,3185,6656,25,186,14,11
54244,40985,443,29028,443,allow,3166,2097,1069,24,46,12,12
54245,60401,30046,40405,30046,allow,70,70,0,1,5,1,0
54246,55609,39869,60499,39869,allow,70,70,0,1,5,1,0
54247,39571,443,44587,443,allow,580560,15724,564836,583,30,187,396
54248,39573,443,27028,443,allow,29226,2150,27076,44,30,19,25
54249,39569,443,5001,443,allow,1784075,46752,1737323,1812,47,606,1206
54250,57004,53,12740,53,allow,195,78,117,2,30,1,1
54251,56551,53,25599,53,allow,225,102,123,2,30,1,1
54252,45816,443,14384,443,allow,21950,3632,18318,46,140,20,26
54253,49160,14387,38901,14387,allow,854,150,704,4,1200,2,2
54254,1609,53,1609,53,allow,197,90,107,2,30,1,1
54255,63526,3389,63526,3389,allow,4365,2581,1784,20,33,11,9
54256,32811,443,18226,443,allow,16652,13777,2875,48,44,27,21
54257,39572,443,50194,443,allow,64247,3857,60390,94,30,43,51
54258,58056,443,35080,443,allow,10493,2658,7835,50,1469,26,24
54259,60400,56243,17811,56243,allow,70,70,0,1,5,1,0
54260,60822,443,12029,443,allow,7839,2697,5142,21,137,10,11
54261,63967,53,22995,53,allow,195,102,93,2,33,1,1
54262,51790,46839,55080,46839,allow,70,70,0,2,8,2,0
54263,57140,53,49322,53,allow,177,94,83,2,30,1,1
54264,63972,53,28656,53,allow,325,94,231,2,30,1,1
54265,50151,53,38506,53,allow,177,94,83,2,30,1,1
54266,57397,53,60967,53,allow,177,94,83,2,30,1,1
54267,55539,53,25818,53,allow,249,94,155,2,31,1,1
54268,37965,14259,39595,14259,allow,150,150,0,1,1199,1,0
54269,52048,443,14008,443,allow,3182,1568,1614,8,120,4,4
54270,49919,53,2531,53,allow,225,102,123,2,30,1,1
54271,27005,1102,9620,1102,allow,867,126,741,2,30,1,1
54272,49672,53,36807,53,allow,718,94,624,2,30,1,1
54273,49509,53,2190,53,allow,339,110,229,2,30,1,1
54274,49757,53,31813,53,allow,177,94,83,2,31,1,1
54275,53521,443,20457,443,allow,280,140,140,5,129,3,2
54276,6881,37957,48141,37957,allow,509,150,359,2,1199,1,1
54277,51221,9869,40891,9869,allow,870,330,540,12,1298,6,6
54278,37272,443,58616,443,allow,10809,2465,8344,45,121,21,24
54279,37989,49152,16381,49152,allow,156,156,0,3,8,3,0
54280,58969,80,39801,80,allow,1431,783,648,10,75,6,4
54281,51247,443,62660,443,allow,5747,1892,3855,19,16,11,8
54282,57117,443,28755,443,allow,8997,1155,7842,19,76,11,8
54283,50905,80,47395,80,allow,11749346,149441,11599905,10089,147,2116,7973
54284,41210,443,59857,443,allow,78,78,0,1,5,1,0
54285,58796,443,14867,443,allow,7402,2429,4973,40,139,22,18
54286,58802,443,37884,443,allow,8591,2275,6316,37,137,21,16
54287,51237,443,50232,443,allow,9668,4698,4970,42,16,25,17
54288,55113,53,62810,53,allow,198,102,96,2,33,1,1
54289,49665,53,6360,53,allow,779,298,481,8,67,4,4
54290,27005,1108,19358,1108,allow,873,126,747,2,30,1,1
54291,49628,443,14591,443,allow,12843,3808,9035,26,81,13,13
54292,63783,1375,0,0,deny,109,109,0,1,0,1,0
54293,19698,502,0,0,deny,60,60,0,1,0,1,0
54294,18415,37965,0,0,deny,62,62,0,1,0,1,0
54295,53419,28189,0,0,deny,60,60,0,1,0,1,0
54296,21145,11392,0,0,deny,62,62,0,1,0,1,0
54297,57925,445,0,0,drop,70,70,0,1,0,1,0
54298,57927,445,0,0,drop,70,70,0,1,0,1,0
54299,57921,445,0,0,drop,70,70,0,1,0,1,0
54300,16393,22114,0,0,deny,62,62,0,1,0,1,0
54301,30922,22,0,0,deny,60,60,0,1,0,1,0
54302,41482,23,0,0,deny,60,60,0,1,0,1,0
54303,52934,445,0,0,drop,70,70,0,1,0,1,0
54304,80,56289,0,0,deny,1090,1090,0,1,0,1,0
54305,53469,44847,0,0,deny,66,66,0,1,0,1,0
54306,16660,55783,0,0,deny,62,62,0,1,0,1,0
54307,16361,60888,0,0,deny,146,146,0,1,0,1,0
54308,54062,31573,0,0,deny,66,66,0,1,0,1,0
54309,53328,445,0,0,drop,66,66,0,1,0,1,0
54310,57918,445,0,0,drop,70,70,0,1,0,1,0
54311,57915,445,0,0,drop,70,70,0,1,0,1,0
54312,62827,1,0,0,deny,66,66,0,1,0,1,0
54313,50804,1,0,0,deny,62,62,0,1,0,1,0
54314,3270,35440,0,0,deny,62,62,0,1,0,1,0
54315,52930,445,0,0,drop,70,70,0,1,0,1,0
54316,59592,37965,0,0,deny,62,62,0,1,0,1,0
54317,53321,445,0,0,drop,66,66,0,1,0,1,0
54318,52921,445,0,0,drop,70,70,0,1,0,1,0
54319,52919,445,0,0,drop,70,70,0,1,0,1,0
54320,37903,23,0,0,deny,60,60,0,1,0,1,0
54321,52918,445,0,0,drop,70,70,0,1,0,1,0
54322,52917,445,0,0,drop,70,70,0,1,0,1,0
54323,36903,56205,0,0,deny,146,146,0,1,0,1,0
54324,53320,445,0,0,drop,66,66,0,1,0,1,0
54325,8999,32480,0,0,deny,146,146,0,1,0,1,0
54326,57904,445,0,0,drop,70,70,0,1,0,1,0
54327,52914,445,0,0,drop,70,70,0,1,0,1,0
54328,57901,445,0,0,drop,70,70,0,1,0,1,0
54329,57897,445,0,0,drop,70,70,0,1,0,1,0
54330,12608,21247,0,0,deny,66,66,0,1,0,1,0
54331,53317,445,0,0,drop,66,66,0,1,0,1,0
54332,17008,35440,0,0,deny,62,62,0,1,0,1,0
54333,43688,22114,0,0,deny,66,66,0,1,0,1,0
54334,54214,443,38557,443,allow,499,425,74,4,0,3,1
54335,54215,443,45620,443,allow,499,425,74,4,0,3,1
54336,53817,443,41947,443,allow,499,425,74,4,0,3,1
54337,53816,443,52923,443,allow,499,425,74,4,0,3,1
54338,26053,33720,0,0,deny,160,160,0,1,0,1,0
54339,26053,33720,0,0,deny,160,160,0,1,0,1,0
54340,9095,22114,0,0,deny,146,146,0,1,0,1,0
54341,24480,35440,0,0,deny,62,62,0,1,0,1,0
54342,1024,64147,0,0,deny,62,62,0,1,0,1,0
54343,29424,37807,0,0,deny,66,66,0,1,0,1,0
54344,60196,53,0,0,deny,88,88,0,1,0,1,0
54345,57892,445,0,0,drop,70,70,0,1,0,1,0
54346,10006,64147,0,0,deny,62,62,0,1,0,1,0
54347,52907,445,0,0,drop,70,70,0,1,0,1,0
54348,10265,64147,0,0,deny,66,66,0,1,0,1,0
54349,52726,56205,0,0,deny,66,66,0,1,0,1,0
54350,57889,445,0,0,drop,70,70,0,1,0,1,0
54351,57888,445,0,0,drop,70,70,0,1,0,1,0
54352,57885,445,0,0,drop,70,70,0,1,0,1,0
54353,53309,445,0,0,drop,66,66,0,1,0,1,0
54354,34176,51505,0,0,deny,62,62,0,1,0,1,0
54355,53308,445,0,0,drop,66,66,0,1,0,1,0
54356,53304,445,0,0,drop,66,66,0,1,0,1,0
54357,53302,445,0,0,drop,66,66,0,1,0,1,0
54358,10006,64147,0,0,deny,145,145,0,1,0,1,0
54359,55225,11392,0,0,deny,66,66,0,1,0,1,0
54360,53300,445,0,0,drop,66,66,0,1,0,1,0
54361,53301,445,0,0,drop,66,66,0,1,0,1,0
54362,53298,445,0,0,drop,66,66,0,1,0,1,0
54363,21833,22114,0,0,deny,62,62,0,1,0,1,0
54364,30046,15503,0,0,deny,62,62,0,1,0,1,0
54365,1176,64147,0,0,deny,62,62,0,1,0,1,0
54366,52900,445,0,0,drop,70,70,0,1,0,1,0
54367,52898,445,0,0,drop,70,70,0,1,0,1,0
54368,1024,9319,0,0,deny,62,62,0,1,0,1,0
54369,59377,9319,0,0,deny,62,62,0,1,0,1,0
54370,443,51160,0,0,deny,102,102,0,1,0,1,0
54371,63205,9571,0,0,deny,66,66,0,1,0,1,0
54372,58751,9571,0,0,deny,62,62,0,1,0,1,0
54373,54339,23117,0,0,deny,66,66,0,1,0,1,0
54374,57884,445,0,0,drop,70,70,0,1,0,1,0
54375,57882,445,0,0,drop,70,70,0,1,0,1,0
54376,57878,445,0,0,drop,70,70,0,1,0,1,0
54377,6828,64322,0,0,deny,60,60,0,1,0,1,0
54378,443,64347,0,0,deny,60,60,0,1,0,1,0
54379,443,64347,0,0,deny,85,85,0,1,0,1,0
54380,443,64347,0,0,deny,100,100,0,1,0,1,0
54381,53294,445,0,0,drop,66,66,0,1,0,1,0
54382,36966,10387,0,0,deny,159,159,0,1,0,1,0
54383,52893,445,0,0,drop,70,70,0,1,0,1,0
54384,53293,445,0,0,drop,66,66,0,1,0,1,0
54385,52892,445,0,0,drop,70,70,0,1,0,1,0
54386,42241,11392,0,0,deny,66,66,0,1,0,1,0
54387,53290,445,0,0,drop,66,66,0,1,0,1,0
54388,53289,445,0,0,drop,66,66,0,1,0,1,0
54389,53287,445,0,0,drop,66,66,0,1,0,1,0
54390,26053,33720,0,0,deny,160,160,0,1,0,1,0
54391,26053,33720,0,0,deny,160,160,0,1,0,1,0
54392,52888,445,0,0,drop,70,70,0,1,0,1,0
54393,6881,21162,0,0,deny,146,146,0,1,0,1,0
54394,56474,18375,0,0,deny,62,62,0,1,0,1,0
54395,26053,33720,0,0,deny,160,160,0,1,0,1,0
54396,26053,33720,0,0,deny,160,160,0,1,0,1,0
54397,57870,445,0,0,drop,70,70,0,1,0,1,0
54398,26053,33720,0,0,deny,160,160,0,1,0,1,0
54399,52887,445,0,0,drop,70,70,0,1,0,1,0
54400,63852,35440,0,0,deny,62,62,0,1,0,1,0
54401,57864,445,0,0,drop,70,70,0,1,0,1,0
54402,57862,445,0,0,drop,70,70,0,1,0,1,0
54403,22927,48817,0,0,deny,143,143,0,1,0,1,0
54404,0,0,0,0,allow,320,320,0,5,0,5,0
54405,0,0,0,0,allow,274,274,0,2,0,2,0
54406,17640,55442,0,0,deny,66,66,0,1,0,1,0
54407,59168,39004,0,0,deny,62,62,0,1,0,1,0
54408,53278,445,0,0,drop,66,66,0,1,0,1,0
54409,37008,42707,0,0,deny,62,62,0,1,0,1,0
54410,58022,5601,0,0,deny,60,60,0,1,0,1,0
54411,38320,51505,0,0,deny,66,66,0,1,0,1,0
54412,16059,22114,0,0,deny,62,62,0,1,0,1,0
54413,52882,445,0,0,drop,70,70,0,1,0,1,0
54414,50439,64147,0,0,deny,62,62,0,1,0,1,0
54415,53105,42707,0,0,deny,66,66,0,1,0,1,0
54416,53269,445,0,0,drop,66,66,0,1,0,1,0
54417,15959,56205,0,0,deny,66,66,0,1,0,1,0
54418,57850,445,0,0,drop,70,70,0,1,0,1,0
54419,53267,445,0,0,drop,66,66,0,1,0,1,0
54420,64087,50265,0,0,deny,145,145,0,1,0,1,0
54421,22583,9822,0,0,deny,62,62,0,1,0,1,0
54422,38723,15503,0,0,deny,146,146,0,1,0,1,0
54423,52869,445,0,0,drop,70,70,0,1,0,1,0
54424,31021,35440,0,0,deny,62,62,0,1,0,1,0
54425,5357,32468,0,0,deny,66,66,0,1,0,1,0
54426,53258,445,0,0,drop,66,66,0,1,0,1,0
54427,53252,445,0,0,drop,66,66,0,1,0,1,0
54428,443,37338,0,0,deny,118,118,0,1,0,1,0
54429,52866,445,0,0,drop,70,70,0,1,0,1,0
54430,8976,44847,0,0,deny,62,62,0,1,0,1,0
54431,50710,50584,0,0,deny,146,146,0,1,0,1,0
54432,57504,44847,0,0,deny,66,66,0,1,0,1,0
54433,25010,30188,0,0,deny,62,62,0,1,0,1,0
54434,61420,64097,0,0,deny,66,66,0,1,0,1,0
54435,9095,22114,0,0,deny,62,62,0,1,0,1,0
54436,54575,11392,0,0,deny,66,66,0,1,0,1,0
54437,11983,57470,0,0,deny,62,62,0,1,0,1,0
54438,49805,6881,0,0,deny,66,66,0,1,0,1,0
54439,44594,64147,0,0,deny,66,66,0,1,0,1,0
54440,49906,443,16050,443,allow,6754,2219,4535,21,77,11,10
54441,49873,80,19431,80,allow,9540,2954,6586,18,88,8,10
54442,49860,80,9156,80,allow,6892,2154,4738,22,89,12,10
54443,49857,80,39166,80,allow,7800,1743,6057,20,89,11,9
54444,56620,443,7502,443,allow,8033,2013,6020,20,16,11,9
54445,49884,443,34007,443,allow,5265,1647,3618,16,88,9,7
54446,49880,80,21728,80,allow,2087,1215,872,8,88,5,3
54447,38643,443,16669,443,allow,2540,1317,1223,17,28,9,8
54448,56622,443,13170,443,allow,8034,2014,6020,20,15,11,9
54449,56887,53,15975,53,allow,170,87,83,3,56,2,1
54450,49876,80,23793,80,allow,24764,4454,20310,30,88,12,18
54451,49887,443,18602,443,allow,977,590,387,10,87,6,4
54452,38645,443,41278,443,allow,2535,1177,1358,16,28,7,9
54453,38647,443,59827,443,allow,2634,1411,1223,18,28,10,8
54454,50693,443,1637,443,allow,306,120,186,6,23,3,3
54455,62423,443,31493,443,allow,28031,7016,21015,51,45,23,28
54456,36445,443,44215,443,allow,234,234,0,4,12,4,0
54457,49905,443,56801,443,allow,4712,908,3804,18,77,9,9
54458,49874,80,9513,80,allow,9921,2945,6976,19,88,8,11
54459,36500,3142,36500,3142,allow,138,78,60,2,6,1,1
54460,2081,7000,2081,7000,allow,5914,4395,1519,19,15,10,9
54461,30188,53,30188,53,allow,238,95,143,2,30,1,1
54462,49895,80,46026,80,allow,2781,1400,1381,11,87,6,5
54463,38644,443,1255,443,allow,2622,1399,1223,18,28,10,8
54464,2080,7000,2080,7000,allow,754151,15395,738756,762,16,239,523
54465,49858,80,51229,80,allow,1539,674,865,11,89,6,5
54466,49854,80,32743,80,allow,14603,5117,9486,24,89,12,12
54467,49845,80,64041,80,allow,31466,852,30614,32,89,9,23
54468,49913,443,65032,443,allow,976,589,387,10,76,6,4
54469,38646,443,44799,443,allow,2335,1247,1088,15,28,8,7
54470,49861,80,57112,80,allow,4892,1157,3735,16,89,8,8
54471,56623,443,54121,443,allow,7982,1962,6020,20,15,11,9
54472,26843,53,26843,53,allow,209,77,132,2,33,1,1
54473,49852,80,47954,80,allow,8868,3774,5094,20,89,10,10
54474,49850,443,7132,443,allow,7371,1564,5807,18,89,9,9
54475,49879,80,2147,80,allow,2087,1215,872,8,88,5,3
54476,55521,53,35090,53,allow,701,88,613,2,30,1,1
54477,49853,80,30133,80,allow,15055,6439,8616,26,89,14,12
54478,58793,443,33855,443,allow,40456,12307,28149,114,140,58,56
54479,49855,80,46269,80,allow,41720,6568,35152,47,89,17,30
54480,49234,53,38404,53,allow,170,87,83,2,30,1,1
54481,36661,53,36661,53,allow,237,93,144,2,30,1,1
54482,56785,28902,1768,28902,allow,70,70,0,2,8,2,0
54483,53063,443,53063,443,allow,6793,3206,3587,25,52,15,10
54484,56997,53,44658,53,allow,168,86,82,2,30,1,1
54485,40030,80,62413,80,allow,1286,403,883,16,393,4,12
54486,6881,35766,64668,35766,allow,221,111,110,2,1200,1,1
54487,64539,53,5433,53,allow,170,87,83,2,31,1,1
54488,49875,80,61335,80,allow,35824,4558,31266,39,88,13,26
54489,51174,443,5740,443,allow,12037,3531,8506,35,271,18,17
54490,49872,80,54932,80,allow,31938,3363,28575,38,88,15,23
54491,49859,80,31286,80,allow,1529,677,852,11,89,6,5
54492,54269,443,49860,443,allow,5768,3426,2342,22,135,11,11
54493,49856,80,12008,80,allow,13992,1645,12347,23,89,10,13
54494,2082,7000,2082,7000,allow,3022,1567,1455,16,15,8,8
54495,49877,80,36716,80,allow,28450,4547,23903,34,88,13,21
54496,55594,42459,54770,42459,allow,1253,716,537,12,23,7,5
54497,57118,80,7804,80,allow,2404,568,1836,10,75,6,4
54498,37090,443,37090,443,allow,4637,1730,2907,19,30,11,8
54499,60398,443,6115,443,allow,8060,1868,6192,28,16,15,13
54500,44558,443,44558,443,allow,5480,2503,2977,20,15,11,9
54501,49878,80,42487,80,allow,2086,1214,872,8,88,5,3
54502,56621,443,45506,443,allow,7981,1961,6020,20,15,11,9
54503,49863,443,52855,443,allow,7280,1441,5839,17,89,9,8
54504,49844,80,65486,80,allow,18950,788,18162,23,89,8,15
54505,44546,53,44546,53,allow,204,92,112,2,30,1,1
54506,63513,53,63513,53,allow,236,94,142,2,30,1,1
54507,51202,53,51202,53,allow,221,89,132,2,30,1,1
54508,34517,80,7727,80,allow,1056,682,374,10,16,6,4
54509,39119,53,39119,53,allow,221,89,132,2,30,1,1
54510,50107,53,50107,53,allow,216,89,127,2,30,1,1
54511,6881,6881,55325,6881,allow,853,355,498,4,1200,2,2
54512,56876,53,55574,53,allow,711,87,624,2,31,1,1
54513,3382,53,3382,53,allow,220,100,120,2,31,1,1
54514,52795,443,61686,443,allow,7203,2188,5015,23,186,11,12
54515,30960,45691,5004,45691,allow,330,330,0,6,3609,6,0
54516,52862,445,0,0,drop,70,70,0,1,0,1,0
54517,57839,445,0,0,drop,70,70,0,1,0,1,0
54518,57837,445,0,0,drop,70,70,0,1,0,1,0
54519,57836,445,0,0,drop,70,70,0,1,0,1,0
54520,52860,445,0,0,drop,70,70,0,1,0,1,0
54521,53239,445,0,0,drop,66,66,0,1,0,1,0
54522,53241,445,0,0,drop,66,66,0,1,0,1,0
54523,53240,445,0,0,drop,66,66,0,1,0,1,0
54524,53244,445,0,0,drop,66,66,0,1,0,1,0
54525,53243,445,0,0,drop,66,66,0,1,0,1,0
54526,53238,445,0,0,drop,66,66,0,1,0,1,0
54527,53237,445,0,0,drop,66,66,0,1,0,1,0
54528,53236,445,0,0,drop,66,66,0,1,0,1,0
54529,52858,445,0,0,drop,70,70,0,1,0,1,0
54530,43333,50584,0,0,deny,146,146,0,1,0,1,0
54531,24144,57470,0,0,deny,62,62,0,1,0,1,0
54532,30114,65151,0,0,deny,60,60,0,1,0,1,0
54533,53987,57470,0,0,deny,66,66,0,1,0,1,0
54534,12614,22,0,0,deny,60,60,0,1,0,1,0
54535,28498,36237,0,0,deny,62,62,0,1,0,1,0
54536,52913,2767,0,0,deny,66,66,0,1,0,1,0
54537,57828,445,0,0,drop,70,70,0,1,0,1,0
54538,57827,445,0,0,drop,70,70,0,1,0,1,0
54539,57825,445,0,0,drop,70,70,0,1,0,1,0
54540,57500,23,0,0,deny,60,60,0,1,0,1,0
54541,52851,445,0,0,drop,70,70,0,1,0,1,0
54542,59879,55783,0,0,deny,62,62,0,1,0,1,0
54543,52849,445,0,0,drop,70,70,0,1,0,1,0
54544,53223,445,0,0,drop,66,66,0,1,0,1,0
54545,53224,445,0,0,drop,66,66,0,1,0,1,0
54546,53221,445,0,0,drop,66,66,0,1,0,1,0
54547,52848,445,0,0,drop,70,70,0,1,0,1,0
54548,20726,2767,0,0,deny,62,62,0,1,0,1,0
54549,52847,445,0,0,drop,70,70,0,1,0,1,0
54550,52846,445,0,0,drop,70,70,0,1,0,1,0
54551,52843,445,0,0,drop,70,70,0,1,0,1,0
54552,52842,445,0,0,drop,70,70,0,1,0,1,0
54553,53419,28189,0,0,deny,60,60,0,1,0,1,0
54554,57816,445,0,0,drop,70,70,0,1,0,1,0
54555,22724,9822,0,0,deny,66,66,0,1,0,1,0
54556,57810,445,0,0,drop,70,70,0,1,0,1,0
54557,57808,445,0,0,drop,70,70,0,1,0,1,0
54558,57804,445,0,0,drop,70,70,0,1,0,1,0
54559,25360,51505,0,0,deny,62,62,0,1,0,1,0
54560,55157,7302,0,0,deny,66,66,0,1,0,1,0
54561,54617,64147,0,0,deny,62,62,0,1,0,1,0
54562,54276,39004,0,0,deny,62,62,0,1,0,1,0
54563,45941,23388,0,0,deny,60,60,0,1,0,1,0
54564,52828,445,0,0,drop,70,70,0,1,0,1,0
54565,52827,445,0,0,drop,70,70,0,1,0,1,0
54566,32215,22114,0,0,deny,62,62,0,1,0,1,0
54567,52817,445,0,0,drop,70,70,0,1,0,1,0
54568,52818,445,0,0,drop,70,70,0,1,0,1,0
54569,62767,57470,0,0,deny,74,74,0,1,0,1,0
54570,59201,51221,0,0,deny,66,66,0,1,0,1,0
54571,52743,15503,0,0,deny,66,66,0,1,0,1,0
54572,1067,51221,0,0,deny,62,62,0,1,0,1,0
54573,16387,26193,0,0,deny,60,60,0,1,0,1,0
54574,1067,51221,0,0,deny,145,145,0,1,0,1,0
54575,16387,35308,0,0,deny,60,60,0,1,0,1,0
54576,60217,80,16783,80,allow,4050,2838,1212,14,16,7,7
54577,50628,80,65125,80,allow,4349,647,3702,16,22,7,9
54578,59754,53,11671,53,allow,260,86,174,2,30,1,1
54579,40180,443,53378,443,allow,1310,649,661,13,184,7,6
54580,53201,28513,16417,28513,allow,862,562,300,13,145,8,5
54581,46332,443,57498,443,allow,3132,1697,1435,17,15,10,7
54582,56813,53,9920,53,allow,516,136,380,4,40,2,2
54583,50692,443,32817,443,allow,180,60,120,4,15,2,2
54584,65080,53,49569,53,allow,193,102,91,2,29,1,1
54585,27005,1305,58083,1305,allow,855,126,729,2,29,1,1
54586,27005,1308,10914,1308,allow,855,126,729,2,29,1,1
54587,49281,53,58920,53,allow,345,110,235,2,29,1,1
54588,50689,443,64099,443,allow,180,60,120,4,15,2,2
54589,27005,1202,29779,1202,allow,865,126,739,2,29,1,1
54590,27005,1103,52058,1103,allow,822,126,696,2,29,1,1
54591,45935,25,35960,25,allow,511,191,320,9,60,4,5
54592,35377,443,51737,443,allow,15771,2037,13734,39,187,20,19
54593,57140,53,58402,53,allow,177,94,83,2,29,1,1
54594,53113,8372,13040,8372,allow,758,320,438,11,17,6,5
54595,58794,443,45135,443,allow,20298,11977,8321,85,139,45,40
54596,34737,443,45602,443,allow,5586,1338,4248,17,109,9,8
54597,49632,53,31125,53,allow,288,94,194,2,30,1,1
54598,27005,1105,65392,1105,allow,855,126,729,2,29,1,1
54599,56795,35465,29402,35465,allow,70,70,0,1,5,1,0
54600,55653,53,52726,53,allow,94,94,0,1,29,1,0
54601,15111,53,15111,53,allow,210,98,112,2,29,1,1
54602,64212,53,41326,53,allow,215,102,113,2,30,1,1
54603,49234,53,14008,53,allow,177,94,83,2,30,1,1
54604,59755,53,7532,53,allow,211,78,133,2,30,1,1
54605,27005,1106,25259,1106,allow,903,126,777,2,29,1,1
54606,49752,53,10768,53,allow,193,102,91,2,29,1,1
54607,38194,53,38194,53,allow,210,98,112,2,29,1,1
54608,51802,443,19479,443,allow,4426,1518,2908,12,120,6,6
54609,49868,443,36753,443,allow,6251,1706,4545,16,88,9,7
54610,49893,80,42792,80,allow,1376,946,430,8,86,5,3
54611,65384,53,46519,53,allow,197,102,95,2,33,1,1
54612,53666,80,3658,80,allow,3741,3008,733,16,15,10,6
54613,65378,53,49018,53,allow,212,102,110,2,30,1,1
54614,56972,53,28054,53,allow,177,94,83,2,30,1,1
54615,51004,53,15547,53,allow,194,94,100,2,30,1,1
54616,65135,53,23354,53,allow,312,102,210,2,30,1,1
54617,49900,443,38776,443,allow,8417,1173,7244,18,86,9,9
54618,57371,443,2707,443,allow,5619,927,4692,17,15,10,7
54619,36225,443,18751,443,allow,638,350,288,10,26,6,4
54620,56616,80,15252,80,allow,234,234,0,4,12,4,0
54621,36327,80,6199,80,allow,1348,844,504,13,255,8,5
54622,49886,443,58788,443,allow,77867,2411,75456,82,87,27,55
54623,55022,443,12848,443,allow,14634,1801,12833,28,46,14,14
54624,49888,443,29885,443,allow,117085,3435,113650,123,87,43,80
54625,60196,80,43098,80,allow,70,70,0,2,8,2,0
54626,50823,443,51509,443,allow,6601,1120,5481,17,115,9,8
54627,49898,80,5457,80,allow,1550,1157,393,8,86,5,3
54628,51503,443,42971,443,allow,9239,4472,4767,37,39,21,16
54629,65452,53,31972,53,allow,365,102,263,2,30,1,1
54630,43817,443,47281,443,allow,5911,1666,4245,27,18,15,12
54631,51788,35787,52462,35787,allow,70,70,0,2,8,2,0
54632,56972,53,24503,53,allow,177,94,83,2,30,1,1
54633,21859,53,21859,53,allow,242,98,144,2,30,1,1
54634,57272,53,3406,53,allow,373,107,266,4,45,2,2
54635,34670,53,34670,53,allow,257,106,151,2,30,1,1
54636,56997,53,62280,53,allow,86,86,0,1,30,1,0
54637,50568,443,63503,443,allow,15702,3473,12229,50,70,23,27
54638,54167,53,54167,53,allow,242,98,144,2,30,1,1
54639,49891,53,6545,53,allow,375,126,249,2,30,1,1
54640,44242,5228,42163,5228,allow,10823,1636,9187,32,591,11,21
54641,49882,443,5946,443,allow,5019,1424,3595,15,87,9,6
54642,51769,19165,52583,19165,allow,70,70,0,1,5,1,0
54643,56613,443,6770,443,allow,6016,1284,4732,18,984,8,10
54644,53665,80,59537,80,allow,4417,3685,732,16,15,10,6
54645,55072,53,38583,53,allow,86,86,0,1,30,1,0
54646,49757,53,9163,53,allow,177,94,83,2,30,1,1
54647,49234,53,56023,53,allow,177,94,83,2,30,1,1
54648,49647,53,18676,53,allow,361,102,259,2,30,1,1
54649,48817,14888,48817,14888,allow,481,150,331,2,1200,1,1
54650,56796,41431,54757,41431,allow,70,70,0,1,5,1,0
54651,62424,443,60409,443,allow,4650,3116,1534,19,44,10,9
54652,49349,80,23734,80,allow,185645,6753,178892,213,81,89,124
54653,53437,6057,38097,6057,allow,245,245,0,2,30,2,0
54654,56227,53,50602,53,allow,278,102,176,2,30,1,1
54655,40182,443,24953,443,allow,1312,651,661,13,184,7,6
54656,58724,443,33462,443,allow,10179,4285,5894,60,272,31,29
54657,56887,53,8046,53,allow,250,87,163,4,57,2,2
54658,49211,53,35833,53,allow,484,100,384,4,56,2,2
54659,39980,443,30240,443,allow,2674,1386,1288,17,120,8,9
54660,57425,443,33540,443,allow,130,70,60,2,15,1,1
54661,53598,40326,41639,40326,allow,70,70,0,2,7,2,0
54662,55601,44049,44869,44049,allow,504,318,186,8,15,5,3
54663,64448,53,46885,53,allow,353,92,261,4,38,2,2
54664,41193,443,45935,443,allow,6035,782,5253,16,109,8,8
54665,43785,443,28083,443,allow,6017,1285,4732,18,984,8,10
54666,52881,443,3297,443,allow,130,70,60,2,15,1,1
54667,37145,443,8419,443,allow,4578,2334,2244,21,16,12,9
54668,55604,44235,60786,44235,allow,504,318,186,8,15,5,3
54669,51858,443,51858,443,allow,12505,3792,8713,48,255,24,24
54670,37990,49152,47344,49152,allow,156,156,0,3,7,3,0
54671,51236,443,52300,443,allow,7950,2502,5448,38,15,22,16
54672,60394,80,52231,80,allow,2047,701,1346,16,26,5,11
54673,55847,443,25138,443,allow,8443,1430,7013,17,141,8,9
54674,55462,53,36387,53,allow,579,88,491,4,35,2,2
54675,56782,49135,53247,49135,allow,70,70,0,1,5,1,0
54676,62422,443,30175,443,allow,16258,11067,5191,37,45,21,16
54677,49846,80,53092,80,allow,2644,1918,726,11,89,7,4
54678,49881,80,7229,80,allow,1965,1450,515,7,87,5,2
54679,49901,443,33276,443,allow,5583,1567,4016,16,85,9,7
54680,47694,443,24366,443,allow,23751,3197,20554,42,170,19,23
54681,49889,80,51133,80,allow,1376,946,430,8,87,5,3
54682,27005,1306,35061,1306,allow,858,126,732,2,29,1,1
54683,49650,53,14821,53,allow,821,102,719,2,29,1,1
54684,45159,443,45159,443,allow,5329,2082,3247,22,40,13,9
54685,55786,53,63117,53,allow,177,94,83,2,29,1,1
54686,27005,1104,28939,1104,allow,870,126,744,2,29,1,1
54687,65080,53,41733,53,allow,193,102,91,2,29,1,1
54688,49842,80,44778,80,allow,70094,1629,68465,63,89,16,47
54689,64374,53,64374,53,allow,240,98,142,2,30,1,1
54690,64204,53,27061,53,allow,264,102,162,2,31,1,1
54691,34910,443,46197,443,allow,16227,7159,9068,40,524,21,19
54692,58936,80,60272,80,allow,10003,5095,4908,21,76,12,9
54693,52097,443,1702,443,allow,11181,7329,3852,39,53,20,19
54694,54262,53,54262,53,allow,216,82,134,2,33,1,1
54695,49864,80,42240,80,allow,5205,1474,3731,9,88,5,4
54696,63997,53,40711,53,allow,676,192,484,6,84,3,3
54697,40340,53,40340,53,allow,217,90,127,2,30,1,1
54698,56887,53,51812,53,allow,177,94,83,2,30,1,1
54699,34616,53,34616,53,allow,197,90,107,2,30,1,1
54700,55072,53,58133,53,allow,168,86,82,2,30,1,1
54701,51789,40800,21058,40800,allow,70,70,0,2,8,2,0
54702,35945,8080,16769,8080,allow,170,110,60,2,5,1,1
54703,51687,80,38806,80,allow,1517,481,1036,11,15,6,5
54704,55602,22005,13936,22005,allow,504,318,186,8,15,5,3
54705,49847,80,28928,80,allow,4135,2587,1548,10,89,7,3
54706,49849,80,56031,80,allow,9581,2352,7229,14,89,7,7
54707,65195,53,58646,53,allow,249,94,155,2,30,1,1
54708,64944,443,63703,443,allow,48856,4158,44698,65,120,26,39
54709,53667,80,16085,80,allow,5090,4357,733,17,15,11,6
54710,34597,80,9526,80,allow,1540,553,987,10,15,6,4
54711,51787,35661,32624,35661,allow,70,70,0,2,8,2,0
54712,56794,1,30345,1,allow,70,70,0,1,5,1,0
54713,49891,80,47196,80,allow,1376,946,430,8,86,5,3
54714,35371,443,55003,443,allow,304294,8535,295759,302,132,90,212
54715,49907,53,31143,53,allow,363,98,265,4,54,2,2
54716,56880,53,14600,53,allow,216,102,114,2,30,1,1
54717,49626,53,57027,53,allow,226,110,116,2,30,1,1
54718,53325,443,60728,443,allow,6988,1214,5774,29,315,13,16
54719,65489,53,22228,53,allow,242,102,140,2,30,1,1
54720,45852,53,58364,53,allow,164,78,86,2,30,1,1
54721,64539,53,12093,53,allow,177,94,83,2,30,1,1
54722,55232,53,4973,53,allow,177,94,83,2,30,1,1
54723,46904,443,22687,443,allow,1314,653,661,13,184,7,6
54724,57470,1337,11046,1337,allow,132,132,0,3,1199,3,0
54725,57470,51413,20990,51413,allow,132,132,0,3,1199,3,0
54726,46902,443,9815,443,allow,1312,651,661,13,184,7,6
54727,57470,32554,26489,32554,allow,726,726,0,12,1199,12,0
54728,55877,51413,55340,51413,allow,460,150,310,2,1200,1,1
54729,51221,20864,10145,20864,allow,7308,6812,496,71,3243,63,8
54730,49892,443,33274,443,allow,5737,1602,4135,23,86,13,10
54731,49862,443,6856,443,allow,17924,7867,10057,45,88,24,21
54732,57447,443,54490,443,allow,12192,3788,8404,36,18,18,18
54733,59890,443,21509,443,allow,9801,2337,7464,25,47,13,12
54734,54420,443,57977,443,allow,5809,1552,4257,19,74,11,8
54735,52277,443,12555,443,allow,13832,4868,8964,91,364,37,54
54736,64569,443,62686,443,allow,9157,2109,7048,27,32,15,12
54737,49907,443,5295,443,allow,6754,2219,4535,21,76,11,10
54738,49894,443,43523,443,allow,5597,1462,4135,21,86,11,10
54739,59888,443,25489,443,allow,4350,2061,2289,18,47,10,8
54740,52140,80,9768,80,allow,3476,1433,2043,26,418,14,12
54741,49901,53,27916,53,allow,349,108,241,4,35,2,2
54742,41024,443,41024,443,allow,4639,1732,2907,19,30,11,8
54743,40729,123,44305,123,allow,184,94,90,2,30,1,1
54744,59023,64097,0,0,deny,62,62,0,1,0,1,0
54745,16387,56995,0,0,deny,60,60,0,1,0,1,0
54746,22683,39210,0,0,deny,60,60,0,1,0,1,0
54747,50031,44847,0,0,deny,74,74,0,1,0,1,0
54748,53053,64147,0,0,deny,62,62,0,1,0,1,0
54749,50562,37965,0,0,deny,66,66,0,1,0,1,0
54750,21173,37965,0,0,deny,62,62,0,1,0,1,0
54751,57797,445,0,0,drop,70,70,0,1,0,1,0
54752,57798,445,0,0,drop,70,70,0,1,0,1,0
54753,57794,445,0,0,drop,70,70,0,1,0,1,0
54754,52806,445,0,0,drop,70,70,0,1,0,1,0
54755,20083,6881,0,0,deny,62,62,0,1,0,1,0
54756,8191,51221,0,0,deny,62,62,0,1,0,1,0
54757,43584,24748,0,0,deny,156,156,0,1,0,1,0
54758,7285,51221,0,0,deny,66,66,0,1,0,1,0
54759,64279,23718,0,0,deny,62,62,0,1,0,1,0
54760,14260,36829,0,0,deny,62,62,0,1,0,1,0
54761,26480,64147,0,0,deny,62,62,0,1,0,1,0
54762,53201,445,0,0,drop,66,66,0,1,0,1,0
54763,57791,445,0,0,drop,70,70,0,1,0,1,0
54764,57788,445,0,0,drop,70,70,0,1,0,1,0
54765,52802,445,0,0,drop,70,70,0,1,0,1,0
54766,52793,445,0,0,drop,70,70,0,1,0,1,0
54767,52792,445,0,0,drop,70,70,0,1,0,1,0
54768,53815,443,57260,443,allow,499,425,74,4,0,3,1
54769,53799,443,27170,443,allow,499,425,74,4,0,3,1
54770,53814,443,6695,443,allow,499,425,74,4,0,3,1
54771,61804,51505,0,0,deny,66,66,0,1,0,1,0
54772,32395,30188,0,0,deny,62,62,0,1,0,1,0
54773,52790,445,0,0,drop,70,70,0,1,0,1,0
54774,52789,445,0,0,drop,70,70,0,1,0,1,0
54775,64175,56502,0,0,deny,66,66,0,1,0,1,0
54776,53196,445,0,0,drop,66,66,0,1,0,1,0
54777,52785,445,0,0,drop,70,70,0,1,0,1,0
54778,54991,36829,0,0,deny,66,66,0,1,0,1,0
54779,32185,47807,0,0,deny,159,159,0,1,0,1,0
54780,53192,445,0,0,drop,66,66,0,1,0,1,0
54781,57776,445,0,0,drop,70,70,0,1,0,1,0
54782,25015,64147,0,0,deny,66,66,0,1,0,1,0
54783,28668,8696,0,0,deny,60,60,0,1,0,1,0
54784,57774,445,0,0,drop,70,70,0,1,0,1,0
54785,57772,445,0,0,drop,70,70,0,1,0,1,0
54786,57767,445,0,0,drop,70,70,0,1,0,1,0
54787,53189,445,0,0,drop,66,66,0,1,0,1,0
54788,52779,445,0,0,drop,70,70,0,1,0,1,0
54789,45410,1,0,0,deny,62,62,0,1,0,1,0
54790,50321,40284,0,0,deny,348,348,0,1,0,1,0
54791,57763,445,0,0,drop,70,70,0,1,0,1,0
54792,34822,31573,0,0,deny,62,62,0,1,0,1,0
54793,57761,445,0,0,drop,70,70,0,1,0,1,0
54794,57758,445,0,0,drop,70,70,0,1,0,1,0
54795,57757,445,0,0,drop,70,70,0,1,0,1,0
54796,53183,445,0,0,drop,66,66,0,1,0,1,0
54797,26082,26296,0,0,deny,159,159,0,1,0,1,0
54798,27446,30188,0,0,deny,66,66,0,1,0,1,0
54799,53176,445,0,0,drop,66,66,0,1,0,1,0
54800,53179,445,0,0,drop,66,66,0,1,0,1,0
54801,53175,445,0,0,drop,66,66,0,1,0,1,0
54802,40547,24051,0,0,deny,74,74,0,1,0,1,0
54803,52772,445,0,0,drop,70,70,0,1,0,1,0
54804,53173,445,0,0,drop,66,66,0,1,0,1,0
54805,53172,445,0,0,drop,66,66,0,1,0,1,0
54806,53171,445,0,0,drop,66,66,0,1,0,1,0
54807,52769,445,0,0,drop,70,70,0,1,0,1,0
54808,58326,50584,0,0,deny,62,62,0,1,0,1,0
54809,53779,37965,0,0,deny,66,66,0,1,0,1,0
54810,56946,1,0,0,deny,66,66,0,1,0,1,0
54811,18357,51180,0,0,deny,62,62,0,1,0,1,0
54812,57755,445,0,0,drop,70,70,0,1,0,1,0
54813,57753,445,0,0,drop,70,70,0,1,0,1,0
54814,57752,445,0,0,drop,70,70,0,1,0,1,0
54815,52765,445,0,0,drop,70,70,0,1,0,1,0
54816,53169,445,0,0,drop,66,66,0,1,0,1,0
54817,52764,445,0,0,drop,70,70,0,1,0,1,0
54818,57748,445,0,0,drop,70,70,0,1,0,1,0
54819,53807,443,54173,443,allow,499,425,74,4,0,3,1
54820,53796,443,58960,443,allow,499,425,74,4,0,3,1
54821,53804,443,53478,443,allow,499,425,74,4,0,3,1
54822,53802,443,44070,443,allow,499,425,74,4,0,3,1
54823,53812,443,19260,443,allow,499,425,74,4,0,3,1
54824,53805,443,64828,443,allow,499,425,74,4,0,3,1
54825,53801,443,63448,443,allow,499,425,74,4,0,3,1
54826,53810,443,43179,443,allow,499,425,74,4,0,3,1
54827,53813,443,59809,443,allow,499,425,74,4,0,3,1
54828,53806,443,13248,443,allow,499,425,74,4,0,3,1
54829,53809,443,5069,443,allow,499,425,74,4,0,3,1
54830,53798,443,32162,443,allow,499,425,74,4,0,3,1
54831,53811,443,28685,443,allow,499,425,74,4,0,3,1
54832,53800,443,21628,443,allow,499,425,74,4,0,3,1
54833,53797,443,48154,443,allow,499,425,74,4,0,3,1
54834,53808,443,30751,443,allow,499,425,74,4,0,3,1
54835,53795,443,29582,443,allow,499,425,74,4,0,3,1
54836,53791,443,9232,443,allow,499,425,74,4,0,3,1
54837,53803,443,59546,443,allow,499,425,74,4,0,3,1
54838,53794,443,48669,443,allow,499,425,74,4,0,3,1
54839,53793,443,25367,443,allow,499,425,74,4,0,3,1
54840,53790,443,36167,443,allow,499,425,74,4,0,3,1
54841,53789,443,10563,443,allow,499,425,74,4,0,3,1
54842,53792,443,8707,443,allow,499,425,74,4,0,3,1
54843,0,0,0,0,deny,70,70,0,1,0,1,0
54844,53164,445,0,0,drop,66,66,0,1,0,1,0
54845,46093,32661,0,0,deny,74,74,0,1,0,1,0
54846,64324,37807,0,0,deny,62,62,0,1,0,1,0
54847,65153,38303,0,0,deny,66,66,0,1,0,1,0
54848,53163,445,0,0,drop,66,66,0,1,0,1,0
54849,53161,445,0,0,drop,66,66,0,1,0,1,0
54850,53159,445,0,0,drop,66,66,0,1,0,1,0
54851,48676,53395,0,0,deny,60,60,0,1,0,1,0
54852,52760,445,0,0,drop,70,70,0,1,0,1,0
54853,64889,26467,0,0,deny,66,66,0,1,0,1,0
54854,1660,8696,0,0,deny,62,62,0,1,0,1,0
54855,60550,50584,0,0,deny,62,62,0,1,0,1,0
54856,52758,445,0,0,drop,70,70,0,1,0,1,0
54857,1040,6004,0,0,deny,72,72,0,1,0,1,0
54858,57741,445,0,0,drop,70,70,0,1,0,1,0
54859,443,9986,0,0,deny,297,297,0,1,0,1,0
54860,12605,57470,0,0,deny,62,62,0,1,0,1,0
54861,65501,26467,0,0,deny,66,66,0,1,0,1,0
54862,57734,445,0,0,drop,70,70,0,1,0,1,0
54863,57732,445,0,0,drop,70,70,0,1,0,1,0
54864,59136,50584,0,0,deny,66,66,0,1,0,1,0
54865,60875,50584,0,0,deny,66,66,0,1,0,1,0
54866,52754,445,0,0,drop,70,70,0,1,0,1,0
54867,53151,445,0,0,drop,66,66,0,1,0,1,0
54868,61736,50584,0,0,deny,66,66,0,1,0,1,0
54869,443,5920,0,0,deny,66,66,0,1,0,1,0
54870,42034,28189,0,0,deny,62,62,0,1,0,1,0
54871,12471,48817,0,0,deny,62,62,0,1,0,1,0
54872,45964,2225,0,0,deny,60,60,0,1,0,1,0
54873,53141,445,0,0,drop,66,66,0,1,0,1,0
54874,57720,445,0,0,drop,70,70,0,1,0,1,0
54875,51582,48817,0,0,deny,66,66,0,1,0,1,0
54876,46495,4607,0,0,deny,60,60,0,1,0,1,0
54877,26528,51221,0,0,deny,78,78,0,1,0,1,0
54878,48980,15000,3233,15000,allow,130,70,60,2,5,1,1
54879,56618,443,57435,443,allow,8034,2014,6020,20,15,11,9
54880,64568,443,63585,443,allow,25404,2462,22942,47,32,25,22
54881,55232,53,45264,53,allow,170,87,83,2,30,1,1
54882,59880,443,7834,443,allow,16776,7513,9263,42,47,24,18
54883,27350,80,31798,80,allow,3943,1809,2134,21,82,11,10
54884,43112,443,7009,443,allow,3197,1931,1266,19,15,9,10
54885,56619,443,13830,443,allow,7982,1962,6020,20,15,11,9
54886,26457,80,26457,80,allow,17147,1829,15318,28,17,15,13
54887,50122,443,28442,443,allow,130,70,60,2,15,1,1
54888,43111,443,29874,443,allow,3117,1867,1250,19,15,9,10
54889,51768,61765,15043,61765,allow,66,66,0,1,5,1,0
54890,45587,443,45587,443,allow,5523,2276,3247,22,28,13,9
54891,44695,53,44695,53,allow,198,89,109,2,30,1,1
54892,64979,53,23009,53,allow,188,96,92,2,31,1,1
54893,55917,53,56529,53,allow,170,87,83,2,31,1,1
54894,59343,53,0,0,allow,627,72,555,2,30,1,1
54895,51862,22,51862,22,allow,7902,3301,4601,56,40,26,30
54896,52205,5222,24221,5222,allow,684,280,404,11,26,5,6
54897,52375,80,50220,80,allow,234,234,0,4,12,4,0
54898,43601,443,18392,443,allow,10274,3806,6468,26,413,14,12
54899,50239,443,44236,443,allow,9418,2681,6737,39,256,18,21
54900,38329,80,52994,80,allow,350,210,140,6,16,4,2
54901,37271,443,4038,443,allow,51402,5964,45438,86,153,32,54
54902,56295,443,26147,443,allow,8550,1880,6670,22,376,12,10
54903,56617,443,25954,443,allow,7981,1961,6020,20,16,11,9
54904,37536,80,9440,80,allow,3565,1020,2545,16,15,9,7
54905,58454,443,58454,443,allow,4593,1616,2977,19,76,10,9
54906,59270,53,59270,53,allow,825,99,726,2,30,1,1
54907,56813,53,39428,53,allow,711,87,624,2,30,1,1
54908,8888,53,8888,53,allow,214,97,117,2,30,1,1
54909,55106,53,55106,53,allow,200,90,110,2,30,1,1
54910,53035,5228,40515,5228,allow,2725,1610,1115,20,3600,10,10
54911,56366,53,46809,53,allow,754,94,660,2,31,1,1
54912,53713,443,37609,443,allow,4931,957,3974,17,15,10,7
54913,59487,80,24242,80,allow,350,210,140,6,26,4,2
54914,53714,443,10907,443,allow,4933,957,3976,17,15,10,7
54915,57312,53,57312,53,allow,208,94,114,2,30,1,1
54916,49591,53,51142,53,allow,168,86,82,2,30,1,1
54917,3424,53,3424,53,allow,216,88,128,2,30,1,1
54918,2079,7000,2079,7000,allow,3102,1551,1551,16,16,8,8
54919,56775,53,34626,53,allow,763,101,662,2,30,1,1
54920,50328,53,20316,53,allow,783,96,687,2,30,1,1
54921,56268,53,11800,53,allow,711,87,624,2,31,1,1
54922,49353,53,30816,53,allow,738,86,652,2,31,1,1
54923,30960,45690,12118,45690,allow,330,330,0,6,3609,6,0
54924,49597,53,33201,53,allow,168,86,82,2,31,1,1
54925,55836,53,32275,53,allow,178,91,87,2,31,1,1
54926,65366,53,60695,53,allow,198,101,97,2,31,1,1
54927,55040,53,40859,53,allow,762,98,664,2,31,1,1
54928,56620,53,33976,53,allow,216,110,106,2,31,1,1
54929,49883,53,18157,53,allow,170,87,83,2,30,1,1
54930,55011,53,15618,53,allow,760,96,664,2,31,1,1
54931,56373,53,29361,53,allow,200,102,98,2,31,1,1
54932,65153,53,43651,53,allow,168,86,82,2,31,1,1
54933,65177,53,32886,53,allow,256,93,163,2,31,1,1
54934,30960,45689,37422,45689,allow,330,330,0,6,3609,6,0
54935,56091,53,32743,53,allow,738,86,652,2,31,1,1
54936,50475,53,26369,53,allow,772,100,672,2,31,1,1
54937,55698,53,13157,53,allow,742,88,654,2,31,1,1
54938,55656,53,48878,53,allow,212,108,104,2,31,1,1
54939,57397,53,42342,53,allow,256,93,163,2,31,1,1
54940,64980,53,5647,53,allow,200,102,98,2,31,1,1
54941,61041,443,15332,443,allow,77650,64697,12953,148,902,81,67
54942,10115,52700,0,0,deny,62,62,0,1,0,1,0
54943,8933,56205,0,0,deny,62,62,0,1,0,1,0
54944,60294,30188,0,0,deny,66,66,0,1,0,1,0
54945,52459,5555,0,0,deny,60,60,0,1,0,1,0
54946,53139,445,0,0,drop,66,66,0,1,0,1,0
54947,52741,445,0,0,drop,70,70,0,1,0,1,0
54948,59481,41182,0,0,deny,66,66,0,1,0,1,0
54949,1027,11392,0,0,deny,62,62,0,1,0,1,0
54950,59784,42246,0,0,deny,62,62,0,1,0,1,0
54951,58074,11392,0,0,deny,66,66,0,1,0,1,0
54952,51685,57470,0,0,deny,62,62,0,1,0,1,0
54953,52356,55442,0,0,deny,66,66,0,1,0,1,0
54954,64841,53,24677,53,allow,165,86,79,2,30,1,1
54955,55386,53,14835,53,allow,199,102,97,2,30,1,1
54956,49890,443,15513,443,allow,5597,1462,4135,21,86,11,10
54957,52738,445,0,0,drop,70,70,0,1,0,1,0
54958,53132,445,0,0,drop,66,66,0,1,0,1,0
54959,9246,35440,0,0,deny,66,66,0,1,0,1,0
54960,443,20982,0,0,deny,97,97,0,1,0,1,0
54961,53123,445,0,0,drop,66,66,0,1,0,1,0
54962,62859,35440,0,0,deny,66,66,0,1,0,1,0
54963,53371,26467,0,0,deny,66,66,0,1,0,1,0
54964,14715,56205,0,0,deny,62,62,0,1,0,1,0
54965,30496,57470,0,0,deny,62,62,0,1,0,1,0
54966,59235,52700,0,0,deny,145,145,0,1,0,1,0
54967,52734,445,0,0,drop,70,70,0,1,0,1,0
54968,52732,445,0,0,drop,70,70,0,1,0,1,0
54969,44258,25,0,0,deny,74,74,0,1,0,1,0
54970,64756,11392,0,0,deny,62,62,0,1,0,1,0
54971,57711,445,0,0,drop,70,70,0,1,0,1,0
54972,57708,445,0,0,drop,70,70,0,1,0,1,0
54973,57709,445,0,0,drop,70,70,0,1,0,1,0
54974,52728,445,0,0,drop,70,70,0,1,0,1,0
54975,53113,445,0,0,drop,66,66,0,1,0,1,0
54976,53114,445,0,0,drop,66,66,0,1,0,1,0
54977,53108,445,0,0,drop,66,66,0,1,0,1,0
54978,53115,445,0,0,drop,66,66,0,1,0,1,0
54979,53112,445,0,0,drop,66,66,0,1,0,1,0
54980,53110,445,0,0,drop,66,66,0,1,0,1,0
54981,53111,445,0,0,drop,66,66,0,1,0,1,0
54982,53109,445,0,0,drop,66,66,0,1,0,1,0
54983,17009,53733,0,0,deny,66,66,0,1,0,1,0
54984,14459,11848,0,0,reset-both,148,148,0,1,0,1,0
54985,11464,37965,0,0,deny,62,62,0,1,0,1,0
54986,443,28417,0,0,deny,82,82,0,1,0,1,0
54987,26332,57470,0,0,deny,62,62,0,1,0,1,0
54988,52721,445,0,0,drop,70,70,0,1,0,1,0
54989,64940,36237,0,0,deny,62,62,0,1,0,1,0
54990,57706,445,0,0,drop,70,70,0,1,0,1,0
54991,57701,445,0,0,drop,70,70,0,1,0,1,0
54992,57694,445,0,0,drop,70,70,0,1,0,1,0
54993,52719,445,0,0,drop,70,70,0,1,0,1,0
54994,22587,30188,0,0,deny,66,66,0,1,0,1,0
54995,38645,51221,0,0,deny,62,62,0,1,0,1,0
54996,2923,57470,0,0,deny,66,66,0,1,0,1,0
54997,53096,445,0,0,drop,66,66,0,1,0,1,0
54998,53094,445,0,0,drop,66,66,0,1,0,1,0
54999,53093,445,0,0,drop,66,66,0,1,0,1,0
55000,1227,56205,0,0,deny,66,66,0,1,0,1,0
55001,6712,44818,0,0,deny,66,66,0,1,0,1,0
55002,3564,57470,0,0,deny,62,62,0,1,0,1,0
55003,52718,445,0,0,drop,70,70,0,1,0,1,0
55004,20057,44847,0,0,deny,62,62,0,1,0,1,0
55005,39824,51505,0,0,deny,62,62,0,1,0,1,0
55006,52717,445,0,0,drop,70,70,0,1,0,1,0
55007,52716,445,0,0,drop,70,70,0,1,0,1,0
55008,57691,445,0,0,drop,70,70,0,1,0,1,0
55009,4127,26467,0,0,deny,66,66,0,1,0,1,0
55010,52714,445,0,0,drop,70,70,0,1,0,1,0
55011,49865,443,1213,443,allow,8535,1936,6599,22,87,12,10
55012,49848,443,28970,443,allow,33314,1722,31592,40,88,14,26
55013,49885,443,26423,443,allow,10216,2749,7467,27,86,14,13
55014,64539,53,18826,53,allow,177,94,83,2,29,1,1
55015,49851,80,9497,80,allow,11936,2198,9738,22,88,9,13
55016,53592,23578,40087,23578,allow,70,70,0,2,7,2,0
55017,52118,80,62172,80,allow,3158,1309,1849,28,418,15,13
55018,52126,80,5898,80,allow,3592,2098,1494,26,417,14,12
55019,48220,443,48220,443,allow,4627,1720,2907,18,26,10,8
55020,53664,80,23809,80,allow,3741,3008,733,16,15,10,6
55021,49909,443,16969,443,allow,6754,2219,4535,21,75,11,10
55022,49866,443,6704,443,allow,7128,865,6263,19,87,9,10
55023,49908,443,25535,443,allow,4712,908,3804,18,75,9,9
55024,64380,53,30464,53,allow,196,102,94,2,32,1,1
55025,49342,443,54046,443,allow,10075,6346,3729,48,84,25,23
55026,53604,1046,44060,1046,allow,320,140,180,6,5,3,3
55027,51651,53,58120,53,allow,237,86,151,2,29,1,1
55028,3195,53,3195,53,allow,197,90,107,2,29,1,1
55029,64586,53,31352,53,allow,257,102,155,2,30,1,1
55030,55383,53,13927,53,allow,177,94,83,2,30,1,1
55031,64716,53,5161,53,allow,718,94,624,2,30,1,1
55032,55232,53,8300,53,allow,177,94,83,2,30,1,1
55033,65492,53,43623,53,allow,199,102,97,2,30,1,1
55034,51786,37832,38503,37832,allow,70,70,0,2,8,2,0
55035,51986,80,3605,80,allow,1274,694,580,13,16,6,7
55036,43475,443,10490,443,allow,5578,1646,3932,23,16,13,10
55037,55386,53,64239,53,allow,822,102,720,2,30,1,1
55038,56828,53,33245,53,allow,211,102,109,2,30,1,1
55039,53490,5228,31385,5228,allow,7188,2098,5090,38,113,22,16
55040,46746,443,17806,443,allow,9506,4029,5477,30,330,17,13
55041,35197,443,30510,443,allow,12481,2743,9738,53,20,26,27
55042,50375,80,22563,80,allow,350,210,140,6,15,4,2
55043,51403,443,43951,443,allow,334,70,264,5,17,1,4
55044,49603,53,64849,53,allow,733,94,639,2,30,1,1
55045,59883,443,34270,443,allow,8031,2957,5074,27,46,16,11
55046,65294,53,43260,53,allow,173,94,79,2,30,1,1
55047,65236,53,21854,53,allow,177,94,83,2,30,1,1
55048,65507,53,17701,53,allow,211,102,109,2,30,1,1
55049,65294,53,10566,53,allow,165,86,79,2,30,1,1
55050,65236,53,45022,53,allow,177,94,83,2,30,1,1
55051,51580,80,9107,80,allow,1752,786,966,16,17,9,7
55052,49432,53,25699,53,allow,309,94,215,4,32,2,2
55053,64791,443,54264,443,allow,8580,5765,2815,46,82,22,24
55054,58904,123,61821,123,allow,184,94,90,2,30,1,1
55055,50864,53,14255,53,allow,199,94,105,2,30,1,1
55056,65309,53,31055,53,allow,764,102,662,2,30,1,1
55057,55005,53,64586,53,allow,211,102,109,2,30,1,1
55058,62490,443,60258,443,allow,7206,4320,2886,16,120,8,8
55059,53118,56839,5832,56839,allow,70,70,0,2,8,2,0
55060,49206,80,5739,80,allow,57497,913,56584,52,75,11,41
55061,64967,53,21374,53,allow,389,134,255,2,30,1,1
55062,65492,53,44506,53,allow,822,102,720,2,30,1,1
55063,64113,53,6414,53,allow,216,102,114,2,30,1,1
55064,51832,443,21428,443,allow,2831,740,2091,11,120,5,6
55065,56887,53,53946,53,allow,250,87,163,4,60,2,2
55066,59889,443,40054,443,allow,8305,2325,5980,24,46,13,11
55067,59891,443,64677,443,allow,7718,1947,5771,25,46,14,11
55068,55616,42929,18894,42929,allow,70,70,0,2,8,2,0
55069,55719,8060,46962,8060,allow,70,70,0,1,4,1,0
55070,63782,6969,33183,6969,allow,66,66,0,2,8,2,0
55071,51785,33253,14709,33253,allow,70,70,0,2,8,2,0
55072,53114,32975,63232,32975,allow,70,70,0,1,5,1,0
55073,51792,22318,43615,22318,allow,316,136,180,6,5,3,3
55074,53596,56732,58606,56732,allow,70,70,0,2,7,2,0
55075,55232,53,12562,53,allow,177,94,83,2,29,1,1
55076,60378,11385,17333,11385,allow,1218,774,444,17,26,10,7
55077,52122,80,30528,80,allow,4137,1236,2901,27,418,14,13
55078,49591,53,21458,53,allow,86,86,0,1,29,1,0
55079,49910,443,39120,443,allow,4712,908,3804,18,75,9,9
55080,49869,80,37142,80,allow,2125,1041,1084,11,87,6,5
55081,60403,60092,47131,60092,allow,70,70,0,2,8,2,0
55082,40604,443,31639,443,allow,130,70,60,3,5,2,1
55083,54583,443,25809,443,allow,11307,7633,3674,25,163,18,7
55084,38968,80,48567,80,allow,1280,586,694,10,15,5,5
55085,36535,443,10367,443,allow,416,210,206,7,27,4,3
55086,40511,80,1880,80,allow,1680,950,730,12,15,6,6
55087,46529,80,23858,80,allow,1119,388,731,9,223,5,4
55088,33237,443,28944,443,allow,31065,6730,24335,68,18,37,31
55089,63742,443,58789,443,allow,7444,1915,5529,28,16,16,12
55090,55383,53,49153,53,allow,177,94,83,2,29,1,1
55091,57351,53,48992,53,allow,177,94,83,2,30,1,1
55092,64642,53,40634,53,allow,265,94,171,2,30,1,1
55093,55917,53,40255,53,allow,177,94,83,2,30,1,1
55094,49883,53,14693,53,allow,177,94,83,2,30,1,1
55095,33388,53,33388,53,allow,229,98,131,2,30,1,1
55096,63617,53,24659,53,allow,299,102,197,2,30,1,1
55097,43018,443,63361,443,allow,4664,962,3702,15,120,7,8
55098,65220,53,42472,53,allow,245,94,151,2,30,1,1
55099,59534,53,0,0,allow,627,72,555,2,30,1,1
55100,65396,53,32966,53,allow,178,94,84,2,30,1,1
55101,46730,443,28358,443,allow,7648,1671,5977,25,31,13,12
55102,55917,53,22277,53,allow,177,94,83,2,30,1,1
55103,49597,53,40368,53,allow,86,86,0,1,30,1,0
55104,57351,53,50583,53,allow,177,94,83,2,30,1,1
55105,49890,53,63142,53,allow,767,102,665,2,30,1,1
55106,57152,53,41610,53,allow,733,94,639,2,30,1,1
55107,49591,53,36017,53,allow,168,86,82,2,31,1,1
55108,41816,443,14209,443,allow,88503,3914,84589,114,80,44,70
55109,57589,443,3632,443,allow,2614,1689,925,18,23,10,8
55110,56229,53,12969,53,allow,165,86,79,2,30,1,1
55111,63766,80,33525,80,allow,314,192,122,6,15,4,2
55112,51767,59158,56330,59158,allow,70,70,0,1,5,1,0
55113,26386,53,26386,53,allow,231,90,141,2,30,1,1
55114,64404,53,48455,53,allow,224,94,130,2,30,1,1
55115,64557,53,9245,53,allow,766,102,664,2,30,1,1
55116,57095,53,7010,53,allow,177,94,83,2,30,1,1
55117,39145,443,40241,443,allow,4602,1305,3297,27,183,12,15
55118,56355,53,52899,53,allow,184,94,90,2,31,1,1
55119,6881,6881,44146,6881,allow,502,150,352,2,1199,1,1
55120,52121,443,41012,443,allow,199757,7497,192260,216,45,80,136
55121,64052,53,64052,53,allow,198,90,108,2,30,1,1
55122,59534,53,0,0,allow,216,72,144,2,30,1,1
55123,64841,53,21377,53,allow,173,94,79,2,30,1,1
55124,49883,53,42017,53,allow,177,94,83,2,30,1,1
55125,50233,53,42089,53,allow,748,94,654,2,30,1,1
55126,56196,53,24743,53,allow,498,204,294,6,31,3,3
55127,64979,53,4667,53,allow,194,102,92,2,31,1,1
55128,54967,53,43919,53,allow,178,94,84,2,31,1,1
55129,55617,53,37518,53,allow,194,102,92,2,31,1,1
55130,50594,80,17201,80,allow,3116,452,2664,18,394,5,13
55131,55002,443,31651,443,allow,469783,461079,8704,444,167,329,115
55132,41440,5228,57433,5228,allow,8866,2015,6851,29,4793,14,15
55133,39920,443,36288,443,allow,4552,1255,3297,27,183,12,15
55134,54898,443,38797,443,allow,4559,2054,2505,11,120,6,5
55135,57470,61768,42520,61768,allow,330,330,0,6,1199,6,0
55136,6882,6881,62031,6881,allow,238,118,120,2,1200,1,1
55137,38387,80,17970,80,allow,2008,810,1198,20,394,7,13
55138,15503,26886,1778,26886,allow,481,150,331,2,1200,1,1
55139,44847,31381,18131,31381,allow,150,150,0,1,1200,1,0
55140,57418,443,37526,443,allow,29994,1927,28067,50,20,17,33
55141,52282,80,3560,80,allow,7603,1651,5952,24,16,13,11
55142,34358,80,63755,80,allow,350,210,140,6,16,4,2
55143,29964,53,52267,53,allow,200,86,114,2,30,1,1
55144,53566,8999,11689,8999,allow,3428,1820,1608,21,17,12,9
55145,53576,23505,46519,23505,allow,70,70,0,1,5,1,0
55146,63769,47661,26406,47661,allow,70,70,0,1,5,1,0
55147,59884,443,44531,443,allow,6622,2246,4376,21,46,12,9
55148,51075,80,51075,80,allow,450,246,204,8,26,5,3
55149,52131,443,17836,443,allow,6565,1251,5314,27,31,14,13
55150,33087,443,44739,443,allow,13265,1924,11341,33,201,17,16
55151,63771,7426,20150,7426,allow,70,70,0,1,5,1,0
55152,14431,443,44094,443,allow,2601,1455,1146,18,16,8,10
55153,55089,53,1796,53,allow,199,102,97,2,30,1,1
55154,64308,53,43760,53,allow,181,86,95,2,30,1,1
55155,55089,53,56950,53,allow,199,102,97,2,30,1,1
55156,64599,53,12199,53,allow,767,102,665,2,30,1,1
55157,2362,53,2362,53,allow,225,90,135,2,30,1,1
55158,57095,53,10011,53,allow,177,94,83,2,30,1,1
55159,36255,53,36255,53,allow,197,90,107,2,30,1,1
55160,55346,53,62620,53,allow,177,94,83,2,31,1,1
55161,52710,445,0,0,drop,70,70,0,1,0,1,0
55162,43890,123,0,0,deny,234,234,0,1,0,1,0
55163,17315,11392,0,0,deny,62,62,0,1,0,1,0
55164,57689,445,0,0,drop,70,70,0,1,0,1,0
55165,57679,445,0,0,drop,70,70,0,1,0,1,0
55166,57680,445,0,0,drop,70,70,0,1,0,1,0
55167,57678,445,0,0,drop,70,70,0,1,0,1,0
55168,57441,57470,0,0,deny,66,66,0,1,0,1,0
55169,45941,23386,0,0,deny,60,60,0,1,0,1,0
55170,45941,23386,0,0,deny,60,60,0,1,0,1,0
55171,52698,445,0,0,drop,70,70,0,1,0,1,0
55172,52697,445,0,0,drop,70,70,0,1,0,1,0
55173,52693,445,0,0,drop,70,70,0,1,0,1,0
55174,60480,57470,0,0,deny,62,62,0,1,0,1,0
55175,52687,445,0,0,drop,70,70,0,1,0,1,0
55176,52688,445,0,0,drop,70,70,0,1,0,1,0
55177,56307,52700,0,0,deny,66,66,0,1,0,1,0
55178,52472,7302,0,0,deny,62,62,0,1,0,1,0
55179,61983,50432,0,0,deny,62,62,0,1,0,1,0
55180,46936,35440,0,0,deny,62,62,0,1,0,1,0
55181,53447,44847,0,0,deny,62,62,0,1,0,1,0
55182,7308,50584,0,0,deny,66,66,0,1,0,1,0
55183,38633,51221,0,0,deny,62,62,0,1,0,1,0
55184,58305,51180,0,0,deny,66,66,0,1,0,1,0
55185,12530,35440,0,0,deny,66,66,0,1,0,1,0
55186,57671,445,0,0,drop,70,70,0,1,0,1,0
55187,57669,445,0,0,drop,70,70,0,1,0,1,0
55188,57664,445,0,0,drop,70,70,0,1,0,1,0
55189,54140,43890,0,0,deny,62,62,0,1,0,1,0
55190,52676,445,0,0,drop,70,70,0,1,0,1,0
55191,50820,57470,0,0,deny,66,66,0,1,0,1,0
55192,1024,57470,0,0,deny,62,62,0,1,0,1,0
55193,50067,64147,0,0,deny,66,66,0,1,0,1,0
55194,31112,50584,0,0,deny,66,66,0,1,0,1,0
55195,60196,53,0,0,deny,88,88,0,1,0,1,0
55196,49842,7302,0,0,deny,66,66,0,1,0,1,0
55197,57478,7302,0,0,deny,66,66,0,1,0,1,0
55198,59378,50584,0,0,deny,66,66,0,1,0,1,0
55199,46587,57470,0,0,deny,62,62,0,1,0,1,0
55200,443,10010,0,0,deny,60,60,0,1,0,1,0
55201,3541,22114,0,0,deny,62,62,0,1,0,1,0
55202,61218,22114,0,0,deny,66,66,0,1,0,1,0
55203,44933,23,0,0,deny,60,60,0,1,0,1,0
55204,59701,44847,0,0,deny,62,62,0,1,0,1,0
55205,28668,8696,0,0,deny,60,60,0,1,0,1,0
55206,38976,46824,0,0,deny,62,62,0,1,0,1,0
55207,52671,445,0,0,drop,70,70,0,1,0,1,0
55208,53072,445,0,0,drop,66,66,0,1,0,1,0
55209,57662,445,0,0,drop,70,70,0,1,0,1,0
55210,57661,445,0,0,drop,70,70,0,1,0,1,0
55211,52662,445,0,0,drop,70,70,0,1,0,1,0
55212,52663,445,0,0,drop,70,70,0,1,0,1,0
55213,63547,37965,0,0,deny,66,66,0,1,0,1,0
55214,52658,445,0,0,drop,70,70,0,1,0,1,0
55215,52657,445,0,0,drop,70,70,0,1,0,1,0
55216,1026,30188,0,0,deny,146,146,0,1,0,1,0
55217,63314,57470,0,0,deny,66,66,0,1,0,1,0
55218,51900,48817,0,0,deny,146,146,0,1,0,1,0
55219,52655,445,0,0,drop,70,70,0,1,0,1,0
55220,53065,445,0,0,drop,66,66,0,1,0,1,0
55221,21087,80,21087,80,allow,159790,4676,155114,177,128,67,110
55222,50878,53733,0,0,deny,66,66,0,1,0,1,0
55223,57060,50584,0,0,deny,62,62,0,1,0,1,0
55224,53064,445,0,0,drop,66,66,0,1,0,1,0
55225,56494,15503,0,0,deny,146,146,0,1,0,1,0
55226,57653,445,0,0,drop,70,70,0,1,0,1,0
55227,58468,57587,0,0,deny,66,66,0,1,0,1,0
55228,57645,445,0,0,drop,70,70,0,1,0,1,0
55229,57644,445,0,0,drop,70,70,0,1,0,1,0
55230,57639,445,0,0,drop,70,70,0,1,0,1,0
55231,53062,445,0,0,drop,66,66,0,1,0,1,0
55232,59940,50584,0,0,deny,62,62,0,1,0,1,0
55233,65060,35440,0,0,deny,62,62,0,1,0,1,0
55234,52649,445,0,0,drop,70,70,0,1,0,1,0
55235,9957,32480,0,0,deny,62,62,0,1,0,1,0
55236,53437,44847,0,0,deny,62,62,0,1,0,1,0
55237,8211,28793,0,0,deny,62,62,0,1,0,1,0
55238,57636,445,0,0,drop,70,70,0,1,0,1,0
55239,62804,37965,0,0,deny,62,62,0,1,0,1,0
55240,0,0,0,0,allow,124,64,60,2,0,1,1
55241,57633,445,0,0,drop,70,70,0,1,0,1,0
55242,57632,445,0,0,drop,70,70,0,1,0,1,0
55243,57629,445,0,0,drop,70,70,0,1,0,1,0
55244,53055,445,0,0,drop,66,66,0,1,0,1,0
55245,52642,445,0,0,drop,70,70,0,1,0,1,0
55246,1888,51505,0,0,deny,62,62,0,1,0,1,0
55247,60188,15503,0,0,deny,62,62,0,1,0,1,0
55248,52641,445,0,0,drop,70,70,0,1,0,1,0
55249,53047,445,0,0,drop,66,66,0,1,0,1,0
55250,53048,445,0,0,drop,66,66,0,1,0,1,0
55251,53046,445,0,0,drop,66,66,0,1,0,1,0
55252,63701,46824,0,0,deny,66,66,0,1,0,1,0
55253,53045,445,0,0,drop,66,66,0,1,0,1,0
55254,53043,445,0,0,drop,66,66,0,1,0,1,0
55255,53042,445,0,0,drop,66,66,0,1,0,1,0
55256,50084,26672,0,0,deny,62,62,0,1,0,1,0
55257,52635,445,0,0,drop,70,70,0,1,0,1,0
55258,23274,50584,0,0,deny,62,62,0,1,0,1,0
55259,52103,53733,0,0,deny,66,66,0,1,0,1,0
55260,54062,49813,0,0,deny,62,62,0,1,0,1,0
55261,52634,445,0,0,drop,70,70,0,1,0,1,0
55262,52447,43890,0,0,deny,66,66,0,1,0,1,0
55263,21733,56205,0,0,deny,66,66,0,1,0,1,0
55264,57628,445,0,0,drop,70,70,0,1,0,1,0
55265,57625,445,0,0,drop,70,70,0,1,0,1,0
55266,57621,445,0,0,drop,70,70,0,1,0,1,0
55267,53038,445,0,0,drop,66,66,0,1,0,1,0
55268,57620,445,0,0,drop,70,70,0,1,0,1,0
55269,13654,50584,0,0,deny,146,146,0,1,0,1,0
55270,53037,445,0,0,drop,66,66,0,1,0,1,0
55271,52630,445,0,0,drop,70,70,0,1,0,1,0
55272,59128,44847,0,0,deny,62,62,0,1,0,1,0
55273,53033,445,0,0,drop,66,66,0,1,0,1,0
55274,53035,445,0,0,drop,66,66,0,1,0,1,0
55275,53031,445,0,0,drop,66,66,0,1,0,1,0
55276,52629,445,0,0,drop,70,70,0,1,0,1,0
55277,58396,22114,0,0,deny,66,66,0,1,0,1,0
55278,63615,23,0,0,deny,60,60,0,1,0,1,0
55279,46275,64147,0,0,deny,62,62,0,1,0,1,0
55280,56119,46824,0,0,deny,62,62,0,1,0,1,0
55281,57614,445,0,0,drop,70,70,0,1,0,1,0
55282,29203,26467,0,0,deny,62,62,0,1,0,1,0
55283,54910,32480,0,0,deny,66,66,0,1,0,1,0
55284,50418,80,62798,80,allow,12920,6875,6045,25,27,13,12
55285,50431,80,44826,80,allow,318,192,126,6,27,4,2
55286,50435,80,28947,80,allow,318,192,126,6,27,4,2
55287,2075,7000,2075,7000,allow,5850,4395,1455,18,15,10,8
55288,65287,3389,65287,3389,allow,3409,1454,1955,16,16,8,8
55289,50446,80,5062,80,allow,318,192,126,6,27,4,2
55290,34539,80,34539,80,allow,22098,1602,20496,24,57,6,18
55291,56613,443,29986,443,allow,7981,1961,6020,20,16,11,9
55292,56614,443,40071,443,allow,8034,2014,6020,20,15,11,9
55293,49914,443,44270,443,allow,5895,728,5167,16,27,8,8
55294,52324,443,52324,443,allow,6727,762,5965,15,26,8,7
55295,55089,53,42866,53,allow,198,101,97,2,30,1,1
55296,57257,53,11711,53,allow,764,99,665,2,30,1,1
55297,11295,40040,23656,40040,allow,213,89,124,4,31,2,2
55298,55735,53,17069,53,allow,772,100,672,2,30,1,1
55299,50432,80,29144,80,allow,318,192,126,6,27,4,2
55300,2076,7000,2076,7000,allow,5194,3739,1455,18,15,10,8
55301,51541,3389,51541,3389,allow,3609,1654,1955,19,18,11,8
55302,56615,443,31008,443,allow,7982,1962,6020,20,15,11,9
55303,52322,443,52322,443,allow,6926,828,6098,17,26,9,8
55304,2074,7010,2074,7010,allow,4279,2090,2189,16,15,8,8
55305,57115,53,57910,53,allow,788,108,680,2,30,1,1
55306,57095,53,44244,53,allow,170,87,83,2,30,1,1
55307,56741,53,9430,53,allow,814,110,704,2,30,1,1
55308,50181,80,60161,80,allow,2149,1165,984,15,77,8,7
55309,56357,53,52220,53,allow,172,88,84,2,30,1,1
55310,56616,443,54486,443,allow,8033,2013,6020,20,15,11,9
55311,63760,37264,26706,37264,allow,504,382,122,8,16,6,2
55312,60334,7080,60334,7080,allow,2960,432,2528,11,15,6,5
55313,50427,80,43709,80,allow,312,192,120,6,27,4,2
55314,2078,7000,2078,7000,allow,3006,1615,1391,15,15,8,7
55315,64633,53,4250,53,allow,762,98,664,2,30,1,1
55316,57855,443,34807,443,allow,4370,3370,1000,19,187,10,9
55317,55552,53,38672,53,allow,767,102,665,2,30,1,1
55318,58819,1433,58819,1433,allow,124,60,64,2,5,1,1
55319,55462,53,13103,53,allow,188,96,92,2,30,1,1
55320,56567,53,56060,53,allow,188,96,92,2,31,1,1
55321,58488,3389,58488,3389,allow,3428,1714,1714,16,31,8,8
55322,56771,53,7291,53,allow,270,95,175,4,60,2,2
55323,50755,80,50755,80,allow,450,246,204,8,25,5,3
55324,58054,25,23956,25,allow,1370,496,874,16,16,8,8
55325,65290,3389,65290,3389,allow,3327,1438,1889,15,16,8,7
55326,51784,34568,29870,34568,allow,70,70,0,2,8,2,0
55327,50948,80,50948,80,allow,520,246,274,9,25,5,4
55328,53572,22754,17581,22754,allow,70,70,0,1,5,1,0
55329,2077,7000,2077,7000,allow,3054,1599,1455,16,15,8,8
55330,58509,80,60586,80,allow,1666,1130,536,12,16,7,5
55331,2073,7000,2073,7000,allow,3566,1999,1567,16,15,8,8
55332,55617,18319,24832,18319,allow,320,140,180,6,7,3,3
55333,50966,443,44457,443,allow,7975,3304,4671,19,86,11,8
55334,50428,80,50756,80,allow,312,192,120,6,27,4,2
55335,51765,52862,65009,52862,allow,66,66,0,1,5,1,0
55336,63205,443,63205,443,allow,9324,4240,5084,24,16,13,11
55337,2072,7000,2072,7000,allow,3164,783,2381,15,16,7,8
55338,44805,3389,44805,3389,allow,4870,2631,2239,23,19,13,10
55339,50445,80,48799,80,allow,318,192,126,6,27,4,2
55340,63525,53,0,0,allow,174,77,97,2,30,1,1
55341,55417,53,30758,53,allow,196,100,96,2,30,1,1
55342,56620,53,51991,53,allow,322,110,212,4,30,2,2
55343,65192,53,4438,53,allow,172,88,84,2,30,1,1
55344,55514,53,44502,53,allow,783,96,687,2,30,1,1
55345,55113,53,29716,53,allow,196,100,96,2,31,1,1
55346,56355,53,30971,53,allow,184,94,90,2,31,1,1
55347,56724,53,15012,53,allow,749,89,660,2,31,1,1
55348,55336,53,13699,53,allow,295,101,194,4,31,2,2
55349,56569,53,65375,53,allow,91,91,0,1,31,1,0
55350,55990,53,40258,53,allow,182,93,89,2,30,1,1
55351,52544,19000,32388,19000,allow,492,216,276,2,31,1,1
55352,56386,53,13942,53,allow,170,87,83,2,31,1,1
55353,57040,53,4133,53,allow,810,108,702,2,31,1,1
55354,55282,53,18223,53,allow,771,101,670,2,31,1,1
55355,65188,53,51573,53,allow,731,91,640,2,31,1,1
55356,49432,53,56971,53,allow,170,87,83,2,31,1,1
55357,55582,53,11114,53,allow,778,103,675,2,31,1,1
55358,57350,53,19217,53,allow,771,101,670,2,31,1,1
55359,55826,53,30050,53,allow,86,86,0,1,31,1,0
55360,51221,51413,20920,51413,allow,459,149,310,2,1200,1,1
55361,50584,11830,62858,11830,allow,2118,900,1218,14,4232,7,7
55362,63978,53,11123,53,allow,212,108,104,2,31,1,1
55363,56220,53,22417,53,allow,772,103,669,2,31,1,1
55364,5938,49414,0,0,allow,60,60,0,1,90,1,0
55365,64637,53,20905,53,allow,810,108,702,2,30,1,1
55366,50584,53,43253,53,allow,174,89,85,2,31,1,1
55367,65149,53,43485,53,allow,760,97,663,2,31,1,1
55368,56743,53,42878,53,allow,816,97,719,2,30,1,1
55369,55746,53,61389,53,allow,216,110,106,2,31,1,1
55370,56995,53,58865,53,allow,168,86,82,2,31,1,1
55371,55809,53,62877,53,allow,731,85,646,2,31,1,1
55372,55735,53,65479,53,allow,184,94,90,2,31,1,1
55373,49263,53,10892,53,allow,731,85,646,2,31,1,1
55374,56935,53,37247,53,allow,174,89,85,2,31,1,1
55375,51951,443,56049,443,allow,6633,3485,3148,34,197,19,15
55376,55454,53,60200,53,allow,202,103,99,2,31,1,1
55377,15341,23,0,0,allow,60,60,0,1,90,1,0
55378,10151,19083,54566,19083,allow,489,149,340,2,1200,1,1
55379,55081,53,2837,53,allow,711,87,624,2,31,1,1
55380,56186,53,1999,53,allow,196,100,96,2,31,1,1
55381,55273,53,51928,53,allow,166,85,81,2,31,1,1
55382,56282,53,64449,53,allow,751,95,656,2,31,1,1
55383,56072,53,60907,53,allow,198,101,97,2,31,1,1
55384,57094,53,64941,53,allow,192,98,94,2,31,1,1
55385,45944,443,12806,443,allow,4715,1935,2780,24,183,11,13
55386,57608,445,0,0,drop,70,70,0,1,0,1,0
55387,57604,445,0,0,drop,70,70,0,1,0,1,0
55388,65384,57470,0,0,deny,66,66,0,1,0,1,0
55389,54600,6881,0,0,deny,66,66,0,1,0,1,0
55390,52624,445,0,0,drop,70,70,0,1,0,1,0
55391,26528,51221,0,0,deny,78,78,0,1,0,1,0
55392,63183,64147,0,0,deny,66,66,0,1,0,1,0
55393,443,28417,0,0,deny,82,82,0,1,0,1,0
55394,6881,6881,0,0,deny,146,146,0,1,0,1,0
55395,53023,445,0,0,drop,66,66,0,1,0,1,0
55396,1534,54369,0,0,deny,66,66,0,1,0,1,0
55397,51999,37965,0,0,deny,62,62,0,1,0,1,0
55398,64847,53,37930,53,allow,211,102,109,2,30,1,1
55399,55990,53,28837,53,allow,183,94,89,2,30,1,1
55400,50448,443,40818,443,allow,1119,595,524,12,26,6,6
55401,34489,35440,0,0,deny,62,62,0,1,0,1,0
55402,53013,445,0,0,drop,66,66,0,1,0,1,0
55403,33292,50584,0,0,deny,62,62,0,1,0,1,0
55404,57594,445,0,0,drop,70,70,0,1,0,1,0
55405,48430,22,0,0,deny,60,60,0,1,0,1,0
55406,62189,64147,0,0,deny,145,145,0,1,0,1,0
55407,52611,445,0,0,drop,70,70,0,1,0,1,0
55408,58305,18375,0,0,deny,66,66,0,1,0,1,0
55409,53010,445,0,0,drop,66,66,0,1,0,1,0
55410,61221,35440,0,0,deny,66,66,0,1,0,1,0
55411,52608,445,0,0,drop,70,70,0,1,0,1,0
55412,21420,44847,0,0,deny,66,66,0,1,0,1,0
55413,53591,35889,63951,35889,allow,320,140,180,6,6,3,3
55414,50307,53,50594,53,allow,1370,89,1281,4,33,2,2
55415,27416,53,27416,53,allow,214,82,132,2,32,1,1
55416,56620,53,31427,53,allow,216,110,106,2,30,1,1
55417,64979,53,10691,53,allow,194,102,92,2,30,1,1
55418,50280,53,42526,53,allow,794,102,692,2,30,1,1
55419,51196,443,64591,443,allow,346,140,206,6,130,3,3
55420,49524,443,52573,443,allow,52864,3584,49280,86,95,39,47
55421,56546,443,24280,443,allow,134,60,74,3,5,2,1
55422,55052,80,37545,80,allow,11677266,314362,11362904,12711,129,5174,7537
55423,64776,53,33019,53,allow,935,334,601,8,62,4,4
55424,49202,53,22068,53,allow,498,204,294,6,29,3,3
55425,65357,53,38110,53,allow,194,102,92,2,29,1,1
55426,49229,53,54866,53,allow,178,94,84,2,29,1,1
55427,49320,53,59903,53,allow,177,94,83,2,30,1,1
55428,55417,53,60973,53,allow,198,102,96,2,30,1,1
55429,57201,53,46716,53,allow,214,110,104,2,30,1,1
55430,56229,53,1556,53,allow,173,94,79,2,30,1,1
55431,34360,80,12302,80,allow,494,280,214,8,14,5,3
55432,51009,80,51009,80,allow,450,246,204,8,25,5,3
55433,60750,40010,25363,40010,allow,316,136,180,6,6,3,3
55434,38872,443,38872,443,allow,4480,1573,2907,19,29,11,8
55435,49919,80,50897,80,allow,2821387,64706,2756681,2277,183,418,1859
55436,63779,12226,36658,12226,allow,66,66,0,2,7,2,0
55437,48913,443,1076,443,allow,6922,1618,5304,23,35,12,11
55438,49449,80,49449,80,allow,416,198,218,7,29,4,3
55439,47402,443,25875,443,allow,6118,1180,4938,22,16,11,11
55440,59882,443,38875,443,allow,10017,3031,6986,30,45,17,13
55441,65357,53,40859,53,allow,194,102,92,2,29,1,1
55442,59343,53,0,0,allow,178,72,106,2,29,1,1
55443,50689,80,50689,80,allow,450,246,204,8,25,5,3
55444,50362,53,58174,53,allow,214,110,104,2,29,1,1
55445,38671,443,7350,443,allow,7897,3562,4335,19,16,10,9
55446,49883,53,5470,53,allow,177,94,83,2,29,1,1
55447,65396,53,55502,53,allow,186,102,84,2,29,1,1
55448,55080,53,11951,53,allow,173,94,79,2,29,1,1
55449,52120,443,51831,443,allow,305183,9715,295468,312,44,107,205
55450,40923,53,40923,53,allow,200,90,110,2,29,1,1
55451,4702,53,4702,53,allow,220,90,130,2,29,1,1
55452,53571,19636,6508,19636,allow,70,70,0,1,4,1,0
55453,55089,53,6638,53,allow,199,102,97,2,30,1,1
55454,55346,53,65324,53,allow,177,94,83,2,29,1,1
55455,65192,53,33207,53,allow,178,94,84,2,30,1,1
55456,26447,80,26447,80,allow,12599,1479,11120,28,16,15,13
55457,63630,53,44818,53,allow,278,94,184,2,30,1,1
55458,33243,443,3619,443,allow,35991,3996,31995,58,17,26,32
55459,50450,80,49757,80,allow,26924,4418,22506,34,25,13,21
55460,61364,443,41959,443,allow,8492,2950,5542,27,16,15,12
55461,50437,80,64833,80,allow,314,192,122,6,26,4,2
55462,64730,53,5756,53,allow,261,94,167,2,30,1,1
55463,64836,53,53586,53,allow,241,94,147,2,30,1,1
55464,50440,53,45707,53,allow,216,110,106,2,30,1,1
55465,49597,53,32706,53,allow,168,86,82,2,31,1,1
55466,65030,53,52927,53,allow,785,110,675,2,30,1,1
55467,51406,443,38367,443,allow,8186,2146,6040,29,33,16,13
55468,33242,443,38172,443,allow,14244,2907,11337,33,17,17,16
55469,50426,443,9963,443,allow,5713,1079,4634,15,26,8,7
55470,50421,80,60680,80,allow,7162,3201,3961,19,27,11,8
55471,50462,80,58102,80,allow,4603,2152,2451,14,22,8,6
55472,55836,53,17150,53,allow,181,94,87,2,33,1,1
55473,50438,80,13874,80,allow,314,192,122,6,26,4,2
55474,57095,53,33152,53,allow,177,94,83,2,30,1,1
55475,55735,53,28047,53,allow,184,94,90,2,30,1,1
55476,55101,53,47277,53,allow,197,102,95,2,30,1,1
55477,56719,53,59269,53,allow,185,102,83,2,30,1,1
55478,56719,53,51859,53,allow,185,102,83,2,30,1,1
55479,50440,53,39485,53,allow,216,110,106,2,30,1,1
55480,56567,53,21156,53,allow,194,102,92,2,30,1,1
55481,56373,53,9472,53,allow,200,102,98,2,30,1,1
55482,49422,53,52820,53,allow,719,208,511,6,32,3,3
55483,50449,443,5504,443,allow,7588,1850,5738,19,25,10,9
55484,49353,53,9997,53,allow,237,94,143,2,30,1,1
55485,48409,443,36994,443,allow,5993,1261,4732,18,982,8,10
55486,34355,80,5779,80,allow,416,210,206,7,15,4,3
55487,55746,53,40664,53,allow,216,110,106,2,30,1,1
55488,56386,53,3694,53,allow,177,94,83,2,30,1,1
55489,51487,443,18707,443,allow,10453,3977,6476,27,54,15,12
55490,49432,53,51069,53,allow,177,94,83,2,30,1,1
55491,64980,53,3433,53,allow,200,102,98,2,30,1,1
55492,55990,53,30769,53,allow,183,94,89,2,30,1,1
55493,49564,53,7876,53,allow,168,78,90,2,30,1,1
55494,56995,53,18611,53,allow,168,86,82,2,30,1,1
55495,64840,53,24107,53,allow,356,118,238,2,30,1,1
55496,44587,443,26672,443,allow,16341,3306,13035,42,17,24,18
55497,55077,53,19465,53,allow,277,90,187,4,32,2,2
55498,50439,80,32782,80,allow,318,192,126,6,26,4,2
55499,65291,53,53725,53,allow,889,404,485,10,30,5,5
55500,52704,53,49844,53,allow,168,78,90,2,30,1,1
55501,63067,443,13404,443,allow,2570995,60656,2510339,2538,34,844,1694
55502,34354,80,61619,80,allow,350,210,140,6,15,4,2
55503,51766,48169,32212,48169,allow,70,70,0,1,5,1,0
55504,60038,80,60038,80,allow,12881,767,12114,21,21,9,12
55505,50434,80,31890,80,allow,318,192,126,6,26,4,2
55506,52380,443,20377,443,allow,8659,3601,5058,34,80,18,16
55507,65496,53,6299,53,allow,210,86,124,2,30,1,1
55508,56620,53,63507,53,allow,216,110,106,2,30,1,1
55509,60760,53,0,0,allow,86,86,0,1,30,1,0
55510,56658,53,12429,53,allow,229,94,135,2,30,1,1
55511,49971,53,55758,53,allow,198,102,96,2,30,1,1
55512,57090,53,28237,53,allow,198,102,96,2,30,1,1
55513,34529,443,32303,443,allow,77395,64623,12772,206,188,116,90
55514,37277,80,37277,80,allow,52625,3140,49485,55,52,14,41
55515,49913,443,31997,443,allow,5570,901,4669,16,27,8,8
55516,34359,80,6984,80,allow,350,210,140,6,14,4,2
55517,51764,33432,6081,33432,allow,70,70,0,1,5,1,0
55518,53570,24874,57819,24874,allow,70,70,0,1,4,1,0
55519,53372,443,36591,443,allow,214,140,74,4,20,3,1
55520,63768,55755,10523,55755,allow,70,70,0,1,4,1,0
55521,55417,53,34497,53,allow,198,102,96,2,33,1,1
55522,60402,47094,53695,47094,allow,320,140,180,6,7,3,3
55523,53575,1025,61617,1025,allow,70,70,0,1,4,1,0
55524,50441,80,60802,80,allow,318,192,126,6,26,4,2
55525,50433,80,24726,80,allow,318,192,126,6,26,4,2
55526,65470,443,40363,443,allow,372361,11310,361051,385,16,136,249
55527,50122,443,55695,443,allow,6407,1101,5306,18,26,10,8
55528,49623,53,34250,53,allow,790,110,680,2,29,1,1
55529,50424,443,50613,443,allow,5713,1079,4634,15,26,8,7
55530,53070,53,0,0,allow,168,74,94,2,29,1,1
55531,55080,53,13972,53,allow,165,86,79,2,29,1,1
55532,57201,53,40982,53,allow,214,110,104,2,29,1,1
55533,33246,443,57032,443,allow,8340,2896,5444,28,16,16,12
55534,50362,53,33305,53,allow,214,110,104,2,29,1,1
55535,46159,443,12485,443,allow,124567,6787,117780,175,263,82,93
55536,59321,53,33396,53,allow,209,70,139,2,30,1,1
55537,49320,53,28326,53,allow,185,102,83,2,30,1,1
55538,65130,53,25428,53,allow,646,200,446,6,62,3,3
55539,63942,53,65464,53,allow,214,102,112,2,30,1,1
55540,49405,53,14474,53,allow,94,94,0,1,30,1,0
55541,50106,53,61175,53,allow,209,110,99,2,30,1,1
55542,60375,53,25105,53,allow,226,94,132,2,31,1,1
55543,56386,53,9835,53,allow,177,94,83,2,31,1,1
55544,49068,443,40796,443,allow,8664,2567,6097,20,120,10,10
55545,55439,53,52898,53,allow,209,110,99,2,30,1,1
55546,55776,53,52683,53,allow,216,110,106,2,30,1,1
55547,17481,53,17481,53,allow,198,90,108,2,30,1,1
55548,56567,53,28811,53,allow,194,102,92,2,31,1,1
55549,36157,53,43020,53,allow,164,78,86,2,31,1,1
55550,65366,53,59432,53,allow,199,102,97,2,31,1,1
55551,56186,53,13478,53,allow,198,102,96,2,31,1,1
55552,57094,53,10369,53,allow,196,102,94,2,30,1,1
55553,49591,53,7578,53,allow,168,86,82,2,32,1,1
55554,53117,37529,25510,37529,allow,70,70,0,2,8,2,0
55555,50463,80,9327,80,allow,1718,1247,471,9,15,5,4
55556,50496,443,27297,443,allow,90570,3437,87133,103,90,34,69
55557,50148,80,44851,80,allow,17314,6865,10449,50,79,24,26
55558,33245,443,3684,443,allow,7279,2884,4395,28,16,16,12
55559,63764,12343,45903,12343,allow,504,382,122,8,15,6,2
55560,55462,53,6708,53,allow,194,102,92,2,30,1,1
55561,65366,53,11375,53,allow,199,102,97,2,30,1,1
55562,55107,53,52328,53,allow,214,102,112,2,30,1,1
55563,56373,53,63287,53,allow,200,102,98,2,30,1,1
55564,50613,53,60735,53,allow,814,110,704,2,30,1,1
55565,56373,53,59936,53,allow,200,102,98,2,30,1,1
55566,41886,53,43611,53,allow,168,78,90,2,30,1,1
55567,50440,53,43767,53,allow,216,110,106,2,30,1,1
55568,49971,53,63730,53,allow,198,102,96,2,30,1,1
55569,30188,14432,60719,14432,allow,868,150,718,4,1200,2,2
55570,49433,53,38840,53,allow,167,86,81,2,30,1,1
55571,50922,443,21315,443,allow,6180,1241,4939,18,982,8,10
55572,52321,443,52321,443,allow,6727,762,5965,15,25,8,7
55573,58889,443,61172,443,allow,3956,2519,1437,18,80,10,8
55574,50440,80,41548,80,allow,318,192,126,6,26,4,2
55575,50429,80,32057,80,allow,318,192,126,6,26,4,2
55576,50430,80,29932,80,allow,318,192,126,6,26,4,2
55577,50150,80,7592,80,allow,73454,5461,67993,74,79,22,52
55578,50312,80,40765,80,allow,2699,1007,1692,14,64,7,7
55579,50425,443,34304,443,allow,5653,1079,4574,14,26,8,6
55580,50374,443,61017,443,allow,8485,1804,6681,30,316,14,16
55581,33238,443,21628,443,allow,21538,3952,17586,48,17,27,21
55582,55836,53,27528,53,allow,181,94,87,2,30,1,1
55583,55656,53,37585,53,allow,214,110,104,2,30,1,1
55584,55656,53,7470,53,allow,214,110,104,2,30,1,1
55585,54967,53,27983,53,allow,178,94,84,2,30,1,1
55586,55617,53,59978,53,allow,194,102,92,2,30,1,1
55587,37637,53,37222,53,allow,168,78,90,2,30,1,1
55588,52221,53,10859,53,allow,177,86,91,2,30,1,1
55589,40507,53,2072,53,allow,86,86,0,1,30,1,0
55590,50455,443,11561,443,allow,107749,6262,101487,142,138,58,84
55591,38523,53,38523,53,allow,214,82,132,2,32,1,1
55592,33664,80,55691,80,allow,70,70,0,1,5,1,0
55593,50436,80,19701,80,allow,314,192,122,6,26,4,2
55594,55990,53,6469,53,allow,183,94,89,2,30,1,1
55595,55735,53,52965,53,allow,184,94,90,2,30,1,1
55596,56771,53,2287,53,allow,270,95,175,4,60,2,2
55597,65153,53,29688,53,allow,168,86,82,2,30,1,1
55598,50106,53,26028,53,allow,209,110,99,2,30,1,1
55599,63978,53,60357,53,allow,214,110,104,2,30,1,1
55600,64980,53,54616,53,allow,200,102,98,2,30,1,1
55601,50584,53,20103,53,allow,179,94,85,2,30,1,1
55602,63978,53,35344,53,allow,214,110,104,2,30,1,1
55603,58263,443,17697,443,allow,12494,5331,7163,48,122,21,27
55604,33067,53,0,0,allow,86,86,0,1,30,1,0
55605,55336,53,26759,53,allow,199,102,97,2,31,1,1
55606,50103,53,41648,53,allow,168,86,82,2,31,1,1
55607,56809,53,41798,53,allow,178,94,84,2,31,1,1
55608,64413,443,46827,443,allow,5660875,75934,5584941,4719,141,686,4033
55609,55746,53,54887,53,allow,216,110,106,2,30,1,1
55610,64001,53,4323,53,allow,183,94,89,2,30,1,1
55611,65036,53,40667,53,allow,214,110,104,2,30,1,1
55612,50105,53,29739,53,allow,969,86,883,2,30,1,1
55613,57090,53,19646,53,allow,198,102,96,2,30,1,1
55614,55656,53,44214,53,allow,214,110,104,2,30,1,1
55615,64001,53,1260,53,allow,183,94,89,2,30,1,1
55616,65036,53,28927,53,allow,214,110,104,2,30,1,1
55617,65366,53,12473,53,allow,199,102,97,2,30,1,1
55618,56355,53,13355,53,allow,184,94,90,2,30,1,1
55619,55454,53,12071,53,allow,209,110,99,2,31,1,1
55620,40942,123,62465,123,allow,184,94,90,2,30,1,1
55621,56386,53,21142,53,allow,177,94,83,2,30,1,1
55622,49543,53,11834,53,allow,779,110,669,2,30,1,1
55623,56357,53,34112,53,allow,178,94,84,2,30,1,1
55624,64995,53,33043,53,allow,199,102,97,2,30,1,1
55625,57259,53,43312,53,allow,199,102,97,2,31,1,1
55626,50103,53,21620,53,allow,168,86,82,2,30,1,1
55627,54956,53,56541,53,allow,194,102,92,2,30,1,1
55628,64995,53,32093,53,allow,199,102,97,2,30,1,1
55629,55372,53,55372,53,allow,216,90,126,2,30,1,1
55630,56501,53,9977,53,allow,216,94,122,2,31,1,1
55631,57094,53,18443,53,allow,196,102,94,2,31,1,1
55632,55364,53,26181,53,allow,168,86,82,2,31,1,1
55633,65300,53,9182,53,allow,195,102,93,2,31,1,1
55634,56355,53,43280,53,allow,184,94,90,2,31,1,1
55635,52251,443,26101,443,allow,23328780,730794,22597986,24754,320,8113,16641
55636,35745,443,18614,443,allow,7634,4417,3217,35,197,19,16
55637,55101,53,52227,53,allow,197,102,95,2,31,1,1
55638,49608,53,63046,53,allow,198,110,88,2,31,1,1
55639,49432,53,5253,53,allow,177,94,83,2,31,1,1
55640,56072,53,35892,53,allow,199,102,97,2,31,1,1
55641,8861,443,39985,443,allow,42890,30849,12041,214,420,106,108
55642,39500,443,7473,443,allow,6517,2048,4469,21,90,12,9
55643,50523,443,53596,443,allow,6676,1074,5602,22,84,12,10
55644,38535,443,55811,443,allow,910,358,552,14,47,6,8
55645,43368,80,43368,80,allow,232198,9152,223046,290,21,134,156
55646,50512,443,55722,443,allow,6945,1842,5103,25,87,14,11
55647,54956,53,60675,53,allow,194,102,92,2,31,1,1
55648,63761,25933,42159,25933,allow,436,254,182,7,15,4,3
55649,53593,32022,37169,32022,allow,320,140,180,6,6,3,3
55650,65338,53,10255,53,allow,314,88,226,4,44,2,2
55651,51509,443,60240,443,allow,1307,688,619,14,37,8,6
55652,50586,443,6357,443,allow,2756,1594,1162,20,27,11,9
55653,58703,50584,0,0,deny,66,66,0,1,0,1,0
55654,53004,445,0,0,drop,66,66,0,1,0,1,0
55655,53000,445,0,0,drop,66,66,0,1,0,1,0
55656,21892,15503,0,0,deny,62,62,0,1,0,1,0
55657,21145,11392,0,0,deny,62,62,0,1,0,1,0
55658,39895,26467,0,0,deny,62,62,0,1,0,1,0
55659,52604,445,0,0,drop,70,70,0,1,0,1,0
55660,52602,445,0,0,drop,70,70,0,1,0,1,0
55661,17320,14914,0,0,deny,148,148,0,1,0,1,0
55662,52600,445,0,0,drop,70,70,0,1,0,1,0
55663,62071,22114,0,0,deny,62,62,0,1,0,1,0
55664,56712,46824,0,0,deny,66,66,0,1,0,1,0
55665,60018,64147,0,0,deny,62,62,0,1,0,1,0
55666,57583,445,0,0,drop,70,70,0,1,0,1,0
55667,57581,445,0,0,drop,70,70,0,1,0,1,0
55668,52980,445,0,0,drop,66,66,0,1,0,1,0
55669,52986,445,0,0,drop,66,66,0,1,0,1,0
55670,52983,445,0,0,drop,66,66,0,1,0,1,0
55671,52981,445,0,0,drop,66,66,0,1,0,1,0
55672,52987,445,0,0,drop,66,66,0,1,0,1,0
55673,52988,445,0,0,drop,66,66,0,1,0,1,0
55674,52985,445,0,0,drop,66,66,0,1,0,1,0
55675,52984,445,0,0,drop,66,66,0,1,0,1,0
55676,53469,44847,0,0,deny,66,66,0,1,0,1,0
55677,10533,23,0,0,deny,60,60,0,1,0,1,0
55678,47962,16069,0,0,deny,62,62,0,1,0,1,0
55679,52593,445,0,0,drop,70,70,0,1,0,1,0
55680,52591,445,0,0,drop,70,70,0,1,0,1,0
55681,7905,48817,0,0,deny,146,146,0,1,0,1,0
55682,36906,50584,0,0,deny,62,62,0,1,0,1,0
55683,57579,445,0,0,drop,70,70,0,1,0,1,0
55684,57569,445,0,0,drop,70,70,0,1,0,1,0
55685,57566,445,0,0,drop,70,70,0,1,0,1,0
55686,52590,445,0,0,drop,70,70,0,1,0,1,0
55687,52589,445,0,0,drop,70,70,0,1,0,1,0
55688,52588,445,0,0,drop,70,70,0,1,0,1,0
55689,52968,445,0,0,drop,66,66,0,1,0,1,0
55690,52966,445,0,0,drop,66,66,0,1,0,1,0
55691,52965,445,0,0,drop,66,66,0,1,0,1,0
55692,52586,445,0,0,drop,70,70,0,1,0,1,0
55693,52583,445,0,0,drop,70,70,0,1,0,1,0
55694,62549,64147,0,0,deny,62,62,0,1,0,1,0
55695,58598,50584,0,0,deny,62,62,0,1,0,1,0
55696,443,28417,0,0,deny,82,82,0,1,0,1,0
55697,57562,445,0,0,drop,70,70,0,1,0,1,0
55698,50535,51505,0,0,deny,66,66,0,1,0,1,0
55699,62776,62413,0,0,deny,62,62,0,1,0,1,0
55700,32491,15503,0,0,deny,66,66,0,1,0,1,0
55701,49699,64147,0,0,deny,62,62,0,1,0,1,0
55702,17008,35440,0,0,deny,62,62,0,1,0,1,0
55703,54111,62609,0,0,deny,148,148,0,1,0,1,0
55704,64482,64147,0,0,deny,62,62,0,1,0,1,0
55705,57560,445,0,0,drop,70,70,0,1,0,1,0
55706,24411,12809,0,0,deny,60,60,0,1,0,1,0
55707,52570,445,0,0,drop,70,70,0,1,0,1,0
55708,52569,445,0,0,drop,70,70,0,1,0,1,0
55709,52565,445,0,0,drop,70,70,0,1,0,1,0
55710,57552,445,0,0,drop,70,70,0,1,0,1,0
55711,57550,445,0,0,drop,70,70,0,1,0,1,0
55712,57548,445,0,0,drop,70,70,0,1,0,1,0
55713,52559,445,0,0,drop,70,70,0,1,0,1,0
55714,52560,445,0,0,drop,70,70,0,1,0,1,0
55715,49664,37965,0,0,deny,66,66,0,1,0,1,0
55716,60196,53,0,0,deny,88,88,0,1,0,1,0
55717,55296,23718,0,0,deny,66,66,0,1,0,1,0
55718,12608,21247,0,0,deny,66,66,0,1,0,1,0
55719,57772,50584,0,0,deny,66,66,0,1,0,1,0
55720,29424,37807,0,0,deny,66,66,0,1,0,1,0
55721,60196,53,0,0,deny,88,88,0,1,0,1,0
55722,15274,81,0,0,deny,60,60,0,1,0,1,0
55723,58445,17500,0,0,deny,66,66,0,1,0,1,0
55724,31469,23,0,0,deny,60,60,0,1,0,1,0
55725,40971,1433,0,0,deny,60,60,0,1,0,1,0
55726,28668,8696,0,0,deny,60,60,0,1,0,1,0
55727,21833,22114,0,0,deny,62,62,0,1,0,1,0
55728,52548,445,0,0,drop,70,70,0,1,0,1,0
55729,37902,23718,0,0,deny,146,146,0,1,0,1,0
55730,57543,445,0,0,drop,70,70,0,1,0,1,0
55731,57540,445,0,0,drop,70,70,0,1,0,1,0
55732,57537,445,0,0,drop,70,70,0,1,0,1,0
55733,1176,64147,0,0,deny,62,62,0,1,0,1,0
55734,59592,37965,0,0,deny,62,62,0,1,0,1,0
55735,9412,7302,0,0,deny,66,66,0,1,0,1,0
55736,47910,7454,0,0,deny,60,60,0,1,0,1,0
55737,47910,7454,0,0,deny,60,60,0,1,0,1,0
55738,443,28417,0,0,deny,82,82,0,1,0,1,0
55739,63465,56205,0,0,deny,66,66,0,1,0,1,0
55740,42685,51180,0,0,deny,62,62,0,1,0,1,0
55741,18415,37965,0,0,deny,62,62,0,1,0,1,0
55742,52544,445,0,0,drop,70,70,0,1,0,1,0
55743,58995,443,49054,443,allow,8826,2860,5966,21,9,10,11
55744,26921,37965,0,0,deny,62,62,0,1,0,1,0
55745,37597,50584,0,0,deny,66,66,0,1,0,1,0
55746,51617,21247,0,0,deny,66,66,0,1,0,1,0
55747,59918,44847,0,0,deny,66,66,0,1,0,1,0
55748,36656,64147,0,0,deny,62,62,0,1,0,1,0
55749,52944,445,0,0,drop,66,66,0,1,0,1,0
55750,54343,50584,0,0,deny,66,66,0,1,0,1,0
55751,57533,445,0,0,drop,70,70,0,1,0,1,0
55752,57534,445,0,0,drop,70,70,0,1,0,1,0
55753,80,54605,0,0,deny,66,66,0,1,0,1,0
55754,54471,36237,0,0,deny,66,66,0,1,0,1,0
55755,52533,445,0,0,drop,70,70,0,1,0,1,0
55756,52535,445,0,0,drop,70,70,0,1,0,1,0
55757,52532,445,0,0,drop,70,70,0,1,0,1,0
55758,52531,445,0,0,drop,70,70,0,1,0,1,0
55759,52527,445,0,0,drop,70,70,0,1,0,1,0
55760,1323,64147,0,0,deny,66,66,0,1,0,1,0
55761,443,28417,0,0,deny,82,82,0,1,0,1,0
55762,0,0,0,0,deny,70,70,0,1,0,1,0
55763,0,0,0,0,allow,480,244,236,4,0,2,2
55764,0,0,0,0,deny,182,182,0,1,0,1,0
55765,48087,16069,0,0,deny,62,62,0,1,0,1,0
55766,52940,445,0,0,drop,66,66,0,1,0,1,0
55767,45941,23388,0,0,deny,60,60,0,1,0,1,0
55768,52936,445,0,0,drop,66,66,0,1,0,1,0
55769,16059,22114,0,0,deny,62,62,0,1,0,1,0
55770,57523,445,0,0,drop,70,70,0,1,0,1,0
55771,57515,445,0,0,drop,70,70,0,1,0,1,0
55772,57514,445,0,0,drop,70,70,0,1,0,1,0
55773,57511,445,0,0,drop,70,70,0,1,0,1,0
55774,52522,445,0,0,drop,70,70,0,1,0,1,0
55775,52933,445,0,0,drop,66,66,0,1,0,1,0
55776,61315,48817,0,0,deny,62,62,0,1,0,1,0
55777,57508,445,0,0,drop,70,70,0,1,0,1,0
55778,52514,445,0,0,drop,70,70,0,1,0,1,0
55779,57283,64147,0,0,deny,66,66,0,1,0,1,0
55780,52511,445,0,0,drop,70,70,0,1,0,1,0
55781,57505,445,0,0,drop,70,70,0,1,0,1,0
55782,57504,445,0,0,drop,70,70,0,1,0,1,0
55783,57501,445,0,0,drop,70,70,0,1,0,1,0
55784,20378,23,0,0,deny,60,60,0,1,0,1,0
55785,52926,445,0,0,drop,66,66,0,1,0,1,0
55786,39359,15503,0,0,deny,74,74,0,1,0,1,0
55787,52920,445,0,0,drop,66,66,0,1,0,1,0
55788,52923,445,0,0,drop,66,66,0,1,0,1,0
55789,52919,445,0,0,drop,66,66,0,1,0,1,0
55790,64890,51180,0,0,deny,62,62,0,1,0,1,0
55791,52916,445,0,0,drop,66,66,0,1,0,1,0
55792,52917,445,0,0,drop,66,66,0,1,0,1,0
55793,52915,445,0,0,drop,66,66,0,1,0,1,0
55794,52508,445,0,0,drop,70,70,0,1,0,1,0
55795,31521,57470,0,0,deny,145,145,0,1,0,1,0
55796,52506,445,0,0,drop,70,70,0,1,0,1,0
55797,45908,33330,0,0,deny,60,60,0,1,0,1,0
55798,443,28417,0,0,deny,82,82,0,1,0,1,0
55799,52743,15503,0,0,deny,66,66,0,1,0,1,0
55800,30046,15503,0,0,deny,62,62,0,1,0,1,0
55801,61420,64097,0,0,deny,66,66,0,1,0,1,0
55802,11252,23,0,0,deny,60,60,0,1,0,1,0
55803,57498,445,0,0,drop,70,70,0,1,0,1,0
55804,57499,445,0,0,drop,70,70,0,1,0,1,0
55805,57496,445,0,0,drop,70,70,0,1,0,1,0
55806,52910,445,0,0,drop,66,66,0,1,0,1,0
55807,52502,445,0,0,drop,70,70,0,1,0,1,0
55808,64516,53,13798,53,allow,216,110,106,2,30,1,1
55809,37133,80,37133,80,allow,12799,979,11820,20,17,9,11
55810,57896,443,11349,443,allow,7332,3746,3586,37,176,19,18
55811,51269,36983,55294,36983,allow,70,70,0,2,8,2,0
55812,59819,443,17243,443,allow,1401,864,537,12,29,6,6
55813,63204,443,63204,443,allow,9340,4256,5084,24,16,13,11
55814,40791,443,54664,443,allow,7236,2069,5167,25,25,12,13
55815,57893,443,16617,443,allow,1867,1228,639,18,176,11,7
55816,55943,53,5113,53,allow,1415,94,1321,4,31,2,2
55817,53584,62974,25990,62974,allow,70,70,0,2,8,2,0
55818,49217,53,12085,53,allow,202,103,99,2,31,1,1
55819,49374,53,54400,53,allow,186,95,91,2,31,1,1
55820,55101,53,27553,53,allow,194,99,95,2,30,1,1
55821,35048,80,62136,80,allow,15867,2466,13401,29,33,16,13
55822,53587,32029,60710,32029,allow,70,70,0,2,8,2,0
55823,51780,21130,9712,21130,allow,70,70,0,2,8,2,0
55824,53567,43167,28309,43167,allow,492,306,186,8,16,5,3
55825,65300,53,37068,53,allow,190,97,93,2,31,1,1
55826,59823,443,61551,443,allow,306,180,126,6,29,4,2
55827,51782,10637,37366,10637,allow,70,70,0,2,8,2,0
55828,34166,443,49916,443,allow,8290,2156,6134,24,81,14,10
55829,56611,443,45204,443,allow,7983,1963,6020,20,15,11,9
55830,57884,443,2033,443,allow,3981,1811,2170,26,177,14,12
55831,56809,53,64424,53,allow,172,88,84,2,31,1,1
55832,55364,53,1221,53,allow,168,86,82,2,31,1,1
55833,53564,63344,20702,63344,allow,1721,971,750,15,16,8,7
55834,56610,443,4585,443,allow,8035,2015,6020,20,16,11,9
55835,35567,443,35567,443,allow,5413,2166,3247,22,39,13,9
55836,64680,53,32256,53,allow,768,99,669,2,30,1,1
55837,44913,443,18458,443,allow,414,140,274,7,27,3,4
55838,56612,443,41735,443,allow,8033,2013,6020,20,15,11,9
55839,58992,443,6436,443,allow,3049,1857,1192,20,21,9,11
55840,46684,80,18811,80,allow,4294,1112,3182,15,199,4,11
55841,46982,443,35062,443,allow,3847,2650,1197,22,35,13,9
55842,59817,443,40958,443,allow,1401,864,537,12,29,6,6
55843,59836,443,19606,443,allow,1587,924,663,15,27,7,8
55844,51781,43909,29947,43909,allow,70,70,0,2,8,2,0
55845,53580,48066,41215,48066,allow,70,70,0,2,8,2,0
55846,55655,53,48004,53,allow,304,110,194,4,35,2,2
55847,49888,53,54251,53,allow,196,100,96,2,30,1,1
55848,43597,443,44647,443,allow,47048,9293,37755,63,412,28,35
55849,53246,443,15204,443,allow,134,60,74,3,11,2,1
55850,57901,443,18752,443,allow,3924,1906,2018,26,170,14,12
55851,57892,443,36599,443,allow,6394,3923,2471,42,176,22,20
55852,57905,443,45669,443,allow,1851,1152,699,18,169,10,8
55853,57900,443,44556,443,allow,1798,1159,639,17,170,10,7
55854,50376,53,65518,53,allow,164,84,80,2,31,1,1
55855,64417,53,46438,53,allow,184,94,90,2,31,1,1
55856,55675,53,52778,53,allow,764,99,665,2,31,1,1
55857,54956,53,34992,53,allow,188,96,92,2,31,1,1
55858,44482,443,27809,443,allow,16517,3254,13263,37,271,18,19
55859,34165,443,5648,443,allow,8208,2080,6128,24,81,14,10
55860,45273,53,45273,53,allow,213,79,134,2,32,1,1
55861,39207,80,25613,80,allow,78,78,0,1,5,1,0
55862,57885,443,33287,443,allow,1792,1153,639,17,177,10,7
55863,57904,443,36166,443,allow,4042,2515,1527,28,169,14,14
55864,59818,443,31542,443,allow,1401,864,537,12,29,6,6
55865,57877,443,6198,443,allow,9256443,112898,9143545,7609,178,1428,6181
55866,53579,59332,37605,59332,allow,70,70,0,2,8,2,0
55867,65411,53,35148,53,allow,771,101,670,2,30,1,1
55868,49841,53,53641,53,allow,751,95,656,2,30,1,1
55869,57897,443,36818,443,allow,1865,1226,639,18,176,11,7
55870,64815,53,23371,53,allow,755,94,661,2,30,1,1
55871,56601,53,60579,53,allow,168,78,90,2,30,1,1
55872,64001,53,5288,53,allow,182,93,89,2,30,1,1
55873,56391,53,63935,53,allow,758,93,665,2,31,1,1
55874,55171,53,26173,53,allow,762,97,665,2,31,1,1
55875,65334,443,56103,443,allow,3182,1568,1614,8,120,4,4
55876,43585,443,18767,443,allow,6636,3565,3071,22,187,13,9
55877,64595,53,64819,53,allow,166,85,81,2,31,1,1
55878,55147,53,27402,53,allow,184,94,90,2,31,1,1
55879,64903,53,49771,53,allow,777,87,690,2,31,1,1
55880,52169,443,53007,443,allow,7905,4819,3086,27,139,13,14
55881,56919,53,19863,53,allow,186,95,91,2,31,1,1
55882,5938,51883,0,0,allow,60,60,0,1,91,1,0
55883,5938,16167,0,0,allow,60,60,0,1,91,1,0
55884,55802,443,44281,443,allow,30007,2755,27252,41,136,16,25
55885,56557,53,31623,53,allow,212,108,104,2,31,1,1
55886,56312,53,44683,53,allow,756,95,661,2,31,1,1
55887,55077,53,1629,53,allow,174,89,85,2,31,1,1
55888,64287,53,20763,53,allow,178,91,87,2,31,1,1
55889,55217,53,15991,53,allow,744,89,655,2,31,1,1
55890,57252,53,46137,53,allow,182,93,89,2,31,1,1
55891,56926,53,49989,53,allow,747,93,654,2,31,1,1
55892,21594,22448,0,0,allow,62,62,0,1,61,1,0
55893,5938,39160,0,0,allow,60,60,0,1,91,1,0
55894,54993,53,53914,53,allow,751,95,656,2,31,1,1
55895,5938,35844,0,0,allow,60,60,0,1,91,1,0
55896,64924,53,58224,53,allow,747,93,654,2,31,1,1
55897,56227,53,18236,53,allow,174,89,85,2,31,1,1
55898,64715,53,60812,53,allow,202,103,99,2,31,1,1
55899,65246,53,4675,53,allow,182,93,89,2,31,1,1
55900,65246,53,34223,53,allow,182,93,89,2,31,1,1
55901,49901,53,35015,53,allow,186,95,91,2,31,1,1
55902,55604,53,44456,53,allow,758,93,665,2,31,1,1
55903,43472,5228,13384,5228,allow,2531,1416,1115,17,3600,8,9
55904,57492,445,0,0,drop,70,70,0,1,0,1,0
55905,52909,445,0,0,drop,66,66,0,1,0,1,0
55906,49805,6881,0,0,deny,66,66,0,1,0,1,0
55907,34176,51505,0,0,deny,62,62,0,1,0,1,0
55908,46478,64147,0,0,deny,145,145,0,1,0,1,0
55909,51837,37965,0,0,deny,66,66,0,1,0,1,0
55910,58022,8800,0,0,deny,60,60,0,1,0,1,0
55911,52905,445,0,0,drop,66,66,0,1,0,1,0
55912,52907,445,0,0,drop,66,66,0,1,0,1,0
55913,44594,64147,0,0,deny,66,66,0,1,0,1,0
55914,11648,37965,0,0,deny,145,145,0,1,0,1,0
55915,52501,445,0,0,drop,70,70,0,1,0,1,0
55916,58338,3369,0,0,deny,60,60,0,1,0,1,0
55917,54575,11392,0,0,deny,66,66,0,1,0,1,0
55918,52903,445,0,0,drop,66,66,0,1,0,1,0
55919,42252,33303,0,0,deny,60,60,0,1,0,1,0
55920,28973,30188,0,0,deny,66,66,0,1,0,1,0
55921,57484,445,0,0,drop,70,70,0,1,0,1,0
55922,56609,53,42819,53,allow,199,102,97,2,31,1,1
55923,49573,53,10183,53,allow,770,102,668,2,30,1,1
55924,51763,34121,50527,34121,allow,70,70,0,1,5,1,0
55925,25629,28678,25311,28678,allow,1806,1806,0,22,225,22,0
55926,61345,21247,0,0,deny,66,66,0,1,0,1,0
55927,52496,445,0,0,drop,70,70,0,1,0,1,0
55928,29109,11392,0,0,deny,146,146,0,1,0,1,0
55929,57482,445,0,0,drop,70,70,0,1,0,1,0
55930,57477,445,0,0,drop,70,70,0,1,0,1,0
55931,28498,36237,0,0,deny,62,62,0,1,0,1,0
55932,443,56117,0,0,deny,97,97,0,1,0,1,0
55933,7222,57470,0,0,deny,62,62,0,1,0,1,0
55934,50788,48817,0,0,deny,62,62,0,1,0,1,0
55935,52895,445,0,0,drop,66,66,0,1,0,1,0
55936,11816,50584,0,0,deny,66,66,0,1,0,1,0
55937,52885,445,0,0,drop,66,66,0,1,0,1,0
55938,53553,443,31063,443,allow,3708,1988,1720,20,255,10,10
55939,57898,443,41076,443,allow,240332,6623,233709,258,170,92,166
55940,41699,443,36765,443,allow,40273,3243,37030,60,77,28,32
55941,41689,443,36583,443,allow,1307513,51701,1255812,1486,148,576,910
55942,56344,53,55607,53,allow,167,86,81,2,30,1,1
55943,56430,53,61403,53,allow,193,102,91,2,30,1,1
55944,62880,53,59831,53,allow,248,78,170,2,30,1,1
55945,55336,53,49932,53,allow,199,102,97,2,30,1,1
55946,55273,53,29396,53,allow,167,86,81,2,30,1,1
55947,56082,53,4620,53,allow,182,94,88,2,30,1,1
55948,64945,53,44242,53,allow,243,94,149,2,30,1,1
55949,51342,53,21697,53,allow,199,94,105,2,30,1,1
55950,56609,53,65200,53,allow,199,102,97,2,30,1,1
55951,51512,443,52808,443,allow,626132,21332,604800,730,33,294,436
55952,48304,443,22064,443,allow,6606,2153,4453,22,95,13,9
55953,37695,443,3343,443,allow,1134364,30994,1103370,1170,175,403,767
55954,55113,53,62881,53,allow,198,102,96,2,33,1,1
55955,12945,53,12945,53,allow,233,90,143,2,32,1,1
55956,49176,53,50257,53,allow,528,178,350,6,43,3,3
55957,57890,443,58945,443,allow,3588,1991,1597,27,176,14,13
55958,49433,53,5828,53,allow,167,86,81,2,29,1,1
55959,55776,53,11863,53,allow,216,110,106,2,29,1,1
55960,65138,53,38637,53,allow,765,102,663,2,30,1,1
55961,55988,443,19724,443,allow,14754,7879,6875,37,231,20,17
55962,61363,80,43167,80,allow,1931,752,1179,15,16,8,7
55963,52212,80,6091,80,allow,366,246,120,6,34,4,2
55964,51506,443,52823,443,allow,584947,21842,563105,678,36,286,392
55965,60045,443,35524,443,allow,17161,1619,15542,18,151,4,14
55966,53578,34129,11045,34129,allow,70,70,0,2,7,2,0
55967,56615,80,9225,80,allow,234,234,0,4,11,4,0
55968,51759,55308,19017,55308,allow,70,70,0,1,5,1,0
55969,50531,80,18243,80,allow,1704,799,905,11,83,6,5
55970,50519,443,37665,443,allow,7967,1647,6320,25,85,14,11
55971,64551,53,37333,53,allow,495,127,368,4,33,2,2
55972,50513,443,44199,443,allow,9766,1810,7956,30,86,16,14
55973,51758,31009,29940,31009,allow,70,70,0,1,5,1,0
55974,50604,443,64927,443,allow,1385,783,602,14,23,8,6
55975,51761,19136,25240,19136,allow,70,70,0,1,5,1,0
55976,50602,443,61178,443,allow,3901,1858,2043,19,23,11,8
55977,55615,53,40819,53,allow,225,110,115,2,30,1,1
55978,57257,53,4922,53,allow,173,94,79,2,30,1,1
55979,65285,53,31109,53,allow,294,102,192,2,30,1,1
55980,53017,443,37363,443,allow,15038,4142,10896,48,108,24,24
55981,49456,443,44613,443,allow,939,547,392,11,27,5,6
55982,50022,443,50896,443,allow,70,70,0,2,5,2,0
55983,53028,80,62533,80,allow,70,70,0,1,5,1,0
55984,51760,36558,34247,36558,allow,70,70,0,1,5,1,0
55985,36464,443,36464,443,allow,4373,1466,2907,19,29,11,8
55986,57903,443,52416,443,allow,5465,2653,2812,28,169,14,14
55987,51925,443,7342,443,allow,16797,8530,8267,53,82,30,23
55988,57883,443,47068,443,allow,1786,1147,639,17,177,10,7
55989,50459,53,40007,53,allow,811,94,717,2,30,1,1
55990,49993,53,48809,53,allow,212,102,110,2,30,1,1
55991,55293,53,0,0,allow,166,73,93,2,30,1,1
55992,56186,53,36968,53,allow,198,102,96,2,30,1,1
55993,56809,53,35484,53,allow,178,94,84,2,30,1,1
55994,65246,53,13640,53,allow,767,102,665,2,30,1,1
55995,50542,443,1665,443,allow,5779,1472,4307,22,78,12,10
55996,59828,443,44871,443,allow,306,180,126,6,29,4,2
55997,49851,53,2859,53,allow,306,88,218,4,32,2,2
55998,55480,53,36431,53,allow,378,97,281,4,33,2,2
55999,57872,443,43316,443,allow,183325,10358,172967,289,227,95,194
56000,60397,43129,42698,43129,allow,70,70,0,1,5,1,0
56001,53092,443,13048,443,allow,97276,2756,94520,96,96,21,75
56002,57889,443,40826,443,allow,1851,1212,639,18,177,11,7
56003,56344,53,18094,53,allow,167,86,81,2,30,1,1
56004,56673,443,49966,443,allow,5726,1474,4252,22,81,13,9
56005,50831,443,11343,443,allow,721741,131746,589995,1518,322,787,731
56006,62034,53,62034,53,allow,216,90,126,2,30,1,1
56007,57259,53,43508,53,allow,199,102,97,2,30,1,1
56008,59832,443,5609,443,allow,302,120,182,6,28,3,3
56009,55336,53,7329,53,allow,199,102,97,2,30,1,1
56010,65484,53,31170,53,allow,195,102,93,2,30,1,1
56011,55655,53,10525,53,allow,304,110,194,4,34,2,2
56012,57186,53,41154,53,allow,177,94,83,2,30,1,1
56013,56962,53,9664,53,allow,177,94,83,2,30,1,1
56014,55600,80,5814,80,allow,70,70,0,1,5,1,0
56015,65484,53,32858,53,allow,195,102,93,2,30,1,1
56016,57891,443,65008,443,allow,1856,1217,639,18,176,11,7
56017,55240,53,36394,53,allow,816,102,714,2,30,1,1
56018,64936,53,3056,53,allow,193,102,91,2,30,1,1
56019,41700,443,15367,443,allow,167721,6935,160786,185,77,68,117
56020,49217,53,36290,53,allow,209,110,99,2,30,1,1
56021,53053,443,10274,443,allow,9303,2569,6734,39,106,20,19
56022,53036,443,40328,443,allow,249145,4184,244961,218,107,40,178
56023,51466,4545,51466,4545,allow,156,156,0,3,8,3,0
56024,57888,443,55452,443,allow,113115,8327,104788,184,177,77,107
56025,55454,53,25468,53,allow,209,110,99,2,30,1,1
56026,55273,53,29948,53,allow,167,86,81,2,30,1,1
56027,57186,53,42967,53,allow,177,94,83,2,30,1,1
56028,64516,53,8350,53,allow,216,110,106,2,30,1,1
56029,64652,53,53769,53,allow,198,94,104,2,30,1,1
56030,55077,53,42307,53,allow,179,94,85,2,30,1,1
56031,57369,16881,7618,16881,allow,564,318,246,9,15,5,4
56032,56569,53,5839,53,allow,181,94,87,2,32,1,1
56033,57894,443,52904,443,allow,4544,1112,3432,21,176,12,9
56034,49492,80,50602,80,allow,1680,1210,470,9,15,5,4
56035,49449,443,30580,443,allow,1574,921,653,14,15,7,7
56036,12136,53,12136,53,allow,198,90,108,2,30,1,1
56037,41674,443,45032,443,allow,14424911,433341,13991570,15454,320,5482,9972
56038,53240,443,16717,443,allow,1296713,27754,1268959,1253,118,366,887
56039,55375,53,8307,53,allow,214,110,104,2,30,1,1
56040,55375,53,30516,53,allow,214,110,104,2,30,1,1
56041,36405,53,36515,53,allow,199,94,105,2,30,1,1
56042,49888,53,39344,53,allow,198,102,96,2,30,1,1
56043,55240,53,47282,53,allow,193,102,91,2,30,1,1
56044,50039,53,19771,53,allow,261,110,151,2,30,1,1
56045,64595,53,62622,53,allow,167,86,81,2,30,1,1
56046,60280,443,7130,443,allow,46713,2661,44052,55,120,21,34
56047,45871,443,58048,443,allow,275011,235921,39090,651,350,363,288
56048,56557,53,41528,53,allow,214,110,104,2,30,1,1
56049,37815,443,28606,443,allow,6226,4834,1392,17,125,11,6
56050,64002,53,17468,53,allow,796,105,691,4,59,2,2
56051,55273,53,49246,53,allow,317,85,232,4,60,2,2
56052,49374,53,36144,53,allow,193,102,91,2,30,1,1
56053,51507,443,1531,443,allow,584465,23057,561408,694,36,303,391
56054,40453,443,6651,443,allow,5655,1614,4041,22,30,11,11
56055,35965,443,31855,443,allow,3821,2814,1007,22,17,12,10
56056,52188,443,37924,443,allow,1768,1034,734,16,65,8,8
56057,50511,443,12647,443,allow,6352,1073,5279,22,85,12,10
56058,51516,443,35060,443,allow,1195,634,561,12,21,7,5
56059,51511,443,55401,443,allow,213140,10321,202819,260,33,108,152
56060,50518,443,9409,443,allow,7117,1288,5829,22,84,12,10
56061,53589,40281,13610,40281,allow,70,70,0,2,7,2,0
56062,65469,443,41637,443,allow,92958,4869,88089,109,15,44,65
56063,50514,443,24194,443,allow,11554,3028,8526,34,86,19,15
56064,51498,443,13741,443,allow,134,60,74,3,4,2,1
56065,49345,443,4175,443,allow,61954,10029,51925,114,82,50,64
56066,55655,53,55322,53,allow,304,110,194,4,34,2,2
56067,58027,80,53632,80,allow,1225,711,514,11,15,5,6
56068,55113,53,41095,53,allow,198,102,96,2,29,1,1
56069,55981,53,55529,53,allow,168,78,90,2,30,1,1
56070,51778,60565,25061,60565,allow,70,70,0,2,8,2,0
56071,64980,53,10354,53,allow,200,102,98,2,29,1,1
56072,56935,53,38764,53,allow,179,94,85,2,30,1,1
56073,55375,53,47639,53,allow,214,110,104,2,30,1,1
56074,53016,443,45563,443,allow,50403,2032,48371,66,108,21,45
56075,53583,15354,6378,15354,allow,70,70,0,2,7,2,0
56076,57464,80,36285,80,allow,234,234,0,4,11,4,0
56077,55776,53,40395,53,allow,216,110,106,2,29,1,1
56078,50023,443,17571,443,allow,70,70,0,2,5,2,0
56079,56186,53,3994,53,allow,198,102,96,2,29,1,1
56080,51762,12747,31596,12747,allow,70,70,0,1,5,1,0
56081,64001,53,52493,53,allow,183,94,89,2,29,1,1
56082,64936,53,55896,53,allow,816,102,714,2,30,1,1
56083,65036,53,38858,53,allow,214,110,104,2,29,1,1
56084,49608,53,63386,53,allow,198,110,88,2,29,1,1
56085,64309,53,10386,53,allow,308,94,214,2,30,1,1
56086,55439,53,53595,53,allow,209,110,99,2,29,1,1
56087,57895,443,60971,443,allow,10639,4680,5959,53,176,24,29
56088,64516,53,41634,53,allow,216,110,106,2,30,1,1
56089,63978,53,35845,53,allow,214,110,104,2,30,1,1
56090,56919,53,23336,53,allow,193,102,91,2,30,1,1
56091,45637,443,46378,443,allow,6701,3487,3214,35,196,19,16
56092,55826,53,22161,53,allow,168,86,82,2,30,1,1
56093,55735,53,20718,53,allow,184,94,90,2,30,1,1
56094,64714,53,62163,53,allow,289,134,155,2,30,1,1
56095,58754,53,0,0,allow,258,80,178,2,30,1,1
56096,50458,53,16491,53,allow,458,188,270,6,30,3,3
56097,51543,53,3333,53,allow,78,78,0,1,30,1,0
56098,64839,53,30697,53,allow,443,182,261,6,30,3,3
56099,49259,53,28989,53,allow,168,86,82,2,30,1,1
56100,56246,53,33774,53,allow,209,110,99,2,30,1,1
56101,50121,53,5203,53,allow,152,78,74,2,30,1,1
56102,64287,53,8601,53,allow,181,94,87,2,31,1,1
56103,65420,53,28650,53,allow,166,86,80,2,31,1,1
56104,41690,443,19019,443,allow,1478937,62961,1415976,1678,148,649,1029
56105,54085,443,49010,443,allow,4128,1929,2199,38,48,21,17
56106,64780,443,53095,443,allow,70785,3306,67479,99,80,34,65
56107,51779,49525,24742,49525,allow,70,70,0,2,8,2,0
56108,56779,43137,15198,43137,allow,70,70,0,1,5,1,0
56109,64085,53,10076,53,allow,351,102,249,4,43,2,2
56110,57899,443,40248,443,allow,6115,1035,5080,21,170,11,10
56111,49448,443,34233,443,allow,1574,921,653,14,15,7,7
56112,56430,53,37979,53,allow,193,102,91,2,30,1,1
56113,65429,53,14191,53,allow,200,94,106,2,30,1,1
56114,65265,53,37973,53,allow,821,102,719,2,30,1,1
56115,56072,53,56771,53,allow,199,102,97,2,30,1,1
56116,49693,443,16419,443,allow,12060,4857,7203,25,71,14,11
56117,65192,53,25403,53,allow,249,102,147,2,30,1,1
56118,55364,53,12032,53,allow,168,86,82,2,30,1,1
56119,56962,53,9303,53,allow,177,94,83,2,30,1,1
56120,56252,443,19925,443,allow,6728,1775,4953,25,275,13,12
56121,55918,53,38281,53,allow,184,94,90,2,31,1,1
56122,36826,443,2632,443,allow,6040,1612,4428,21,255,12,9
56123,50636,443,49176,443,allow,7332,1611,5721,17,15,9,8
56124,57902,443,7313,443,allow,1912,1213,699,19,169,11,8
56125,57881,443,48213,443,allow,3486,2064,1422,26,177,14,12
56126,39921,80,15019,80,allow,1151,711,440,10,15,5,5
56127,50420,80,36435,80,allow,5048,4344,704,11,26,6,5
56128,50076,80,31297,80,allow,1052,612,440,10,15,5,5
56129,56072,53,61103,53,allow,199,102,97,2,30,1,1
56130,46827,443,46276,443,allow,8277,1368,6909,31,120,14,17
56131,57882,443,30006,443,allow,22342,1787,20555,38,177,16,22
56132,57880,443,33669,443,allow,1868,1229,639,18,177,11,7
56133,61362,443,33042,443,allow,8167,2671,5496,22,69,11,11
56134,43735,53,12080,53,allow,168,78,90,2,30,1,1
56135,58754,53,0,0,allow,627,80,547,2,30,1,1
56136,56082,53,27828,53,allow,182,94,88,2,30,1,1
56137,64417,53,4241,53,allow,184,94,90,2,30,1,1
56138,59237,53,43242,53,allow,164,78,86,2,30,1,1
56139,49246,53,24337,53,allow,779,86,693,2,30,1,1
56140,55101,53,1606,53,allow,197,102,95,2,30,1,1
56141,56033,443,32455,443,allow,3250,1058,2192,13,136,6,7
56142,49439,53,56004,53,allow,197,102,95,2,31,1,1
56143,49972,53,23300,53,allow,184,94,90,2,30,1,1
56144,55100,53,1559,53,allow,178,94,84,2,30,1,1
56145,56246,53,1913,53,allow,209,110,99,2,30,1,1
56146,49217,53,2129,53,allow,209,110,99,2,31,1,1
56147,54956,53,14576,53,allow,194,102,92,2,31,1,1
56148,49597,53,63650,53,allow,168,86,82,2,31,1,1
56149,56765,53,27082,53,allow,194,102,92,2,31,1,1
56150,49667,53,65196,53,allow,183,94,89,2,30,1,1
56151,49374,53,45816,53,allow,193,102,91,2,30,1,1
56152,41002,53,33121,53,allow,164,78,86,2,30,1,1
56153,49365,53,39023,53,allow,195,102,93,2,30,1,1
56154,64041,53,58555,53,allow,200,102,98,2,31,1,1
56155,49794,53,12589,53,allow,197,102,95,2,30,1,1
56156,56026,53,4908,53,allow,183,94,89,2,31,1,1
56157,50376,53,23494,53,allow,166,86,80,2,31,1,1
56158,55100,53,26652,53,allow,178,94,84,2,31,1,1
56159,65300,53,18303,53,allow,195,102,93,2,31,1,1
56160,58856,443,16403,443,allow,4005,1421,2584,14,136,7,7
56161,45493,5223,26430,5223,allow,4196,1378,2818,21,3002,12,9
56162,19473,32332,63968,32332,allow,481,150,331,2,1200,1,1
56163,48894,53,34771,53,allow,164,78,86,2,31,1,1
56164,50121,53,43532,53,allow,152,78,74,2,31,1,1
56165,56223,53,58545,53,allow,185,102,83,2,31,1,1
56166,64323,53,30451,53,allow,195,102,93,2,31,1,1
56167,44076,443,35127,443,allow,202384,47621,154763,307,198,112,195
56168,15503,37512,24044,37512,allow,528,528,0,9,1199,9,0
56169,64417,53,37642,53,allow,184,94,90,2,31,1,1
56170,60016,443,40510,443,allow,134,60,74,3,6,2,1
56171,64732,53,52596,53,allow,189,102,87,2,30,1,1
56172,57015,53,61760,53,allow,279,94,185,2,30,1,1
56173,51090,53,42988,53,allow,164,78,86,2,30,1,1
56174,57094,53,61596,53,allow,196,102,94,2,30,1,1
56175,55364,53,21776,53,allow,168,86,82,2,31,1,1
56176,56962,53,40705,53,allow,177,94,83,2,31,1,1
56177,59816,443,30172,443,allow,622,310,312,11,29,6,5
56178,51955,443,64636,443,allow,8390,1525,6865,24,26,11,13
56179,50862,443,14909,443,allow,9930,2085,7845,21,318,11,10
56180,33244,443,30372,443,allow,4239,2487,1752,19,16,11,8
56181,49399,80,18487,80,allow,4382,2084,2298,18,66,10,8
56182,49397,80,15765,80,allow,4382,2084,2298,18,66,10,8
56183,57906,443,49224,443,allow,9316,3279,6037,39,186,20,19
56184,60194,80,35341,80,allow,70,70,0,2,8,2,0
56185,33240,443,43731,443,allow,7375,4769,2606,24,16,14,10
56186,49794,53,1835,53,allow,197,102,95,2,30,1,1
56187,64516,53,9042,53,allow,216,110,106,2,30,1,1
56188,49259,53,59958,53,allow,184,102,82,2,30,1,1
56189,49183,53,24061,53,allow,209,110,99,2,31,1,1
56190,57466,445,0,0,drop,70,70,0,1,0,1,0
56191,52483,445,0,0,drop,70,70,0,1,0,1,0
56192,19570,50584,0,0,deny,62,62,0,1,0,1,0
56193,51693,22114,0,0,deny,62,62,0,1,0,1,0
56194,22583,9822,0,0,deny,62,62,0,1,0,1,0
56195,22724,9822,0,0,deny,66,66,0,1,0,1,0
56196,52480,445,0,0,drop,70,70,0,1,0,1,0
56197,52883,445,0,0,drop,66,66,0,1,0,1,0
56198,52459,33890,0,0,deny,60,60,0,1,0,1,0
56199,52876,445,0,0,drop,66,66,0,1,0,1,0
56200,53355,23117,0,0,deny,66,66,0,1,0,1,0
56201,52870,445,0,0,drop,66,66,0,1,0,1,0
56202,52475,445,0,0,drop,70,70,0,1,0,1,0
56203,62767,57470,0,0,deny,74,74,0,1,0,1,0
56204,11983,57470,0,0,deny,62,62,0,1,0,1,0
56205,54631,44847,0,0,deny,70,70,0,1,0,1,0
56206,52474,445,0,0,drop,70,70,0,1,0,1,0
56207,49160,31652,0,0,reset-both,146,146,0,1,0,1,0
56208,18172,23,0,0,deny,60,60,0,1,0,1,0
56209,52472,445,0,0,drop,70,70,0,1,0,1,0
56210,25101,50584,0,0,deny,146,146,0,1,0,1,0
56211,27442,44847,0,0,deny,62,62,0,1,0,1,0
56212,56778,35440,0,0,deny,62,62,0,1,0,1,0
56213,14872,23,0,0,deny,60,60,0,1,0,1,0
56214,57455,445,0,0,drop,70,70,0,1,0,1,0
56215,57452,445,0,0,drop,70,70,0,1,0,1,0
56216,57453,445,0,0,drop,70,70,0,1,0,1,0
56217,25565,62778,0,0,deny,60,60,0,1,0,1,0
56218,52854,445,0,0,drop,66,66,0,1,0,1,0
56219,52860,445,0,0,drop,66,66,0,1,0,1,0
56220,52855,445,0,0,drop,66,66,0,1,0,1,0
56221,52856,445,0,0,drop,66,66,0,1,0,1,0
56222,52857,445,0,0,drop,66,66,0,1,0,1,0
56223,52859,445,0,0,drop,66,66,0,1,0,1,0
56224,52852,445,0,0,drop,66,66,0,1,0,1,0
56225,52853,445,0,0,drop,66,66,0,1,0,1,0
56226,42951,44847,0,0,deny,66,66,0,1,0,1,0
56227,54773,50584,0,0,deny,66,66,0,1,0,1,0
56228,6980,48543,0,0,deny,139,139,0,1,0,1,0
56229,54684,37965,0,0,deny,62,62,0,1,0,1,0
56230,64279,23718,0,0,deny,62,62,0,1,0,1,0
56231,52465,445,0,0,drop,70,70,0,1,0,1,0
56232,53166,61600,0,0,deny,66,66,0,1,0,1,0
56233,52463,445,0,0,drop,70,70,0,1,0,1,0
56234,45964,2666,0,0,deny,60,60,0,1,0,1,0
56235,9095,22114,0,0,deny,62,62,0,1,0,1,0
56236,7444,57470,0,0,deny,66,66,0,1,0,1,0
56237,48180,143,0,0,deny,60,60,0,1,0,1,0
56238,53783,443,19626,443,allow,499,425,74,4,0,3,1
56239,53782,443,62733,443,allow,499,425,74,4,0,3,1
56240,62678,57470,0,0,deny,62,62,0,1,0,1,0
56241,52462,445,0,0,drop,70,70,0,1,0,1,0
56242,52461,445,0,0,drop,70,70,0,1,0,1,0
56243,32395,30188,0,0,deny,62,62,0,1,0,1,0
56244,57447,445,0,0,drop,70,70,0,1,0,1,0
56245,57442,445,0,0,drop,70,70,0,1,0,1,0
56246,57441,445,0,0,drop,70,70,0,1,0,1,0
56247,52460,445,0,0,drop,70,70,0,1,0,1,0
56248,52454,445,0,0,drop,70,70,0,1,0,1,0
56249,52457,445,0,0,drop,70,70,0,1,0,1,0
56250,14082,50584,0,0,deny,62,62,0,1,0,1,0
56251,6712,5632,0,0,deny,60,60,0,1,0,1,0
56252,52838,445,0,0,drop,66,66,0,1,0,1,0
56253,52840,445,0,0,drop,66,66,0,1,0,1,0
56254,52837,445,0,0,drop,66,66,0,1,0,1,0
56255,48706,23393,0,0,deny,60,60,0,1,0,1,0
56256,55254,50584,0,0,deny,66,66,0,1,0,1,0
56257,28668,8696,0,0,deny,60,60,0,1,0,1,0
56258,57434,445,0,0,drop,70,70,0,1,0,1,0
56259,60875,56205,0,0,deny,66,66,0,1,0,1,0
56260,52442,445,0,0,drop,70,70,0,1,0,1,0
56261,52441,445,0,0,drop,70,70,0,1,0,1,0
56262,52439,445,0,0,drop,70,70,0,1,0,1,0
56263,80,37649,0,0,deny,60,60,0,1,0,1,0
56264,53105,42707,0,0,deny,66,66,0,1,0,1,0
56265,52432,445,0,0,drop,70,70,0,1,0,1,0
56266,52431,445,0,0,drop,70,70,0,1,0,1,0
56267,57432,445,0,0,drop,70,70,0,1,0,1,0
56268,20,17095,0,0,deny,554,554,0,1,0,1,0
56269,37008,42707,0,0,deny,62,62,0,1,0,1,0
56270,57427,445,0,0,drop,70,70,0,1,0,1,0
56271,57426,445,0,0,drop,70,70,0,1,0,1,0
56272,57421,445,0,0,drop,70,70,0,1,0,1,0
56273,27446,30188,0,0,deny,66,66,0,1,0,1,0
56274,80,53945,0,0,deny,60,60,0,1,0,1,0
56275,61241,22114,0,0,deny,66,66,0,1,0,1,0
56276,56453,37965,0,0,deny,62,62,0,1,0,1,0
56277,52420,445,0,0,drop,70,70,0,1,0,1,0
56278,47413,23,0,0,deny,60,60,0,1,0,1,0
56279,46349,51505,0,0,deny,70,70,0,1,0,1,0
56280,57415,445,0,0,drop,70,70,0,1,0,1,0
56281,57413,445,0,0,drop,70,70,0,1,0,1,0
56282,57409,445,0,0,drop,70,70,0,1,0,1,0
56283,3521,6881,0,0,deny,66,66,0,1,0,1,0
56284,53779,37965,0,0,deny,66,66,0,1,0,1,0
56285,45410,1,0,0,deny,62,62,0,1,0,1,0
56286,56946,1,0,0,deny,66,66,0,1,0,1,0
56287,17177,64147,0,0,deny,62,62,0,1,0,1,0
56288,52416,445,0,0,drop,70,70,0,1,0,1,0
56289,34129,11045,0,0,deny,62,62,0,1,0,1,0
56290,65153,38303,0,0,deny,66,66,0,1,0,1,0
56291,63670,64097,0,0,deny,66,66,0,1,0,1,0
56292,52407,445,0,0,drop,70,70,0,1,0,1,0
56293,52405,445,0,0,drop,70,70,0,1,0,1,0
56294,50355,43890,0,0,deny,62,62,0,1,0,1,0
56295,52401,445,0,0,drop,70,70,0,1,0,1,0
56296,52402,445,0,0,drop,70,70,0,1,0,1,0
56297,52816,445,0,0,drop,66,66,0,1,0,1,0
56298,6666,8443,0,0,deny,60,60,0,1,0,1,0
56299,57407,445,0,0,drop,70,70,0,1,0,1,0
56300,57404,445,0,0,drop,70,70,0,1,0,1,0
56301,58022,3000,0,0,deny,60,60,0,1,0,1,0
56302,52399,445,0,0,drop,70,70,0,1,0,1,0
56303,38926,37965,0,0,deny,62,62,0,1,0,1,0
56304,80,9918,0,0,deny,60,60,0,1,0,1,0
56305,5379,37965,0,0,deny,62,62,0,1,0,1,0
56306,59136,50584,0,0,deny,66,66,0,1,0,1,0
56307,33908,48983,0,0,deny,145,145,0,1,0,1,0
56308,1040,6004,0,0,deny,72,72,0,1,0,1,0
56309,52812,445,0,0,drop,66,66,0,1,0,1,0
56310,61736,50584,0,0,deny,66,66,0,1,0,1,0
56311,64406,50584,0,0,deny,66,66,0,1,0,1,0
56312,57452,57470,0,0,deny,62,62,0,1,0,1,0
56313,52808,445,0,0,drop,66,66,0,1,0,1,0
56314,52394,445,0,0,drop,70,70,0,1,0,1,0
56315,57393,445,0,0,drop,70,70,0,1,0,1,0
56316,52749,64147,0,0,deny,66,66,0,1,0,1,0
56317,57390,445,0,0,drop,70,70,0,1,0,1,0
56318,57387,445,0,0,drop,70,70,0,1,0,1,0
56319,57383,445,0,0,drop,70,70,0,1,0,1,0
56320,1660,8696,0,0,deny,62,62,0,1,0,1,0
56321,52807,445,0,0,drop,66,66,0,1,0,1,0
56322,1660,8696,0,0,deny,145,145,0,1,0,1,0
56323,12471,48817,0,0,deny,62,62,0,1,0,1,0
56324,51582,48817,0,0,deny,66,66,0,1,0,1,0
56325,52386,445,0,0,drop,70,70,0,1,0,1,0
56326,59481,41182,0,0,deny,66,66,0,1,0,1,0
56327,52385,445,0,0,drop,70,70,0,1,0,1,0
56328,57379,445,0,0,drop,70,70,0,1,0,1,0
56329,21892,15503,0,0,deny,62,62,0,1,0,1,0
56330,1025,35447,0,0,deny,62,62,0,1,0,1,0
56331,55072,53,57853,53,allow,701,88,613,2,30,1,1
56332,56246,53,65270,53,allow,202,103,99,2,30,1,1
56333,50319,53,28862,53,allow,756,95,661,2,30,1,1
56334,45373,443,33904,443,allow,33357,26315,7042,65,273,38,27
56335,57745,15000,1994,15000,allow,130,70,60,2,5,1,1
56336,55974,53,19851,53,allow,762,98,664,2,30,1,1
56337,55605,53,8941,53,allow,711,87,624,2,30,1,1
56338,49445,53,33858,53,allow,770,101,669,2,30,1,1
56339,45118,15000,63789,15000,allow,130,70,60,2,6,1,1
56340,64311,53,1855,53,allow,198,101,97,2,31,1,1
56341,56406,53,47759,53,allow,749,89,660,2,30,1,1
56342,51757,54657,24157,54657,allow,66,66,0,1,5,1,0
56343,51267,38070,5566,38070,allow,210,140,70,4,14,3,1
56344,55427,53,28517,53,allow,772,103,669,2,30,1,1
56345,65359,53,29324,53,allow,186,95,91,2,30,1,1
56346,65060,53,36666,53,allow,761,100,661,2,30,1,1
56347,56609,53,56720,53,allow,198,101,97,2,30,1,1
56348,59888,80,59888,80,allow,55739,967,54772,53,15,13,40
56349,59417,443,49153,443,allow,2898,1700,1198,16,15,8,8
56350,56607,443,1098,443,allow,7862,1873,5989,20,15,11,9
56351,55918,53,15697,53,allow,184,94,90,2,31,1,1
56352,55117,53,60693,53,allow,756,95,661,2,31,1,1
56353,49851,53,28608,53,allow,164,84,80,2,30,1,1
56354,65283,53,18469,53,allow,732,89,643,2,30,1,1
56355,64831,53,59275,53,allow,216,110,106,2,30,1,1
56356,49439,53,62852,53,allow,194,99,95,2,31,1,1
56357,49197,53,27457,53,allow,751,95,656,2,30,1,1
56358,51775,57887,60310,57887,allow,70,70,0,2,8,2,0
56359,50422,443,13716,443,allow,1389,868,521,12,25,6,6
56360,35047,80,8306,80,allow,7891,2035,5856,17,32,10,7
56361,43033,443,43033,443,allow,10239,2017,8222,23,18,14,9
56362,53834,15000,23428,15000,allow,130,70,60,2,6,1,1
56363,62185,53,27701,53,allow,578,286,292,9,15,5,4
56364,21870,53,21870,53,allow,209,77,132,2,32,1,1
56365,64323,53,38959,53,allow,190,97,93,2,31,1,1
56366,2941,7000,2941,7000,allow,3398,947,2451,18,27,9,9
56367,51783,12296,8284,12296,allow,316,136,180,6,6,3,3
56368,63763,17368,8449,17368,allow,66,66,0,1,5,1,0
56369,49537,53,46669,53,allow,269,96,173,4,59,2,2
56370,56608,443,64637,443,allow,8034,2014,6020,20,15,11,9
56371,35049,80,15791,80,allow,5773,1197,4576,14,32,8,6
56372,50347,53,8937,53,allow,756,95,661,2,30,1,1
56373,5588,5588,0,0,allow,3354,1792,1562,46,194,23,23
56374,56609,443,31583,443,allow,7982,1962,6020,20,15,11,9
56375,56818,53,44106,53,allow,755,94,661,2,30,1,1
56376,64900,53,55374,53,allow,778,103,675,2,30,1,1
56377,56962,53,51903,53,allow,170,87,83,2,30,1,1
56378,50240,53,16161,53,allow,733,93,640,2,30,1,1
56379,55008,53,25566,53,allow,762,98,664,2,30,1,1
56380,49972,53,21304,53,allow,184,94,90,2,30,1,1
56381,64618,53,46697,53,allow,196,100,96,2,31,1,1
56382,64653,53,37901,53,allow,755,93,662,2,31,1,1
56383,64041,53,17809,53,allow,200,102,98,2,30,1,1
56384,49687,53,24599,53,allow,775,103,672,2,31,1,1
56385,44588,443,64745,443,allow,8850,2551,6299,32,369,16,16
56386,49978,53,47119,53,allow,774,101,673,2,31,1,1
56387,64438,53,41293,53,allow,184,94,90,2,31,1,1
56388,49670,53,15548,53,allow,168,86,82,2,31,1,1
56389,49539,53,44717,53,allow,170,87,83,2,31,1,1
56390,65131,53,39663,53,allow,168,86,82,2,31,1,1
56391,65189,27216,23592,27216,allow,226,71,155,2,31,1,1
56392,65514,53,6429,53,allow,212,108,104,2,31,1,1
56393,57306,53,11858,53,allow,170,87,83,2,31,1,1
56394,55049,53,52659,53,allow,733,86,647,2,31,1,1
56395,56987,53,30832,53,allow,192,98,94,2,31,1,1
56396,65380,53,11853,53,allow,176,90,86,2,31,1,1
56397,5938,58817,0,0,allow,60,60,0,1,90,1,0
56398,49997,53,52835,53,allow,418,75,343,2,31,1,1
56399,49290,53,15607,53,allow,760,97,663,2,31,1,1
56400,65189,27241,23433,27241,allow,235,71,164,2,31,1,1
56401,49429,53,19123,53,allow,204,104,100,2,31,1,1
56402,49361,53,45475,53,allow,184,94,90,2,31,1,1
56403,56111,53,53180,53,allow,174,89,85,2,31,1,1
56404,37961,443,30943,443,allow,10229,2777,7452,30,361,15,15
56405,56765,53,13979,53,allow,188,96,92,2,31,1,1
56406,56104,53,20610,53,allow,194,99,95,2,31,1,1
56407,65014,53,3896,53,allow,186,95,91,2,31,1,1
56408,65516,53,26116,53,allow,202,103,99,2,31,1,1
56409,50460,53,61853,53,allow,753,96,657,2,31,1,1
56410,56878,53,21554,53,allow,168,86,82,2,31,1,1
56411,64913,53,27699,53,allow,182,93,89,2,31,1,1
56412,57258,53,12137,53,allow,757,98,659,2,31,1,1
56413,65063,53,62698,53,allow,176,90,86,2,31,1,1
56414,49384,53,31275,53,allow,178,91,87,2,31,1,1
56415,47054,443,53511,443,allow,6803,2164,4639,14,121,7,7
56416,6881,6881,2620,6881,allow,150,150,0,1,1200,1,0
56417,62864,443,56821,443,allow,86513,10300,76213,131,137,54,77
56418,55594,53,11300,53,allow,753,96,657,2,31,1,1
56419,52233,443,57646,443,allow,5479,929,4550,20,360,10,10
56420,65336,53,13952,53,allow,782,105,677,2,31,1,1
56421,33000,53,0,0,allow,82,82,0,1,31,1,0
56422,56332,53,13726,53,allow,202,103,99,2,31,1,1
56423,56494,53,64995,53,allow,793,101,692,2,31,1,1
56424,49861,53,49122,53,allow,196,100,96,2,31,1,1
56425,55517,53,21431,53,allow,174,89,85,2,31,1,1
56426,49785,53,38466,53,allow,206,105,101,2,31,1,1
56427,56071,53,41864,53,allow,186,95,91,2,31,1,1
56428,56552,53,11395,53,allow,190,97,93,2,31,1,1
56429,57251,53,30748,53,allow,780,104,676,2,31,1,1
56430,56477,53,34733,53,allow,198,101,97,2,31,1,1
56431,21133,26760,14164,26760,allow,480,149,331,2,1200,1,1
56432,57377,445,0,0,drop,70,70,0,1,0,1,0
56433,57375,445,0,0,drop,70,70,0,1,0,1,0
56434,57373,445,0,0,drop,70,70,0,1,0,1,0
56435,59020,9600,0,0,deny,60,60,0,1,0,1,0
56436,52799,445,0,0,drop,66,66,0,1,0,1,0
56437,43671,37965,0,0,deny,62,62,0,1,0,1,0
56438,29623,37807,0,0,deny,62,62,0,1,0,1,0
56439,1027,11392,0,0,deny,62,62,0,1,0,1,0
56440,12821,37965,0,0,deny,66,66,0,1,0,1,0
56441,21274,30188,0,0,deny,62,62,0,1,0,1,0
56442,52795,445,0,0,drop,66,66,0,1,0,1,0
56443,52791,445,0,0,drop,66,66,0,1,0,1,0
56444,52790,445,0,0,drop,66,66,0,1,0,1,0
56445,52379,445,0,0,drop,70,70,0,1,0,1,0
56446,52378,445,0,0,drop,70,70,0,1,0,1,0
56447,52789,445,0,0,drop,66,66,0,1,0,1,0
56448,52788,445,0,0,drop,66,66,0,1,0,1,0
56449,52786,445,0,0,drop,66,66,0,1,0,1,0
56450,56100,53,41303,53,allow,177,94,83,2,30,1,1
56451,56705,53,17593,53,allow,168,78,90,2,30,1,1
56452,9246,35440,0,0,deny,66,66,0,1,0,1,0
56453,51829,36134,0,0,deny,66,66,0,1,0,1,0
56454,50143,35253,0,0,deny,66,66,0,1,0,1,0
56455,52374,445,0,0,drop,70,70,0,1,0,1,0
56456,64051,36829,0,0,deny,66,66,0,1,0,1,0
56457,57370,445,0,0,drop,70,70,0,1,0,1,0
56458,57371,445,0,0,drop,70,70,0,1,0,1,0
56459,57366,445,0,0,drop,70,70,0,1,0,1,0
56460,49160,34021,0,0,reset-both,146,146,0,1,0,1,0
56461,52782,445,0,0,drop,66,66,0,1,0,1,0
56462,57364,445,0,0,drop,70,70,0,1,0,1,0
56463,52373,445,0,0,drop,70,70,0,1,0,1,0
56464,443,14315,0,0,deny,158,158,0,1,0,1,0
56465,52781,445,0,0,drop,66,66,0,1,0,1,0
56466,53298,26467,0,0,deny,62,62,0,1,0,1,0
56467,58468,37965,0,0,deny,66,66,0,1,0,1,0
56468,52779,445,0,0,drop,66,66,0,1,0,1,0
56469,52777,445,0,0,drop,66,66,0,1,0,1,0
56470,52775,445,0,0,drop,66,66,0,1,0,1,0
56471,443,15564,0,0,deny,85,85,0,1,0,1,0
56472,17009,53733,0,0,deny,66,66,0,1,0,1,0
56473,52368,445,0,0,drop,70,70,0,1,0,1,0
56474,65209,57866,0,0,deny,66,66,0,1,0,1,0
56475,59315,35440,0,0,deny,62,62,0,1,0,1,0
56476,64771,53,10938,53,allow,228,110,118,2,30,1,1
56477,55989,443,55989,443,allow,4378,1471,2907,19,29,11,8
56478,55147,53,9806,53,allow,184,94,90,2,30,1,1
56479,64243,53,24679,53,allow,244,94,150,2,30,1,1
56480,55147,53,22954,53,allow,184,94,90,2,30,1,1
56481,49266,53,16843,53,allow,199,102,97,2,30,1,1
56482,39047,443,36034,443,allow,10831,1381,9450,22,19,12,10
56483,49398,80,11997,80,allow,3651,2020,1631,16,65,9,7
56484,50457,443,62733,443,allow,3091,1708,1383,15,21,9,6
56485,55599,80,22870,80,allow,1165,473,692,10,14,5,5
56486,63762,41373,27152,41373,allow,70,70,0,1,4,1,0
56487,50393,53,2809,53,allow,759,94,665,2,29,1,1
56488,49667,53,34670,53,allow,183,94,89,2,29,1,1
56489,11295,40018,57800,40018,allow,213,89,124,4,31,2,2
56490,56883,53,10133,53,allow,184,94,90,2,30,1,1
56491,49400,80,44770,80,allow,3651,2020,1631,16,65,9,7
56492,50384,443,60892,443,allow,7723,2591,5132,23,49,12,11
56493,54168,80,20934,80,allow,1582,1003,579,12,360,6,6
56494,49424,53,45939,53,allow,198,102,96,2,32,1,1
56495,64613,53,15938,53,allow,179,94,85,2,30,1,1
56496,63757,51413,50296,51413,allow,70,70,0,1,4,1,0
56497,25061,53,25061,53,allow,214,82,132,2,32,1,1
56498,33241,443,5641,443,allow,37452,28136,9316,56,15,33,23
56499,59815,443,31852,443,allow,4586,955,3631,17,28,9,8
56500,56765,53,64406,53,allow,194,102,92,2,29,1,1
56501,57257,53,41032,53,allow,173,94,79,2,29,1,1
56502,55605,27274,9607,27274,allow,130,70,60,2,4,1,1
56503,49888,53,1710,53,allow,198,102,96,2,29,1,1
56504,55077,53,32952,53,allow,179,94,85,2,29,1,1
56505,49872,53,49872,53,allow,218,90,128,2,29,1,1
56506,55739,53,37345,53,allow,458,188,270,6,29,3,3
56507,55429,53,62139,53,allow,182,102,80,2,30,1,1
56508,49817,53,35154,53,allow,286,110,176,2,30,1,1
56509,56100,53,9631,53,allow,177,94,83,2,30,1,1
56510,49896,443,39739,443,allow,151170,17408,133762,256,130,118,138
56511,65211,53,54701,53,allow,183,94,89,2,30,1,1
56512,64685,53,15480,53,allow,199,102,97,2,30,1,1
56513,56335,53,48756,53,allow,816,102,714,2,30,1,1
56514,49972,53,40776,53,allow,184,94,90,2,30,1,1
56515,56987,53,21347,53,allow,196,102,94,2,30,1,1
56516,64093,53,8656,53,allow,225,110,115,2,30,1,1
56517,64715,53,47413,53,allow,209,110,99,2,30,1,1
56518,57252,53,53751,53,allow,183,94,89,2,30,1,1
56519,49539,53,50465,53,allow,177,94,83,2,30,1,1
56520,49167,53,55909,53,allow,193,102,91,2,30,1,1
56521,51776,14645,41362,14645,allow,70,70,0,2,8,2,0
56522,51752,7000,51752,7000,allow,3638,2087,1551,17,16,10,7
56523,34079,80,3796,80,allow,5053,4178,875,17,15,9,8
56524,64643,53,40117,53,allow,177,94,83,2,30,1,1
56525,50575,53,5901,53,allow,766,102,664,2,30,1,1
56526,51953,443,64481,443,allow,8900,2020,6880,28,25,15,13
56527,65246,53,37552,53,allow,183,94,89,2,30,1,1
56528,56456,53,8981,53,allow,195,102,93,2,30,1,1
56529,56456,53,17169,53,allow,195,102,93,2,30,1,1
56530,64685,53,31549,53,allow,199,102,97,2,30,1,1
56531,64585,53,51194,53,allow,210,110,100,2,30,1,1
56532,64874,53,28911,53,allow,808,110,698,2,30,1,1
56533,49433,53,41471,53,allow,165,86,79,2,30,1,1
56534,55918,53,24727,53,allow,184,94,90,2,30,1,1
56535,56223,53,26337,53,allow,177,94,83,2,30,1,1
56536,65249,53,5221,53,allow,166,86,80,2,30,1,1
56537,55429,53,31053,53,allow,182,102,80,2,30,1,1
56538,44690,443,54599,443,allow,1648,813,835,17,185,9,8
56539,64585,53,55669,53,allow,210,110,100,2,30,1,1
56540,65189,27015,29892,27015,allow,295,78,217,2,30,1,1
56541,64417,53,47310,53,allow,369,94,275,4,49,2,2
56542,49968,53,46436,53,allow,285,94,191,2,30,1,1
56543,64715,53,35107,53,allow,209,110,99,2,30,1,1
56544,64831,53,56461,53,allow,216,110,106,2,30,1,1
56545,56335,53,52497,53,allow,193,102,91,2,30,1,1
56546,49622,53,47185,53,allow,185,102,83,2,30,1,1
56547,49634,443,60698,443,allow,20860,1618,19242,35,122,15,20
56548,49537,53,59309,53,allow,269,96,173,4,59,2,2
56549,65091,80,65091,80,allow,18499242,314733,18184509,19253,37,4700,14553
56550,50648,80,55586,80,allow,132,132,0,2,8,2,0
56551,51773,23728,42323,23728,allow,70,70,0,2,8,2,0
56552,63366,30365,45991,30365,allow,738,318,420,12,163,5,7
56553,49851,53,3240,53,allow,166,86,80,2,30,1,1
56554,56649,53,35726,53,allow,152,78,74,2,30,1,1
56555,51468,80,31366,80,allow,3389,2054,1335,19,25,11,8
56556,34275,443,58408,443,allow,4880,3216,1664,29,79,15,14
56557,42358,80,63133,80,allow,1081,641,440,9,14,4,5
56558,26833,443,13799,443,allow,21487,16430,5057,39,21,22,17
56559,51774,16930,45672,16930,allow,70,70,0,2,8,2,0
56560,58924,443,13598,443,allow,7783,2690,5093,24,255,13,11
56561,63759,64509,61744,64509,allow,70,70,0,1,4,1,0
56562,57257,80,32555,80,allow,1369,495,874,12,361,6,6
56563,56919,53,23059,53,allow,423,95,328,4,34,2,2
56564,64700,53,51210,53,allow,458,188,270,6,29,3,3
56565,64595,53,24899,53,allow,167,86,81,2,29,1,1
56566,49739,443,63017,443,allow,3085,1404,1681,15,15,7,8
56567,64732,53,44138,53,allow,189,102,87,2,29,1,1
56568,49888,53,17695,53,allow,198,102,96,2,29,1,1
56569,49217,53,20500,53,allow,209,110,99,2,29,1,1
56570,54287,443,51264,443,allow,8603,853,7750,27,92,9,18
56571,51268,47662,5610,47662,allow,70,70,0,2,8,2,0
56572,55596,14795,19064,14795,allow,630,444,186,9,16,6,3
56573,56919,53,16423,53,allow,193,102,91,2,29,1,1
56574,64936,53,18480,53,allow,749,94,655,2,29,1,1
56575,49365,53,27288,53,allow,195,102,93,2,29,1,1
56576,55147,53,48564,53,allow,184,94,90,2,30,1,1
56577,64552,53,41507,53,allow,754,94,660,2,30,1,1
56578,49530,53,54763,53,allow,265,102,163,2,30,1,1
56579,49622,53,45379,53,allow,185,102,83,2,30,1,1
56580,56557,53,49880,53,allow,214,110,104,2,29,1,1
56581,49399,53,15486,53,allow,775,102,673,2,30,1,1
56582,65211,53,44478,53,allow,183,94,89,2,30,1,1
56583,49901,53,39046,53,allow,193,102,91,2,29,1,1
56584,64595,53,55733,53,allow,167,86,81,2,30,1,1
56585,64311,53,39516,53,allow,199,102,97,2,30,1,1
56586,65189,27237,9524,27237,allow,234,78,156,2,30,1,1
56587,56111,53,49193,53,allow,179,94,85,2,31,1,1
56588,64403,53,2532,53,allow,199,102,97,2,31,1,1
56589,56552,53,3851,53,allow,195,102,93,2,31,1,1
56590,51637,443,21678,443,allow,3110,1049,2061,14,136,7,7
56591,49167,53,5532,53,allow,816,102,714,2,30,1,1
56592,56121,53,17284,53,allow,207,86,121,2,30,1,1
56593,56552,53,34046,53,allow,195,102,93,2,30,1,1
56594,1927,53,62865,53,allow,210,78,132,2,30,1,1
56595,65189,27015,61124,27015,allow,250,78,172,2,30,1,1
56596,65189,27015,46211,27015,allow,267,78,189,2,30,1,1
56597,55461,53,35895,53,allow,198,110,88,2,30,1,1
56598,49917,53,18720,53,allow,209,110,99,2,30,1,1
56599,65189,27017,19229,27017,allow,239,78,161,2,30,1,1
56600,65189,27015,18038,27015,allow,257,78,179,2,30,1,1
56601,65189,27207,3306,27207,allow,230,78,152,2,30,1,1
56602,65189,27015,25952,27015,allow,281,78,203,2,30,1,1
56603,55918,53,15262,53,allow,184,94,90,2,31,1,1
56604,65189,27015,36838,27015,allow,257,78,179,2,30,1,1
56605,10089,80,55892,80,allow,130,70,60,2,15,1,1
56606,3303,80,51748,80,allow,2338,1419,919,10,15,5,5
56607,51756,41471,58464,41471,allow,70,70,0,1,5,1,0
56608,51158,443,53566,443,allow,3155111,84086,3071025,3163,75,1072,2091
56609,46438,443,46438,443,allow,5337,2090,3247,22,39,13,9
56610,56026,53,28063,53,allow,183,94,89,2,30,1,1
56611,57252,53,53666,53,allow,183,94,89,2,30,1,1
56612,49433,53,27774,53,allow,173,94,79,2,30,1,1
56613,56104,53,22926,53,allow,197,102,95,2,30,1,1
56614,34947,53,51809,53,allow,168,78,90,2,30,1,1
56615,49860,53,63227,53,allow,184,102,82,2,30,1,1
56616,64026,53,1792,53,allow,211,102,109,2,30,1,1
56617,43693,53,25103,53,allow,164,78,86,2,30,1,1
56618,56649,53,31076,53,allow,168,94,74,2,30,1,1
56619,57252,53,37679,53,allow,183,94,89,2,30,1,1
56620,55512,53,3521,53,allow,458,188,270,6,30,3,3
56621,56809,53,37761,53,allow,178,94,84,2,30,1,1
56622,64311,53,19538,53,allow,199,102,97,2,30,1,1
56623,64585,53,40349,53,allow,210,110,100,2,30,1,1
56624,56246,53,30677,53,allow,209,110,99,2,30,1,1
56625,65359,53,28420,53,allow,193,102,91,2,30,1,1
56626,65249,53,21680,53,allow,182,102,80,2,30,1,1
56627,65529,53,50654,53,allow,821,102,719,2,30,1,1
56628,64715,53,61600,53,allow,209,110,99,2,30,1,1
56629,56227,53,28291,53,allow,179,94,85,2,30,1,1
56630,40193,443,57432,443,allow,1462,735,727,15,185,8,7
56631,45109,443,1117,443,allow,11156,3899,7257,31,234,17,14
56632,64913,53,27503,53,allow,183,94,89,2,30,1,1
56633,53115,40693,38172,40693,allow,70,70,0,2,8,2,0
56634,49728,443,15564,443,allow,7626,1676,5950,29,63,10,19
56635,57249,443,12847,443,allow,7965,2643,5322,42,15,24,18
56636,49183,53,29477,53,allow,209,110,99,2,30,1,1
56637,65420,53,11720,53,allow,166,86,80,2,30,1,1
56638,64643,53,62127,53,allow,177,94,83,2,30,1,1
56639,56557,53,47692,53,allow,214,110,104,2,30,1,1
56640,64287,53,53632,53,allow,181,94,87,2,30,1,1
56641,56004,53,34719,53,allow,177,94,83,2,30,1,1
56642,57152,53,2032,53,allow,183,94,89,2,30,1,1
56643,56126,53,43934,53,allow,183,94,89,2,30,1,1
56644,65189,27015,44891,27015,allow,255,78,177,2,30,1,1
56645,56126,53,32815,53,allow,183,94,89,2,30,1,1
56646,65189,30015,16566,30015,allow,276,78,198,2,30,1,1
56647,49696,53,30519,53,allow,178,94,84,2,30,1,1
56648,56609,53,37814,53,allow,199,102,97,2,30,1,1
56649,56987,53,59227,53,allow,196,102,94,2,30,1,1
56650,65516,53,16518,53,allow,209,110,99,2,31,1,1
56651,57306,53,15056,53,allow,177,94,83,2,31,1,1
56652,55688,53,48185,53,allow,183,94,89,2,31,1,1
56653,57007,53,19153,53,allow,183,94,89,2,31,1,1
56654,64618,53,21647,53,allow,198,102,96,2,30,1,1
56655,56104,53,63968,53,allow,197,102,95,2,30,1,1
56656,64438,53,59049,53,allow,184,94,90,2,30,1,1
56657,56111,53,45505,53,allow,179,94,85,2,30,1,1
56658,55467,53,34377,53,allow,193,102,91,2,30,1,1
56659,65189,28515,39536,28515,allow,266,78,188,2,30,1,1
56660,56883,53,20999,53,allow,184,94,90,2,30,1,1
56661,56071,53,13568,53,allow,193,102,91,2,30,1,1
56662,49361,53,51044,53,allow,184,94,90,2,31,1,1
56663,55517,53,14797,53,allow,179,94,85,2,31,1,1
56664,37965,16153,40075,16153,allow,1320,1320,0,21,1682,21,0
56665,65189,27015,1984,27015,allow,260,78,182,2,30,1,1
56666,56332,53,1947,53,allow,209,110,99,2,31,1,1
56667,65469,53,29881,53,allow,195,102,93,2,31,1,1
56668,54990,53,46533,53,allow,166,86,80,2,31,1,1
56669,64618,53,55916,53,allow,198,102,96,2,31,1,1
56670,57172,53,10868,53,allow,196,102,94,2,31,1,1
56671,49174,53,1263,53,allow,166,86,80,2,31,1,1
56672,59103,443,51275,443,allow,4209,2056,2153,50,277,24,26
56673,38444,443,18273,443,allow,3547,955,2592,13,120,6,7
56674,49204,443,40475,443,allow,1786,172,1614,7,120,3,4
56675,64041,53,11407,53,allow,200,102,98,2,31,1,1
56676,53430,443,50940,443,allow,4383,2064,2319,11,120,6,5
56677,56071,53,32735,53,allow,193,102,91,2,31,1,1
56678,58427,5223,31205,5223,allow,13841,6601,7240,42,622,19,23
56679,61146,443,19937,443,allow,8580941,269463,8311478,9202,122,3016,6186
56680,49160,1025,14161,1025,allow,868,150,718,4,1200,2,2
56681,37965,48782,19115,48782,allow,132,132,0,3,1199,3,0
56682,56601,53,16656,53,allow,239,94,145,2,31,1,1
56683,44839,443,23952,443,allow,3188,2056,1132,23,121,13,10
56684,56033,53,58148,53,allow,213,102,111,2,31,1,1
56685,49861,53,27236,53,allow,198,102,96,2,31,1,1
56686,50326,53,27014,53,allow,720,94,626,2,31,1,1
56687,65359,53,19133,53,allow,193,102,91,2,31,1,1
56688,55461,53,48907,53,allow,198,110,88,2,31,1,1
56689,49384,53,17338,53,allow,181,94,87,2,31,1,1
56690,55857,53,56112,53,allow,199,102,97,2,31,1,1
56691,49901,53,59612,53,allow,193,102,91,2,31,1,1
56692,56783,53,24430,53,allow,199,102,97,2,31,1,1
56693,64831,53,30238,53,allow,216,110,106,2,31,1,1
56694,49860,53,48565,53,allow,168,86,82,2,31,1,1
56695,57172,53,34011,53,allow,196,102,94,2,31,1,1
56696,49972,53,6023,53,allow,314,94,220,4,31,2,2
56697,64288,443,27448,443,allow,252,70,182,3,120,1,2
56698,55688,53,29682,53,allow,183,94,89,2,31,1,1
56699,36366,443,13851,443,allow,6147,910,5237,18,16,10,8
56700,53237,443,53237,443,allow,1210,637,573,14,34,7,7
56701,46167,80,10521,80,allow,78,78,0,1,5,1,0
56702,57007,53,36349,53,allow,183,94,89,2,31,1,1
56703,64403,53,9122,53,allow,199,102,97,2,31,1,1
56704,49537,53,25046,53,allow,269,96,173,4,59,2,2
56705,46052,443,47336,443,allow,9815,5382,4433,51,237,20,31
56706,43357,443,59688,443,allow,1053,566,487,10,15,6,4
56707,53236,443,53236,443,allow,1210,637,573,14,34,7,7
56708,45169,443,45169,443,allow,282,140,142,5,152,3,2
56709,65131,53,4831,53,allow,168,86,82,2,30,1,1
56710,57357,445,0,0,drop,70,70,0,1,0,1,0
56711,33822,57470,0,0,deny,66,66,0,1,0,1,0
56712,57353,445,0,0,drop,70,70,0,1,0,1,0
56713,57349,445,0,0,drop,70,70,0,1,0,1,0
56714,11716,37965,0,0,deny,62,62,0,1,0,1,0
56715,4910,2149,0,0,deny,62,62,0,1,0,1,0
56716,52766,445,0,0,drop,66,66,0,1,0,1,0
56717,51745,30188,0,0,deny,62,62,0,1,0,1,0
56718,52355,445,0,0,drop,70,70,0,1,0,1,0
56719,31845,55777,0,0,deny,62,62,0,1,0,1,0
56720,16293,57470,0,0,deny,62,62,0,1,0,1,0
56721,52757,445,0,0,drop,66,66,0,1,0,1,0
56722,22587,30188,0,0,deny,66,66,0,1,0,1,0
56723,57336,445,0,0,drop,70,70,0,1,0,1,0
56724,19747,37965,0,0,deny,62,62,0,1,0,1,0
56725,9448,57866,0,0,deny,146,146,0,1,0,1,0
56726,52352,445,0,0,drop,70,70,0,1,0,1,0
56727,64341,57470,0,0,deny,62,62,0,1,0,1,0
56728,52755,445,0,0,drop,66,66,0,1,0,1,0
56729,2522,64147,0,0,deny,62,62,0,1,0,1,0
56730,56307,52700,0,0,deny,66,66,0,1,0,1,0
56731,10003,64147,0,0,deny,62,62,0,1,0,1,0
56732,10115,52700,0,0,deny,62,62,0,1,0,1,0
56733,52247,51505,0,0,deny,146,146,0,1,0,1,0
56734,6712,44818,0,0,deny,66,66,0,1,0,1,0
56735,63379,36237,0,0,deny,62,62,0,1,0,1,0
56736,52747,445,0,0,drop,66,66,0,1,0,1,0
56737,52348,445,0,0,drop,70,70,0,1,0,1,0
56738,18357,51180,0,0,deny,62,62,0,1,0,1,0
56739,58305,51180,0,0,deny,66,66,0,1,0,1,0
56740,52346,445,0,0,drop,70,70,0,1,0,1,0
56741,52740,445,0,0,drop,66,66,0,1,0,1,0
56742,12530,35440,0,0,deny,66,66,0,1,0,1,0
56743,7308,50584,0,0,deny,66,66,0,1,0,1,0
56744,52344,445,0,0,drop,70,70,0,1,0,1,0
56745,10586,37965,0,0,deny,62,62,0,1,0,1,0
56746,53777,443,29327,443,allow,495,421,74,4,0,3,1
56747,53769,443,28627,443,allow,499,425,74,4,0,3,1
56748,4540,23,0,0,deny,60,60,0,1,0,1,0
56749,31112,50584,0,0,deny,66,66,0,1,0,1,0
56750,47103,55378,0,0,deny,146,146,0,1,0,1,0
56751,57329,445,0,0,drop,70,70,0,1,0,1,0
56752,57325,445,0,0,drop,70,70,0,1,0,1,0
56753,57324,445,0,0,drop,70,70,0,1,0,1,0
56754,59378,50584,0,0,deny,66,66,0,1,0,1,0
56755,63305,62413,0,0,deny,66,66,0,1,0,1,0
56756,52732,445,0,0,drop,66,66,0,1,0,1,0
56757,52731,445,0,0,drop,66,66,0,1,0,1,0
56758,52730,445,0,0,drop,66,66,0,1,0,1,0
56759,52726,445,0,0,drop,66,66,0,1,0,1,0
56760,52724,445,0,0,drop,66,66,0,1,0,1,0
56761,52729,445,0,0,drop,66,66,0,1,0,1,0
56762,52725,445,0,0,drop,66,66,0,1,0,1,0
56763,52727,445,0,0,drop,66,66,0,1,0,1,0
56764,65250,22114,0,0,deny,66,66,0,1,0,1,0
56765,52337,445,0,0,drop,70,70,0,1,0,1,0
56766,56217,5900,0,0,deny,60,60,0,1,0,1,0
56767,43129,20220,0,0,deny,62,62,0,1,0,1,0
56768,14715,56205,0,0,deny,62,62,0,1,0,1,0
56769,52335,445,0,0,drop,70,70,0,1,0,1,0
56770,58950,5900,0,0,deny,60,60,0,1,0,1,0
56771,64024,57470,0,0,deny,62,62,0,1,0,1,0
56772,52334,445,0,0,drop,70,70,0,1,0,1,0
56773,6881,55108,0,0,deny,143,143,0,1,0,1,0
56774,45941,23386,0,0,deny,60,60,0,1,0,1,0
56775,52333,445,0,0,drop,70,70,0,1,0,1,0
56776,26722,11446,0,0,deny,66,66,0,1,0,1,0
56777,52332,445,0,0,drop,70,70,0,1,0,1,0
56778,63547,37965,0,0,deny,66,66,0,1,0,1,0
56779,52330,445,0,0,drop,70,70,0,1,0,1,0
56780,52328,445,0,0,drop,70,70,0,1,0,1,0
56781,11464,37965,0,0,deny,62,62,0,1,0,1,0
56782,53015,64147,0,0,deny,145,145,0,1,0,1,0
56783,50052,65008,0,0,deny,60,60,0,1,0,1,0
56784,57321,445,0,0,drop,70,70,0,1,0,1,0
56785,57319,445,0,0,drop,70,70,0,1,0,1,0
56786,57317,445,0,0,drop,70,70,0,1,0,1,0
56787,64756,11392,0,0,deny,62,62,0,1,0,1,0
56788,3802,55777,0,0,deny,66,66,0,1,0,1,0
56789,52709,445,0,0,drop,66,66,0,1,0,1,0
56790,52710,445,0,0,drop,66,66,0,1,0,1,0
56791,52712,445,0,0,drop,66,66,0,1,0,1,0
56792,1028,62609,0,0,deny,148,148,0,1,0,1,0
56793,52314,445,0,0,drop,70,70,0,1,0,1,0
56794,52313,445,0,0,drop,70,70,0,1,0,1,0
56795,52309,445,0,0,drop,70,70,0,1,0,1,0
56796,61912,17546,0,0,deny,66,66,0,1,0,1,0
56797,57306,445,0,0,drop,70,70,0,1,0,1,0
56798,52303,445,0,0,drop,70,70,0,1,0,1,0
56799,52304,445,0,0,drop,70,70,0,1,0,1,0
56800,40547,24051,0,0,deny,74,74,0,1,0,1,0
56801,57304,445,0,0,drop,70,70,0,1,0,1,0
56802,50734,37965,0,0,deny,62,62,0,1,0,1,0
56803,57301,445,0,0,drop,70,70,0,1,0,1,0
56804,57294,445,0,0,drop,70,70,0,1,0,1,0
56805,57293,445,0,0,drop,70,70,0,1,0,1,0
56806,43235,23,0,0,deny,60,60,0,1,0,1,0
56807,42745,50011,0,0,deny,62,62,0,1,0,1,0
56808,60480,57470,0,0,deny,62,62,0,1,0,1,0
56809,19610,9571,0,0,deny,62,62,0,1,0,1,0
56810,22541,64147,0,0,deny,62,62,0,1,0,1,0
56811,30598,46824,0,0,deny,62,62,0,1,0,1,0
56812,39810,48817,0,0,deny,148,148,0,1,0,1,0
56813,46093,32661,0,0,deny,74,74,0,1,0,1,0
56814,52292,445,0,0,drop,70,70,0,1,0,1,0
56815,39824,51505,0,0,deny,62,62,0,1,0,1,0
56816,65512,44847,0,0,deny,66,66,0,1,0,1,0
56817,13372,50584,0,0,deny,66,66,0,1,0,1,0
56818,59055,11392,0,0,deny,66,66,0,1,0,1,0
56819,57286,445,0,0,drop,70,70,0,1,0,1,0
56820,57284,445,0,0,drop,70,70,0,1,0,1,0
56821,57281,445,0,0,drop,70,70,0,1,0,1,0
56822,52103,53733,0,0,deny,66,66,0,1,0,1,0
56823,61185,54532,0,0,deny,62,62,0,1,0,1,0
56824,52288,445,0,0,drop,70,70,0,1,0,1,0
56825,49628,35440,0,0,deny,66,66,0,1,0,1,0
56826,52519,44847,0,0,deny,62,62,0,1,0,1,0
56827,1749,64147,0,0,deny,62,62,0,1,0,1,0
56828,25772,7302,0,0,deny,62,62,0,1,0,1,0
56829,52278,445,0,0,drop,70,70,0,1,0,1,0
56830,52277,445,0,0,drop,70,70,0,1,0,1,0
56831,49976,22114,0,0,deny,66,66,0,1,0,1,0
56832,52275,445,0,0,drop,70,70,0,1,0,1,0
56833,52273,445,0,0,drop,70,70,0,1,0,1,0
56834,45079,31573,0,0,deny,66,66,0,1,0,1,0
56835,55413,37965,0,0,deny,62,62,0,1,0,1,0
56836,52271,445,0,0,drop,70,70,0,1,0,1,0
56837,46774,64147,0,0,deny,145,145,0,1,0,1,0
56838,35036,26296,0,0,deny,159,159,0,1,0,1,0
56839,57654,35440,0,0,deny,66,66,0,1,0,1,0
56840,52690,445,0,0,drop,66,66,0,1,0,1,0
56841,57278,445,0,0,drop,70,70,0,1,0,1,0
56842,57276,445,0,0,drop,70,70,0,1,0,1,0
56843,51151,64147,0,0,deny,62,62,0,1,0,1,0
56844,6881,6881,0,0,deny,62,62,0,1,0,1,0
56845,63183,64147,0,0,deny,66,66,0,1,0,1,0
56846,52266,445,0,0,drop,70,70,0,1,0,1,0
56847,52683,445,0,0,drop,66,66,0,1,0,1,0
56848,64252,53,36702,53,allow,198,101,97,2,31,1,1
56849,49696,53,54642,53,allow,172,88,84,2,30,1,1
56850,34114,443,15852,443,allow,6206,1695,4511,25,16,13,12
56851,53560,42459,25720,42459,allow,552,306,246,9,17,5,4
56852,47510,443,50202,443,allow,5149,852,4297,16,15,9,7
56853,64403,53,60359,53,allow,198,101,97,2,30,1,1
56854,47087,15000,40073,15000,allow,138,78,60,2,5,1,1
56855,50930,443,54294,443,allow,134,60,74,3,10,2,1
56856,60395,6890,18737,6890,allow,70,70,0,1,5,1,0
56857,49945,53,48312,53,allow,281,97,184,4,58,2,2
56858,56750,53,47077,53,allow,711,87,624,2,30,1,1
56859,49175,53,59846,53,allow,186,95,91,2,30,1,1
56860,65469,53,59478,53,allow,190,97,93,2,30,1,1
56861,50391,8080,50391,8080,allow,1614,785,829,11,54,6,5
56862,50387,8080,50387,8080,allow,7241,3224,4017,23,61,14,9
56863,49421,443,54717,443,allow,5422,801,4621,21,173,9,12
56864,51614,15000,49065,15000,allow,130,70,60,2,5,1,1
56865,48271,15000,29989,15000,allow,130,70,60,2,5,1,1
56866,56604,443,5643,443,allow,7915,1926,5989,20,15,11,9
56867,65498,53,36093,53,allow,202,103,99,2,31,1,1
56868,57010,53,20752,53,allow,198,101,97,2,30,1,1
56869,56603,443,20013,443,allow,7890,1901,5989,20,16,11,9
56870,53565,58695,4400,58695,allow,70,70,0,1,5,1,0
56871,45554,443,45554,443,allow,4617,1710,2907,19,26,11,8
56872,55317,443,24510,443,allow,5692,1239,4453,23,16,13,10
56873,50388,8080,50388,8080,allow,4417,2499,1918,18,56,10,8
56874,55353,53,50744,53,allow,168,86,82,2,30,1,1
56875,53229,443,53229,443,allow,1402,856,546,12,34,6,6
56876,53232,443,53232,443,allow,1270,697,573,15,33,8,7
56877,15629,53,15629,53,allow,209,77,132,2,32,1,1
56878,56606,443,12642,443,allow,7914,1925,5989,20,15,11,9
56879,40103,443,24820,443,allow,161,101,60,2,5,1,1
56880,55467,53,15072,53,allow,186,95,91,2,30,1,1
56881,55670,53,52397,53,allow,774,101,673,2,30,1,1
56882,65357,53,15221,53,allow,176,90,86,2,30,1,1
56883,57051,443,6628,443,allow,594793,518081,76712,1350,1004,781,569
56884,65231,53,23789,53,allow,200,102,98,2,31,1,1
56885,57007,53,22184,53,allow,182,93,89,2,31,1,1
56886,53165,443,53165,443,allow,208,66,142,4,148,2,2
56887,56605,443,61768,443,allow,7863,1874,5989,20,15,11,9
56888,53234,443,53234,443,allow,1276,703,573,15,33,8,7
56889,65258,53,4624,53,allow,186,95,91,2,31,1,1
56890,59031,80,8208,80,allow,4119,611,3508,12,18,4,8
56891,47164,15000,48096,15000,allow,130,70,60,2,5,1,1
56892,25803,53,25803,53,allow,231,88,143,2,33,1,1
56893,51753,15038,53015,15038,allow,66,66,0,1,5,1,0
56894,19876,53,19876,53,allow,209,77,132,2,33,1,1
56895,51772,59814,12241,59814,allow,70,70,0,2,8,2,0
56896,56918,53,41255,53,allow,778,103,675,2,30,1,1
56897,5588,5588,0,0,allow,3354,1792,1562,46,195,23,23
56898,65131,53,35643,53,allow,168,86,82,2,30,1,1
56899,56883,53,62227,53,allow,184,94,90,2,30,1,1
56900,49676,53,36174,53,allow,733,86,647,2,30,1,1
56901,65189,27015,25924,27015,allow,233,71,162,2,30,1,1
56902,56425,53,17413,53,allow,760,97,663,2,30,1,1
56903,55688,53,32958,53,allow,182,93,89,2,30,1,1
56904,65189,27255,47951,27255,allow,278,71,207,2,30,1,1
56905,59948,443,41928,443,allow,349197,16542,332655,411,129,150,261
56906,49229,53,8820,53,allow,88,88,0,1,31,1,0
56907,57416,53,62592,53,allow,186,95,91,2,31,1,1
56908,49632,443,26348,443,allow,3618,961,2657,13,121,6,7
56909,49486,53,33759,53,allow,170,87,83,2,31,1,1
56910,65040,53,62726,53,allow,176,90,86,2,31,1,1
56911,50604,53,2592,53,allow,752,93,659,2,31,1,1
56912,64885,53,64870,53,allow,753,93,660,2,31,1,1
56913,65048,53,26939,53,allow,188,96,92,2,31,1,1
56914,55634,53,60487,53,allow,204,104,100,2,31,1,1
56915,64216,53,11505,53,allow,182,93,89,2,30,1,1
56916,57172,53,55364,53,allow,192,98,94,2,31,1,1
56917,55796,53,45006,53,allow,192,98,94,2,31,1,1
56918,49777,53,59395,53,allow,164,84,80,2,31,1,1
56919,64986,53,47302,53,allow,176,90,86,2,31,1,1
56920,55705,53,57706,53,allow,202,103,99,2,31,1,1
56921,56802,53,9464,53,allow,753,93,660,2,31,1,1
56922,49917,53,47966,53,allow,752,93,659,2,31,1,1
56923,49369,53,3787,53,allow,182,93,89,2,31,1,1
56924,65179,53,5745,53,allow,184,94,90,2,31,1,1
56925,56901,53,23977,53,allow,710,89,621,2,31,1,1
56926,56167,53,36482,53,allow,172,88,84,2,31,1,1
56927,50265,41071,33048,41071,allow,1716,1716,0,27,2188,27,0
56928,57139,53,1323,53,allow,164,84,80,2,31,1,1
56929,58034,443,61141,443,allow,4553,856,3697,17,362,9,8
56930,49983,53,22293,53,allow,206,105,101,2,31,1,1
56931,65424,53,25204,53,allow,204,104,100,2,31,1,1
56932,55743,53,6640,53,allow,748,106,642,2,31,1,1
56933,64949,53,23952,53,allow,208,106,102,2,31,1,1
56934,34734,443,41689,443,allow,7974,2716,5258,50,7261,26,24
56935,52680,445,0,0,drop,66,66,0,1,0,1,0
56936,1534,54369,0,0,deny,66,66,0,1,0,1,0
56937,57266,445,0,0,drop,70,70,0,1,0,1,0
56938,51105,50584,0,0,deny,62,62,0,1,0,1,0
56939,57262,445,0,0,drop,70,70,0,1,0,1,0
56940,57255,445,0,0,drop,70,70,0,1,0,1,0
56941,54836,443,5754,443,allow,119863,100823,19040,322,229,183,139
56942,50166,53,40117,53,allow,211,78,133,2,30,1,1
56943,50583,53,37919,53,allow,819,102,717,2,30,1,1
56944,56878,53,41614,53,allow,168,86,82,2,30,1,1
56945,49429,53,36318,53,allow,210,110,100,2,30,1,1
56946,56445,53,29245,53,allow,199,102,97,2,30,1,1
56947,56354,53,51631,53,allow,200,94,106,2,30,1,1
56948,53230,443,53230,443,allow,1462,916,546,13,34,7,6
56949,44879,443,44879,443,allow,7123,1020,6103,19,151,11,8
56950,49738,443,52506,443,allow,3085,1404,1681,15,15,7,8
56951,19371,53,19371,53,allow,214,82,132,2,31,1,1
56952,53235,443,53235,443,allow,1270,697,573,15,33,8,7
56953,44368,443,44368,443,allow,7123,1020,6103,19,151,11,8
56954,37109,80,41807,80,allow,763,434,329,8,14,5,3
56955,63672,443,63672,443,allow,4398,1491,2907,19,27,11,8
56956,63203,443,63203,443,allow,9324,4240,5084,24,16,13,11
56957,43218,443,21139,443,allow,7375,2087,5288,24,255,12,12
56958,51413,443,36557,443,allow,202,70,132,3,11,1,2
56959,55609,39869,9261,39869,allow,70,70,0,2,8,2,0
56960,65529,53,6825,53,allow,198,102,96,2,29,1,1
56961,49670,53,58566,53,allow,168,86,82,2,29,1,1
56962,59882,53,29947,53,allow,244,86,158,2,29,1,1
56963,65131,53,1840,53,allow,168,86,82,2,29,1,1
56964,57152,53,61515,53,allow,183,94,89,2,29,1,1
56965,57306,53,25248,53,allow,177,94,83,2,29,1,1
56966,52957,53,50377,53,allow,168,78,90,2,29,1,1
56967,55215,53,18031,53,allow,315,126,189,2,29,1,1
56968,56441,53,35817,53,allow,209,110,99,2,29,1,1
56969,64041,53,24835,53,allow,200,102,98,2,29,1,1
56970,44603,53,44603,53,allow,229,98,131,2,29,1,1
56971,65189,27212,4653,27212,allow,254,78,176,2,29,1,1
56972,55688,53,38445,53,allow,183,94,89,2,29,1,1
56973,49266,53,6643,53,allow,199,102,97,2,29,1,1
56974,65189,28115,45956,28115,allow,284,78,206,2,29,1,1
56975,49917,53,29420,53,allow,209,110,99,2,29,1,1
56976,65189,27015,11223,27015,allow,275,78,197,2,29,1,1
56977,65488,53,4906,53,allow,232,110,122,2,29,1,1
56978,65189,27015,42181,27015,allow,262,78,184,2,29,1,1
56979,56004,53,27325,53,allow,177,94,83,2,29,1,1
56980,65189,27268,56111,27268,allow,232,78,154,2,29,1,1
56981,55857,53,40207,53,allow,199,102,97,2,29,1,1
56982,65189,27016,20619,27016,allow,249,78,171,2,29,1,1
56983,49439,53,40925,53,allow,197,102,95,2,30,1,1
56984,65189,27015,60711,27015,allow,278,78,200,2,29,1,1
56985,65189,28015,14178,28015,allow,240,78,162,2,29,1,1
56986,64011,53,63004,53,allow,228,110,118,2,29,1,1
56987,65189,27202,50060,27202,allow,230,78,152,2,29,1,1
56988,55346,53,11251,53,allow,396,102,294,2,30,1,1
56989,49945,53,50921,53,allow,281,97,184,4,58,2,2
56990,50966,443,34957,443,allow,6350,1072,5278,18,40,10,8
56991,55614,29731,2636,29731,allow,70,70,0,2,8,2,0
56992,55615,13826,16063,13826,allow,70,70,0,2,8,2,0
56993,58053,25,49850,25,allow,1316,442,874,15,16,7,8
56994,65504,53,33205,53,allow,193,102,91,2,30,1,1
56995,56332,53,27865,53,allow,209,110,99,2,30,1,1
56996,49730,53,24529,53,allow,211,110,101,2,30,1,1
56997,50238,53,50499,53,allow,438,180,258,6,30,3,3
56998,56987,53,64863,53,allow,196,102,94,2,30,1,1
56999,65063,53,50094,53,allow,180,94,86,2,30,1,1
57000,57077,53,61276,53,allow,166,86,80,2,30,1,1
57001,55469,443,55469,443,allow,4579,1672,2907,19,29,11,8
57002,57010,53,26340,53,allow,199,102,97,2,30,1,1
57003,57306,53,20608,53,allow,573,186,387,6,71,3,3
57004,56477,53,13759,53,allow,199,102,97,2,30,1,1
57005,65380,53,10002,53,allow,180,94,86,2,30,1,1
57006,41343,443,31271,443,allow,7601,1595,6006,25,35,12,13
57007,56144,53,15210,53,allow,177,94,83,2,30,1,1
57008,49539,53,64502,53,allow,340,87,253,4,50,2,2
57009,56783,53,42766,53,allow,199,102,97,2,30,1,1
57010,56783,21279,18481,21279,allow,70,70,0,2,8,2,0
57011,65357,53,23805,53,allow,180,94,86,2,30,1,1
57012,6040,53,41772,53,allow,323,94,229,2,30,1,1
57013,49968,53,43611,53,allow,751,94,657,2,30,1,1
57014,37889,53,32762,53,allow,199,94,105,2,30,1,1
57015,57331,53,38724,53,allow,166,86,80,2,30,1,1
57016,50583,53,45479,53,allow,196,102,94,2,30,1,1
57017,55502,53,15110,53,allow,194,102,92,2,30,1,1
57018,65014,53,57511,53,allow,193,102,91,2,30,1,1
57019,65380,53,23186,53,allow,180,94,86,2,30,1,1
57020,57010,53,46777,53,allow,199,102,97,2,30,1,1
57021,56357,53,47293,53,allow,196,102,94,2,30,1,1
57022,65516,53,21286,53,allow,209,110,99,2,30,1,1
57023,65063,53,22032,53,allow,180,94,86,2,30,1,1
57024,49486,53,9984,53,allow,177,94,83,2,30,1,1
57025,42936,53,47625,53,allow,199,94,105,2,30,1,1
57026,56006,53,47168,53,allow,210,102,108,2,30,1,1
57027,55353,53,65240,53,allow,168,86,82,2,30,1,1
57028,55705,53,14171,53,allow,209,110,99,2,30,1,1
57029,59424,443,18512,443,allow,252,70,182,3,120,1,2
57030,46451,443,47700,443,allow,350492,17722,332770,449,125,169,280
57031,56477,53,54398,53,allow,199,102,97,2,30,1,1
57032,49384,53,27649,53,allow,181,94,87,2,30,1,1
57033,51771,19103,40132,19103,allow,70,70,0,2,8,2,0
57034,51411,443,11555,443,allow,202,70,132,3,11,1,2
57035,41972,5222,18449,5222,allow,5709,2977,2732,62,621,31,31
57036,37694,443,63637,443,allow,234688,15158,219530,324,173,157,167
57037,64913,53,26175,53,allow,555,195,360,6,62,3,3
57038,57010,53,64390,53,allow,199,102,97,2,30,1,1
57039,65417,53,53892,53,allow,183,94,89,2,30,1,1
57040,54984,53,62420,53,allow,994,86,908,2,30,1,1
57041,49439,53,11369,53,allow,197,102,95,2,30,1,1
57042,59614,53,24145,53,allow,417,78,339,2,30,1,1
57043,56899,53,4081,53,allow,258,102,156,2,30,1,1
57044,56375,53,53548,53,allow,184,102,82,2,30,1,1
57045,55057,53,28179,53,allow,889,404,485,10,30,5,5
57046,65231,53,56850,53,allow,200,102,98,2,30,1,1
57047,51755,24236,52970,24236,allow,136,136,0,3,13,3,0
57048,51754,1182,24029,1182,allow,70,70,0,1,5,1,0
57049,49478,53,32475,53,allow,551,114,437,4,37,2,2
57050,65295,53,41511,53,allow,944,205,739,6,45,3,3
57051,51715,443,35378,443,allow,4175264,89546,4085718,4141,532,1111,3030
57052,49730,53,46996,53,allow,211,110,101,2,30,1,1
57053,55722,53,19688,53,allow,226,110,116,2,30,1,1
57054,41780,53,0,0,allow,86,86,0,1,30,1,0
57055,65131,53,31647,53,allow,168,86,82,2,30,1,1
57056,49183,53,46145,53,allow,817,102,715,2,30,1,1
57057,55502,53,12440,53,allow,817,102,715,2,30,1,1
57058,64913,53,45899,53,allow,183,94,89,2,30,1,1
57059,49885,53,57862,53,allow,786,110,676,2,30,1,1
57060,57416,53,21354,53,allow,193,102,91,2,30,1,1
57061,55706,53,9851,53,allow,258,102,156,2,30,1,1
57062,49638,53,6600,53,allow,210,110,100,2,30,1,1
57063,49638,53,20349,53,allow,210,110,100,2,30,1,1
57064,65014,53,36571,53,allow,193,102,91,2,30,1,1
57065,50017,53,65009,53,allow,741,94,647,2,30,1,1
57066,38317,443,31937,443,allow,9834,4297,5537,26,326,12,14
57067,51322,443,58671,443,allow,6250,1422,4828,20,17,10,10
57068,50716,80,11421,80,allow,1106,326,780,12,140,6,6
57069,35866,80,8550,80,allow,1114,534,580,12,15,7,5
57070,35353,443,65162,443,allow,1833,991,842,14,224,7,7
57071,58362,443,29130,443,allow,13272,2360,10912,37,208,19,18
57072,35354,443,9498,443,allow,2392,917,1475,16,224,8,8
57073,42597,443,21561,443,allow,6131,1399,4732,20,979,10,10
57074,49420,443,10802,443,allow,4932,1046,3886,21,173,10,11
57075,33521,80,30889,80,allow,3429,1679,1750,14,22,8,6
57076,56614,80,65163,80,allow,234,234,0,4,11,4,0
57077,39358,443,53461,443,allow,9115,6806,2309,37,80,20,17
57078,53231,443,53231,443,allow,1402,856,546,12,34,6,6
57079,49288,443,9666,443,allow,7846,2369,5477,23,385,10,13
57080,12162,53,12162,53,allow,233,90,143,2,33,1,1
57081,64287,53,8913,53,allow,280,91,189,4,33,2,2
57082,60400,56243,28136,56243,allow,70,70,0,2,8,2,0
57083,51295,443,27138,443,allow,7448,1737,5711,24,201,13,11
57084,55467,53,6293,53,allow,320,95,225,4,41,2,2
57085,64618,53,41913,53,allow,305,100,205,4,54,2,2
57086,59418,443,19462,443,allow,7222,1633,5589,24,201,13,11
57087,35267,80,35004,80,allow,613,539,74,7,15,6,1
57088,49235,53,43539,53,allow,164,78,86,2,29,1,1
57089,56441,53,4935,53,allow,209,110,99,2,29,1,1
57090,1928,53,30597,53,allow,210,78,132,2,29,1,1
57091,65189,28215,62292,28215,allow,259,78,181,2,29,1,1
57092,56883,53,30894,53,allow,184,94,90,2,29,1,1
57093,65189,27016,36079,27016,allow,78,78,0,1,29,1,0
57094,65189,27257,41492,27257,allow,252,78,174,2,29,1,1
57095,65189,27214,42310,27214,allow,231,78,153,2,29,1,1
57096,50006,53,41506,53,allow,994,86,908,2,29,1,1
57097,64323,53,18965,53,allow,195,102,93,2,30,1,1
57098,55467,53,17631,53,allow,193,102,91,2,29,1,1
57099,61858,10443,43005,10443,allow,10747,2507,8240,26,48,14,12
57100,65514,53,14703,53,allow,214,110,104,2,29,1,1
57101,65056,53,34239,53,allow,199,102,97,2,29,1,1
57102,65189,28125,44608,28125,allow,78,78,0,1,29,1,0
57103,55517,53,26427,53,allow,179,94,85,2,29,1,1
57104,54990,53,62190,53,allow,166,86,80,2,29,1,1
57105,65056,53,26315,53,allow,199,102,97,2,29,1,1
57106,49429,53,17254,53,allow,210,110,100,2,29,1,1
57107,64311,53,4229,53,allow,199,102,97,2,29,1,1
57108,49539,53,25645,53,allow,177,94,83,2,30,1,1
57109,65131,53,44924,53,allow,168,86,82,2,30,1,1
57110,49851,53,9637,53,allow,166,86,80,2,29,1,1
57111,49183,53,53469,53,allow,194,102,92,2,30,1,1
57112,55634,53,8065,53,allow,210,110,100,2,30,1,1
57113,42151,53,3505,53,allow,168,78,90,2,30,1,1
57114,49341,53,47990,53,allow,199,102,97,2,31,1,1
57115,56375,53,4600,53,allow,184,102,82,2,30,1,1
57116,49785,53,52317,53,allow,211,110,101,2,30,1,1
57117,65380,53,28417,53,allow,180,94,86,2,30,1,1
57118,56963,53,26493,53,allow,210,110,100,2,30,1,1
57119,55796,53,36094,53,allow,196,102,94,2,30,1,1
57120,56111,53,5335,53,allow,179,94,85,2,30,1,1
57121,65258,53,48935,53,allow,193,102,91,2,30,1,1
57122,54031,53,23447,53,allow,168,78,90,2,30,1,1
57123,64739,53,35789,53,allow,164,86,78,2,31,1,1
57124,56477,53,18413,53,allow,386,101,285,4,31,2,2
57125,64831,53,42481,53,allow,216,110,106,2,30,1,1
57126,57570,443,58853,443,allow,6226,4213,2013,30,79,18,12
57127,27464,53,27464,53,allow,233,90,143,2,32,1,1
57128,50390,8080,50390,8080,allow,378,180,198,7,54,4,3
57129,64403,53,16361,53,allow,783,197,586,6,70,3,3
57130,65014,53,29342,53,allow,193,102,91,2,30,1,1
57131,65063,53,52560,53,allow,180,94,86,2,30,1,1
57132,49785,53,47696,53,allow,211,110,101,2,30,1,1
57133,65359,53,55689,53,allow,193,102,91,2,30,1,1
57134,56104,53,24374,53,allow,197,102,95,2,30,1,1
57135,64216,53,1409,53,allow,183,94,89,2,30,1,1
57136,49229,53,18433,53,allow,178,94,84,2,31,1,1
57137,49361,53,25462,53,allow,184,94,90,2,30,1,1
57138,50885,80,41376,80,allow,291594,13131,278463,312,159,116,196
57139,60401,30046,28995,30046,allow,70,70,0,2,8,2,0
57140,35790,443,59845,443,allow,6777,1527,5250,24,201,13,11
57141,52404,443,21006,443,allow,132575,6675,125900,206,94,91,115
57142,50389,8080,50389,8080,allow,5724,1509,4215,18,55,10,8
57143,49812,53,36103,53,allow,1411,98,1313,4,52,2,2
57144,65504,53,23026,53,allow,193,102,91,2,30,1,1
57145,65417,53,31307,53,allow,183,94,89,2,30,1,1
57146,60601,53,19741,53,allow,451,86,365,2,30,1,1
57147,56144,53,34369,53,allow,177,94,83,2,30,1,1
57148,64121,53,21027,53,allow,365,102,263,2,31,1,1
57149,55199,443,3846,443,allow,18132,8636,9496,40,176,23,17
57150,48673,443,24154,443,allow,18147,9173,8974,42,175,24,18
57151,51467,443,7148,443,allow,20313,6637,13676,45,24,23,22
57152,55610,23383,23402,23383,allow,70,70,0,2,8,2,0
57153,49562,443,58637,443,allow,9908,4692,5216,30,92,16,14
57154,49361,53,49782,53,allow,166,86,80,2,30,1,1
57155,64323,53,64062,53,allow,195,102,93,2,30,1,1
57156,56357,53,43441,53,allow,819,102,717,2,30,1,1
57157,49175,53,18016,53,allow,193,102,91,2,30,1,1
57158,59645,53,23128,53,allow,263,94,169,2,30,1,1
57159,64438,53,4120,53,allow,184,94,90,2,30,1,1
57160,56332,53,16709,53,allow,209,110,99,2,30,1,1
57161,65514,53,43311,53,allow,214,110,104,2,30,1,1
57162,64216,53,16244,53,allow,183,94,89,2,30,1,1
57163,43326,443,42679,443,allow,10063,2126,7937,36,120,18,18
57164,55353,53,1525,53,allow,168,86,82,2,30,1,1
57165,56605,53,38242,53,allow,341,110,231,2,30,1,1
57166,64252,53,2072,53,allow,199,102,97,2,30,1,1
57167,65258,53,25267,53,allow,193,102,91,2,30,1,1
57168,65469,53,49560,53,allow,195,102,93,2,30,1,1
57169,64235,53,40648,53,allow,197,102,95,2,30,1,1
57170,56963,53,63248,53,allow,210,110,100,2,30,1,1
57171,49983,53,2734,53,allow,211,110,101,2,30,1,1
57172,65448,53,6069,53,allow,264,110,154,2,30,1,1
57173,65498,53,57439,53,allow,209,110,99,2,30,1,1
57174,64216,53,45002,53,allow,295,93,202,4,30,2,2
57175,65040,53,10817,53,allow,180,94,86,2,31,1,1
57176,56326,53,47935,53,allow,177,94,83,2,31,1,1
57177,49670,53,59914,53,allow,168,86,82,2,31,1,1
57178,57470,2710,46091,2710,allow,124,124,0,3,1199,3,0
57179,49732,53,17684,53,allow,178,94,84,2,30,1,1
57180,64986,53,8227,53,allow,180,94,86,2,30,1,1
57181,55958,53,25725,53,allow,209,102,107,2,30,1,1
57182,56765,53,52447,53,allow,194,102,92,2,30,1,1
57183,64254,53,19864,53,allow,197,94,103,2,30,1,1
57184,65498,53,39980,53,allow,209,110,99,2,30,1,1
57185,65424,53,39053,53,allow,210,110,100,2,31,1,1
57186,56953,53,15670,53,allow,421,78,343,2,31,1,1
57187,49486,53,40876,53,allow,177,94,83,2,31,1,1
57188,65514,53,32610,53,allow,214,110,104,2,31,1,1
57189,57172,53,27478,53,allow,196,102,94,2,31,1,1
57190,55145,443,65048,443,allow,13231,6169,7062,38,120,19,19
57191,65498,53,26410,53,allow,209,110,99,2,30,1,1
57192,49785,53,63638,53,allow,211,110,101,2,30,1,1
57193,49777,53,14014,53,allow,166,86,80,2,30,1,1
57194,49429,53,19279,53,allow,210,110,100,2,30,1,1
57195,55796,53,53720,53,allow,196,102,94,2,30,1,1
57196,55975,53,28209,53,allow,195,102,93,2,30,1,1
57197,57007,53,62995,53,allow,183,94,89,2,31,1,1
57198,49670,53,37029,53,allow,168,86,82,2,30,1,1
57199,64420,53,18764,53,allow,386,102,284,2,30,1,1
57200,49831,53,24463,53,allow,364,102,262,2,30,1,1
57201,65024,53,10602,53,allow,196,94,102,2,30,1,1
57202,49696,53,9591,53,allow,178,94,84,2,30,1,1
57203,49862,53,52956,53,allow,715,94,621,2,31,1,1
57204,49861,53,56690,53,allow,198,102,96,2,31,1,1
57205,55975,53,44915,53,allow,195,102,93,2,31,1,1
57206,64677,53,13173,53,allow,195,102,93,2,31,1,1
57207,49175,53,45258,53,allow,193,102,91,2,31,1,1
57208,55286,53,22334,53,allow,194,102,92,2,31,1,1
57209,64517,53,18639,53,allow,194,102,92,2,31,1,1
57210,65231,53,37315,53,allow,200,102,98,2,31,1,1
57211,49696,53,25941,53,allow,178,94,84,2,31,1,1
57212,6881,30096,6963,30096,allow,509,150,359,2,1199,1,1
57213,39402,443,48958,443,allow,6417,1255,5162,24,360,12,12
57214,17750,14132,3203,14132,allow,150,150,0,1,1200,1,0
57215,6881,20326,20950,20326,allow,509,150,359,2,1200,1,1
57216,49478,53,58294,53,allow,164,86,78,2,31,1,1
57217,56279,443,57070,443,allow,97608,4852,92756,108,121,37,71
57218,56445,53,26251,53,allow,199,102,97,2,30,1,1
57219,49861,53,42147,53,allow,198,102,96,2,30,1,1
57220,49486,53,16915,53,allow,177,94,83,2,30,1,1
57221,49369,53,54778,53,allow,183,94,89,2,30,1,1
57222,64531,53,60188,53,allow,183,94,89,2,30,1,1
57223,49983,53,17295,53,allow,211,110,101,2,31,1,1
57224,65258,53,31384,53,allow,193,102,91,2,31,1,1
57225,55796,53,15761,53,allow,196,102,94,2,31,1,1
57226,64873,53,31946,53,allow,195,94,101,2,31,1,1
57227,50022,53,5739,53,allow,179,94,85,2,31,1,1
57228,49777,53,45833,53,allow,166,86,80,2,31,1,1
57229,60384,443,37407,443,allow,39385,3771,35614,67,129,27,40
57230,49803,443,21959,443,allow,9506,1461,8045,20,158,9,11
57231,48847,443,1416,443,allow,2523,1483,1040,19,276,10,9
57232,37965,25180,40858,25180,allow,858,858,0,14,1199,14,0
57233,64408,53,9592,53,allow,257,126,131,2,31,1,1
57234,53558,30815,59383,30815,allow,492,306,186,8,16,5,3
57235,51676,443,25301,443,allow,90135,76061,14074,251,247,132,119
57236,64949,53,48447,53,allow,212,110,102,2,31,1,1
57237,55353,53,50896,53,allow,311,86,225,4,55,2,2
57238,41833,443,22584,443,allow,50425,3972,46453,63,122,25,38
57239,47884,443,47884,443,allow,4672,1765,2907,18,28,10,8
57240,53561,35885,5770,35885,allow,70,70,0,1,5,1,0
57241,57267,443,26309,443,allow,126,60,66,3,6,2,1
57242,57257,445,0,0,drop,70,70,0,1,0,1,0
57243,52678,445,0,0,drop,66,66,0,1,0,1,0
57244,52258,445,0,0,drop,70,70,0,1,0,1,0
57245,52257,445,0,0,drop,70,70,0,1,0,1,0
57246,13747,8887,13747,8887,deny,500,500,0,1,0,1,0
57247,33289,50584,0,0,deny,146,146,0,1,0,1,0
57248,61221,35440,0,0,deny,66,66,0,1,0,1,0
57249,57251,445,0,0,drop,70,70,0,1,0,1,0
57250,58305,18375,0,0,deny,66,66,0,1,0,1,0
57251,62338,50011,0,0,deny,62,62,0,1,0,1,0
57252,57249,445,0,0,drop,70,70,0,1,0,1,0
57253,57248,445,0,0,drop,70,70,0,1,0,1,0
57254,57246,445,0,0,drop,70,70,0,1,0,1,0
57255,52251,445,0,0,drop,70,70,0,1,0,1,0
57256,52671,445,0,0,drop,66,66,0,1,0,1,0
57257,48676,53398,0,0,deny,60,60,0,1,0,1,0
57258,52250,445,0,0,drop,70,70,0,1,0,1,0
57259,52665,445,0,0,drop,66,66,0,1,0,1,0
57260,52666,445,0,0,drop,66,66,0,1,0,1,0
57261,52664,445,0,0,drop,66,66,0,1,0,1,0
57262,58703,50584,0,0,deny,66,66,0,1,0,1,0
57263,26324,30188,0,0,deny,62,62,0,1,0,1,0
57264,52660,445,0,0,drop,66,66,0,1,0,1,0
57265,52661,445,0,0,drop,66,66,0,1,0,1,0
57266,52658,445,0,0,drop,66,66,0,1,0,1,0
57267,52246,445,0,0,drop,70,70,0,1,0,1,0
57268,56703,50584,0,0,deny,62,62,0,1,0,1,0
57269,51191,26467,0,0,deny,66,66,0,1,0,1,0
57270,63583,37965,0,0,deny,62,62,0,1,0,1,0
57271,16393,22114,0,0,deny,66,66,0,1,0,1,0
57272,52245,445,0,0,drop,70,70,0,1,0,1,0
57273,61426,64910,0,0,deny,66,66,0,1,0,1,0
57274,57244,445,0,0,drop,70,70,0,1,0,1,0
57275,57241,445,0,0,drop,70,70,0,1,0,1,0
57276,57240,445,0,0,drop,70,70,0,1,0,1,0
57277,5223,59023,0,0,deny,66,66,0,1,0,1,0
57278,52657,445,0,0,drop,66,66,0,1,0,1,0
57279,30599,46824,0,0,deny,66,66,0,1,0,1,0
57280,57236,445,0,0,drop,70,70,0,1,0,1,0
57281,443,46382,0,0,deny,66,66,0,1,0,1,0
57282,52652,445,0,0,drop,66,66,0,1,0,1,0
57283,52651,445,0,0,drop,66,66,0,1,0,1,0
57284,53772,443,49684,443,allow,499,425,74,4,0,3,1
57285,53770,443,15341,443,allow,499,425,74,4,0,3,1
57286,53768,443,3588,443,allow,499,425,74,4,0,3,1
57287,53755,443,8268,443,allow,499,425,74,4,0,3,1
57288,53771,443,40823,443,allow,499,425,74,4,0,3,1
57289,53760,443,44529,443,allow,499,425,74,4,0,3,1
57290,53765,443,33408,443,allow,499,425,74,4,0,3,1
57291,53759,443,57982,443,allow,499,425,74,4,0,3,1
57292,53763,443,53593,443,allow,499,425,74,4,0,3,1
57293,53773,443,19967,443,allow,499,425,74,4,0,3,1
57294,53766,443,46858,443,allow,499,425,74,4,0,3,1
57295,53774,443,4137,443,allow,499,425,74,4,0,3,1
57296,53761,443,39818,443,allow,499,425,74,4,0,3,1
57297,53762,443,60750,443,allow,499,425,74,4,0,3,1
57298,53750,443,4212,443,allow,499,425,74,4,0,3,1
57299,53757,443,15611,443,allow,499,425,74,4,0,3,1
57300,53767,443,6984,443,allow,499,425,74,4,0,3,1
57301,53764,443,56074,443,allow,499,425,74,4,0,3,1
57302,53752,443,21616,443,allow,499,425,74,4,0,3,1
57303,53753,443,5988,443,allow,499,425,74,4,0,3,1
57304,53758,443,30147,443,allow,499,425,74,4,0,3,1
57305,53754,443,24588,443,allow,499,425,74,4,0,3,1
57306,53756,443,48419,443,allow,499,425,74,4,0,3,1
57307,53751,443,44095,443,allow,499,425,74,4,0,3,1
57308,52649,445,0,0,drop,66,66,0,1,0,1,0
57309,56712,46824,0,0,deny,66,66,0,1,0,1,0
57310,56119,46824,0,0,deny,62,62,0,1,0,1,0
57311,39823,36237,0,0,deny,62,62,0,1,0,1,0
57312,52647,445,0,0,drop,66,66,0,1,0,1,0
57313,64219,51050,0,0,deny,66,66,0,1,0,1,0
57314,52240,445,0,0,drop,70,70,0,1,0,1,0
57315,54062,31573,0,0,deny,66,66,0,1,0,1,0
57316,62071,22114,0,0,deny,62,62,0,1,0,1,0
57317,57232,445,0,0,drop,70,70,0,1,0,1,0
57318,32511,23,0,0,deny,60,60,0,1,0,1,0
57319,3270,35440,0,0,deny,66,66,0,1,0,1,0
57320,57225,445,0,0,drop,70,70,0,1,0,1,0
57321,57224,445,0,0,drop,70,70,0,1,0,1,0
57322,36906,50584,0,0,deny,62,62,0,1,0,1,0
57323,13654,50584,0,0,deny,62,62,0,1,0,1,0
57324,52638,445,0,0,drop,66,66,0,1,0,1,0
57325,40834,50584,0,0,deny,62,62,0,1,0,1,0
57326,52227,445,0,0,drop,70,70,0,1,0,1,0
57327,58486,57470,0,0,deny,66,66,0,1,0,1,0
57328,32491,15503,0,0,deny,66,66,0,1,0,1,0
57329,50535,51505,0,0,deny,66,66,0,1,0,1,0
57330,52224,445,0,0,drop,70,70,0,1,0,1,0
57331,52629,445,0,0,drop,66,66,0,1,0,1,0
57332,42252,33303,0,0,deny,60,60,0,1,0,1,0
57333,57210,445,0,0,drop,70,70,0,1,0,1,0
57334,24480,35440,0,0,deny,66,66,0,1,0,1,0
57335,52497,47967,0,0,deny,143,143,0,1,0,1,0
57336,52626,445,0,0,drop,66,66,0,1,0,1,0
57337,16660,55783,0,0,deny,62,62,0,1,0,1,0
57338,52220,445,0,0,drop,70,70,0,1,0,1,0
57339,52218,445,0,0,drop,70,70,0,1,0,1,0
57340,52618,445,0,0,drop,66,66,0,1,0,1,0
57341,26110,2310,0,0,deny,148,148,0,1,0,1,0
57342,52216,445,0,0,drop,70,70,0,1,0,1,0
57343,52615,445,0,0,drop,66,66,0,1,0,1,0
57344,51265,31652,0,0,reset-both,72,72,0,1,0,1,0
57345,19156,3846,0,0,deny,145,145,0,1,0,1,0
57346,54339,23117,0,0,deny,66,66,0,1,0,1,0
57347,9412,7302,0,0,deny,66,66,0,1,0,1,0
57348,63465,56205,0,0,deny,66,66,0,1,0,1,0
57349,52209,445,0,0,drop,70,70,0,1,0,1,0
57350,57199,445,0,0,drop,70,70,0,1,0,1,0
57351,57196,445,0,0,drop,70,70,0,1,0,1,0
57352,57197,445,0,0,drop,70,70,0,1,0,1,0
57353,52596,445,0,0,drop,66,66,0,1,0,1,0
57354,52600,445,0,0,drop,66,66,0,1,0,1,0
57355,52603,445,0,0,drop,66,66,0,1,0,1,0
57356,52602,445,0,0,drop,66,66,0,1,0,1,0
57357,52598,445,0,0,drop,66,66,0,1,0,1,0
57358,52601,445,0,0,drop,66,66,0,1,0,1,0
57359,52604,445,0,0,drop,66,66,0,1,0,1,0
57360,52599,445,0,0,drop,66,66,0,1,0,1,0
57361,1024,64147,0,0,deny,62,62,0,1,0,1,0
57362,52207,445,0,0,drop,70,70,0,1,0,1,0
57363,37597,50584,0,0,deny,66,66,0,1,0,1,0
57364,443,31353,0,0,deny,97,97,0,1,0,1,0
57365,443,49313,0,0,deny,97,97,0,1,0,1,0
57366,51617,21247,0,0,deny,66,66,0,1,0,1,0
57367,58445,17500,0,0,deny,66,66,0,1,0,1,0
57368,52206,445,0,0,drop,70,70,0,1,0,1,0
57369,57772,50584,0,0,deny,66,66,0,1,0,1,0
57370,52205,445,0,0,drop,70,70,0,1,0,1,0
57371,52204,445,0,0,drop,70,70,0,1,0,1,0
57372,52200,445,0,0,drop,70,70,0,1,0,1,0
57373,52201,445,0,0,drop,70,70,0,1,0,1,0
57374,44546,32468,0,0,deny,146,146,0,1,0,1,0
57375,62549,64147,0,0,deny,62,62,0,1,0,1,0
57376,54343,50584,0,0,deny,66,66,0,1,0,1,0
57377,1323,64147,0,0,deny,66,66,0,1,0,1,0
57378,60018,64147,0,0,deny,62,62,0,1,0,1,0
57379,63852,35440,0,0,deny,66,66,0,1,0,1,0
57380,0,0,0,0,allow,320,320,0,5,0,5,0
57381,57194,445,0,0,drop,70,70,0,1,0,1,0
57382,57189,445,0,0,drop,70,70,0,1,0,1,0
57383,57181,445,0,0,drop,70,70,0,1,0,1,0
57384,16716,57470,0,0,deny,145,145,0,1,0,1,0
57385,52186,445,0,0,drop,70,70,0,1,0,1,0
57386,52185,445,0,0,drop,70,70,0,1,0,1,0
57387,52179,445,0,0,drop,70,70,0,1,0,1,0
57388,52583,445,0,0,drop,66,66,0,1,0,1,0
57389,52584,445,0,0,drop,66,66,0,1,0,1,0
57390,52582,445,0,0,drop,66,66,0,1,0,1,0
57391,52175,445,0,0,drop,70,70,0,1,0,1,0
57392,52176,445,0,0,drop,70,70,0,1,0,1,0
57393,24375,12809,0,0,deny,60,60,0,1,0,1,0
57394,57179,445,0,0,drop,70,70,0,1,0,1,0
57395,26921,37965,0,0,deny,62,62,0,1,0,1,0
57396,50439,64147,0,0,deny,66,66,0,1,0,1,0
57397,26924,37965,0,0,deny,66,66,0,1,0,1,0
57398,57176,445,0,0,drop,70,70,0,1,0,1,0
57399,57164,445,0,0,drop,70,70,0,1,0,1,0
57400,57168,445,0,0,drop,70,70,0,1,0,1,0
57401,57167,445,0,0,drop,70,70,0,1,0,1,0
57402,11410,36237,0,0,deny,146,146,0,1,0,1,0
57403,52164,445,0,0,drop,70,70,0,1,0,1,0
57404,34756,8055,0,0,deny,159,159,0,1,0,1,0
57405,57283,64147,0,0,deny,66,66,0,1,0,1,0
57406,65384,57470,0,0,deny,66,66,0,1,0,1,0
57407,47910,7454,0,0,deny,60,60,0,1,0,1,0
57408,13864,30718,0,0,deny,60,60,0,1,0,1,0
57409,49831,30188,0,0,deny,62,62,0,1,0,1,0
57410,63667,57470,0,0,deny,145,145,0,1,0,1,0
57411,59168,39004,0,0,deny,62,62,0,1,0,1,0
57412,51815,51221,0,0,deny,74,74,0,1,0,1,0
57413,24592,50584,0,0,deny,62,62,0,1,0,1,0
57414,57157,445,0,0,drop,70,70,0,1,0,1,0
57415,57156,445,0,0,drop,70,70,0,1,0,1,0
57416,57153,445,0,0,drop,70,70,0,1,0,1,0
57417,8976,44847,0,0,deny,66,66,0,1,0,1,0
57418,52160,445,0,0,drop,70,70,0,1,0,1,0
57419,47888,2310,0,0,deny,145,145,0,1,0,1,0
57420,52150,445,0,0,drop,70,70,0,1,0,1,0
57421,52151,445,0,0,drop,70,70,0,1,0,1,0
57422,52146,445,0,0,drop,70,70,0,1,0,1,0
57423,52147,445,0,0,drop,70,70,0,1,0,1,0
57424,52144,445,0,0,drop,70,70,0,1,0,1,0
57425,56445,53,52720,53,allow,198,101,97,2,30,1,1
57426,42135,443,55299,443,allow,6531,1249,5282,24,286,13,11
57427,62228,443,62228,443,allow,296688,57600,239088,332,96,141,191
57428,34366,443,43232,443,allow,1053,566,487,10,16,6,4
57429,42699,5222,6919,5222,allow,420,156,264,7,18,3,4
57430,35052,80,38624,80,allow,350,210,140,6,30,4,2
57431,49341,53,42621,53,allow,198,101,97,2,30,1,1
57432,50022,53,39220,53,allow,174,89,85,2,30,1,1
57433,64631,443,8739,443,allow,8701,3408,5293,48,256,22,26
57434,49332,53,40502,53,allow,281,98,183,4,57,2,2
57435,55046,80,55074,80,allow,1056,682,374,10,16,6,4
57436,11073,3389,11073,3389,allow,4085,1916,2169,21,18,12,9
57437,65115,53,24765,53,allow,186,95,91,2,30,1,1
57438,55975,53,65159,53,allow,190,97,93,2,30,1,1
57439,56326,53,54656,53,allow,170,87,83,2,30,1,1
57440,56830,53,35063,53,allow,752,93,659,2,30,1,1
57441,50881,80,50881,80,allow,13503,1052,12451,23,21,10,13
57442,49699,53,40136,53,allow,266,89,177,4,58,2,2
57443,43108,443,11094,443,allow,3117,1867,1250,19,16,9,10
57444,59416,443,46812,443,allow,2834,1700,1134,16,15,8,8
57445,55598,41565,5694,41565,allow,70,70,0,1,5,1,0
57446,49643,443,30041,443,allow,1640,1089,551,14,15,8,6
57447,56602,443,27563,443,allow,7942,1953,5989,20,15,11,9
57448,31123,53,31123,53,allow,231,88,143,2,34,1,1
57449,35050,80,51635,80,allow,350,210,140,6,30,4,2
57450,63749,13219,47890,13219,allow,504,382,122,8,15,6,2
57451,50566,443,50394,443,allow,11116,4583,6533,39,256,19,20
57452,56774,39553,19722,39553,allow,66,66,0,1,5,1,0
57453,58508,443,23694,443,allow,3386,1894,1492,20,25,10,10
57454,55286,53,55062,53,allow,188,96,92,2,30,1,1
57455,64235,53,36798,53,allow,194,99,95,2,30,1,1
57456,62229,443,62229,443,allow,211574,21152,190422,236,96,92,144
57457,35051,80,55027,80,allow,350,210,140,6,30,4,2
57458,64850,53,42650,53,allow,192,98,94,2,31,1,1
57459,24608,53,24608,53,allow,209,77,132,2,33,1,1
57460,45202,443,49520,443,allow,15153,8118,7035,45,271,22,23
57461,59415,443,30552,443,allow,2854,1700,1154,16,16,8,8
57462,60884,443,11637,443,allow,7411,3022,4389,26,46,15,11
57463,56601,443,9573,443,allow,7889,1900,5989,20,15,11,9
57464,59829,443,18743,443,allow,182,60,122,4,26,2,2
57465,49644,80,17566,80,allow,2950,601,2349,12,15,6,6
57466,38599,443,40890,443,allow,3605,1648,1957,20,255,10,10
57467,57367,443,24702,443,allow,7498,2799,4699,24,17,13,11
57468,56773,53,6473,53,allow,735,88,647,2,30,1,1
57469,56600,443,35329,443,allow,7941,1952,5989,20,15,11,9
57470,52346,5222,7493,5222,allow,3983,1663,2320,40,151,19,21
57471,56868,53,63238,53,allow,752,93,659,2,30,1,1
57472,64531,53,46731,53,allow,182,93,89,2,30,1,1
57473,63943,53,51755,53,allow,274,90,184,4,56,2,2
57474,50069,53,5416,53,allow,174,89,85,2,30,1,1
57475,34070,53,34070,53,allow,250,108,142,2,30,1,1
57476,65451,53,43825,53,allow,172,88,84,2,31,1,1
57477,64997,53,9569,53,allow,164,84,80,2,31,1,1
57478,64517,53,41007,53,allow,188,96,92,2,31,1,1
57479,57470,55000,8797,55000,allow,726,726,0,12,1200,12,0
57480,64677,53,35002,53,allow,190,97,93,2,31,1,1
57481,56744,53,44320,53,allow,740,93,647,2,31,1,1
57482,60366,443,31619,443,allow,14484,7411,7073,26,60,15,11
57483,56066,53,46856,53,allow,208,106,102,2,30,1,1
57484,49635,53,55370,53,allow,204,104,100,2,30,1,1
57485,54998,53,35657,53,allow,174,89,85,2,31,1,1
57486,49297,53,13905,53,allow,182,93,89,2,31,1,1
57487,64914,53,32177,53,allow,168,86,82,2,31,1,1
57488,56320,53,39261,53,allow,182,93,89,2,31,1,1
57489,64546,53,12738,53,allow,182,93,89,2,31,1,1
57490,64608,53,13914,53,allow,208,106,102,2,31,1,1
57491,57102,53,62083,53,allow,761,100,661,2,31,1,1
57492,64689,53,18910,53,allow,182,93,89,2,31,1,1
57493,54943,60038,0,0,allow,66,66,0,1,90,1,0
57494,64982,53,19403,53,allow,190,97,93,2,31,1,1
57495,57470,35667,24783,35667,allow,132,132,0,3,1200,3,0
57496,65098,53,21613,53,allow,740,93,647,2,31,1,1
57497,65371,53,39965,53,allow,198,101,97,2,31,1,1
57498,64726,53,62108,53,allow,172,88,84,2,31,1,1
57499,55964,443,21962,443,allow,4455,798,3657,17,136,7,10
57500,65513,53,35186,53,allow,190,97,93,2,31,1,1
57501,57470,54154,42196,54154,allow,480,149,331,2,1200,1,1
57502,6881,6881,0,0,deny,62,62,0,1,0,1,0
57503,18655,50584,0,0,deny,62,62,0,1,0,1,0
57504,28973,30188,0,0,deny,66,66,0,1,0,1,0
57505,42237,36237,0,0,deny,66,66,0,1,0,1,0
57506,57414,57470,0,0,deny,146,146,0,1,0,1,0
57507,52560,445,0,0,drop,66,66,0,1,0,1,0
57508,51172,443,45149,443,allow,1472,965,507,13,20,7,6
57509,50153,80,50079,80,allow,41846,1261,40585,45,75,13,32
57510,49332,53,38516,53,allow,281,98,183,4,57,2,2
57511,51413,443,51090,443,allow,63766,32148,31618,103,42,51,52
57512,57150,445,0,0,drop,70,70,0,1,0,1,0
57513,57149,445,0,0,drop,70,70,0,1,0,1,0
57514,26531,37965,0,0,deny,62,62,0,1,0,1,0
57515,24144,57470,0,0,deny,62,62,0,1,0,1,0
57516,61345,21247,0,0,deny,66,66,0,1,0,1,0
57517,53987,57470,0,0,deny,66,66,0,1,0,1,0
57518,52137,445,0,0,drop,70,70,0,1,0,1,0
57519,50784,52952,0,0,deny,62,62,0,1,0,1,0
57520,52913,2767,0,0,deny,66,66,0,1,0,1,0
57521,30114,65151,0,0,deny,60,60,0,1,0,1,0
57522,59879,55783,0,0,deny,66,66,0,1,0,1,0
57523,52555,445,0,0,drop,66,66,0,1,0,1,0
57524,64158,53,28086,53,allow,211,102,109,2,30,1,1
57525,55705,53,50083,53,allow,209,110,99,2,30,1,1
57526,54998,53,11974,53,allow,179,94,85,2,30,1,1
57527,49635,53,17449,53,allow,210,110,100,2,30,1,1
57528,49940,443,15585,443,allow,4363,1298,3065,17,127,8,9
57529,49260,53,30297,53,allow,791,85,706,4,57,2,2
57530,65266,53,28016,53,allow,536,113,423,4,56,2,2
57531,62230,443,62230,443,allow,119850,11021,108829,134,95,50,84
57532,50901,80,56736,80,allow,11091,2772,8319,22,154,12,10
57533,51777,63497,24893,63497,allow,316,136,180,6,6,3,3
57534,51177,443,18641,443,allow,154,94,60,2,4,1,1
57535,64252,53,63394,53,allow,381,101,280,4,43,2,2
57536,65040,53,46633,53,allow,180,94,86,2,29,1,1
57537,64999,53,64999,53,allow,230,90,140,2,30,1,1
57538,49228,443,49228,443,allow,32952,11546,21406,60,71,36,24
57539,60775,443,60775,443,allow,4652,1745,2907,19,29,11,8
57540,59978,443,59552,443,allow,10132,5161,4971,42,15,25,17
57541,49175,53,11847,53,allow,193,102,91,2,29,1,1
57542,60749,40010,57224,40010,allow,316,136,180,6,5,3,3
57543,64711,53,52164,53,allow,178,94,84,2,29,1,1
57544,35370,443,45689,443,allow,87183,4177,83006,104,126,34,70
57545,57139,53,34151,53,allow,166,86,80,2,29,1,1
57546,55747,53,57229,53,allow,215,102,113,2,29,1,1
57547,65040,53,64566,53,allow,180,94,86,2,29,1,1
57548,65469,53,34501,53,allow,195,102,93,2,29,1,1
57549,64956,53,13763,53,allow,565,92,473,4,38,2,2
57550,55705,53,38579,53,allow,209,110,99,2,29,1,1
57551,55634,53,37153,53,allow,210,110,100,2,30,1,1
57552,53555,57861,41718,57861,allow,492,306,186,8,15,5,3
57553,55286,53,58993,53,allow,194,102,92,2,29,1,1
57554,57139,53,51563,53,allow,166,86,80,2,30,1,1
57555,55517,53,64032,53,allow,179,94,85,2,29,1,1
57556,49341,53,19411,53,allow,199,102,97,2,29,1,1
57557,51779,3389,21341,3389,allow,62242217,4119315,58122902,123738,4772,43917,79821
57558,2070,53,2070,53,allow,233,90,143,2,32,1,1
57559,36074,80,23733,80,allow,1158,792,366,10,17,6,4
57560,59977,443,64573,443,allow,7971,2647,5324,38,15,24,14
57561,50203,80,15124,80,allow,4020,1978,2042,16,66,9,7
57562,64079,53,36707,53,allow,232,94,138,2,30,1,1
57563,49332,53,50877,53,allow,281,98,183,4,57,2,2
57564,46590,443,20776,443,allow,6665,1130,5535,24,287,13,11
57565,50307,443,50307,443,allow,4378,1471,2907,19,30,11,8
57566,57127,53,41259,53,allow,195,102,93,2,30,1,1
57567,60886,443,34294,443,allow,3855,2679,1176,28,45,15,13
57568,39821,443,37984,443,allow,11179,7205,3974,47,136,26,21
57569,51171,443,60392,443,allow,1532,965,567,14,20,7,7
57570,49367,53,7025,53,allow,548,112,436,4,36,2,2
57571,34239,80,12111,80,allow,1056,682,374,10,15,6,4
57572,63226,443,50931,443,allow,4462,2023,2439,33,125,17,16
57573,64986,53,27800,53,allow,180,94,86,2,30,1,1
57574,55597,7485,34248,7485,allow,70,70,0,1,5,1,0
57575,8984,443,5920,443,allow,13750,4934,8816,64,167,31,33
57576,25776,53,25776,53,allow,233,90,143,2,32,1,1
57577,56167,53,17314,53,allow,178,94,84,2,30,1,1
57578,60405,443,60867,443,allow,6570,1988,4582,19,57,10,9
57579,45564,443,3708,443,allow,69614,5520,64094,100,21,52,48
57580,64739,53,12107,53,allow,172,94,78,2,30,1,1
57581,50149,80,19755,80,allow,78701,4331,74370,77,75,21,56
57582,49920,80,51045,80,allow,3649288,78688,3570600,2923,179,528,2395
57583,57416,53,2716,53,allow,193,102,91,2,30,1,1
57584,65048,53,32798,53,allow,194,102,92,2,30,1,1
57585,63998,53,51868,53,allow,263,126,137,2,30,1,1
57586,64531,53,41084,53,allow,183,94,89,2,30,1,1
57587,49983,53,57759,53,allow,211,110,101,2,30,1,1
57588,64388,53,48927,53,allow,248,102,146,2,30,1,1
57589,49820,53,40891,53,allow,211,102,109,2,30,1,1
57590,64126,53,25754,53,allow,255,102,153,2,30,1,1
57591,60887,443,40935,443,allow,3795,2679,1116,27,45,15,12
57592,45174,443,32047,443,allow,6196,1417,4779,21,665,11,10
57593,43120,80,4226,80,allow,1151,711,440,10,15,5,5
57594,50419,80,40888,80,allow,3664,1440,2224,12,23,6,6
57595,50193,443,31534,443,allow,2404,1121,1283,14,115,7,7
57596,63943,53,16297,53,allow,258,90,168,4,56,2,2
57597,49777,53,60241,53,allow,272,84,188,4,60,2,2
57598,50069,53,27415,53,allow,179,94,85,2,30,1,1
57599,49369,53,21146,53,allow,183,94,89,2,30,1,1
57600,49297,53,2852,53,allow,183,94,89,2,30,1,1
57601,57139,53,32218,53,allow,166,86,80,2,30,1,1
57602,54998,53,33990,53,allow,179,94,85,2,30,1,1
57603,60875,443,9147,443,allow,45373,35377,9996,88,72,48,40
57604,56782,49135,47020,49135,allow,70,70,0,2,8,2,0
57605,60278,80,27803,80,allow,1422,734,688,7,99,4,3
57606,55563,53,20716,53,allow,290,118,172,2,30,1,1
57607,65140,53,14760,53,allow,752,110,642,2,30,1,1
57608,56167,53,49116,53,allow,178,94,84,2,30,1,1
57609,59717,443,16330,443,allow,303966,26201,277765,521,167,208,313
57610,61592,443,6581,443,allow,19544,8237,11307,29,121,13,16
57611,47817,443,11040,443,allow,18158,2080,16078,34,122,19,15
57612,51414,443,43551,443,allow,78740,40216,38524,126,42,66,60
57613,45633,80,23400,80,allow,1573,702,871,12,45,7,5
57614,46341,443,54451,443,allow,9172,3518,5654,39,103,21,18
57615,56521,443,48766,443,allow,8760,3693,5067,20,90,12,8
57616,49699,53,32857,53,allow,266,89,177,4,58,2,2
57617,46974,443,29237,443,allow,5861,1151,4710,18,34,10,8
57618,56552,53,47161,53,allow,195,102,93,2,29,1,1
57619,50016,80,57935,80,allow,827,687,140,6,32,4,2
57620,56071,53,60998,53,allow,193,102,91,2,29,1,1
57621,64986,53,30082,53,allow,180,94,86,2,30,1,1
57622,53447,80,56181,80,allow,1517,481,1036,11,15,6,5
57623,57134,53,48452,53,allow,178,94,84,2,30,1,1
57624,51769,19165,28138,19165,allow,70,70,0,2,8,2,0
57625,65179,53,52575,53,allow,184,94,90,2,30,1,1
57626,55595,33677,1152,33677,allow,210,140,70,4,14,3,1
57627,49341,53,41507,53,allow,199,102,97,2,30,1,1
57628,53537,34901,47127,34901,allow,672,426,246,11,21,7,4
57629,65115,53,52563,53,allow,193,102,91,2,30,1,1
57630,62234,443,62234,443,allow,187597,6822,180775,203,92,67,136
57631,64213,53,34758,53,allow,342,105,237,4,53,2,2
57632,55286,53,38062,53,allow,194,102,92,2,29,1,1
57633,63747,80,64940,80,allow,314,192,122,6,15,4,2
57634,49384,53,28172,53,allow,181,94,87,2,29,1,1
57635,64252,53,2109,53,allow,199,102,97,2,29,1,1
57636,49699,53,7442,53,allow,266,89,177,4,58,2,2
57637,64438,53,9645,53,allow,184,94,90,2,29,1,1
57638,65185,53,26657,53,allow,453,186,267,6,30,3,3
57639,49361,53,37385,53,allow,184,94,90,2,29,1,1
57640,56402,53,29838,53,allow,322,134,188,2,30,1,1
57641,57416,53,8404,53,allow,193,102,91,2,29,1,1
57642,55955,53,39332,53,allow,164,86,78,2,30,1,1
57643,64997,53,31899,53,allow,166,86,80,2,30,1,1
57644,65179,53,63378,53,allow,184,94,90,2,31,1,1
57645,50022,53,26770,53,allow,179,94,85,2,31,1,1
57646,65179,53,56146,53,allow,184,94,90,2,30,1,1
57647,58080,3389,58080,3389,allow,3564,1850,1714,18,32,10,8
57648,55664,53,37409,53,allow,195,102,93,2,30,1,1
57649,64546,53,39505,53,allow,183,94,89,2,31,1,1
57650,49945,53,3434,53,allow,281,97,184,4,57,2,2
57651,64124,80,34060,80,allow,1517,481,1036,11,15,6,5
57652,60883,443,40215,443,allow,11586,5435,6151,46,46,25,21
57653,42790,443,55460,443,allow,13859,3232,10627,50,256,21,29
57654,54932,443,37338,443,allow,84306,6712,77594,156,236,58,98
57655,59814,443,30492,443,allow,1560,977,583,15,30,8,7
57656,36811,80,46728,80,allow,1475,837,638,10,15,5,5
57657,50423,80,33009,80,allow,23470,2457,21013,31,22,13,18
57658,49369,53,36980,53,allow,183,94,89,2,30,1,1
57659,56641,53,52292,53,allow,453,186,267,6,30,3,3
57660,40926,53,16373,53,allow,168,78,90,2,30,1,1
57661,57127,53,41835,53,allow,195,102,93,2,30,1,1
57662,59089,443,40663,443,allow,77560,5020,72540,93,121,34,59
57663,52221,443,62267,443,allow,4567,717,3850,17,148,7,10
57664,60885,443,21890,443,allow,3855,2679,1176,28,45,15,13
57665,56784,23140,27615,23140,allow,70,70,0,1,5,1,0
57666,64783,53,41526,53,allow,561,99,462,4,38,2,2
57667,63227,443,37596,443,allow,1373,734,639,17,125,10,7
57668,56759,53,42507,53,allow,338,118,220,2,30,1,1
57669,55937,53,58356,53,allow,179,94,85,2,30,1,1
57670,57268,53,42841,53,allow,205,94,111,2,30,1,1
57671,56167,53,4828,53,allow,178,94,84,2,30,1,1
57672,64850,53,49939,53,allow,196,102,94,2,30,1,1
57673,55955,53,59392,53,allow,164,86,78,2,30,1,1
57674,65522,53,17756,53,allow,1281,94,1187,2,30,1,1
57675,57323,53,57323,53,allow,216,98,118,2,30,1,1
57676,64859,53,0,0,allow,220,81,139,2,30,1,1
57677,37168,443,5501,443,allow,4871,923,3948,19,360,10,9
57678,56932,53,30512,53,allow,172,94,78,2,30,1,1
57679,55975,53,39571,53,allow,195,102,93,2,30,1,1
57680,31710,53,31710,53,allow,233,90,143,2,32,1,1
57681,60195,80,59592,80,allow,70,70,0,1,5,1,0
57682,56775,20617,21189,20617,allow,70,70,0,1,5,1,0
57683,51752,31677,14033,31677,allow,70,70,0,1,5,1,0
57684,52194,80,42397,80,allow,1151,711,440,10,15,5,5
57685,57134,53,29907,53,allow,178,94,84,2,30,1,1
57686,49229,53,43907,53,allow,178,94,84,2,30,1,1
57687,56326,53,34552,53,allow,177,94,83,2,30,1,1
57688,55634,53,10243,53,allow,210,110,100,2,30,1,1
57689,64303,53,3497,53,allow,212,102,110,2,30,1,1
57690,49478,53,25544,53,allow,172,94,78,2,30,1,1
57691,51459,53,51459,53,allow,256,114,142,2,30,1,1
57692,42758,123,49346,123,allow,184,94,90,2,30,1,1
57693,64235,53,18011,53,allow,197,102,95,2,30,1,1
57694,65231,53,2677,53,allow,200,102,98,2,30,1,1
57695,52088,53,34492,53,allow,168,78,90,2,30,1,1
57696,59475,53,33895,53,allow,179,86,93,2,30,1,1
57697,65451,53,9414,53,allow,178,94,84,2,30,1,1
57698,49635,53,59666,53,allow,210,110,100,2,30,1,1
57699,50022,53,51786,53,allow,179,94,85,2,30,1,1
57700,55664,53,32292,53,allow,195,102,93,2,30,1,1
57701,65371,53,1608,53,allow,199,102,97,2,30,1,1
57702,65424,53,5090,53,allow,210,110,100,2,31,1,1
57703,65513,53,29862,53,allow,195,102,93,2,31,1,1
57704,65048,53,7806,53,allow,194,102,92,2,30,1,1
57705,56066,53,20182,53,allow,212,110,102,2,30,1,1
57706,56418,53,19002,53,allow,183,94,89,2,30,1,1
57707,49442,53,40025,53,allow,198,94,104,2,31,1,1
57708,64850,53,36878,53,allow,196,102,94,2,31,1,1
57709,64677,53,46523,53,allow,195,102,93,2,31,1,1
57710,65451,53,7550,53,allow,178,94,84,2,31,1,1
57711,35685,443,31847,443,allow,2967,876,2091,11,120,5,6
57712,64011,443,26030,443,allow,4196,1407,2789,19,135,9,10
57713,33814,443,5866,443,allow,8601,2870,5731,40,225,22,18
57714,56288,53,49732,53,allow,183,94,89,2,31,1,1
57715,49631,443,48718,443,allow,8558,1006,7552,16,121,7,9
57716,38659,443,10582,443,allow,11202,2200,9002,39,131,20,19
57717,6881,6881,52538,6881,allow,118,118,0,1,1200,1,0
57718,37965,20926,65479,20926,allow,481,150,331,2,1199,1,1
57719,48991,80,63971,80,allow,121475,5644,115831,163,145,81,82
57720,56418,53,28996,53,allow,183,94,89,2,31,1,1
57721,65115,53,25677,53,allow,368,95,273,4,61,2,2
57722,57415,443,15579,443,allow,28216,10325,17891,93,23,42,51
57723,44928,443,35200,443,allow,9345,2224,7121,40,112,22,18
57724,43227,443,48195,443,allow,460628,23936,436692,580,124,264,316
57725,58190,53,48181,53,allow,648,86,562,4,51,2,2
57726,60538,80,60538,80,allow,318,120,198,6,26,3,3
57727,53915,443,38797,443,allow,7917,2410,5507,32,26,18,14
57728,54998,53,29340,53,allow,438,89,349,4,60,2,2
57729,49424,53,11040,53,allow,198,102,96,2,33,1,1
57730,60539,80,60539,80,allow,318,120,198,6,26,3,3
57731,48892,443,58975,443,allow,740,210,530,12,110,4,8
57732,64055,53,48031,53,allow,501,94,407,4,52,2,2
57733,56656,53,3129,53,allow,255,88,167,4,53,2,2
57734,57351,62413,0,0,deny,62,62,0,1,0,1,0
57735,61616,23,0,0,deny,60,60,0,1,0,1,0
57736,52552,445,0,0,drop,66,66,0,1,0,1,0
57737,57140,445,0,0,drop,70,70,0,1,0,1,0
57738,59585,36237,0,0,deny,62,62,0,1,0,1,0
57739,52128,445,0,0,drop,70,70,0,1,0,1,0
57740,57132,445,0,0,drop,70,70,0,1,0,1,0
57741,57130,445,0,0,drop,70,70,0,1,0,1,0
57742,57129,445,0,0,drop,70,70,0,1,0,1,0
57743,52126,445,0,0,drop,70,70,0,1,0,1,0
57744,52549,445,0,0,drop,66,66,0,1,0,1,0
57745,80,37649,0,0,deny,60,60,0,1,0,1,0
57746,20726,2767,0,0,deny,66,66,0,1,0,1,0
57747,11816,50584,0,0,deny,66,66,0,1,0,1,0
57748,80,53945,0,0,deny,60,60,0,1,0,1,0
57749,52121,445,0,0,drop,70,70,0,1,0,1,0
57750,7275,39827,0,0,deny,74,74,0,1,0,1,0
57751,57123,445,0,0,drop,70,70,0,1,0,1,0
57752,60292,7129,0,0,deny,62,62,0,1,0,1,0
57753,52120,445,0,0,drop,70,70,0,1,0,1,0
57754,57121,445,0,0,drop,70,70,0,1,0,1,0
57755,57119,445,0,0,drop,70,70,0,1,0,1,0
57756,57117,445,0,0,drop,70,70,0,1,0,1,0
57757,52543,445,0,0,drop,66,66,0,1,0,1,0
57758,25360,51505,0,0,deny,66,66,0,1,0,1,0
57759,32215,22114,0,0,deny,66,66,0,1,0,1,0
57760,54276,39004,0,0,deny,66,66,0,1,0,1,0
57761,52537,445,0,0,drop,66,66,0,1,0,1,0
57762,52536,445,0,0,drop,66,66,0,1,0,1,0
57763,52534,445,0,0,drop,66,66,0,1,0,1,0
57764,12283,25773,0,0,reset-both,139,139,0,1,0,1,0
57765,1024,64147,0,0,deny,62,62,0,1,0,1,0
57766,52116,445,0,0,drop,70,70,0,1,0,1,0
57767,52531,445,0,0,drop,66,66,0,1,0,1,0
57768,52533,445,0,0,drop,66,66,0,1,0,1,0
57769,52532,445,0,0,drop,66,66,0,1,0,1,0
57770,59023,64097,0,0,deny,66,66,0,1,0,1,0
57771,43457,31573,0,0,deny,146,146,0,1,0,1,0
57772,53355,23117,0,0,deny,66,66,0,1,0,1,0
57773,52115,445,0,0,drop,70,70,0,1,0,1,0
57774,53053,64147,0,0,deny,66,66,0,1,0,1,0
57775,80,9918,0,0,deny,60,60,0,1,0,1,0
57776,37577,443,55436,443,allow,499,425,74,4,0,3,1
57777,37580,443,1520,443,allow,499,425,74,4,0,3,1
57778,37578,443,38222,443,allow,499,425,74,4,0,3,1
57779,37579,443,43995,443,allow,499,425,74,4,0,3,1
57780,37576,443,42873,443,allow,499,425,74,4,0,3,1
57781,37575,443,28180,443,allow,499,425,74,4,0,3,1
57782,62780,35440,0,0,deny,66,66,0,1,0,1,0
57783,57116,445,0,0,drop,70,70,0,1,0,1,0
57784,57114,445,0,0,drop,70,70,0,1,0,1,0
57785,57110,445,0,0,drop,70,70,0,1,0,1,0
57786,52528,445,0,0,drop,66,66,0,1,0,1,0
57787,22683,39210,0,0,deny,60,60,0,1,0,1,0
57788,57108,445,0,0,drop,70,70,0,1,0,1,0
57789,52524,445,0,0,drop,66,66,0,1,0,1,0
57790,11458,2767,0,0,deny,62,62,0,1,0,1,0
57791,26439,37965,0,0,deny,66,66,0,1,0,1,0
57792,52521,445,0,0,drop,66,66,0,1,0,1,0
57793,52522,445,0,0,drop,66,66,0,1,0,1,0
57794,52110,445,0,0,drop,70,70,0,1,0,1,0
57795,53475,3389,0,0,deny,62,62,0,1,0,1,0
57796,61043,57470,0,0,deny,78,78,0,1,0,1,0
57797,52519,445,0,0,drop,66,66,0,1,0,1,0
57798,42951,44847,0,0,deny,66,66,0,1,0,1,0
57799,12232,41864,0,0,deny,139,139,0,1,0,1,0
57800,14615,57866,0,0,deny,62,62,0,1,0,1,0
57801,53166,61600,0,0,deny,66,66,0,1,0,1,0
57802,54773,50584,0,0,deny,66,66,0,1,0,1,0
57803,53211,22114,0,0,deny,62,62,0,1,0,1,0
57804,57101,445,0,0,drop,70,70,0,1,0,1,0
57805,57097,445,0,0,drop,70,70,0,1,0,1,0
57806,57094,445,0,0,drop,70,70,0,1,0,1,0
57807,58977,37965,0,0,deny,66,66,0,1,0,1,0
57808,45603,35894,0,0,deny,145,145,0,1,0,1,0
57809,61804,51505,0,0,deny,66,66,0,1,0,1,0
57810,52508,445,0,0,drop,66,66,0,1,0,1,0
57811,52097,445,0,0,drop,70,70,0,1,0,1,0
57812,51196,53,0,0,allow,206,83,123,2,0,1,1
57813,49424,53,32316,53,allow,100,100,0,1,0,1,0
57814,6057,51221,0,0,deny,62,62,0,1,0,1,0
57815,59156,50584,0,0,deny,62,62,0,1,0,1,0
57816,19858,64147,0,0,deny,62,62,0,1,0,1,0
57817,55254,50584,0,0,deny,66,66,0,1,0,1,0
57818,52094,445,0,0,drop,70,70,0,1,0,1,0
57819,21777,50584,0,0,deny,62,62,0,1,0,1,0
57820,60875,56205,0,0,deny,66,66,0,1,0,1,0
57821,52501,445,0,0,drop,66,66,0,1,0,1,0
57822,57080,445,0,0,drop,70,70,0,1,0,1,0
57823,52498,445,0,0,drop,66,66,0,1,0,1,0
57824,52089,445,0,0,drop,70,70,0,1,0,1,0
57825,45964,3111,0,0,deny,60,60,0,1,0,1,0
57826,52088,445,0,0,drop,70,70,0,1,0,1,0
57827,42572,995,0,0,deny,60,60,0,1,0,1,0
57828,39941,995,0,0,deny,60,60,0,1,0,1,0
57829,52086,445,0,0,drop,70,70,0,1,0,1,0
57830,58382,50584,0,0,deny,62,62,0,1,0,1,0
57831,52492,445,0,0,drop,66,66,0,1,0,1,0
57832,52486,445,0,0,drop,66,66,0,1,0,1,0
57833,40547,24051,0,0,deny,74,74,0,1,0,1,0
57834,443,23220,0,0,deny,100,100,0,1,0,1,0
57835,3521,6881,0,0,deny,66,66,0,1,0,1,0
57836,52079,445,0,0,drop,70,70,0,1,0,1,0
57837,5575,8889,5575,8889,deny,497,497,0,1,0,1,0
57838,3225,64147,0,0,deny,62,62,0,1,0,1,0
57839,52077,445,0,0,drop,70,70,0,1,0,1,0
57840,57071,445,0,0,drop,70,70,0,1,0,1,0
57841,57070,445,0,0,drop,70,70,0,1,0,1,0
57842,57068,445,0,0,drop,70,70,0,1,0,1,0
57843,52475,445,0,0,drop,66,66,0,1,0,1,0
57844,52476,445,0,0,drop,66,66,0,1,0,1,0
57845,52474,445,0,0,drop,66,66,0,1,0,1,0
57846,52469,445,0,0,drop,66,66,0,1,0,1,0
57847,52470,445,0,0,drop,66,66,0,1,0,1,0
57848,52473,445,0,0,drop,66,66,0,1,0,1,0
57849,52472,445,0,0,drop,66,66,0,1,0,1,0
57850,52471,445,0,0,drop,66,66,0,1,0,1,0
57851,46093,32661,0,0,deny,74,74,0,1,0,1,0
57852,52076,445,0,0,drop,70,70,0,1,0,1,0
57853,63670,64097,0,0,deny,66,66,0,1,0,1,0
57854,52075,445,0,0,drop,70,70,0,1,0,1,0
57855,52074,445,0,0,drop,70,70,0,1,0,1,0
57856,52068,445,0,0,drop,70,70,0,1,0,1,0
57857,52067,445,0,0,drop,70,70,0,1,0,1,0
57858,27368,22114,0,0,deny,62,62,0,1,0,1,0
57859,49516,35894,0,0,deny,62,62,0,1,0,1,0
57860,52055,445,0,0,drop,70,70,0,1,0,1,0
57861,52054,445,0,0,drop,70,70,0,1,0,1,0
57862,52049,445,0,0,drop,70,70,0,1,0,1,0
57863,1284,50584,0,0,deny,62,62,0,1,0,1,0
57864,57063,445,0,0,drop,70,70,0,1,0,1,0
57865,57057,445,0,0,drop,70,70,0,1,0,1,0
57866,57056,445,0,0,drop,70,70,0,1,0,1,0
57867,20844,64147,0,0,deny,66,66,0,1,0,1,0
57868,52045,445,0,0,drop,70,70,0,1,0,1,0
57869,52044,445,0,0,drop,70,70,0,1,0,1,0
57870,62678,57470,0,0,deny,62,62,0,1,0,1,0
57871,64788,43890,0,0,deny,62,62,0,1,0,1,0
57872,52456,445,0,0,drop,66,66,0,1,0,1,0
57873,52455,445,0,0,drop,66,66,0,1,0,1,0
57874,52453,445,0,0,drop,66,66,0,1,0,1,0
57875,64406,50584,0,0,deny,66,66,0,1,0,1,0
57876,57452,57470,0,0,deny,62,62,0,1,0,1,0
57877,36881,56205,0,0,deny,146,146,0,1,0,1,0
57878,57050,445,0,0,drop,70,70,0,1,0,1,0
57879,49800,5900,0,0,deny,60,60,0,1,0,1,0
57880,52749,64147,0,0,deny,66,66,0,1,0,1,0
57881,30307,51505,0,0,deny,62,62,0,1,0,1,0
57882,57048,445,0,0,drop,70,70,0,1,0,1,0
57883,57043,445,0,0,drop,70,70,0,1,0,1,0
57884,57038,445,0,0,drop,70,70,0,1,0,1,0
57885,57039,445,0,0,drop,70,70,0,1,0,1,0
57886,59523,37965,0,0,deny,62,62,0,1,0,1,0
57887,52033,445,0,0,drop,70,70,0,1,0,1,0
57888,46495,4607,0,0,deny,60,60,0,1,0,1,0
57889,29623,37807,0,0,deny,62,62,0,1,0,1,0
57890,8910,62413,0,0,deny,146,146,0,1,0,1,0
57891,55045,53,38947,53,allow,747,92,655,2,30,1,1
57892,54854,443,6189,443,allow,32544,28348,4196,63,332,31,32
57893,5530,80,5530,80,allow,514,246,268,9,91,5,4
57894,43107,443,43113,443,allow,3051,1801,1250,18,16,8,10
57895,50497,443,10813,443,allow,1642025,26957,1615068,1478,17,406,1072
57896,49897,80,15304,80,allow,188,128,60,3,15,2,1
57897,137,137,20437,137,allow,384,384,0,5,51,5,0
57898,56418,53,62864,53,allow,182,93,89,2,30,1,1
57899,55337,53,11833,53,allow,294,106,188,4,56,2,2
57900,58215,443,23391,443,allow,7337,1630,5707,23,256,12,11
57901,51768,61765,18579,61765,allow,70,70,0,2,8,2,0
57902,51751,55855,62891,55855,allow,66,66,0,1,5,1,0
57903,51749,1408,5548,1408,allow,66,66,0,1,5,1,0
57904,55540,53,5728,53,allow,757,98,659,2,31,1,1
57905,50128,53,3916,53,allow,757,98,659,2,30,1,1
57906,59850,443,34758,443,allow,10260,1360,8900,22,18,7,15
57907,63745,39800,55951,39800,allow,504,382,122,8,16,6,2
57908,56376,53,45759,53,allow,196,100,96,2,30,1,1
57909,59800,443,57363,443,allow,94202,5247,88955,115,37,41,74
57910,59846,443,17762,443,allow,23856,3218,20638,40,18,16,24
57911,59849,443,38799,443,allow,8368,1360,7008,19,18,7,12
57912,60962,443,57911,443,allow,50093,8331,41762,75,48,36,39
57913,47822,80,47822,80,allow,1435,1293,142,5,15,3,2
57914,63750,63343,14942,63343,allow,66,66,0,1,5,1,0
57915,56656,53,54597,53,allow,255,88,167,4,53,2,2
57916,59838,443,12869,443,allow,5520,3416,2104,27,22,13,14
57917,45268,443,29338,443,allow,7503,2345,5158,34,256,17,17
57918,60537,80,60537,80,allow,318,120,198,6,25,3,3
57919,56288,53,56709,53,allow,182,93,89,2,31,1,1
57920,59409,443,2486,443,allow,7775,3174,4601,25,16,11,14
57921,59839,443,29303,443,allow,93467,4007,89460,107,22,33,74
57922,56772,61424,62775,61424,allow,66,66,0,1,5,1,0
57923,59725,443,1736,443,allow,89790,6036,83754,112,55,41,71
57924,47150,9339,62687,9339,allow,179194,19657,159537,415,149,202,213
57925,64327,53,64327,53,allow,243,100,143,2,30,1,1
57926,59845,443,19704,443,allow,14702,1976,12726,28,18,10,18
57927,57342,80,40590,80,allow,1056,682,374,10,15,6,4
57928,49631,443,7469,443,allow,11772,5416,6356,25,49,15,10
57929,48556,80,48556,80,allow,19225,817,18408,29,15,13,16
57930,59835,443,54646,443,allow,13306,9499,3807,32,23,17,15
57931,53112,29258,48583,29258,allow,70,70,0,1,5,1,0
57932,4009,53,4009,53,allow,231,88,143,2,33,1,1
57933,54204,443,50779,443,allow,18159,12786,5373,34,270,19,15
57934,59905,443,62793,443,allow,21212,14546,6666,43,362,24,19
57935,42881,443,61289,443,allow,28707,2793,25914,58,115,29,29
57936,49625,443,57635,443,allow,4252,726,3526,13,16,7,6
57937,60391,47212,11970,47212,allow,164,70,94,2,5,1,1
57938,60392,1134,49045,1134,allow,70,70,0,1,5,1,0
57939,61645,443,61645,443,allow,4702,1795,2907,19,28,11,8
57940,39611,443,31755,443,allow,234,234,0,4,12,4,0
57941,55394,53,55394,53,allow,197,76,121,2,30,1,1
57942,65159,53,15273,53,allow,286,103,183,4,52,2,2
57943,64811,53,2888,53,allow,186,95,91,2,30,1,1
57944,64706,53,4952,53,allow,174,89,85,2,30,1,1
57945,55664,53,44957,53,allow,190,97,93,2,30,1,1
57946,49672,53,36267,53,allow,761,100,661,2,30,1,1
57947,33845,53,0,0,allow,82,82,0,1,30,1,0
57948,65372,53,1041,53,allow,196,100,96,2,31,1,1
57949,58035,80,30742,80,allow,100364,4917,95447,133,241,67,66
57950,5938,6987,0,0,allow,60,60,0,1,90,1,0
57951,57614,443,56701,443,allow,25824,14215,11609,65,757,32,33
57952,6882,6889,43478,6889,allow,221,111,110,2,1200,1,1
57953,54677,5228,25400,5228,allow,6679,2730,3949,43,4309,23,20
57954,46844,53,0,0,allow,82,82,0,1,31,1,0
57955,56727,53,26195,53,allow,762,101,661,2,31,1,1
57956,56458,53,36864,53,allow,192,98,94,2,31,1,1
57957,60593,80,31498,80,allow,123436,6053,117383,165,241,83,82
57958,64840,53,31006,53,allow,186,95,91,2,31,1,1
57959,56924,53,30417,53,allow,216,110,106,2,31,1,1
57960,54489,443,33538,443,allow,4263,2019,2244,14,136,7,7
57961,50584,55727,63781,55727,allow,2268,1050,1218,15,5442,8,7
57962,30960,45686,49488,45686,allow,330,330,0,6,3609,6,0
57963,12605,57470,0,0,deny,62,62,0,1,0,1,0
57964,12821,37965,0,0,deny,66,66,0,1,0,1,0
57965,21274,30188,0,0,deny,62,62,0,1,0,1,0
57966,52029,445,0,0,drop,70,70,0,1,0,1,0
57967,51685,57470,0,0,deny,66,66,0,1,0,1,0
57968,62859,35440,0,0,deny,66,66,0,1,0,1,0
57969,56526,443,61934,443,allow,7563,3697,3866,19,15,10,9
57970,29363,443,29363,443,allow,29861,6027,23834,65,37,34,31
57971,57028,445,0,0,drop,70,70,0,1,0,1,0
57972,57026,445,0,0,drop,70,70,0,1,0,1,0
57973,57024,445,0,0,drop,70,70,0,1,0,1,0
57974,64051,36829,0,0,deny,66,66,0,1,0,1,0
57975,52019,445,0,0,drop,70,70,0,1,0,1,0
57976,52020,445,0,0,drop,70,70,0,1,0,1,0
57977,58468,37965,0,0,deny,66,66,0,1,0,1,0
57978,5914,10214,0,0,deny,100,100,0,1,0,1,0
57979,6889,41864,0,0,deny,143,143,0,1,0,1,0
57980,52016,445,0,0,drop,70,70,0,1,0,1,0
57981,52015,445,0,0,drop,70,70,0,1,0,1,0
57982,57165,34101,0,0,deny,62,62,0,1,0,1,0
57983,43671,37965,0,0,deny,62,62,0,1,0,1,0
57984,52012,445,0,0,drop,70,70,0,1,0,1,0
57985,30496,57470,0,0,deny,62,62,0,1,0,1,0
57986,50143,35253,0,0,deny,66,66,0,1,0,1,0
57987,52433,445,0,0,drop,66,66,0,1,0,1,0
57988,1025,35447,0,0,deny,62,62,0,1,0,1,0
57989,57022,445,0,0,drop,70,70,0,1,0,1,0
57990,57021,445,0,0,drop,70,70,0,1,0,1,0
57991,65209,57866,0,0,deny,66,66,0,1,0,1,0
57992,55286,37965,0,0,deny,66,66,0,1,0,1,0
57993,52007,445,0,0,drop,70,70,0,1,0,1,0
57994,6666,6379,0,0,deny,60,60,0,1,0,1,0
57995,26332,57470,0,0,deny,62,62,0,1,0,1,0
57996,52427,445,0,0,drop,66,66,0,1,0,1,0
57997,51999,445,0,0,drop,70,70,0,1,0,1,0
57998,52424,445,0,0,drop,66,66,0,1,0,1,0
57999,51998,445,0,0,drop,70,70,0,1,0,1,0
58000,57010,445,0,0,drop,70,70,0,1,0,1,0
58001,52676,53733,0,0,deny,62,62,0,1,0,1,0
58002,57004,445,0,0,drop,70,70,0,1,0,1,0
58003,57002,445,0,0,drop,70,70,0,1,0,1,0
58004,57001,445,0,0,drop,70,70,0,1,0,1,0
58005,4594,35993,0,0,deny,62,62,0,1,0,1,0
58006,32892,23,0,0,deny,60,60,0,1,0,1,0
58007,56380,80,20906,80,allow,1466,729,737,12,16,7,5
58008,44410,443,17016,443,allow,2359,1436,923,18,38,10,8
58009,64914,53,27750,53,allow,168,86,82,2,30,1,1
58010,56320,53,53678,53,allow,183,94,89,2,30,1,1
58011,51103,53,0,0,allow,174,77,97,2,30,1,1
58012,35991,443,1116,443,allow,10857,4247,6610,27,121,13,14
58013,49332,53,28193,53,allow,281,98,183,4,56,2,2
58014,64235,53,30515,53,allow,321,99,222,4,52,2,2
58015,5234,28162,61929,28162,allow,449555,320,449235,719,50,6,713
58016,60536,80,60536,80,allow,318,120,198,6,25,3,3
58017,51770,37237,29637,37237,allow,316,136,180,6,6,3,3
58018,58682,80,4123,80,allow,1345,726,619,16,362,8,8
58019,55337,53,8346,53,allow,294,106,188,4,56,2,2
58020,48893,443,17087,443,allow,16227,2037,14190,40,109,19,21
58021,56656,53,41327,53,allow,255,88,167,4,52,2,2
58022,49888,443,12324,443,allow,1072526,64733,1007793,1501,232,690,811
58023,57417,443,11340,443,allow,43052,2466,40586,64,18,21,43
58024,55337,53,22307,53,allow,294,106,188,4,55,2,2
58025,47264,443,35933,443,allow,7201,3870,3331,33,315,17,16
58026,63943,53,24441,53,allow,509,176,333,6,56,3,3
58027,58704,80,26628,80,allow,4115,3452,663,13,15,7,6
58028,55719,8060,30409,8060,allow,70,70,0,2,7,2,0
58029,56816,80,41001,80,allow,420340,15216,405124,441,376,163,278
58030,60004,443,3185,443,allow,134,60,74,3,4,2,1
58031,49699,53,17835,53,allow,266,89,177,4,58,2,2
58032,65424,53,57166,53,allow,210,110,100,2,29,1,1
58033,60535,80,60535,80,allow,318,120,198,6,25,3,3
58034,64546,53,11850,53,allow,183,94,89,2,29,1,1
58035,48012,443,51500,443,allow,1429,1295,134,10,29,8,2
58036,51137,80,51137,80,allow,66992,5462,61530,79,26,30,49
58037,56425,80,34044,80,allow,17188,1559,15629,25,31,10,15
58038,64914,53,63909,53,allow,86,86,0,1,29,1,0
58039,56656,53,40908,53,allow,255,88,167,4,53,2,2
58040,64982,53,7068,53,allow,321,97,224,4,57,2,2
58041,28122,443,63914,443,allow,7808,2487,5321,34,446,16,18
58042,123,123,44322,123,allow,184,94,90,2,29,1,1
58043,65159,53,20643,53,allow,286,103,183,4,51,2,2
58044,64939,53,4454,53,allow,199,94,105,2,29,1,1
58045,64531,53,56972,53,allow,183,94,89,2,29,1,1
58046,55931,53,41701,53,allow,294,118,176,2,29,1,1
58047,61041,53,61041,53,allow,214,90,124,2,29,1,1
58048,65532,53,19828,53,allow,819,102,717,2,30,1,1
58049,64689,53,34039,53,allow,183,94,89,2,30,1,1
58050,55372,53,7739,53,allow,448,184,264,6,30,3,3
58051,59811,443,39338,443,allow,36149,11297,24852,56,29,25,31
58052,53209,443,56508,443,allow,11086,2564,8522,42,186,21,21
58053,50945,80,50945,80,allow,78911,2499,76412,88,26,32,56
58054,55013,53,33517,53,allow,821,102,719,2,30,1,1
58055,65168,53,45025,53,allow,749,94,655,2,30,1,1
58056,64982,53,35426,53,allow,195,102,93,2,30,1,1
58057,50165,53,36668,53,allow,211,78,133,2,30,1,1
58058,59416,443,53026,443,allow,10642,3654,6988,26,125,14,12
58059,49830,443,7649,443,allow,6131,1960,4171,18,15,10,8
58060,55013,53,27966,53,allow,198,102,96,2,30,1,1
58061,64823,53,7121,53,allow,199,102,97,2,31,1,1
58062,49418,27015,10254,27015,allow,78,78,0,1,30,1,0
58063,64982,53,7315,53,allow,195,102,93,2,30,1,1
58064,64689,53,48296,53,allow,183,94,89,2,30,1,1
58065,49748,53,20050,53,allow,763,102,661,2,30,1,1
58066,51767,59158,21535,59158,allow,70,70,0,2,8,2,0
58067,12116,53,12116,53,allow,214,82,132,2,33,1,1
58068,64608,53,12446,53,allow,212,110,102,2,30,1,1
58069,50367,53,23115,53,allow,198,102,96,2,30,1,1
58070,56403,443,35663,443,allow,24745,1926,22819,39,170,18,21
58071,51008,80,51008,80,allow,114613,6365,108248,134,26,51,83
58072,56339,53,35770,53,allow,280,78,202,2,30,1,1
58073,56320,53,14969,53,allow,183,94,89,2,30,1,1
58074,56288,53,30293,53,allow,183,94,89,2,30,1,1
58075,64677,53,6467,53,allow,195,102,93,2,30,1,1
58076,50291,53,32259,53,allow,86,86,0,1,30,1,0
58077,49418,27017,44700,27017,allow,78,78,0,1,30,1,0
58078,55038,443,25937,443,allow,11429,4904,6525,33,156,18,15
58079,28064,53,28064,53,allow,233,90,143,2,32,1,1
58080,56023,53,4937,53,allow,338,106,232,4,37,2,2
58081,50880,80,50880,80,allow,163985,6578,157407,188,26,72,116
58082,47400,80,1203,80,allow,1052,612,440,10,15,5,5
58083,49297,53,48060,53,allow,183,94,89,2,30,1,1
58084,5405,53,5405,53,allow,645,90,555,2,30,1,1
58085,5284,53,5284,53,allow,178,82,96,2,30,1,1
58086,64703,53,15968,53,allow,314,92,222,4,31,2,2
58087,61938,443,14944,443,allow,7118,2462,4656,18,75,10,8
58088,49346,53,23031,53,allow,228,110,118,2,30,1,1
58089,64608,53,62804,53,allow,212,110,102,2,30,1,1
58090,64726,53,39418,53,allow,178,94,84,2,30,1,1
58091,56376,53,65133,53,allow,198,102,96,2,30,1,1
58092,44929,443,17835,443,allow,554,280,274,9,111,5,4
58093,50916,80,44611,80,allow,11456216,116932,11339284,9298,139,1683,7615
58094,49267,443,42451,443,allow,19851,15702,4149,63,109,34,29
58095,55337,53,17571,53,allow,294,106,188,4,56,2,2
58096,59813,443,22135,443,allow,23244,13793,9451,50,29,26,24
58097,59937,443,7727,443,allow,8852,1428,7424,22,199,11,11
58098,51658,80,26955,80,allow,39464,2150,37314,81,20,26,55
58099,10018,80,16761,80,allow,1052,612,440,10,15,5,5
58100,52513,443,40002,443,allow,5096,810,4286,15,15,8,7
58101,56767,34578,60694,34578,allow,564,318,246,9,16,5,4
58102,51750,54567,46467,54567,allow,70,70,0,1,5,1,0
58103,54410,443,16745,443,allow,7256,1669,5587,27,318,15,12
58104,51266,16103,36869,16103,allow,70,70,0,1,5,1,0
58105,52640,6881,33244,6881,allow,719,413,306,10,14,5,5
58106,65067,53,43932,53,allow,411,115,296,4,38,2,2
58107,52087,443,46518,443,allow,5780,1646,4134,22,15,11,11
58108,37433,443,8364,443,allow,8641,955,7686,19,259,8,11
58109,53521,443,50004,443,allow,130,70,60,2,15,1,1
58110,57948,443,32601,443,allow,5914,1514,4400,23,15,12,11
58111,56609,80,38761,80,allow,234,234,0,4,12,4,0
58112,37385,443,16177,443,allow,8824,2041,6783,34,255,17,17
58113,59936,443,17847,443,allow,34167,3638,30529,50,200,23,27
58114,65048,53,15306,53,allow,297,96,201,4,42,2,2
58115,64680,53,61021,53,allow,808,272,536,8,78,4,4
58116,56932,53,43209,53,allow,172,94,78,2,29,1,1
58117,64811,53,37013,53,allow,193,102,91,2,29,1,1
58118,49635,53,38499,53,allow,210,110,100,2,29,1,1
58119,50688,80,50688,80,allow,167293,8028,159265,186,26,68,118
58120,46625,80,46625,80,allow,51574,3466,48108,63,156,23,40
58121,46899,80,46899,80,allow,82739,3221,79518,91,156,28,63
58122,49845,443,22803,443,allow,10396,4585,5811,38,54,21,17
58123,55664,53,1350,53,allow,195,102,93,2,30,1,1
58124,65159,53,25271,53,allow,286,103,183,4,52,2,2
58125,56326,53,1837,53,allow,177,94,83,2,29,1,1
58126,65115,53,24571,53,allow,193,102,91,2,29,1,1
58127,49945,53,14331,53,allow,281,97,184,4,56,2,2
58128,64706,53,11232,53,allow,179,94,85,2,29,1,1
58129,49099,53,46349,53,allow,238,94,144,2,30,1,1
58130,49297,53,44299,53,allow,183,94,89,2,30,1,1
58131,1926,53,62848,53,allow,210,78,132,2,30,1,1
58132,49589,53,21247,53,allow,198,94,104,2,30,1,1
58133,64726,53,24139,53,allow,178,94,84,2,30,1,1
58134,65186,27126,54671,27126,allow,268,78,190,2,30,1,1
58135,65183,27126,22289,27126,allow,268,78,190,2,30,1,1
58136,49378,53,33691,53,allow,179,86,93,2,30,1,1
58137,50791,53,50791,53,allow,231,90,141,2,30,1,1
58138,48817,64245,48817,64245,allow,481,150,331,2,1200,1,1
58139,57338,80,37762,80,allow,1420,715,705,12,16,7,5
58140,50367,53,53044,53,allow,821,102,719,2,30,1,1
58141,64914,53,55728,53,allow,168,86,82,2,30,1,1
58142,64546,53,29110,53,allow,183,94,89,2,30,1,1
58143,64706,53,5159,53,allow,179,94,85,2,30,1,1
58144,59848,53,28215,53,allow,239,102,137,2,30,1,1
58145,56320,53,53146,53,allow,183,94,89,2,30,1,1
58146,64689,53,60672,53,allow,183,94,89,2,30,1,1
58147,64811,53,21833,53,allow,193,102,91,2,30,1,1
58148,49418,27015,32814,27015,allow,257,78,179,2,30,1,1
58149,59810,443,31870,443,allow,27370,17071,10299,51,30,26,25
58150,53114,32975,31768,32975,allow,70,70,0,2,8,2,0
58151,61716,80,3411,80,allow,9323,5142,4181,23,20,12,11
58152,53108,7003,16327,7003,allow,512,326,186,9,22,6,3
58153,65468,443,32669,443,allow,421329,12430,408899,433,16,152,281
58154,65451,53,45725,53,allow,178,94,84,2,30,1,1
58155,52483,443,4472,443,allow,12863,8410,4453,22,31,13,9
58156,64726,53,25224,53,allow,178,94,84,2,30,1,1
58157,50386,8080,50386,8080,allow,5533,2632,2901,20,46,12,8
58158,64706,53,6789,53,allow,179,94,85,2,30,1,1
58159,64850,53,16958,53,allow,196,102,94,2,30,1,1
58160,64823,53,51719,53,allow,199,102,97,2,30,1,1
58161,49418,27016,64137,27016,allow,270,78,192,2,30,1,1
58162,56376,53,35947,53,allow,198,102,96,2,30,1,1
58163,64608,53,18292,53,allow,212,110,102,2,30,1,1
58164,42112,443,17056,443,allow,11459,2165,9294,29,259,11,18
58165,56773,28093,43311,28093,allow,70,70,0,1,5,1,0
58166,46624,80,46624,80,allow,34504,2526,31978,45,156,16,29
58167,6712,80,6712,80,allow,514,246,268,9,82,5,4
58168,1925,53,9734,53,allow,210,78,132,2,30,1,1
58169,1923,53,53314,53,allow,260,86,174,2,30,1,1
58170,49667,53,65184,53,allow,448,184,264,6,30,3,3
58171,65185,27126,57830,27126,allow,268,78,190,2,30,1,1
58172,65126,53,60546,53,allow,718,94,624,2,30,1,1
58173,58873,53,50618,53,allow,168,78,90,2,30,1,1
58174,65513,53,15039,53,allow,195,102,93,2,31,1,1
58175,58499,123,31733,123,allow,184,94,90,2,30,1,1
58176,48040,53,11212,53,allow,168,78,90,2,30,1,1
58177,64322,53,52794,53,allow,250,94,156,2,30,1,1
58178,49418,27015,15763,27015,allow,248,78,170,2,30,1,1
58179,56376,53,49970,53,allow,198,102,96,2,31,1,1
58180,56458,53,9119,53,allow,196,102,94,2,31,1,1
58181,34726,53,62948,53,allow,168,78,90,2,30,1,1
58182,56953,443,22328,443,allow,7245,1282,5963,16,135,7,9
58183,64517,53,39078,53,allow,194,102,92,2,31,1,1
58184,65167,443,56897,443,allow,4925,2188,2737,36,360,16,20
58185,44847,6882,30467,6882,allow,502,150,352,2,1200,1,1
58186,55877,39578,13811,39578,allow,150,150,0,1,1200,1,0
58187,64997,53,57263,53,allow,166,86,80,2,31,1,1
58188,65532,53,33764,53,allow,196,102,94,2,30,1,1
58189,49566,53,59606,53,allow,200,94,106,2,30,1,1
58190,39785,443,37102,443,allow,7967,2261,5706,18,121,8,10
58191,46013,80,29418,80,allow,134,60,74,3,6,2,1
58192,52034,80,13450,80,allow,4185,3462,723,14,16,7,7
58193,49828,443,20161,443,allow,5927,1644,4283,18,16,10,8
58194,64139,53,9779,53,allow,498,93,405,4,47,2,2
58195,65011,53,37444,53,allow,183,94,89,2,31,1,1
58196,53575,1025,56604,1025,allow,70,70,0,2,8,2,0
58197,50334,53,13800,53,allow,216,110,106,2,30,1,1
58198,65187,27126,30981,27126,allow,268,78,190,2,30,1,1
58199,49893,443,25504,443,allow,617481,41514,575967,856,221,381,475
58200,65371,53,53875,53,allow,356,101,255,4,55,2,2
58201,57221,443,19947,443,allow,7306,2784,4522,22,202,12,10
58202,43895,443,52101,443,allow,1442,721,721,15,199,8,7
58203,55730,53,15730,53,allow,196,102,94,2,30,1,1
58204,64619,53,62516,53,allow,229,94,135,2,30,1,1
58205,65371,53,17018,53,allow,199,102,97,2,30,1,1
58206,52420,445,0,0,drop,66,66,0,1,0,1,0
58207,64776,50584,0,0,deny,62,62,0,1,0,1,0
58208,51992,445,0,0,drop,70,70,0,1,0,1,0
58209,51991,445,0,0,drop,70,70,0,1,0,1,0
58210,19747,37965,0,0,deny,62,62,0,1,0,1,0
58211,57441,57470,0,0,deny,66,66,0,1,0,1,0
58212,56996,445,0,0,drop,70,70,0,1,0,1,0
58213,56993,445,0,0,drop,70,70,0,1,0,1,0
58214,56990,445,0,0,drop,70,70,0,1,0,1,0
58215,56991,445,0,0,drop,70,70,0,1,0,1,0
58216,52472,7302,0,0,deny,66,66,0,1,0,1,0
58217,38848,11119,0,0,deny,146,146,0,1,0,1,0
58218,52415,445,0,0,drop,66,66,0,1,0,1,0
58219,51987,445,0,0,drop,70,70,0,1,0,1,0
58220,53447,44847,0,0,deny,66,66,0,1,0,1,0
58221,61983,50432,0,0,deny,66,66,0,1,0,1,0
58222,52407,445,0,0,drop,66,66,0,1,0,1,0
58223,52412,445,0,0,drop,66,66,0,1,0,1,0
58224,52406,445,0,0,drop,66,66,0,1,0,1,0
58225,59701,44847,0,0,deny,66,66,0,1,0,1,0
58226,20650,26467,0,0,deny,62,62,0,1,0,1,0
58227,52403,445,0,0,drop,66,66,0,1,0,1,0
58228,52405,445,0,0,drop,66,66,0,1,0,1,0
58229,52404,445,0,0,drop,66,66,0,1,0,1,0
58230,51985,445,0,0,drop,70,70,0,1,0,1,0
58231,1227,56205,0,0,deny,66,66,0,1,0,1,0
58232,56987,445,0,0,drop,70,70,0,1,0,1,0
58233,56986,445,0,0,drop,70,70,0,1,0,1,0
58234,56984,445,0,0,drop,70,70,0,1,0,1,0
58235,54140,43890,0,0,deny,66,66,0,1,0,1,0
58236,52439,35894,0,0,deny,70,70,0,1,0,1,0
58237,9092,26672,0,0,deny,60,60,0,1,0,1,0
58238,52399,445,0,0,drop,66,66,0,1,0,1,0
58239,56980,445,0,0,drop,70,70,0,1,0,1,0
58240,51981,445,0,0,drop,70,70,0,1,0,1,0
58241,58248,50584,0,0,deny,62,62,0,1,0,1,0
58242,55074,53,55407,53,allow,770,101,669,2,0,1,1
58243,52397,445,0,0,drop,66,66,0,1,0,1,0
58244,4903,42873,0,0,deny,70,70,0,1,0,1,0
58245,80,37649,0,0,deny,60,60,0,1,0,1,0
58246,52395,445,0,0,drop,66,66,0,1,0,1,0
58247,52393,445,0,0,drop,66,66,0,1,0,1,0
58248,27010,64147,0,0,deny,62,62,0,1,0,1,0
58249,46587,57470,0,0,deny,66,66,0,1,0,1,0
58250,80,53945,0,0,deny,60,60,0,1,0,1,0
58251,63305,62413,0,0,deny,66,66,0,1,0,1,0
58252,52391,445,0,0,drop,66,66,0,1,0,1,0
58253,28839,30188,0,0,deny,62,62,0,1,0,1,0
58254,17315,11392,0,0,deny,66,66,0,1,0,1,0
58255,59411,37965,0,0,deny,62,62,0,1,0,1,0
58256,56973,445,0,0,drop,70,70,0,1,0,1,0
58257,10248,21247,0,0,deny,62,62,0,1,0,1,0
58258,80,9918,0,0,deny,60,60,0,1,0,1,0
58259,14397,37965,0,0,deny,62,62,0,1,0,1,0
58260,56968,445,0,0,drop,70,70,0,1,0,1,0
58261,56965,445,0,0,drop,70,70,0,1,0,1,0
58262,52208,43890,0,0,deny,62,62,0,1,0,1,0
58263,38976,46824,0,0,deny,62,62,0,1,0,1,0
58264,54305,35440,0,0,deny,62,62,0,1,0,1,0
58265,26722,11446,0,0,deny,66,66,0,1,0,1,0
58266,51968,445,0,0,drop,70,70,0,1,0,1,0
58267,63314,57470,0,0,deny,66,66,0,1,0,1,0
58268,52383,445,0,0,drop,66,66,0,1,0,1,0
58269,16293,57470,0,0,deny,62,62,0,1,0,1,0
58270,51965,445,0,0,drop,70,70,0,1,0,1,0
58271,44538,50584,0,0,deny,62,62,0,1,0,1,0
58272,40547,24051,0,0,deny,74,74,0,1,0,1,0
58273,59940,50584,0,0,deny,66,66,0,1,0,1,0
58274,52373,445,0,0,drop,66,66,0,1,0,1,0
58275,33931,50584,0,0,deny,62,62,0,1,0,1,0
58276,65060,35440,0,0,deny,66,66,0,1,0,1,0
58277,56952,445,0,0,drop,70,70,0,1,0,1,0
58278,9957,32480,0,0,deny,66,66,0,1,0,1,0
58279,38645,51221,0,0,deny,62,62,0,1,0,1,0
58280,53437,44847,0,0,deny,66,66,0,1,0,1,0
58281,51961,445,0,0,drop,70,70,0,1,0,1,0
58282,26365,22,0,0,deny,60,60,0,1,0,1,0
58283,55749,37965,0,0,deny,66,66,0,1,0,1,0
58284,33979,23,0,0,deny,60,60,0,1,0,1,0
58285,18545,23,0,0,deny,60,60,0,1,0,1,0
58286,51959,445,0,0,drop,70,70,0,1,0,1,0
58287,46093,32661,0,0,deny,74,74,0,1,0,1,0
58288,52370,445,0,0,drop,66,66,0,1,0,1,0
58289,30129,37965,0,0,deny,72,72,0,1,0,1,0
58290,62804,37965,0,0,deny,66,66,0,1,0,1,0
58291,0,0,0,0,allow,156,156,0,2,0,2,0
58292,0,0,0,0,allow,244,244,0,2,0,2,0
58293,51957,445,0,0,drop,70,70,0,1,0,1,0
58294,64948,25198,0,0,deny,145,145,0,1,0,1,0
58295,8211,28793,0,0,deny,66,66,0,1,0,1,0
58296,53300,37807,0,0,deny,62,62,0,1,0,1,0
58297,60188,15503,0,0,deny,66,66,0,1,0,1,0
58298,52364,445,0,0,drop,66,66,0,1,0,1,0
58299,65512,44847,0,0,deny,66,66,0,1,0,1,0
58300,52361,445,0,0,drop,66,66,0,1,0,1,0
58301,55937,53,29379,53,allow,174,89,85,2,0,1,1
58302,34531,23117,0,0,deny,62,62,0,1,0,1,0
58303,25602,64147,0,0,deny,62,62,0,1,0,1,0
58304,51760,50584,0,0,deny,66,66,0,1,0,1,0
58305,51244,3855,0,0,deny,100,100,0,1,0,1,0
58306,51815,51221,0,0,deny,74,74,0,1,0,1,0
58307,59055,11392,0,0,deny,66,66,0,1,0,1,0
58308,43129,20220,0,0,deny,62,62,0,1,0,1,0
58309,51950,445,0,0,drop,70,70,0,1,0,1,0
58310,6889,48817,0,0,deny,143,143,0,1,0,1,0
58311,51948,445,0,0,drop,70,70,0,1,0,1,0
58312,25091,64147,0,0,deny,66,66,0,1,0,1,0
58313,49628,35440,0,0,deny,66,66,0,1,0,1,0
58314,59128,44847,0,0,deny,66,66,0,1,0,1,0
58315,56945,445,0,0,drop,70,70,0,1,0,1,0
58316,63701,46824,0,0,deny,66,66,0,1,0,1,0
58317,56941,445,0,0,drop,70,70,0,1,0,1,0
58318,56940,445,0,0,drop,70,70,0,1,0,1,0
58319,51947,445,0,0,drop,70,70,0,1,0,1,0
58320,21733,56205,0,0,deny,66,66,0,1,0,1,0
58321,52347,445,0,0,drop,66,66,0,1,0,1,0
58322,52346,445,0,0,drop,66,66,0,1,0,1,0
58323,52345,445,0,0,drop,66,66,0,1,0,1,0
58324,52342,445,0,0,drop,66,66,0,1,0,1,0
58325,52341,445,0,0,drop,66,66,0,1,0,1,0
58326,52344,445,0,0,drop,66,66,0,1,0,1,0
58327,52348,445,0,0,drop,66,66,0,1,0,1,0
58328,52340,445,0,0,drop,66,66,0,1,0,1,0
58329,51946,445,0,0,drop,70,70,0,1,0,1,0
58330,51945,445,0,0,drop,70,70,0,1,0,1,0
58331,50084,26672,0,0,deny,62,62,0,1,0,1,0
58332,51941,445,0,0,drop,70,70,0,1,0,1,0
58333,51939,445,0,0,drop,70,70,0,1,0,1,0
58334,45079,31573,0,0,deny,66,66,0,1,0,1,0
58335,42632,44847,0,0,deny,62,62,0,1,0,1,0
58336,57654,35440,0,0,deny,66,66,0,1,0,1,0
58337,49976,22114,0,0,deny,66,66,0,1,0,1,0
58338,51927,445,0,0,drop,70,70,0,1,0,1,0
58339,51926,445,0,0,drop,70,70,0,1,0,1,0
58340,15131,50584,0,0,deny,62,62,0,1,0,1,0
58341,51923,445,0,0,drop,70,70,0,1,0,1,0
58342,51914,445,0,0,drop,70,70,0,1,0,1,0
58343,51913,445,0,0,drop,70,70,0,1,0,1,0
58344,59732,443,44274,443,allow,34866,3347,31519,55,54,22,33
58345,53572,22754,38870,22754,allow,70,70,0,2,8,2,0
58346,46714,80,46714,80,allow,83777,2610,81167,90,155,27,63
58347,59407,443,31789,443,allow,3298,2132,1166,16,15,8,8
58348,3697,80,55800,80,allow,6688,1208,5480,20,104,12,8
58349,65011,53,38944,53,allow,182,93,89,2,30,1,1
58350,56769,11155,5156,11155,allow,66,66,0,1,5,1,0
58351,51746,17867,44740,17867,allow,136,136,0,3,14,3,0
58352,49768,80,40790,80,allow,254,128,126,5,15,3,2
58353,49825,443,10152,443,allow,15401,3011,12390,37,65,21,16
58354,44796,443,34897,443,allow,8158,2927,5231,25,85,15,10
58355,44776,443,54500,443,allow,10087,4073,6014,33,88,18,15
58356,56628,53,54812,53,allow,789,110,679,2,30,1,1
58357,49580,53,21716,53,allow,192,98,94,2,30,1,1
58358,48790,443,60676,443,allow,7298,2661,4637,21,19,11,10
58359,59405,443,60870,443,allow,9052,2120,6932,28,23,14,14
58360,64613,53,26326,53,allow,89,89,0,1,30,1,0
58361,58006,443,30394,443,allow,9596,1688,7908,26,255,13,13
58362,56598,443,16755,443,allow,8630,2126,6504,20,15,11,9
58363,40764,443,58656,443,allow,3321,1297,2024,13,28,7,6
58364,57064,443,57064,443,allow,4378,1471,2907,19,29,11,8
58365,33317,53,33317,53,allow,231,88,143,2,32,1,1
58366,59795,443,6313,443,allow,120014,7352,112662,155,37,64,91
58367,52458,53,52458,53,allow,231,88,143,2,33,1,1
58368,51765,52862,26786,52862,allow,70,70,0,2,7,2,0
58369,51747,54301,33615,54301,allow,136,136,0,3,14,3,0
58370,53557,39731,45884,39731,allow,70,70,0,1,5,1,0
58371,51145,80,27456,80,allow,78198970,2041652,76157318,79332,368,28698,50634
58372,42105,53,20788,53,allow,168,78,90,2,30,1,1
58373,56597,443,58985,443,allow,8700,2196,6504,21,16,12,9
58374,50317,443,44223,443,allow,13565,6019,7546,35,112,19,16
58375,54506,443,29033,443,allow,89702,83941,5761,91,181,66,25
58376,56857,53,30246,53,allow,711,87,624,2,30,1,1
58377,59340,53,59340,53,allow,215,90,125,2,30,1,1
58378,49996,53,3392,53,allow,182,93,89,2,31,1,1
58379,49418,27015,26473,27015,allow,280,71,209,2,31,1,1
58380,55577,53,64711,53,allow,198,101,97,2,31,1,1
58381,59408,443,57336,443,allow,2914,1780,1134,16,15,8,8
58382,51649,80,42317,80,allow,1965,1402,563,13,16,7,6
58383,50116,22,50116,22,allow,60,60,0,1,5,1,0
58384,40408,1488,40408,1488,allow,156,156,0,3,8,3,0
58385,59808,443,39380,443,allow,23950,2135,21815,43,35,16,27
58386,52920,443,42636,443,allow,6253,2132,4121,19,16,10,9
58387,59847,443,63269,443,allow,21180,2662,18518,34,17,14,20
58388,59788,443,40327,443,allow,134688,7027,127661,166,37,64,102
58389,65312,53,47796,53,allow,180,92,88,2,30,1,1
58390,49418,27015,16562,27015,allow,269,71,198,2,31,1,1
58391,49418,27018,39372,27018,allow,259,71,188,2,31,1,1
58392,52060,443,18866,443,allow,40726,3421,37305,52,121,20,32
58393,60730,443,28797,443,allow,14776,5238,9538,41,175,21,20
58394,55088,53,2549,53,allow,186,95,91,2,31,1,1
58395,51135,443,21022,443,allow,640504,257235,383269,1476,797,643,833
58396,44219,443,26012,443,allow,35920,26656,9264,60,128,30,30
58397,40893,123,36091,123,allow,184,94,90,2,31,1,1
58398,49418,27018,26196,27018,allow,71,71,0,1,31,1,0
58399,49418,27017,43664,27017,allow,259,71,188,2,31,1,1
58400,49418,27018,46953,27018,allow,249,71,178,2,31,1,1
58401,57949,5228,62651,5228,allow,2655,1540,1115,19,3601,9,10
58402,54316,53,0,0,allow,325,77,248,2,31,1,1
58403,49418,27020,19032,27020,allow,246,71,175,2,31,1,1
58404,49418,27015,41865,27015,allow,242,71,171,2,31,1,1
58405,49418,27014,49598,27014,allow,235,71,164,2,31,1,1
58406,42071,443,52227,443,allow,9366,5830,3536,23,121,12,11
58407,1987,26467,0,0,deny,62,62,0,1,0,1,0
58408,56939,445,0,0,drop,70,70,0,1,0,1,0
58409,56937,445,0,0,drop,70,70,0,1,0,1,0
58410,56926,445,0,0,drop,70,70,0,1,0,1,0
58411,38633,51221,0,0,deny,66,66,0,1,0,1,0
58412,46849,36237,0,0,deny,62,62,0,1,0,1,0
58413,61013,41705,0,0,deny,66,66,0,1,0,1,0
58414,52326,445,0,0,drop,66,66,0,1,0,1,0
58415,52328,445,0,0,drop,66,66,0,1,0,1,0
58416,52327,445,0,0,drop,66,66,0,1,0,1,0
58417,56922,445,0,0,drop,70,70,0,1,0,1,0
58418,25536,50584,0,0,deny,62,62,0,1,0,1,0
58419,49418,27015,24745,27015,allow,270,78,192,2,30,1,1
58420,65463,53,50986,53,allow,177,94,83,2,30,1,1
58421,46275,64147,0,0,deny,62,62,0,1,0,1,0
58422,56920,445,0,0,drop,70,70,0,1,0,1,0
58423,51902,445,0,0,drop,70,70,0,1,0,1,0
58424,33292,50584,0,0,deny,66,66,0,1,0,1,0
58425,39165,23,0,0,deny,60,60,0,1,0,1,0
58426,56911,445,0,0,drop,70,70,0,1,0,1,0
58427,56912,445,0,0,drop,70,70,0,1,0,1,0
58428,56908,445,0,0,drop,70,70,0,1,0,1,0
58429,58022,5555,0,0,deny,60,60,0,1,0,1,0
58430,34489,35440,0,0,deny,66,66,0,1,0,1,0
58431,51999,37965,0,0,deny,62,62,0,1,0,1,0
58432,30084,21247,0,0,deny,146,146,0,1,0,1,0
58433,19610,9571,0,0,deny,62,62,0,1,0,1,0
58434,26324,30188,0,0,deny,62,62,0,1,0,1,0
58435,51895,445,0,0,drop,70,70,0,1,0,1,0
58436,38980,17,0,0,deny,60,60,0,1,0,1,0
58437,80,37649,0,0,deny,60,60,0,1,0,1,0
58438,52975,23718,0,0,deny,62,62,0,1,0,1,0
58439,56458,53,38538,53,allow,196,102,94,2,30,1,1
58440,64997,53,25843,53,allow,166,86,80,2,30,1,1
58441,38604,53,38604,53,allow,203,82,121,2,30,1,1
58442,50089,443,48630,443,allow,12446,2347,10099,44,190,23,21
58443,60747,40010,30374,40010,allow,316,136,180,6,6,3,3
58444,53571,19636,50196,19636,allow,70,70,0,2,7,2,0
58445,49216,53,31679,53,allow,789,110,679,2,29,1,1
58446,49418,27025,65106,27025,allow,240,78,162,2,30,1,1
58447,57968,443,57498,443,allow,6254,1581,4673,21,190,12,9
58448,51062,80,29351,80,allow,36568,23029,13539,94,194,47,47
58449,55084,443,37269,443,allow,5556,1438,4118,22,196,12,10
58450,38570,443,8181,443,allow,6260,1587,4673,21,191,12,9
58451,44099,443,28525,443,allow,6235,1562,4673,21,191,12,9
58452,65513,53,57723,53,allow,195,102,93,2,29,1,1
58453,53559,58968,6999,58968,allow,70,70,0,1,4,1,0
58454,63769,47661,30265,47661,allow,66,66,0,2,7,2,0
58455,53895,53,0,0,allow,86,86,0,1,29,1,0
58456,56215,53,45300,53,allow,168,78,90,2,29,1,1
58457,63771,7426,29432,7426,allow,66,66,0,2,7,2,0
58458,65188,27126,32293,27126,allow,268,78,190,2,29,1,1
58459,14430,443,35759,443,allow,2629,1470,1159,18,15,8,10
58460,64355,53,49915,53,allow,402,118,284,2,29,1,1
58461,47739,53,26929,53,allow,168,78,90,2,29,1,1
58462,56418,53,6346,53,allow,183,94,89,2,29,1,1
58463,64645,53,50507,53,allow,391,96,295,4,49,2,2
58464,56239,53,9531,53,allow,179,86,93,2,29,1,1
58465,56288,53,34669,53,allow,183,94,89,2,30,1,1
58466,65184,27126,4649,27126,allow,268,78,190,2,29,1,1
58467,65463,53,23022,53,allow,177,94,83,2,30,1,1
58468,49418,23010,54751,23010,allow,288,78,210,2,30,1,1
58469,56845,53,40181,53,allow,730,102,628,2,30,1,1
58470,49418,27400,52679,27400,allow,78,78,0,1,30,1,0
58471,40215,443,8042,443,allow,6423,1543,4880,21,191,12,9
58472,51766,48169,62941,48169,allow,70,70,0,2,7,2,0
58473,56924,53,7241,53,allow,216,110,106,2,30,1,1
58474,64527,53,58780,53,allow,228,102,126,2,30,1,1
58475,64871,53,62774,53,allow,263,94,169,2,31,1,1
58476,49418,27017,57316,27017,allow,262,78,184,2,30,1,1
58477,49418,27118,47467,27118,allow,78,78,0,1,30,1,0
58478,49918,443,49171,443,allow,10385,3107,7278,28,16,16,12
58479,32160,53,32160,53,allow,233,90,143,2,32,1,1
58480,51988,53,22023,53,allow,78,78,0,1,30,1,0
58481,41907,53,41907,53,allow,233,90,143,2,33,1,1
58482,49418,27015,40892,27015,allow,250,78,172,2,30,1,1
58483,18837,53,18837,53,allow,233,90,143,2,32,1,1
58484,53551,60444,1391,60444,allow,492,306,186,8,15,5,3
58485,56509,80,38678,80,allow,3697,832,2865,12,15,7,5
58486,35374,443,7317,443,allow,1558,971,587,14,123,8,6
58487,36682,80,24588,80,allow,130,70,60,2,15,1,1
58488,56114,53,2423,53,allow,216,110,106,2,30,1,1
58489,63128,443,30036,443,allow,4994,379,4615,9,15,4,5
58490,44211,53,44211,53,allow,850,114,736,2,30,1,1
58491,65312,53,52827,53,allow,182,94,88,2,30,1,1
58492,65312,53,55577,53,allow,182,94,88,2,30,1,1
58493,57132,53,36267,53,allow,177,94,83,2,30,1,1
58494,56458,53,47423,53,allow,196,102,94,2,30,1,1
58495,57321,53,18718,53,allow,199,102,97,2,30,1,1
58496,51550,53,60452,53,allow,168,78,90,2,30,1,1
58497,37696,443,12389,443,allow,32798,2912,29886,58,170,29,29
58498,56770,52920,10024,52920,allow,70,70,0,1,5,1,0
58499,64145,53,5953,53,allow,504,105,399,4,35,2,2
58500,49230,443,49230,443,allow,123041,10988,112053,185,67,86,99
58501,65372,53,40284,53,allow,198,102,96,2,30,1,1
58502,49301,53,20768,53,allow,214,102,112,2,30,1,1
58503,44116,123,64380,123,allow,184,94,90,2,30,1,1
58504,64840,53,3676,53,allow,193,102,91,2,30,1,1
58505,56924,53,61139,53,allow,216,110,106,2,30,1,1
58506,64281,53,41166,53,allow,492,90,402,4,45,2,2
58507,39042,443,60755,443,allow,3589,1251,2338,15,20,9,6
58508,57321,53,57606,53,allow,199,102,97,2,30,1,1
58509,65312,53,9346,53,allow,182,94,88,2,30,1,1
58510,57367,53,52070,53,allow,177,94,83,2,30,1,1
58511,50550,443,42250,443,allow,8123,1809,6314,22,71,12,10
58512,43893,443,47910,443,allow,1440,719,721,15,198,8,7
58513,49774,443,43328,443,allow,8130,2220,5910,23,16,13,10
58514,36258,443,41571,443,allow,1128432,47396,1081036,1242,142,458,784
58515,3688,80,37150,80,allow,7072,1145,5927,20,105,12,8
58516,53570,24874,32383,24874,allow,70,70,0,2,7,2,0
58517,41210,443,11454,443,allow,234,234,0,4,11,4,0
58518,49418,27015,12745,27015,allow,227,78,149,2,30,1,1
58519,65467,443,32500,443,allow,92244,4799,87445,107,15,43,64
58520,52795,443,15981,443,allow,1444,723,721,15,198,8,7
58521,51105,80,8408,80,allow,366,240,126,7,20,5,2
58522,46989,80,46989,80,allow,82082,3212,78870,90,155,27,63
58523,53556,1024,47936,1024,allow,70,70,0,1,4,1,0
58524,51764,33432,19826,33432,allow,70,70,0,2,8,2,0
58525,46053,443,15914,443,allow,6999,1563,5436,18,186,3,15
58526,53553,2297,50955,2297,allow,70,70,0,1,4,1,0
58527,63768,55755,28718,55755,allow,66,66,0,2,7,2,0
58528,53111,50809,43690,50809,allow,70,70,0,1,4,1,0
58529,52459,33899,52459,33899,allow,66,66,0,1,5,1,0
58530,49418,53,51153,53,allow,379,93,286,4,37,2,2
58531,53576,23505,43782,23505,allow,70,70,0,2,7,2,0
58532,55612,36239,64723,36239,allow,320,140,180,6,5,3,3
58533,30296,53,30296,53,allow,233,90,143,2,33,1,1
58534,35373,443,52870,443,allow,255313,6947,248366,253,123,74,179
58535,46910,443,1706,443,allow,5714,1536,4178,24,21,13,11
58536,51221,64509,12506,64509,allow,3564,3564,0,55,4073,55,0
58537,55730,53,1752,53,allow,819,102,717,2,29,1,1
58538,57731,443,57731,443,allow,5508,2261,3247,22,38,13,9
58539,50334,53,27323,53,allow,216,110,106,2,29,1,1
58540,64811,53,25235,53,allow,193,102,91,2,29,1,1
58541,56114,53,59313,53,allow,216,110,106,2,30,1,1
58542,64517,53,41974,53,allow,194,102,92,2,29,1,1
58543,64877,53,24531,53,allow,309,110,199,2,30,1,1
58544,50164,53,36057,53,allow,260,86,174,2,29,1,1
58545,64580,53,58796,53,allow,200,94,106,2,30,1,1
58546,52652,443,42861,443,allow,283768,16167,267601,384,116,148,236
58547,56924,53,48740,53,allow,216,110,106,2,30,1,1
58548,56431,53,52567,53,allow,323,110,213,2,30,1,1
58549,51120,443,19662,443,allow,2940,787,2153,11,119,5,6
58550,37472,443,30492,443,allow,17764,5080,12684,46,121,22,24
58551,49418,27015,51226,27015,allow,274,78,196,2,30,1,1
58552,49418,27018,13297,27018,allow,259,78,181,2,30,1,1
58553,64320,53,48665,53,allow,199,102,97,2,30,1,1
58554,49418,27018,36116,27018,allow,256,78,178,2,30,1,1
58555,65011,53,28977,53,allow,183,94,89,2,31,1,1
58556,49418,27015,50232,27015,allow,286,78,208,2,31,1,1
58557,35005,53,35005,53,allow,233,90,143,2,33,1,1
58558,24276,53,24276,53,allow,233,90,143,2,33,1,1
58559,56771,43648,21453,43648,allow,70,70,0,1,5,1,0
58560,58552,443,44204,443,allow,28468,2316,26152,43,42,15,28
58561,58541,28678,6280,28678,allow,1806,1806,0,22,224,22,0
58562,51747,7000,51747,7000,allow,3132,815,2317,14,15,7,7
58563,55577,53,12118,53,allow,199,102,97,2,30,1,1
58564,49827,443,50182,443,allow,5863,1580,4283,17,15,9,8
58565,3694,80,3582,80,allow,6919,1220,5699,20,104,12,8
58566,8168,80,8168,80,allow,282487,10736,271751,315,52,124,191
58567,64275,53,2712,53,allow,644,198,446,6,48,3,3
58568,57132,53,31918,53,allow,177,94,83,2,30,1,1
58569,55577,53,47306,53,allow,199,102,97,2,30,1,1
58570,65443,53,31902,53,allow,730,102,628,2,30,1,1
58571,49418,27200,10128,27200,allow,78,78,0,1,30,1,0
58572,55788,53,26476,53,allow,231,110,121,2,30,1,1
58573,49418,27015,52335,27015,allow,295,78,217,2,30,1,1
58574,51715,443,60037,443,allow,4887,2346,2541,16,120,8,8
58575,53888,443,42576,443,allow,8935,4627,4308,22,121,12,10
58576,49418,27015,20814,27015,allow,249,78,171,2,30,1,1
58577,48233,443,29829,443,allow,9759,3896,5863,28,230,15,13
58578,3691,80,6351,80,allow,6826,1214,5612,20,105,12,8
58579,65372,53,29268,53,allow,198,102,96,2,30,1,1
58580,49996,53,62453,53,allow,183,94,89,2,30,1,1
58581,49580,53,4352,53,allow,196,102,94,2,30,1,1
58582,49580,53,60391,53,allow,196,102,94,2,30,1,1
58583,49418,27017,6721,27017,allow,300,78,222,2,30,1,1
58584,49418,27015,7927,27015,allow,295,78,217,2,31,1,1
58585,49418,27018,21489,27018,allow,255,78,177,2,31,1,1
58586,15503,56331,21797,56331,allow,481,150,331,2,1200,1,1
58587,57470,52339,38751,52339,allow,594,594,0,10,1199,10,0
58588,49418,27017,9977,27017,allow,260,78,182,2,31,1,1
58589,49418,52013,42400,52013,allow,278,78,200,2,31,1,1
58590,49418,27016,31344,27016,allow,250,78,172,2,31,1,1
58591,53541,443,39871,443,allow,10583,1889,8694,28,251,10,18
58592,57470,53377,9260,53377,allow,594,594,0,10,1199,10,0
58593,45294,443,12924,443,allow,6290,4832,1458,18,120,11,7
58594,49759,53,30943,53,allow,216,110,106,2,31,1,1
58595,49418,27017,45242,27017,allow,259,78,181,2,31,1,1
58596,57268,443,29567,443,allow,11546,3604,7942,38,120,20,18
58597,49418,27017,22257,27017,allow,271,78,193,2,31,1,1
58598,49418,27018,42742,27018,allow,274,78,196,2,31,1,1
58599,55461,443,1970,443,allow,6314,4856,1458,18,120,11,7
58600,64336,443,26343,443,allow,10099,4296,5803,30,124,13,17
58601,49418,27035,7817,27035,allow,250,78,172,2,31,1,1
58602,64613,53,60043,53,allow,179,94,85,2,30,1,1
58603,57661,53,46284,53,allow,70,70,0,1,30,1,0
58604,49418,27015,20912,27015,allow,302,78,224,2,30,1,1
58605,49418,27016,50703,27016,allow,258,78,180,2,31,1,1
58606,55593,80,19208,80,allow,3276,404,2872,11,15,5,6
58607,51104,80,56002,80,allow,1524,1028,496,10,21,7,3
58608,34217,443,35043,443,allow,6650,1556,5094,23,18,13,10
58609,65318,80,50736,80,allow,2356,499,1857,10,134,6,4
58610,64613,53,44378,53,allow,179,94,85,2,30,1,1
58611,49418,27016,1873,27016,allow,281,78,203,2,31,1,1
58612,65449,53,65266,53,allow,507,193,314,6,57,3,3
58613,55608,17425,43686,17425,allow,320,140,180,6,7,3,3
58614,39799,443,18557,443,allow,5597,3595,2002,42,68,23,19
58615,55577,53,3000,53,allow,699,204,495,6,57,3,3
58616,5115,53,5115,53,allow,216,90,126,2,30,1,1
58617,55519,53,47075,53,allow,193,102,91,2,30,1,1
58618,57271,53,58158,53,allow,288,94,194,2,30,1,1
58619,6666,8888,0,0,deny,60,60,0,1,0,1,0
58620,80,53945,0,0,deny,60,60,0,1,0,1,0
58621,50422,50584,0,0,deny,62,62,0,1,0,1,0
58622,51887,445,0,0,drop,70,70,0,1,0,1,0
58623,51886,445,0,0,drop,70,70,0,1,0,1,0
58624,56901,445,0,0,drop,70,70,0,1,0,1,0
58625,56900,445,0,0,drop,70,70,0,1,0,1,0
58626,56896,445,0,0,drop,70,70,0,1,0,1,0
58627,80,9918,0,0,deny,60,60,0,1,0,1,0
58628,59943,37807,0,0,deny,146,146,0,1,0,1,0
58629,51880,445,0,0,drop,70,70,0,1,0,1,0
58630,51881,445,0,0,drop,70,70,0,1,0,1,0
58631,51877,445,0,0,drop,70,70,0,1,0,1,0
58632,16393,22114,0,0,deny,66,66,0,1,0,1,0
58633,60960,49049,0,0,deny,62,62,0,1,0,1,0
58634,62930,21247,0,0,deny,66,66,0,1,0,1,0
58635,30920,64147,0,0,deny,62,62,0,1,0,1,0
58636,64982,50584,0,0,deny,146,146,0,1,0,1,0
58637,34228,45129,0,0,deny,148,148,0,1,0,1,0
58638,6881,6881,0,0,deny,62,62,0,1,0,1,0
58639,54062,31573,0,0,deny,66,66,0,1,0,1,0
58640,50181,64147,0,0,deny,66,66,0,1,0,1,0
58641,52303,445,0,0,drop,66,66,0,1,0,1,0
58642,56895,445,0,0,drop,70,70,0,1,0,1,0
58643,56894,445,0,0,drop,70,70,0,1,0,1,0
58644,51872,445,0,0,drop,70,70,0,1,0,1,0
58645,3270,35440,0,0,deny,66,66,0,1,0,1,0
58646,48478,49903,0,0,deny,62,62,0,1,0,1,0
58647,51864,445,0,0,drop,70,70,0,1,0,1,0
58648,34916,51185,0,0,deny,62,62,0,1,0,1,0
58649,51861,445,0,0,drop,70,70,0,1,0,1,0
58650,52298,445,0,0,drop,66,66,0,1,0,1,0
58651,38053,50584,0,0,deny,146,146,0,1,0,1,0
58652,35657,48637,0,0,deny,62,62,0,1,0,1,0
58653,25523,35974,0,0,deny,62,62,0,1,0,1,0
58654,52296,445,0,0,drop,66,66,0,1,0,1,0
58655,56881,445,0,0,drop,70,70,0,1,0,1,0
58656,58598,50584,0,0,deny,66,66,0,1,0,1,0
58657,56878,445,0,0,drop,70,70,0,1,0,1,0
58658,56874,445,0,0,drop,70,70,0,1,0,1,0
58659,56872,445,0,0,drop,70,70,0,1,0,1,0
58660,443,43775,0,0,deny,97,97,0,1,0,1,0
58661,49699,64147,0,0,deny,66,66,0,1,0,1,0
58662,52294,445,0,0,drop,66,66,0,1,0,1,0
58663,51858,445,0,0,drop,70,70,0,1,0,1,0
58664,51856,445,0,0,drop,70,70,0,1,0,1,0
58665,60923,49903,0,0,deny,66,66,0,1,0,1,0
58666,62392,15503,0,0,deny,62,62,0,1,0,1,0
58667,5575,8889,5575,8889,deny,498,498,0,1,0,1,0
58668,9092,26672,0,0,deny,60,60,0,1,0,1,0
58669,56869,445,0,0,drop,70,70,0,1,0,1,0
58670,49664,37965,0,0,deny,66,66,0,1,0,1,0
58671,24480,35440,0,0,deny,66,66,0,1,0,1,0
58672,51852,445,0,0,drop,70,70,0,1,0,1,0
58673,56865,445,0,0,drop,70,70,0,1,0,1,0
58674,56864,445,0,0,drop,70,70,0,1,0,1,0
58675,56861,445,0,0,drop,70,70,0,1,0,1,0
58676,55296,23718,0,0,deny,66,66,0,1,0,1,0
58677,52287,445,0,0,drop,66,66,0,1,0,1,0
58678,47962,16069,0,0,deny,62,62,0,1,0,1,0
58679,51851,445,0,0,drop,70,70,0,1,0,1,0
58680,52282,445,0,0,drop,66,66,0,1,0,1,0
58681,52283,445,0,0,drop,66,66,0,1,0,1,0
58682,52280,445,0,0,drop,66,66,0,1,0,1,0
58683,52276,445,0,0,drop,66,66,0,1,0,1,0
58684,52277,445,0,0,drop,66,66,0,1,0,1,0
58685,52275,445,0,0,drop,66,66,0,1,0,1,0
58686,62452,21247,0,0,deny,62,62,0,1,0,1,0
58687,64482,64147,0,0,deny,66,66,0,1,0,1,0
58688,16387,26193,0,0,deny,60,60,0,1,0,1,0
58689,16387,35308,0,0,deny,60,60,0,1,0,1,0
58690,16387,56995,0,0,deny,60,60,0,1,0,1,0
58691,23528,44847,0,0,deny,146,146,0,1,0,1,0
58692,51846,445,0,0,drop,70,70,0,1,0,1,0
58693,56860,445,0,0,drop,70,70,0,1,0,1,0
58694,56858,445,0,0,drop,70,70,0,1,0,1,0
58695,56854,445,0,0,drop,70,70,0,1,0,1,0
58696,56967,35440,0,0,deny,66,66,0,1,0,1,0
58697,61426,64910,0,0,deny,66,66,0,1,0,1,0
58698,52273,445,0,0,drop,66,66,0,1,0,1,0
58699,54339,23117,0,0,deny,66,66,0,1,0,1,0
58700,56852,445,0,0,drop,70,70,0,1,0,1,0
58701,52269,445,0,0,drop,66,66,0,1,0,1,0
58702,52267,445,0,0,drop,66,66,0,1,0,1,0
58703,52265,445,0,0,drop,66,66,0,1,0,1,0
58704,37876,5900,0,0,deny,60,60,0,1,0,1,0
58705,52263,445,0,0,drop,66,66,0,1,0,1,0
58706,50668,58833,0,0,deny,62,62,0,1,0,1,0
58707,30303,19391,0,0,deny,181,181,0,1,0,1,0
58708,80,37649,0,0,deny,60,60,0,1,0,1,0
58709,80,53945,0,0,deny,60,60,0,1,0,1,0
58710,54471,36237,0,0,deny,66,66,0,1,0,1,0
58711,56844,445,0,0,drop,70,70,0,1,0,1,0
58712,33832,55108,0,0,deny,148,148,0,1,0,1,0
58713,59918,44847,0,0,deny,66,66,0,1,0,1,0
58714,51833,445,0,0,drop,70,70,0,1,0,1,0
58715,43580,57470,0,0,deny,145,145,0,1,0,1,0
58716,443,11135,0,0,deny,66,66,0,1,0,1,0
58717,80,9918,0,0,deny,60,60,0,1,0,1,0
58718,56836,445,0,0,drop,70,70,0,1,0,1,0
58719,56837,445,0,0,drop,70,70,0,1,0,1,0
58720,46557,57866,0,0,deny,62,62,0,1,0,1,0
58721,63852,35440,0,0,deny,66,66,0,1,0,1,0
58722,0,0,0,0,deny,60,60,0,1,0,1,0
58723,48087,16069,0,0,deny,66,66,0,1,0,1,0
58724,52255,445,0,0,drop,66,66,0,1,0,1,0
58725,5223,44091,0,0,deny,220,220,0,1,0,1,0
58726,34211,23,0,0,deny,60,60,0,1,0,1,0
58727,52245,445,0,0,drop,66,66,0,1,0,1,0
58728,50439,64147,0,0,deny,66,66,0,1,0,1,0
58729,51826,445,0,0,drop,70,70,0,1,0,1,0
58730,56825,445,0,0,drop,70,70,0,1,0,1,0
58731,1024,64147,0,0,deny,62,62,0,1,0,1,0
58732,51824,445,0,0,drop,70,70,0,1,0,1,0
58733,42685,51180,0,0,deny,62,62,0,1,0,1,0
58734,1431,30041,0,0,deny,62,62,0,1,0,1,0
58735,51822,445,0,0,drop,70,70,0,1,0,1,0
58736,39217,31573,0,0,deny,146,146,0,1,0,1,0
58737,31748,56205,0,0,deny,146,146,0,1,0,1,0
58738,13654,50584,0,0,deny,62,62,0,1,0,1,0
58739,52243,445,0,0,drop,66,66,0,1,0,1,0
58740,44491,50584,0,0,deny,146,146,0,1,0,1,0
58741,40834,50584,0,0,deny,62,62,0,1,0,1,0
58742,52236,445,0,0,drop,66,66,0,1,0,1,0
58743,64890,51180,0,0,deny,66,66,0,1,0,1,0
58744,52231,445,0,0,drop,66,66,0,1,0,1,0
58745,24592,50584,0,0,deny,62,62,0,1,0,1,0
58746,25880,44847,0,0,deny,146,146,0,1,0,1,0
58747,51815,445,0,0,drop,70,70,0,1,0,1,0
58748,60192,35440,0,0,deny,62,62,0,1,0,1,0
58749,8976,44847,0,0,deny,66,66,0,1,0,1,0
58750,51815,51221,0,0,deny,74,74,0,1,0,1,0
58751,56327,44512,0,0,deny,66,66,0,1,0,1,0
58752,51813,445,0,0,drop,70,70,0,1,0,1,0
58753,49418,27016,14268,27016,allow,236,71,165,2,30,1,1
58754,49418,27016,42028,27016,allow,246,71,175,2,30,1,1
58755,49418,52013,5997,52013,allow,257,71,186,2,30,1,1
58756,39396,443,4891,443,allow,7531,2720,4811,24,331,13,11
58757,61459,80,3928,80,allow,4671,2593,2078,15,85,9,6
58758,43106,443,35974,443,allow,3259,1913,1346,18,16,8,10
58759,44740,443,62303,443,allow,5954,1454,4500,22,142,13,9
58760,49418,27015,34023,27015,allow,249,71,178,2,30,1,1
58761,49418,27015,33472,27015,allow,71,71,0,1,30,1,0
58762,49418,27015,48509,27015,allow,266,71,195,2,31,1,1
58763,49418,27013,52057,27013,allow,230,71,159,2,31,1,1
58764,65339,53,50441,53,allow,186,95,91,2,31,1,1
58765,49418,27019,50504,27019,allow,71,71,0,1,30,1,0
58766,43105,443,31281,443,allow,3115,1849,1266,18,16,8,10
58767,64992,53,63333,53,allow,170,87,83,2,30,1,1
58768,49418,27016,27118,27016,allow,231,71,160,2,30,1,1
58769,55231,443,25575,443,allow,10684454,328574,10355880,11599,77,3693,7906
58770,65317,80,47905,80,allow,1014,507,507,8,133,5,3
58771,55519,53,8879,53,allow,186,95,91,2,30,1,1
58772,49418,27016,26293,27016,allow,257,71,186,2,30,1,1
58773,51117,60038,0,0,allow,66,66,0,1,90,1,0
58774,51101,80,9411,80,allow,366,240,126,7,20,5,2
58775,53974,53,45539,53,allow,578,286,292,9,15,5,4
58776,60022,443,60022,443,allow,18674,1910,16764,32,18,17,15
58777,49759,53,28731,53,allow,216,110,106,2,30,1,1
58778,50614,443,33140,443,allow,3499,1732,1767,15,16,9,6
58779,50447,443,44649,443,allow,12362,3372,8990,34,143,18,16
58780,49418,27017,46358,27017,allow,252,71,181,2,30,1,1
58781,57367,53,62826,53,allow,170,87,83,2,30,1,1
58782,45713,53,45713,53,allow,217,87,130,2,30,1,1
58783,6354,53,6354,53,allow,217,87,130,2,30,1,1
58784,49418,27019,38743,27019,allow,251,71,180,2,30,1,1
58785,49418,27018,61835,27018,allow,248,71,177,2,30,1,1
58786,51425,53,0,0,allow,194,87,107,2,30,1,1
58787,49418,27016,46428,27016,allow,249,71,178,2,30,1,1
58788,49418,27015,56301,27015,allow,258,71,187,2,30,1,1
58789,49418,27017,12752,27017,allow,283,71,212,2,31,1,1
58790,49418,27015,14381,27015,allow,248,71,177,2,31,1,1
58791,51744,1678,56992,1678,allow,66,66,0,1,5,1,0
58792,51341,7000,51341,7000,allow,3132,815,2317,14,16,7,7
58793,51745,2572,3211,2572,allow,66,66,0,1,5,1,0
58794,54631,443,58856,443,allow,8367,3945,4422,81,616,42,39
58795,28470,80,28470,80,allow,355544,12402,343142,378,26,134,244
58796,35647,3389,35647,3389,allow,4575,2400,2175,20,18,11,9
58797,50496,443,2792,443,allow,751676,8792,742884,617,16,123,494
58798,43230,80,43230,80,allow,6776,692,6084,16,20,8,8
58799,64320,53,33961,53,allow,198,101,97,2,30,1,1
58800,49418,27016,22907,27016,allow,254,71,183,2,30,1,1
58801,10001,40041,23223,40041,allow,151,89,62,2,30,1,1
58802,28858,80,28858,80,allow,83253,4938,78315,99,26,39,60
58803,49418,27017,63792,27017,allow,256,71,185,2,30,1,1
58804,53670,53,0,0,allow,82,82,0,1,30,1,0
58805,29245,80,29245,80,allow,27233,4047,23186,44,27,20,24
58806,49418,27017,33582,27017,allow,71,71,0,1,30,1,0
58807,49418,27015,17910,27015,allow,232,71,161,2,31,1,1
58808,63810,443,22948,443,allow,8243,4867,3376,33,137,16,17
58809,62524,123,21935,123,allow,184,94,90,2,31,1,1
58810,60354,443,37287,443,allow,10223,3933,6290,49,115,22,27
58811,61143,443,58972,443,allow,6391,3788,2603,14,121,7,7
58812,53442,443,36564,443,allow,28728581,857403,27871178,29322,132,8944,20378
58813,61475,443,7125,443,allow,198481,12339,186142,247,64,112,135
58814,23151,53,23151,53,allow,194,87,107,2,31,1,1
58815,60962,53,0,0,allow,180,80,100,2,31,1,1
58816,59455,53,0,0,allow,221,81,140,2,31,1,1
58817,30960,45673,1133,45673,allow,462,462,0,8,3633,8,0
58818,64025,24855,0,0,allow,66,66,0,1,90,1,0
58819,51812,445,0,0,drop,70,70,0,1,0,1,0
58820,61315,48817,0,0,deny,62,62,0,1,0,1,0
58821,51811,445,0,0,drop,70,70,0,1,0,1,0
58822,51810,445,0,0,drop,70,70,0,1,0,1,0
58823,64897,2323,0,0,deny,60,60,0,1,0,1,0
58824,51806,445,0,0,drop,70,70,0,1,0,1,0
58825,51807,445,0,0,drop,70,70,0,1,0,1,0
58826,56815,445,0,0,drop,70,70,0,1,0,1,0
58827,56813,445,0,0,drop,70,70,0,1,0,1,0
58828,56812,445,0,0,drop,70,70,0,1,0,1,0
58829,18655,50584,0,0,deny,62,62,0,1,0,1,0
58830,52214,445,0,0,drop,66,66,0,1,0,1,0
58831,52220,445,0,0,drop,66,66,0,1,0,1,0
58832,51837,37965,0,0,deny,66,66,0,1,0,1,0
58833,52219,445,0,0,drop,66,66,0,1,0,1,0
58834,52217,445,0,0,drop,66,66,0,1,0,1,0
58835,52215,445,0,0,deny,66,66,0,1,0,1,0
58836,52216,445,0,0,drop,66,66,0,1,0,1,0
58837,52213,445,0,0,drop,66,66,0,1,0,1,0
58838,52212,445,0,0,drop,66,66,0,1,0,1,0
58839,36656,64147,0,0,deny,62,62,0,1,0,1,0
58840,51792,445,0,0,drop,70,70,0,1,0,1,0
58841,51791,445,0,0,drop,70,70,0,1,0,1,0
58842,51788,445,0,0,drop,70,70,0,1,0,1,0
58843,49418,27017,35147,27017,allow,78,78,0,1,30,1,0
58844,40583,80,60376,80,allow,898,543,355,10,255,6,4
58845,28275,80,28275,80,allow,303421,10894,292527,324,26,116,208
58846,20898,53,20898,53,allow,233,90,143,2,32,1,1
58847,51758,31009,36831,31009,allow,70,70,0,2,8,2,0
58848,45057,443,53651,443,allow,1394,733,661,14,80,8,6
58849,49418,27017,15205,27017,allow,252,78,174,2,30,1,1
58850,49996,53,6579,53,allow,183,94,89,2,30,1,1
58851,55899,443,47257,443,allow,4819,2304,2515,16,135,8,8
58852,49418,27016,47902,27016,allow,245,78,167,2,30,1,1
58853,65319,80,8384,80,allow,2284,484,1800,10,133,6,4
58854,58052,25,34376,25,allow,540,256,284,9,30,5,4
58855,63741,36776,9191,36776,allow,70,70,0,1,4,1,0
58856,10002,40012,52638,40012,allow,261,198,63,2,29,1,1
58857,49418,27015,8182,27015,allow,252,78,174,2,29,1,1
58858,49418,27016,33402,27016,allow,259,78,181,2,29,1,1
58859,49418,27015,20028,27015,allow,264,78,186,2,29,1,1
58860,49418,27015,52265,27015,allow,266,78,188,2,30,1,1
58861,49418,27015,32130,27015,allow,260,78,182,2,30,1,1
58862,49418,49000,14471,49000,allow,270,78,192,2,30,1,1
58863,51060,80,61015,80,allow,4632,2660,1972,49,193,26,23
58864,51231,443,1331,443,allow,1396,735,661,14,80,8,6
58865,41502,443,22197,443,allow,1053,566,487,10,48,6,4
58866,50448,443,27905,443,allow,10382,3262,7120,30,142,16,14
58867,50912,80,58684,80,allow,9578491,119422,9459069,8079,137,1689,6390
58868,57886,80,60119,80,allow,6526,1210,5316,15,17,8,7
58869,41999,80,10138,80,allow,38137,1920,36217,51,81,24,27
58870,63742,26305,40966,26305,allow,70,70,0,1,4,1,0
58871,50048,80,54605,80,allow,2140,1030,1110,22,149,8,14
58872,38091,7275,44065,7275,allow,350,210,140,6,15,4,2
58873,65011,53,20412,53,allow,183,94,89,2,29,1,1
58874,56955,53,20294,53,allow,184,86,98,2,29,1,1
58875,64520,53,44752,53,allow,184,86,98,2,29,1,1
58876,38211,123,28193,123,allow,184,94,90,2,29,1,1
58877,49418,27015,10652,27015,allow,224,78,146,2,30,1,1
58878,57367,53,51549,53,allow,177,94,83,2,29,1,1
58879,49815,53,18819,53,allow,212,102,110,2,29,1,1
58880,49418,27015,65524,27015,allow,287,78,209,2,30,1,1
58881,49527,53,19400,53,allow,200,94,106,2,30,1,1
58882,55088,53,55518,53,allow,193,102,91,2,30,1,1
58883,49418,27015,2773,27015,allow,243,78,165,2,30,1,1
58884,64828,53,62244,53,allow,260,102,158,2,30,1,1
58885,56018,443,53493,443,allow,162,102,60,2,5,1,1
58886,58876,80,60067,80,allow,32098,2435,29663,47,75,24,23
58887,47812,443,45871,443,allow,25864,15150,10714,105,217,54,51
58888,44861,443,26247,443,allow,1053,566,487,10,47,6,4
58889,34183,443,44472,443,allow,10459,2529,7930,31,375,13,18
58890,60139,53,31222,53,allow,218,78,140,2,30,1,1
58891,45601,443,27195,443,allow,5378,984,4394,18,17,10,8
58892,63112,443,43251,443,allow,3695,2713,982,21,82,12,9
58893,46342,53,46342,53,allow,233,90,143,2,32,1,1
58894,56335,53,31703,53,allow,260,102,158,2,30,1,1
58895,63770,24466,46194,24466,allow,312,132,180,6,6,3,3
58896,51495,443,20935,443,allow,55465,11462,44003,89,31,43,46
58897,55971,53,55971,53,allow,233,90,143,2,33,1,1
58898,51760,36558,43821,36558,allow,70,70,0,2,8,2,0
58899,10092,443,29539,443,allow,130,70,60,3,5,2,1
58900,60329,7000,60329,7000,allow,3959,1738,2221,15,15,8,7
58901,35735,80,48997,80,allow,1155,781,374,10,15,6,4
58902,50597,443,31048,443,allow,8031,1915,6116,24,17,12,12
58903,54889,53,54889,53,allow,832,106,726,2,30,1,1
58904,50579,443,37078,443,allow,2707,1383,1324,29,36,16,13
58905,28391,80,28391,80,allow,12237,2818,9419,27,26,14,13
58906,57298,8765,45553,8765,allow,2466,1350,1116,37,569,19,18
58907,60397,43129,12174,43129,allow,70,70,0,2,8,2,0
58908,64320,53,61236,53,allow,199,102,97,2,30,1,1
58909,55377,53,9978,53,allow,228,110,118,2,30,1,1
58910,62877,53,36980,53,allow,248,78,170,2,30,1,1
58911,64891,53,17816,53,allow,211,102,109,2,30,1,1
58912,49418,27015,23061,27015,allow,256,78,178,2,30,1,1
58913,49482,53,59102,53,allow,196,94,102,2,30,1,1
58914,55088,53,58589,53,allow,193,102,91,2,30,1,1
58915,65147,53,52735,53,allow,323,102,221,2,30,1,1
58916,49418,27015,26438,27015,allow,78,78,0,1,30,1,0
58917,64314,53,49422,53,allow,319,126,193,2,30,1,1
58918,49418,27025,2656,27025,allow,250,78,172,2,30,1,1
58919,49418,27015,42227,27015,allow,251,78,173,2,30,1,1
58920,40500,53,40500,53,allow,203,82,121,2,30,1,1
58921,49807,53,0,0,allow,218,77,141,2,30,1,1
58922,56650,53,58049,53,allow,253,102,151,2,30,1,1
58923,59112,53,0,0,allow,296,76,220,2,30,1,1
58924,49418,27018,53537,27018,allow,256,78,178,2,30,1,1
58925,49418,27016,30888,27016,allow,255,78,177,2,30,1,1
58926,65381,53,45140,53,allow,241,110,131,2,30,1,1
58927,49418,27015,37811,27015,allow,236,78,158,2,30,1,1
58928,51761,19136,54705,19136,allow,70,70,0,2,8,2,0
58929,50444,80,3294,80,allow,378,192,186,7,19,4,3
58930,65399,53,0,0,allow,191,75,116,2,30,1,1
58931,61320,53,0,0,allow,194,80,114,2,30,1,1
58932,49418,27015,40733,27015,allow,242,78,164,2,30,1,1
58933,65339,53,24574,53,allow,193,102,91,2,30,1,1
58934,57040,53,51890,53,allow,236,94,142,2,30,1,1
58935,50533,443,28213,443,allow,3518,1654,1864,10,120,5,5
58936,51221,19072,17591,19072,allow,330,330,0,6,1200,6,0
58937,44516,443,57254,443,allow,4709,2451,2258,18,304,8,10
58938,49418,27111,53348,27111,allow,258,78,180,2,30,1,1
58939,6881,8999,10252,8999,allow,502,150,352,2,1199,1,1
58940,49418,27016,45260,27016,allow,255,78,177,2,30,1,1
58941,49418,27015,38539,27015,allow,249,78,171,2,30,1,1
58942,65256,53,29045,53,allow,357,105,252,4,57,2,2
58943,64946,53,64946,53,allow,233,90,143,2,33,1,1
58944,49418,27019,26998,27019,allow,242,78,164,2,30,1,1
58945,63744,47106,28036,47106,allow,70,70,0,1,4,1,0
58946,65316,80,11827,80,allow,2430,531,1899,10,133,6,4
58947,53549,40826,14418,40826,allow,492,306,186,8,14,5,3
58948,49418,27333,30238,27333,allow,254,78,176,2,30,1,1
58949,61717,80,65373,80,allow,6160,2912,3248,17,18,9,8
58950,63743,46081,6085,46081,allow,70,70,0,1,4,1,0
58951,50443,80,16210,80,allow,378,192,186,7,19,4,3
58952,47123,443,37885,443,allow,1053,566,487,10,43,6,4
58953,49759,53,16085,53,allow,216,110,106,2,29,1,1
58954,49903,53,18446,53,allow,215,102,113,2,29,1,1
58955,50445,443,50834,443,allow,14431,2090,12341,42,142,20,22
58956,48568,443,2828,443,allow,56258,45661,10597,165,244,88,77
58957,53547,27759,47610,27759,allow,684,432,252,10,16,6,4
58958,49575,53,59647,53,allow,244,102,142,2,29,1,1
58959,49418,27016,34441,27016,allow,263,78,185,2,29,1,1
58960,49418,27015,32548,27015,allow,255,78,177,2,29,1,1
58961,56779,43137,58075,43137,allow,70,70,0,2,8,2,0
58962,64654,53,63011,53,allow,240,110,130,2,30,1,1
58963,55600,80,11201,80,allow,70,70,0,2,8,2,0
58964,51763,34121,10888,34121,allow,70,70,0,2,8,2,0
58965,59794,443,46382,443,allow,408,78,330,6,25,1,5
58966,57367,53,32502,53,allow,177,94,83,2,30,1,1
58967,49996,53,8571,53,allow,183,94,89,2,30,1,1
58968,49418,27017,24547,27017,allow,258,78,180,2,29,1,1
58969,49580,53,62367,53,allow,196,102,94,2,30,1,1
58970,49418,27016,62306,27016,allow,261,78,183,2,30,1,1
58971,49810,53,13654,53,allow,244,94,150,2,30,1,1
58972,55088,53,3753,53,allow,193,102,91,2,29,1,1
58973,49418,27016,5778,27016,allow,263,78,185,2,29,1,1
58974,49418,31000,20791,31000,allow,78,78,0,1,30,1,0
58975,49640,53,5967,53,allow,402,118,284,2,30,1,1
58976,54987,53,61181,53,allow,215,102,113,2,30,1,1
58977,49115,443,63602,443,allow,361013,18864,342149,392,296,110,282
58978,60383,16881,9133,16881,allow,564,318,246,9,18,5,4
58979,45055,443,37161,443,allow,1392,731,661,14,80,8,6
58980,60390,56494,54167,56494,allow,70,70,0,1,5,1,0
58981,52953,80,11532,80,allow,3247,1730,1517,12,36,7,5
58982,40465,443,49132,443,allow,1053,566,487,10,47,6,4
58983,51607,53,31669,53,allow,284,86,198,2,30,1,1
58984,49418,27016,58886,27016,allow,242,78,164,2,30,1,1
58985,49418,27020,23482,27020,allow,248,78,170,2,30,1,1
58986,49418,31000,56556,31000,allow,260,78,182,2,30,1,1
58987,52751,443,8615,443,allow,5378,984,4394,18,17,10,8
58988,49174,443,55183,443,allow,524887,14310,510577,546,18,201,345
58989,49759,53,4425,53,allow,381,110,271,4,32,2,2
58990,51759,55308,58744,55308,allow,70,70,0,2,8,2,0
58991,63563,24096,60999,24096,allow,198,198,0,1,5,1,0
58992,47651,443,48756,443,allow,1053,566,487,10,43,6,4
58993,50416,80,7917,80,allow,11343,3864,7479,22,21,11,11
58994,50442,80,8641,80,allow,378,192,186,7,19,4,3
58995,55627,53,18188,53,allow,240,110,130,2,30,1,1
58996,50912,443,28892,443,allow,8527,2387,6140,21,31,11,10
58997,49418,27015,19557,27015,allow,255,78,177,2,30,1,1
58998,49418,27015,62235,27015,allow,258,78,180,2,30,1,1
58999,64992,53,56297,53,allow,177,94,83,2,30,1,1
59000,123,123,4741,123,allow,184,94,90,2,30,1,1
59001,55167,443,39745,443,allow,12946,5235,7711,38,185,21,17
59002,49545,443,58325,443,allow,7189,1694,5495,31,131,14,17
59003,59836,443,35828,443,allow,1394,733,661,14,80,8,6
59004,51762,12747,44025,12747,allow,70,70,0,2,8,2,0
59005,47894,443,64449,443,allow,70,70,0,2,5,2,0
59006,53225,443,23994,443,allow,6659,1215,5444,17,15,9,8
59007,28608,80,28608,80,allow,602483,18143,584340,627,27,219,408
59008,64320,53,46178,53,allow,199,102,97,2,30,1,1
59009,49418,27016,26183,27016,allow,262,78,184,2,30,1,1
59010,49418,27018,39364,27018,allow,247,78,169,2,30,1,1
59011,49418,30000,55086,30000,allow,280,78,202,2,30,1,1
59012,3027,53,3027,53,allow,199,90,109,2,30,1,1
59013,49418,27222,49485,27222,allow,245,78,167,2,30,1,1
59014,49418,27015,26832,27015,allow,248,78,170,2,30,1,1
59015,45225,443,59513,443,allow,11233,3101,8132,37,150,18,19
59016,49418,27017,11133,27017,allow,247,78,169,2,30,1,1
59017,37525,443,14541,443,allow,9082,3492,5590,26,61,15,11
59018,57333,53,41487,53,allow,258,110,148,2,31,1,1
59019,49246,53,63715,53,allow,286,102,184,2,31,1,1
59020,49561,53,53882,53,allow,211,102,109,2,30,1,1
59021,49160,63307,39518,63307,allow,854,150,704,4,1200,2,2
59022,10151,55149,20876,55149,allow,481,150,331,2,1200,1,1
59023,51221,27417,45430,27417,allow,481,150,331,2,1200,1,1
59024,65339,53,13346,53,allow,949,285,664,8,39,4,4
59025,53110,8830,57205,8830,allow,70,70,0,1,5,1,0
59026,53464,443,61601,443,allow,6550,1555,4995,25,53,13,12
59027,57470,10748,14210,10748,allow,594,594,0,10,1200,10,0
59028,53554,8999,45352,8999,allow,130,70,60,2,5,1,1
59029,59635,7275,39827,7275,allow,448,78,370,6,25,1,5
59030,64090,53,12119,53,allow,227,102,125,2,30,1,1
59031,57470,6881,51127,6881,allow,594,594,0,10,1200,10,0
59032,63762,41373,50271,41373,allow,66,66,0,2,8,2,0
59033,50690,443,43818,443,allow,354,294,60,2,5,1,1
59034,49418,27015,50177,27015,allow,78,78,0,1,30,1,0
59035,7222,57470,0,0,deny,62,62,0,1,0,1,0
59036,51782,445,0,0,drop,70,70,0,1,0,1,0
59037,51781,445,0,0,deny,70,70,0,1,0,1,0
59038,55056,56205,0,0,deny,62,62,0,1,0,1,0
59039,53987,57470,0,0,deny,66,66,0,1,0,1,0
59040,24144,57470,0,0,deny,62,62,0,1,0,1,0
59041,16660,55783,0,0,deny,62,62,0,1,0,1,0
59042,45908,3383,0,0,deny,60,60,0,1,0,1,0
59043,50877,30041,0,0,deny,62,62,0,1,0,1,0
59044,56805,445,0,0,drop,70,70,0,1,0,1,0
59045,56804,445,0,0,drop,70,70,0,1,0,1,0
59046,56797,445,0,0,drop,70,70,0,1,0,1,0
59047,52913,2767,0,0,deny,66,66,0,1,0,1,0
59048,50788,48817,0,0,deny,66,66,0,1,0,1,0
59049,52200,445,0,0,drop,66,66,0,1,0,1,0
59050,52199,445,0,0,drop,66,66,0,1,0,1,0
59051,52197,445,0,0,drop,66,66,0,1,0,1,0
59052,59879,55783,0,0,deny,66,66,0,1,0,1,0
59053,56794,445,0,0,drop,70,70,0,1,0,1,0
59054,51770,445,0,0,drop,70,70,0,1,0,1,0
59055,20726,2767,0,0,deny,66,66,0,1,0,1,0
59056,56792,445,0,0,drop,70,70,0,1,0,1,0
59057,19570,50584,0,0,deny,66,66,0,1,0,1,0
59058,56791,445,0,0,drop,70,70,0,1,0,1,0
59059,56784,445,0,0,drop,70,70,0,1,0,1,0
59060,56783,445,0,0,drop,70,70,0,1,0,1,0
59061,51766,445,0,0,drop,70,70,0,1,0,1,0
59062,61764,57470,0,0,deny,146,146,0,1,0,1,0
59063,54276,39004,0,0,deny,66,66,0,1,0,1,0
59064,59168,39004,0,0,deny,62,62,0,1,0,1,0
59065,3783,40740,0,0,deny,160,160,0,1,0,1,0
59066,32215,22114,0,0,deny,66,66,0,1,0,1,0
59067,51755,445,0,0,drop,70,70,0,1,0,1,0
59068,51756,445,0,0,drop,70,70,0,1,0,1,0
59069,56778,35440,0,0,deny,66,66,0,1,0,1,0
59070,1027,44847,0,0,deny,62,62,0,1,0,1,0
59071,59023,64097,0,0,deny,66,66,0,1,0,1,0
59072,51754,445,0,0,drop,70,70,0,1,0,1,0
59073,51753,445,0,0,drop,70,70,0,1,0,1,0
59074,49001,65473,0,0,deny,174,174,0,1,0,1,0
59075,51749,445,0,0,drop,70,70,0,1,0,1,0
59076,56773,445,0,0,drop,70,70,0,1,0,1,0
59077,56771,445,0,0,drop,70,70,0,1,0,1,0
59078,56768,445,0,0,drop,70,70,0,1,0,1,0
59079,54631,44847,0,0,deny,74,74,0,1,0,1,0
59080,53053,64147,0,0,deny,66,66,0,1,0,1,0
59081,25360,51505,0,0,deny,66,66,0,1,0,1,0
59082,1024,64147,0,0,deny,62,62,0,1,0,1,0
59083,4366,51505,0,0,deny,62,62,0,1,0,1,0
59084,61865,35440,0,0,deny,66,66,0,1,0,1,0
59085,53406,44847,0,0,deny,62,62,0,1,0,1,0
59086,27442,44847,0,0,deny,62,62,0,1,0,1,0
59087,47173,35440,0,0,deny,62,62,0,1,0,1,0
59088,51744,445,0,0,drop,70,70,0,1,0,1,0
59089,16221,50584,0,0,deny,62,62,0,1,0,1,0
59090,52174,445,0,0,drop,66,66,0,1,0,1,0
59091,52802,56205,0,0,deny,62,62,0,1,0,1,0
59092,56767,445,0,0,drop,70,70,0,1,0,1,0
59093,56766,445,0,0,drop,70,70,0,1,0,1,0
59094,51734,445,0,0,drop,70,70,0,1,0,1,0
59095,9092,26672,0,0,deny,60,60,0,1,0,1,0
59096,7444,57470,0,0,deny,66,66,0,1,0,1,0
59097,51733,445,0,0,drop,70,70,0,1,0,1,0
59098,19858,38211,0,0,deny,145,145,0,1,0,1,0
59099,8023,64147,0,0,deny,146,146,0,1,0,1,0
59100,2467,2767,0,0,deny,62,62,0,1,0,1,0
59101,42345,443,8962,443,allow,7593,2146,5447,21,10,12,9
59102,52172,445,0,0,drop,66,66,0,1,0,1,0
59103,61804,51505,0,0,deny,66,66,0,1,0,1,0
59104,14082,50584,0,0,deny,66,66,0,1,0,1,0
59105,52168,445,0,0,drop,66,66,0,1,0,1,0
59106,56754,445,0,0,drop,70,70,0,1,0,1,0
59107,51723,445,0,0,drop,70,70,0,1,0,1,0
59108,54684,37965,0,0,deny,62,62,0,1,0,1,0
59109,51722,445,0,0,drop,70,70,0,1,0,1,0
59110,56751,445,0,0,drop,70,70,0,1,0,1,0
59111,56747,445,0,0,drop,70,70,0,1,0,1,0
59112,56746,445,0,0,drop,70,70,0,1,0,1,0
59113,52167,445,0,0,drop,66,66,0,1,0,1,0
59114,61566,44847,0,0,deny,62,62,0,1,0,1,0
59115,51718,445,0,0,drop,70,70,0,1,0,1,0
59116,56739,445,0,0,drop,70,70,0,1,0,1,0
59117,56247,23,0,0,deny,60,60,0,1,0,1,0
59118,51717,445,0,0,drop,70,70,0,1,0,1,0
59119,56737,445,0,0,drop,70,70,0,1,0,1,0
59120,56735,445,0,0,drop,70,70,0,1,0,1,0
59121,56733,445,0,0,drop,70,70,0,1,0,1,0
59122,52159,445,0,0,drop,66,66,0,1,0,1,0
59123,62696,50584,0,0,deny,62,62,0,1,0,1,0
59124,63065,54369,0,0,deny,66,66,0,1,0,1,0
59125,52156,445,0,0,drop,66,66,0,1,0,1,0
59126,52150,445,0,0,drop,66,66,0,1,0,1,0
59127,52154,445,0,0,drop,66,66,0,1,0,1,0
59128,61241,22114,0,0,deny,66,66,0,1,0,1,0
59129,52148,445,0,0,drop,66,66,0,1,0,1,0
59130,52149,445,0,0,drop,66,66,0,1,0,1,0
59131,52146,445,0,0,drop,66,66,0,1,0,1,0
59132,1873,37965,0,0,deny,62,62,0,1,0,1,0
59133,56453,37965,0,0,deny,66,66,0,1,0,1,0
59134,1025,35447,0,0,deny,62,62,0,1,0,1,0
59135,6881,26296,0,0,deny,143,143,0,1,0,1,0
59136,8999,64910,0,0,deny,146,146,0,1,0,1,0
59137,58382,50584,0,0,deny,62,62,0,1,0,1,0
59138,45941,23388,0,0,deny,60,60,0,1,0,1,0
59139,51712,445,0,0,drop,70,70,0,1,0,1,0
59140,56732,445,0,0,drop,70,70,0,1,0,1,0
59141,56728,445,0,0,drop,70,70,0,1,0,1,0
59142,56727,445,0,0,drop,70,70,0,1,0,1,0
59143,6904,30228,0,0,deny,146,146,0,1,0,1,0
59144,46349,51505,0,0,deny,74,74,0,1,0,1,0
59145,52143,445,0,0,drop,66,66,0,1,0,1,0
59146,56724,445,0,0,drop,70,70,0,1,0,1,0
59147,11951,45026,0,0,deny,60,60,0,1,0,1,0
59148,19642,23,0,0,deny,60,60,0,1,0,1,0
59149,52141,445,0,0,drop,66,66,0,1,0,1,0
59150,52139,445,0,0,drop,66,66,0,1,0,1,0
59151,52138,445,0,0,drop,66,66,0,1,0,1,0
59152,52135,445,0,0,drop,66,66,0,1,0,1,0
59153,16524,22114,0,0,deny,62,62,0,1,0,1,0
59154,50355,43890,0,0,deny,66,66,0,1,0,1,0
59155,51699,445,0,0,drop,70,70,0,1,0,1,0
59156,12471,31573,0,0,deny,62,62,0,1,0,1,0
59157,56716,445,0,0,drop,70,70,0,1,0,1,0
59158,56715,445,0,0,drop,70,70,0,1,0,1,0
59159,56707,445,0,0,drop,70,70,0,1,0,1,0
59160,51696,445,0,0,drop,70,70,0,1,0,1,0
59161,58338,3375,0,0,deny,60,60,0,1,0,1,0
59162,38926,37965,0,0,deny,62,62,0,1,0,1,0
59163,1811,35440,0,0,deny,62,62,0,1,0,1,0
59164,5379,37965,0,0,deny,66,66,0,1,0,1,0
59165,52127,445,0,0,drop,66,66,0,1,0,1,0
59166,51691,445,0,0,drop,70,70,0,1,0,1,0
59167,51690,445,0,0,drop,70,70,0,1,0,1,0
59168,52117,445,0,0,drop,66,66,0,1,0,1,0
59169,56696,445,0,0,drop,70,70,0,1,0,1,0
59170,51688,445,0,0,drop,70,70,0,1,0,1,0
59171,63925,37965,0,0,deny,62,62,0,1,0,1,0
59172,52115,445,0,0,drop,66,66,0,1,0,1,0
59173,52108,445,0,0,drop,66,66,0,1,0,1,0
59174,50972,3544,39467,3544,allow,258,107,151,2,30,1,1
59175,37616,443,9088,443,allow,702409,17257,685152,698,32,233,465
59176,49418,27017,55350,27017,allow,275,71,204,2,31,1,1
59177,49418,27015,13881,27015,allow,237,71,166,2,31,1,1
59178,49418,27015,34985,27015,allow,239,71,168,2,31,1,1
59179,57086,53,16252,53,allow,711,87,624,2,30,1,1
59180,61476,443,42404,443,allow,230640,12863,217777,253,62,98,155
59181,49418,27015,42209,27015,allow,234,71,163,2,31,1,1
59182,37584,80,39013,80,allow,3587,2484,1103,19,135,10,9
59183,51741,48440,47763,48440,allow,136,136,0,3,14,3,0
59184,51740,35988,5363,35988,allow,136,136,0,3,14,3,0
59185,38659,15000,47156,15000,allow,138,78,60,2,5,1,1
59186,49418,27022,63608,27022,allow,229,71,158,2,31,1,1
59187,49418,27015,37107,27015,allow,223,71,152,2,31,1,1
59188,49418,27015,14560,27015,allow,71,71,0,1,30,1,0
59189,45859,443,65407,443,allow,5508,999,4509,20,255,11,9
59190,54144,443,45159,443,allow,5736,1990,3746,25,16,14,11
59191,49418,27015,52121,27015,allow,232,71,161,2,31,1,1
59192,58851,443,62485,443,allow,15848,13507,2341,37,32,19,18
59193,49418,27015,37886,27015,allow,219,71,148,2,31,1,1
59194,49418,27016,40313,27016,allow,71,71,0,1,30,1,0
59195,56683,443,56683,443,allow,4533,1626,2907,19,28,11,8
59196,52096,443,15286,443,allow,283,163,120,4,15,2,2
59197,50458,80,53639,80,allow,1426,865,561,9,15,5,4
59198,57385,80,37415,80,allow,2546,1294,1252,17,138,9,8
59199,55363,443,55363,443,allow,5458,2211,3247,22,39,13,9
59200,58506,53,0,0,allow,192,86,106,2,30,1,1
59201,5588,5588,0,0,allow,3354,1792,1562,46,193,23,23
59202,57477,53,0,0,allow,186,83,103,2,30,1,1
59203,49418,27018,3626,27018,allow,71,71,0,1,30,1,0
59204,65518,53,19504,53,allow,701,88,613,2,30,1,1
59205,5938,20273,0,0,allow,60,60,0,1,90,1,0
59206,44277,443,64665,443,allow,36026,28458,7568,70,407,30,40
59207,49418,27015,36683,27015,allow,251,71,180,2,31,1,1
59208,49418,27017,34824,27017,allow,255,71,184,2,31,1,1
59209,43103,443,44934,443,allow,3149,1899,1250,19,15,9,10
59210,43104,443,41004,443,allow,3067,1817,1250,18,15,8,10
59211,51757,54657,4096,54657,allow,70,70,0,2,8,2,0
59212,63763,17368,13988,17368,allow,66,66,0,2,8,2,0
59213,50532,443,27098,443,allow,7416,1777,5639,23,74,12,11
59214,53550,1,57289,1,allow,70,70,0,1,5,1,0
59215,46339,443,43068,443,allow,4392,1781,2611,21,20,12,9
59216,59793,443,27595,443,allow,840,456,384,14,25,8,6
59217,7487,443,7487,443,allow,4265,1184,3081,18,16,9,9
59218,8978,443,11135,443,allow,49938,20855,29083,165,216,81,84
59219,41643,443,51338,443,allow,16032,13508,2524,37,36,19,18
59220,62731,443,62731,443,allow,9938,3644,6294,31,18,18,13
59221,48889,443,65230,443,allow,87648,6895,80753,131,364,66,65
59222,62108,443,7391,443,allow,9652,2914,6738,22,124,11,11
59223,19473,6889,63001,6889,allow,480,149,331,2,1200,1,1
59224,65306,443,3584,443,allow,5756,1781,3975,23,136,11,12
59225,51681,445,0,0,drop,70,70,0,1,0,1,0
59226,6881,6881,0,0,deny,62,62,0,1,0,1,0
59227,52099,445,0,0,drop,66,66,0,1,0,1,0
59228,26211,1433,0,0,deny,60,60,0,1,0,1,0
59229,51679,445,0,0,drop,70,70,0,1,0,1,0
59230,62859,35440,0,0,deny,66,66,0,1,0,1,0
59231,49418,27015,49804,27015,allow,248,78,170,2,30,1,1
59232,49766,80,16081,80,allow,254,128,126,5,15,3,2
59233,6712,123,0,0,deny,90,90,0,1,0,1,0
59234,51678,445,0,0,drop,70,70,0,1,0,1,0
59235,61000,15503,0,0,deny,146,146,0,1,0,1,0
59236,51677,445,0,0,drop,70,70,0,1,0,1,0
59237,51676,445,0,0,drop,70,70,0,1,0,1,0
59238,51673,445,0,0,drop,70,70,0,1,0,1,0
59239,51672,445,0,0,drop,70,70,0,1,0,1,0
59240,39715,35440,0,0,deny,146,146,0,1,0,1,0
59241,11404,64147,0,0,deny,62,62,0,1,0,1,0
59242,53298,26467,0,0,deny,66,66,0,1,0,1,0
59243,30111,2323,0,0,deny,60,60,0,1,0,1,0
59244,56687,445,0,0,drop,70,70,0,1,0,1,0
59245,56686,445,0,0,drop,70,70,0,1,0,1,0
59246,56683,445,0,0,drop,70,70,0,1,0,1,0
59247,29706,50584,0,0,deny,62,62,0,1,0,1,0
59248,52088,445,0,0,drop,66,66,0,1,0,1,0
59249,52090,445,0,0,drop,66,66,0,1,0,1,0
59250,52084,445,0,0,drop,66,66,0,1,0,1,0
59251,51650,80,36691,80,allow,141348,4210,137138,161,17,58,103
59252,53300,443,53300,443,allow,4406,1499,2907,19,30,11,8
59253,49256,53,47190,53,allow,177,94,83,2,30,1,1
59254,63609,53,0,0,allow,182,81,101,2,30,1,1
59255,55216,53,0,0,allow,192,86,106,2,30,1,1
59256,46893,443,27910,443,allow,622,70,552,10,180,2,8
59257,64112,443,40510,443,allow,4116645,96572,4020073,4029,58,1356,2673
59258,55606,21802,21715,21802,allow,320,140,180,6,5,3,3
59259,49767,80,10412,80,allow,70,70,0,1,4,1,0
59260,50979,80,12190,80,allow,576971,8128,568843,497,38,114,383
59261,37267,443,16640,443,allow,3296,1636,1660,17,255,9,8
59262,49892,443,4679,443,allow,6966,1436,5530,32,600,13,19
59263,49540,443,8159,443,allow,7454,2377,5077,33,130,15,18
59264,36151,443,3051,443,allow,22856,2980,19876,43,116,19,24
59265,56033,443,58131,443,allow,8396,1919,6477,27,116,12,15
59266,10080,443,4270,443,allow,130,70,60,3,5,2,1
59267,36209,443,44738,443,allow,656609,25419,631190,752,62,322,430
59268,51738,47483,4479,47483,allow,70,70,0,1,5,1,0
59269,40334,443,51232,443,allow,8296,3123,5173,40,132,14,26
59270,51656,80,50242,80,allow,152651,4700,147951,174,17,65,109
59271,32053,443,32053,443,allow,28195,6044,22151,58,17,30,28
59272,58941,80,60543,80,allow,1114,534,580,12,15,7,5
59273,53574,23650,56670,23650,allow,320,140,180,6,5,3,3
59274,63759,64509,33605,64509,allow,66,66,0,2,7,2,0
59275,51743,40358,22101,40358,allow,136,136,0,3,14,3,0
59276,56602,80,9300,80,allow,234,234,0,4,11,4,0
59277,49418,27015,54748,27015,allow,78,78,0,1,29,1,0
59278,61723,443,17384,443,allow,6962,979,5983,19,15,10,9
59279,63675,123,55630,123,allow,184,94,90,2,29,1,1
59280,49418,27015,38933,27015,allow,78,78,0,1,29,1,0
59281,64992,53,39214,53,allow,177,94,83,2,29,1,1
59282,49418,27015,35776,27015,allow,78,78,0,1,29,1,0
59283,64992,53,21333,53,allow,177,94,83,2,29,1,1
59284,42307,443,58231,443,allow,101673,5966,95707,121,178,47,74
59285,56928,80,39650,80,allow,526,304,222,8,35,5,3
59286,49418,27015,60296,27015,allow,253,78,175,2,31,1,1
59287,50520,443,34844,443,allow,9942,1211,8731,26,77,14,12
59288,49418,27018,24351,27018,allow,240,78,162,2,30,1,1
59289,53286,443,1896,443,allow,123194,68738,54456,402,287,167,235
59290,49214,443,4327,443,allow,17273,11238,6035,73,919,36,37
59291,56781,17548,14113,17548,allow,70,70,0,1,5,1,0
59292,47705,443,21979,443,allow,25643,2181,23462,44,363,18,26
59293,51756,41471,23556,41471,allow,70,70,0,2,8,2,0
59294,47832,80,56253,80,allow,1151,711,440,10,15,5,5
59295,51407,443,57078,443,allow,202,70,132,3,11,1,2
59296,65178,53,0,0,allow,190,85,105,2,30,1,1
59297,59573,443,39847,443,allow,289380,13628,275752,335,70,142,193
59298,49418,27015,5163,27015,allow,265,78,187,2,31,1,1
59299,64532,53,56480,53,allow,258,110,148,2,30,1,1
59300,56927,80,6442,80,allow,214,140,74,4,35,3,1
59301,49418,27015,55530,27015,allow,244,78,166,2,30,1,1
59302,55146,53,47576,53,allow,277,110,167,2,30,1,1
59303,56709,53,55050,53,allow,211,102,109,2,30,1,1
59304,43032,443,31725,443,allow,6792,3009,3783,20,46,12,8
59305,55312,443,20877,443,allow,7952,3638,4314,36,149,17,19
59306,49418,27015,12957,27015,allow,271,78,193,2,31,1,1
59307,49418,27015,22382,27015,allow,243,78,165,2,31,1,1
59308,49418,27013,52000,27013,allow,241,78,163,2,30,1,1
59309,49418,27444,10177,27444,allow,258,78,180,2,30,1,1
59310,45292,443,27457,443,allow,26444,2671,23773,52,363,25,27
59311,59937,443,12788,443,allow,70,70,0,1,5,1,0
59312,54346,443,30268,443,allow,12594,5098,7496,32,36,17,15
59313,58530,53,0,0,allow,188,84,104,2,30,1,1
59314,49256,53,12893,53,allow,177,94,83,2,30,1,1
59315,59431,443,29795,443,allow,12756,3596,9160,31,299,16,15
59316,61721,443,43568,443,allow,9676,2327,7349,25,16,15,10
59317,57357,53,10860,53,allow,231,94,137,2,30,1,1
59318,58110,53,0,0,allow,178,79,99,2,30,1,1
59319,50972,3544,44578,3544,allow,409,107,302,4,30,2,2
59320,49418,27015,47175,27015,allow,234,78,156,2,30,1,1
59321,49418,27016,3773,27016,allow,242,78,164,2,30,1,1
59322,56744,31151,15345,31151,allow,1703,524,1179,9,30,5,4
59323,49522,80,55749,80,allow,6908,1652,5256,26,225,12,14
59324,59957,443,65089,443,allow,8677,2714,5963,21,114,13,8
59325,55611,53,41439,53,allow,768,200,568,6,53,3,3
59326,52496,443,9919,443,allow,9500,4662,4838,20,16,11,9
59327,51652,80,57447,80,allow,141220,4280,136940,159,17,59,100
59328,51499,443,1743,443,allow,6848,769,6079,17,15,9,8
59329,54528,443,20055,443,allow,6256,1871,4385,20,45,12,8
59330,53573,14856,10337,14856,allow,320,140,180,6,5,3,3
59331,47893,443,63291,443,allow,172,172,0,2,4,2,0
59332,49418,27014,18652,27014,allow,249,78,171,2,31,1,1
59333,49418,27015,11506,27015,allow,248,78,170,2,30,1,1
59334,50208,1688,43148,1688,allow,70,70,0,1,5,1,0
59335,46822,443,53756,443,allow,71073,4403,66670,99,116,41,58
59336,53548,23310,59949,23310,allow,70,70,0,1,4,1,0
59337,53298,443,53298,443,allow,4348,1441,2907,19,29,11,8
59338,33841,443,9860,443,allow,12521,6232,6289,43,80,22,21
59339,53552,8999,43016,8999,allow,70,70,0,1,4,1,0
59340,35428,443,14497,443,allow,9592,2361,7231,25,15,14,11
59341,55605,27274,38364,27274,allow,130,70,60,3,5,2,1
59342,56468,80,52689,80,allow,214,140,74,4,26,3,1
59343,63757,51413,7176,51413,allow,66,66,0,2,7,2,0
59344,59938,443,3054,443,allow,70,70,0,1,5,1,0
59345,51742,20110,30208,20110,allow,136,136,0,3,14,3,0
59346,47892,443,55293,443,allow,172,172,0,2,5,2,0
59347,50521,443,9816,443,allow,11880,1972,9908,29,78,15,14
59348,57287,53,47799,53,allow,305,102,203,2,29,1,1
59349,55807,53,4924,53,allow,257,102,155,2,29,1,1
59350,58331,443,26953,443,allow,31515,26798,4717,91,82,49,42
59351,55851,53,42151,53,allow,277,110,167,2,30,1,1
59352,65339,53,32222,53,allow,193,102,91,2,29,1,1
59353,49418,27015,18735,27015,allow,244,78,166,2,30,1,1
59354,40329,80,42227,80,allow,2128,798,1330,14,46,7,7
59355,64843,443,36183,443,allow,13583,4157,9426,26,120,11,15
59356,55267,53,26990,53,allow,214,102,112,2,29,1,1
59357,64201,53,27931,53,allow,200,94,106,2,29,1,1
59358,64785,53,44600,53,allow,281,94,187,2,29,1,1
59359,65057,53,8165,53,allow,211,94,117,2,30,1,1
59360,64236,53,6587,53,allow,211,102,109,2,30,1,1
59361,53483,443,14059,443,allow,8333,2292,6041,27,360,15,12
59362,49418,4444,6124,4444,allow,238,78,160,2,31,1,1
59363,51498,443,60787,443,allow,7211,823,6388,16,15,10,6
59364,56760,48386,9485,48386,allow,268,70,198,4,19,1,3
59365,59308,443,6790,443,allow,12169,4963,7206,60,262,31,29
59366,49211,443,58097,443,allow,9739,3414,6325,59,928,30,29
59367,53821,53,5224,53,allow,199,94,105,2,30,1,1
59368,46758,123,10814,123,allow,184,94,90,2,30,1,1
59369,56374,53,9778,53,allow,212,102,110,2,30,1,1
59370,57664,443,45877,443,allow,5111,2193,2918,19,120,9,10
59371,33107,443,39338,443,allow,35031,3490,31541,60,363,28,32
59372,44155,443,5461,443,allow,5157,917,4240,20,360,10,10
59373,49418,27015,33694,27015,allow,246,78,168,2,31,1,1
59374,50464,80,5838,80,allow,26020,2247,23773,47,18,23,24
59375,40243,443,64916,443,allow,284,164,120,4,15,2,2
59376,49418,27017,12250,27017,allow,239,78,161,2,30,1,1
59377,58420,443,23233,443,allow,17161,1619,15542,18,149,4,14
59378,26805,443,51742,443,allow,21055,15996,5059,39,22,22,17
59379,64027,53,2870,53,allow,360,97,263,4,38,2,2
59380,62757,123,11526,123,allow,184,94,90,2,30,1,1
59381,50089,53,56216,53,allow,718,94,624,2,30,1,1
59382,64194,53,10058,53,allow,262,126,136,2,30,1,1
59383,64114,53,0,0,allow,200,90,110,2,30,1,1
59384,56120,53,44279,53,allow,177,94,83,2,30,1,1
59385,56120,53,38603,53,allow,177,94,83,2,30,1,1
59386,41485,443,16482,443,allow,29513,23962,5551,40,121,24,16
59387,49418,29999,25371,29999,allow,244,78,166,2,31,1,1
59388,58721,443,55162,443,allow,7973,4166,3807,28,141,14,14
59389,64494,443,46008,443,allow,2872,717,2155,14,135,6,8
59390,60711,443,38043,443,allow,12258,1451,10807,27,360,13,14
59391,6881,39927,58260,39927,allow,228,118,110,2,1199,1,1
59392,56035,443,61035,443,allow,10622,4094,6528,29,514,16,13
59393,52556,443,21958,443,allow,5696,2392,3304,23,135,10,13
59394,43108,443,38121,443,allow,7578,2358,5220,18,121,8,10
59395,36192,443,26140,443,allow,4555,859,3696,17,360,9,8
59396,57470,14806,59723,14806,allow,132,132,0,3,1199,3,0
59397,43345,443,34624,443,allow,7767,1069,6698,23,3971,7,16
59398,57470,33159,38691,33159,allow,594,594,0,10,1199,10,0
59399,6881,6881,22683,6881,allow,502,150,352,2,1200,1,1
59400,46697,5228,40766,5228,allow,9263,549,8714,17,3638,5,12
59401,14667,443,14667,443,allow,20280,2078,18202,35,17,19,16
59402,61376,443,37067,443,allow,31612,3374,28238,59,271,29,30
59403,51204,123,19622,123,allow,184,94,90,2,30,1,1
59404,55326,53,27995,53,allow,177,94,83,2,30,1,1
59405,56096,443,56096,443,allow,5493,2246,3247,22,39,13,9
59406,50036,53,50623,53,allow,353,118,235,2,31,1,1
59407,49418,27001,19678,27001,allow,274,78,196,2,31,1,1
59408,59787,443,59787,443,allow,5525,2278,3247,22,40,13,9
59409,55366,53,65278,53,allow,79,79,0,2,35,2,0
59410,50907,80,50964,80,allow,16037318,218904,15818414,13595,136,2976,10619
59411,65347,53,20093,53,allow,352,94,258,2,30,1,1
59412,54576,443,43696,443,allow,5670,3091,2579,16,121,8,8
59413,52092,445,0,0,drop,66,66,0,1,0,1,0
59414,52087,445,0,0,drop,66,66,0,1,0,1,0
59415,52091,445,0,0,drop,66,66,0,1,0,1,0
59416,52085,445,0,0,drop,66,66,0,1,0,1,0
59417,52086,445,0,0,drop,66,66,0,1,0,1,0
59418,51658,445,0,0,drop,70,70,0,1,0,1,0
59419,51657,445,0,0,drop,70,70,0,1,0,1,0
59420,51655,445,0,0,drop,70,70,0,1,0,1,0
59421,51648,445,0,0,drop,70,70,0,1,0,1,0
59422,51647,445,0,0,drop,70,70,0,1,0,1,0
59423,51829,36134,0,0,deny,66,66,0,1,0,1,0
59424,59315,35440,0,0,deny,66,66,0,1,0,1,0
59425,17177,64147,0,0,deny,62,62,0,1,0,1,0
59426,20389,64147,0,0,deny,62,62,0,1,0,1,0
59427,28124,37965,0,0,deny,145,145,0,1,0,1,0
59428,12311,6881,0,0,deny,62,62,0,1,0,1,0
59429,42946,31573,0,0,deny,146,146,0,1,0,1,0
59430,1227,56205,0,0,deny,66,66,0,1,0,1,0
59431,56678,445,0,0,drop,70,70,0,1,0,1,0
59432,56675,445,0,0,drop,70,70,0,1,0,1,0
59433,56669,445,0,0,drop,70,70,0,1,0,1,0
59434,4910,2149,0,0,deny,66,66,0,1,0,1,0
59435,57441,57470,0,0,deny,66,66,0,1,0,1,0
59436,52072,445,0,0,drop,66,66,0,1,0,1,0
59437,52071,445,0,0,drop,66,66,0,1,0,1,0
59438,52070,445,0,0,drop,66,66,0,1,0,1,0
59439,30496,57470,0,0,deny,62,62,0,1,0,1,0
59440,51636,445,0,0,drop,70,70,0,1,0,1,0
59441,42128,54532,0,0,deny,60,60,0,1,0,1,0
59442,64000,44847,0,0,deny,62,62,0,1,0,1,0
59443,56666,445,0,0,drop,70,70,0,1,0,1,0
59444,60246,44612,0,0,deny,62,62,0,1,0,1,0
59445,50052,65008,0,0,deny,60,60,0,1,0,1,0
59446,27368,22114,0,0,deny,62,62,0,1,0,1,0
59447,11136,15503,0,0,deny,62,62,0,1,0,1,0
59448,56663,445,0,0,drop,70,70,0,1,0,1,0
59449,58329,62413,0,0,deny,62,62,0,1,0,1,0
59450,56654,445,0,0,drop,70,70,0,1,0,1,0
59451,56655,445,0,0,drop,70,70,0,1,0,1,0
59452,56652,445,0,0,drop,70,70,0,1,0,1,0
59453,40082,22,0,0,deny,60,60,0,1,0,1,0
59454,51632,445,0,0,drop,70,70,0,1,0,1,0
59455,64341,57470,0,0,deny,62,62,0,1,0,1,0
59456,31845,55777,0,0,deny,62,62,0,1,0,1,0
59457,59597,37965,0,0,deny,66,66,0,1,0,1,0
59458,38681,15503,0,0,deny,74,74,0,1,0,1,0
59459,53447,44847,0,0,deny,66,66,0,1,0,1,0
59460,51623,445,0,0,drop,70,70,0,1,0,1,0
59461,51622,445,0,0,drop,70,70,0,1,0,1,0
59462,63379,36237,0,0,deny,66,66,0,1,0,1,0
59463,51617,445,0,0,drop,70,70,0,1,0,1,0
59464,51620,445,0,0,drop,70,70,0,1,0,1,0
59465,52472,7302,0,0,deny,66,66,0,1,0,1,0
59466,51616,445,0,0,drop,70,70,0,1,0,1,0
59467,10003,64147,0,0,deny,62,62,0,1,0,1,0
59468,30307,51505,0,0,deny,62,62,0,1,0,1,0
59469,56641,445,0,0,drop,70,70,0,1,0,1,0
59470,56640,445,0,0,drop,70,70,0,1,0,1,0
59471,56639,445,0,0,drop,70,70,0,1,0,1,0
59472,9067,44847,0,0,deny,62,62,0,1,0,1,0
59473,54140,43890,0,0,deny,66,66,0,1,0,1,0
59474,9092,26672,0,0,deny,60,60,0,1,0,1,0
59475,61983,50432,0,0,deny,66,66,0,1,0,1,0
59476,51963,22114,0,0,deny,62,62,0,1,0,1,0
59477,51609,445,0,0,drop,70,70,0,1,0,1,0
59478,1024,22114,0,0,deny,146,146,0,1,0,1,0
59479,12605,57470,0,0,deny,62,62,0,1,0,1,0
59480,10586,37965,0,0,deny,62,62,0,1,0,1,0
59481,46587,57470,0,0,deny,66,66,0,1,0,1,0
59482,51732,50584,0,0,deny,146,146,0,1,0,1,0
59483,28839,30188,0,0,deny,62,62,0,1,0,1,0
59484,65016,37965,0,0,deny,66,66,0,1,0,1,0
59485,17315,11392,0,0,deny,66,66,0,1,0,1,0
59486,52050,445,0,0,drop,66,66,0,1,0,1,0
59487,56638,445,0,0,drop,70,70,0,1,0,1,0
59488,56637,445,0,0,drop,70,70,0,1,0,1,0
59489,60617,64147,0,0,deny,62,62,0,1,0,1,0
59490,27010,64147,0,0,deny,62,62,0,1,0,1,0
59491,51602,445,0,0,drop,70,70,0,1,0,1,0
59492,51599,445,0,0,drop,70,70,0,1,0,1,0
59493,10248,21247,0,0,deny,62,62,0,1,0,1,0
59494,59701,44847,0,0,deny,66,66,0,1,0,1,0
59495,58458,17,0,0,deny,60,60,0,1,0,1,0
59496,2522,64147,0,0,deny,62,62,0,1,0,1,0
59497,64024,57470,0,0,deny,66,66,0,1,0,1,0
59498,48386,9485,0,0,deny,60,60,0,1,0,1,0
59499,61148,37965,0,0,deny,66,66,0,1,0,1,0
59500,26332,57470,0,0,deny,62,62,0,1,0,1,0
59501,63314,57470,0,0,deny,66,66,0,1,0,1,0
59502,52041,445,0,0,drop,66,66,0,1,0,1,0
59503,51596,445,0,0,drop,70,70,0,1,0,1,0
59504,51594,445,0,0,drop,70,70,0,1,0,1,0
59505,52040,445,0,0,drop,66,66,0,1,0,1,0
59506,56628,445,0,0,drop,70,70,0,1,0,1,0
59507,3802,55777,0,0,deny,66,66,0,1,0,1,0
59508,52788,64147,0,0,deny,62,62,0,1,0,1,0
59509,55966,57866,0,0,deny,62,62,0,1,0,1,0
59510,29313,48817,0,0,deny,145,145,0,1,0,1,0
59511,56620,445,0,0,drop,70,70,0,1,0,1,0
59512,56618,445,0,0,drop,70,70,0,1,0,1,0
59513,56616,445,0,0,drop,70,70,0,1,0,1,0
59514,52037,445,0,0,drop,66,66,0,1,0,1,0
59515,25595,2323,0,0,deny,60,60,0,1,0,1,0
59516,50116,22,0,0,deny,60,60,0,1,0,1,0
59517,51590,445,0,0,drop,70,70,0,1,0,1,0
59518,59940,50584,0,0,deny,66,66,0,1,0,1,0
59519,65060,35440,0,0,deny,66,66,0,1,0,1,0
59520,33931,50584,0,0,deny,62,62,0,1,0,1,0
59521,9957,32480,0,0,deny,66,66,0,1,0,1,0
59522,51589,445,0,0,drop,70,70,0,1,0,1,0
59523,53437,44847,0,0,deny,66,66,0,1,0,1,0
59524,51339,50584,0,0,deny,62,62,0,1,0,1,0
59525,56613,445,0,0,deny,70,70,0,1,0,1,0
59526,44538,50584,0,0,deny,62,62,0,1,0,1,0
59527,56608,445,0,0,drop,70,70,0,1,0,1,0
59528,56606,445,0,0,drop,70,70,0,1,0,1,0
59529,56604,445,0,0,drop,70,70,0,1,0,1,0
59530,30129,37965,0,0,deny,72,72,0,1,0,1,0
59531,52188,1433,0,0,deny,60,60,0,1,0,1,0
59532,62804,37965,0,0,deny,66,66,0,1,0,1,0
59533,0,0,0,0,deny,60,60,0,1,0,1,0
59534,52029,445,0,0,drop,66,66,0,1,0,1,0
59535,3001,28680,0,0,deny,148,148,0,1,0,1,0
59536,8211,28793,0,0,deny,66,66,0,1,0,1,0
59537,46389,27098,0,0,deny,66,66,0,1,0,1,0
59538,52027,445,0,0,drop,66,66,0,1,0,1,0
59539,52025,445,0,0,drop,66,66,0,1,0,1,0
59540,52022,445,0,0,drop,66,66,0,1,0,1,0
59541,60188,15503,0,0,deny,66,66,0,1,0,1,0
59542,8889,19777,0,0,deny,60,60,0,1,0,1,0
59543,22541,64147,0,0,deny,66,66,0,1,0,1,0
59544,52020,445,0,0,drop,66,66,0,1,0,1,0
59545,52021,445,0,0,drop,66,66,0,1,0,1,0
59546,55468,23,0,0,deny,60,60,0,1,0,1,0
59547,51584,445,0,0,drop,70,70,0,1,0,1,0
59548,52690,7302,0,0,deny,66,66,0,1,0,1,0
59549,56601,445,0,0,drop,70,70,0,1,0,1,0
59550,56600,445,0,0,drop,70,70,0,1,0,1,0
59551,56598,445,0,0,drop,70,70,0,1,0,1,0
59552,52017,445,0,0,drop,66,66,0,1,0,1,0
59553,32710,22114,0,0,deny,62,62,0,1,0,1,0
59554,56595,445,0,0,drop,70,70,0,1,0,1,0
59555,5223,34403,0,0,deny,220,220,0,1,0,1,0
59556,21733,56205,0,0,deny,66,66,0,1,0,1,0
59557,52012,445,0,0,drop,66,66,0,1,0,1,0
59558,30598,46824,0,0,deny,62,62,0,1,0,1,0
59559,52519,44847,0,0,deny,66,66,0,1,0,1,0
59560,53408,50243,0,0,deny,145,145,0,1,0,1,0
59561,1749,64147,0,0,deny,66,66,0,1,0,1,0
59562,52010,445,0,0,drop,66,66,0,1,0,1,0
59563,52009,445,0,0,drop,66,66,0,1,0,1,0
59564,50734,37965,0,0,deny,62,62,0,1,0,1,0
59565,59128,44847,0,0,deny,66,66,0,1,0,1,0
59566,25772,7302,0,0,deny,66,66,0,1,0,1,0
59567,52007,445,0,0,drop,66,66,0,1,0,1,0
59568,50084,26672,0,0,deny,62,62,0,1,0,1,0
59569,54894,9571,0,0,deny,66,66,0,1,0,1,0
59570,51571,445,0,0,drop,70,70,0,1,0,1,0
59571,55413,37965,0,0,deny,66,66,0,1,0,1,0
59572,42632,44847,0,0,deny,62,62,0,1,0,1,0
59573,61185,54532,0,0,deny,62,62,0,1,0,1,0
59574,42745,50011,0,0,deny,62,62,0,1,0,1,0
59575,50084,26672,0,0,deny,145,145,0,1,0,1,0
59576,56587,445,0,0,drop,70,70,0,1,0,1,0
59577,51568,445,0,0,drop,70,70,0,1,0,1,0
59578,63701,46824,0,0,deny,66,66,0,1,0,1,0
59579,38976,46824,0,0,deny,62,62,0,1,0,1,0
59580,35347,20238,0,0,deny,62,62,0,1,0,1,0
59581,56583,445,0,0,drop,70,70,0,1,0,1,0
59582,56581,445,0,0,drop,70,70,0,1,0,1,0
59583,15131,50584,0,0,deny,62,62,0,1,0,1,0
59584,51151,64147,0,0,deny,66,66,0,1,0,1,0
59585,38645,51221,0,0,deny,62,62,0,1,0,1,0
59586,42209,36237,0,0,deny,146,146,0,1,0,1,0
59587,51413,32480,0,0,deny,72,72,0,1,0,1,0
59588,4515,37807,0,0,deny,146,146,0,1,0,1,0
59589,49418,27025,19302,27025,allow,71,71,0,1,30,1,0
59590,49418,27021,53913,27021,allow,232,71,161,2,30,1,1
59591,49418,27015,47844,27015,allow,214,71,143,2,30,1,1
59592,49418,23333,56641,23333,allow,244,71,173,2,30,1,1
59593,50502,123,48233,123,allow,184,94,90,2,30,1,1
59594,61699,443,44016,443,allow,16358,3103,13255,39,19,19,20
59595,50605,443,19181,443,allow,13409,3033,10376,29,124,15,14
59596,64567,443,24686,443,allow,24984,2042,22942,41,32,19,22
59597,49418,37579,44074,37579,allow,239,71,168,2,30,1,1
59598,60395,6890,41049,6890,allow,70,70,0,2,8,2,0
59599,55326,53,8434,53,allow,170,87,83,2,30,1,1
59600,51164,443,40341,443,allow,7569,2113,5456,26,361,14,12
59601,49418,30007,64637,30007,allow,242,71,171,2,30,1,1
59602,53538,33791,33383,33791,allow,618,432,186,9,17,6,3
59603,49418,37569,43147,37569,allow,237,71,166,2,30,1,1
59604,37174,443,43183,443,allow,752907,69016,683891,1372,231,537,835
59605,49418,27026,25116,27026,allow,71,71,0,1,30,1,0
59606,49418,27022,21779,27022,allow,71,71,0,1,30,1,0
59607,49418,30006,39633,30006,allow,244,71,173,2,30,1,1
59608,62995,3389,62995,3389,allow,4213,2429,1784,18,32,9,9
59609,32971,443,32971,443,allow,18895,2061,16834,34,17,18,16
59610,18796,443,17365,443,allow,2227,1018,1209,17,15,8,9
59611,53574,443,38690,443,allow,117116,5692,111424,153,18,56,97
59612,52625,53,52625,53,allow,231,88,143,2,32,1,1
59613,53565,58695,57027,58695,allow,70,70,0,2,8,2,0
59614,35065,443,35065,443,allow,5537,2290,3247,22,39,13,9
59615,28539,53,28539,53,allow,231,88,143,2,32,1,1
59616,50622,53,42098,53,allow,202,83,119,2,30,1,1
59617,46327,25903,25335,25903,allow,332,192,140,6,25,4,2
59618,39207,80,48256,80,allow,234,234,0,4,12,4,0
59619,36712,53,0,0,allow,138,69,69,2,30,1,1
59620,50437,3389,50437,3389,allow,3444,1730,1714,16,31,8,8
59621,49418,27019,20347,27019,allow,71,71,0,1,30,1,0
59622,49418,27015,42779,27015,allow,227,71,156,2,30,1,1
59623,49418,27015,63577,27015,allow,71,71,0,1,30,1,0
59624,49418,12345,11846,12345,allow,249,71,178,2,30,1,1
59625,49418,30010,58880,30010,allow,238,71,167,2,30,1,1
59626,14469,443,14469,443,allow,274,132,142,5,15,3,2
59627,50501,443,19632,443,allow,1499,930,569,16,78,9,7
59628,42040,5228,16525,5228,allow,60,60,0,1,5,1,0
59629,47091,443,36299,443,allow,6326,4367,1959,31,144,17,14
59630,51753,15038,3918,15038,allow,70,70,0,2,7,2,0
59631,44206,53,19423,53,allow,202,83,119,2,30,1,1
59632,50172,443,41441,443,allow,161,101,60,2,5,1,1
59633,53760,80,45731,80,allow,1667,619,1048,10,45,6,4
59634,49418,30003,43016,30003,allow,71,71,0,1,30,1,0
59635,49418,27015,44388,27015,allow,71,71,0,1,30,1,0
59636,49418,27016,19249,27016,allow,240,71,169,2,30,1,1
59637,49418,16666,10447,16666,allow,71,71,0,1,30,1,0
59638,65348,53,36995,53,allow,170,87,83,2,30,1,1
59639,49418,30002,50815,30002,allow,242,71,171,2,30,1,1
59640,5938,19141,0,0,allow,60,60,0,1,91,1,0
59641,50895,443,43273,443,allow,14584,6798,7786,37,181,18,19
59642,30960,45684,7454,45684,allow,330,330,0,6,3609,6,0
59643,37965,22343,64266,22343,allow,1307,594,713,17,1657,10,7
59644,51997,445,0,0,drop,66,66,0,1,0,1,0
59645,21492,51505,0,0,deny,62,62,0,1,0,1,0
59646,11716,37965,0,0,deny,62,62,0,1,0,1,0
59647,51563,445,0,0,drop,70,70,0,1,0,1,0
59648,38633,51221,0,0,deny,66,66,0,1,0,1,0
59649,54424,50584,0,0,deny,146,146,0,1,0,1,0
59650,25536,50584,0,0,deny,62,62,0,1,0,1,0
59651,51562,445,0,0,drop,70,70,0,1,0,1,0
59652,443,9986,0,0,deny,352,352,0,1,0,1,0
59653,51105,50584,0,0,deny,66,66,0,1,0,1,0
59654,35644,67,0,0,deny,60,60,0,1,0,1,0
59655,51560,445,0,0,drop,70,70,0,1,0,1,0
59656,49418,26259,63056,26259,allow,254,78,176,2,30,1,1
59657,49418,27016,30078,27016,allow,78,78,0,1,30,1,0
59658,49418,30008,26844,30008,allow,236,78,158,2,30,1,1
59659,34464,443,64076,443,allow,1402,910,492,11,360,6,5
59660,57370,443,5735,443,allow,7211,823,6388,16,15,10,6
59661,48252,443,35978,443,allow,283034,39462,243572,536,224,257,279
59662,49418,37569,8517,37569,allow,246,78,168,2,30,1,1
59663,52555,443,31121,443,allow,4362,1826,2536,18,134,8,10
59664,55015,443,30029,443,allow,8133,2402,5731,35,255,17,18
59665,49400,80,14888,80,allow,40119,2475,37644,49,84,16,33
59666,52122,443,45457,443,allow,5841,1986,3855,19,15,11,8
59667,49224,443,16302,443,allow,93540,22718,70822,155,918,65,90
59668,7686,80,7686,80,allow,176670,11287,165383,216,46,96,120
59669,38136,443,41208,443,allow,3919,1099,2820,35,627,9,26
59670,49233,443,34014,443,allow,9622,3524,6098,59,916,29,30
59671,49201,443,23062,443,allow,13738,6378,7360,70,981,33,37
59672,49189,443,36551,443,allow,15611,1501,14110,32,361,14,18
59673,55326,53,39375,53,allow,177,94,83,2,29,1,1
59674,49418,27015,35116,27015,allow,78,78,0,1,30,1,0
59675,49418,27001,35049,27001,allow,256,78,178,2,30,1,1
59676,40232,53,19769,53,allow,205,86,119,2,29,1,1
59677,49418,27015,31380,27015,allow,239,78,161,2,30,1,1
59678,49418,33086,18224,33086,allow,237,78,159,2,30,1,1
59679,56739,42421,49450,42421,allow,2810,1382,1428,12,31,6,6
59680,49418,27015,24624,27015,allow,78,78,0,1,30,1,0
59681,55594,53,28823,53,allow,168,78,90,2,30,1,1
59682,56845,443,17798,443,allow,16207,6355,9852,84,195,43,41
59683,60386,9136,45378,9136,allow,624,318,306,10,16,5,5
59684,57714,53,57714,53,allow,233,90,143,2,32,1,1
59685,63758,57825,49491,57825,allow,312,132,180,6,6,3,3
59686,51739,62163,32244,62163,allow,70,70,0,1,5,1,0
59687,63737,80,37849,80,allow,314,192,122,6,15,4,2
59688,37352,80,54268,80,allow,1115,562,553,13,362,6,7
59689,49418,27015,22086,27015,allow,78,78,0,1,30,1,0
59690,49418,28002,23648,28002,allow,271,78,193,2,30,1,1
59691,42128,80,52556,80,allow,1139,506,633,10,15,6,4
59692,49418,27053,45679,27053,allow,78,78,0,1,30,1,0
59693,56843,443,16451,443,allow,54661,36820,17841,266,201,128,138
59694,51399,443,28295,443,allow,642,582,60,2,5,1,1
59695,65198,53,6063,53,allow,448,94,354,4,49,2,2
59696,49418,33032,30338,33032,allow,78,78,0,1,30,1,0
59697,49418,27015,38880,27015,allow,78,78,0,1,30,1,0
59698,47808,53,24079,53,allow,168,78,90,2,30,1,1
59699,34465,443,9083,443,allow,1402,910,492,11,360,6,5
59700,34466,443,32529,443,allow,1402,910,492,11,360,6,5
59701,49418,33098,30068,33098,allow,78,78,0,1,30,1,0
59702,56844,443,48471,443,allow,10878,4815,6063,60,196,31,29
59703,65426,53,23528,53,allow,706,195,511,6,52,3,3
59704,39356,443,35388,443,allow,7134,2290,4844,29,80,15,14
59705,56541,443,9751,443,allow,130,70,60,2,15,1,1
59706,49418,27015,59160,27015,allow,78,78,0,1,30,1,0
59707,49418,30050,47158,30050,allow,78,78,0,1,30,1,0
59708,64805,53,57151,53,allow,215,102,113,2,30,1,1
59709,49418,33058,55897,33058,allow,244,78,166,2,30,1,1
59710,57144,8525,57144,8525,allow,138,78,60,2,5,1,1
59711,50550,443,50550,443,allow,5642,2395,3247,22,38,13,9
59712,42686,443,38351,443,allow,190,70,120,4,15,2,2
59713,44320,443,12809,443,allow,7244,1861,5383,26,330,14,12
59714,57598,443,10245,443,allow,12463,6762,5701,28,31,14,14
59715,49418,27015,25961,27015,allow,234,78,156,2,30,1,1
59716,49418,27015,26023,27015,allow,78,78,0,1,30,1,0
59717,49418,32036,34122,32036,allow,243,78,165,2,30,1,1
59718,49418,27056,31810,27056,allow,269,78,191,2,30,1,1
59719,56846,443,26374,443,allow,9370,3805,5565,43,181,21,22
59720,44512,443,54023,443,allow,1101393,30310,1071083,1137,109,381,756
59721,50516,443,49495,443,allow,12855,2077,10778,30,78,15,15
59722,38653,443,63492,443,allow,6969,2162,4807,20,15,11,9
59723,49228,443,26216,443,allow,13758,6577,7181,66,918,34,32
59724,55212,443,36417,443,allow,10500,5056,5444,23,143,11,12
59725,60964,443,25466,443,allow,2080,1376,704,17,30,9,8
59726,44516,443,18408,443,allow,156324,6993,149331,192,108,81,111
59727,44514,443,59227,443,allow,448741,15805,432936,491,109,181,310
59728,51774,80,22011,80,allow,240,120,120,5,27,3,2
59729,45619,80,13038,80,allow,1052,612,440,10,15,5,5
59730,50497,443,60901,443,allow,1322,725,597,14,78,7,7
59731,46291,443,48252,443,allow,70,70,0,1,5,1,0
59732,49418,27015,58093,27015,allow,78,78,0,1,30,1,0
59733,50996,443,60752,443,allow,12654,1719,10935,28,21,15,13
59734,59770,443,37125,443,allow,7316,1933,5383,27,16,15,12
59735,49418,29999,18255,29999,allow,239,78,161,2,30,1,1
59736,35164,443,44026,443,allow,5505,995,4510,20,255,11,9
59737,53227,53,29917,53,allow,205,86,119,2,29,1,1
59738,49260,53,27595,53,allow,177,86,91,2,29,1,1
59739,60384,64170,40565,64170,allow,504,318,186,8,16,5,3
59740,49619,53,1376,53,allow,184,86,98,2,30,1,1
59741,49418,27015,11221,27015,allow,240,78,162,2,30,1,1
59742,65348,53,2839,53,allow,177,94,83,2,30,1,1
59743,49418,27015,25593,27015,allow,258,78,180,2,30,1,1
59744,49418,27080,21881,27080,allow,238,78,160,2,30,1,1
59745,49418,27054,42342,27054,allow,272,78,194,2,30,1,1
59746,49418,26169,6616,26169,allow,78,78,0,1,30,1,0
59747,49418,32038,58741,32038,allow,235,78,157,2,30,1,1
59748,49418,32058,6170,32058,allow,78,78,0,1,30,1,0
59749,58663,53,40233,53,allow,167,78,89,2,30,1,1
59750,55454,443,35001,443,allow,1784,247,1537,7,120,4,3
59751,55455,443,13171,443,allow,1786,172,1614,7,120,3,4
59752,50540,443,25941,443,allow,134507,6585,127922,148,121,51,97
59753,50265,13302,54682,13302,allow,2118,858,1260,28,1267,14,14
59754,51754,1182,55646,1182,allow,70,70,0,2,7,2,0
59755,54020,53,54020,53,allow,233,90,143,2,32,1,1
59756,51398,443,32490,443,allow,322,262,60,2,5,1,1
59757,51942,443,54861,443,allow,2646,1322,1324,28,36,15,13
59758,51620,443,24957,443,allow,3330,2281,1049,17,16,9,8
59759,49418,27017,19640,27017,allow,78,78,0,1,30,1,0
59760,49418,33071,57943,33071,allow,78,78,0,1,30,1,0
59761,64133,53,49082,53,allow,225,110,115,2,30,1,1
59762,49418,50019,9812,50019,allow,268,78,190,2,30,1,1
59763,53084,443,55326,443,allow,490914,83866,407048,1048,332,526,522
59764,38993,443,34045,443,allow,7089,1290,5799,24,16,12,12
59765,23589,53,23589,53,allow,220,90,130,2,30,1,1
59766,34294,53,17102,53,allow,168,78,90,2,30,1,1
59767,53860,53,53860,53,allow,197,90,107,2,30,1,1
59768,57235,443,36461,443,allow,8954,3404,5550,34,46,19,15
59769,55326,53,7571,53,allow,177,94,83,2,30,1,1
59770,56841,443,47510,443,allow,156805,44621,112184,289,215,137,152
59771,49418,27015,63355,27015,allow,244,78,166,2,30,1,1
59772,49418,33056,16028,33056,allow,237,78,159,2,30,1,1
59773,49418,27058,37318,27058,allow,263,78,185,2,30,1,1
59774,49418,27055,11921,27055,allow,269,78,191,2,30,1,1
59775,49418,32056,18212,32056,allow,245,78,167,2,30,1,1
59776,51221,27048,22916,27048,allow,132,132,0,3,1200,3,0
59777,54659,443,56106,443,allow,1773,1038,735,17,278,9,8
59778,21133,6085,5257,6085,allow,481,150,331,2,1199,1,1
59779,50096,53,50096,53,allow,197,90,107,2,30,1,1
59780,55440,53,55440,53,allow,220,90,130,2,30,1,1
59781,48755,53,17288,53,allow,168,78,90,2,30,1,1
59782,58662,53,17171,53,allow,167,78,89,2,31,1,1
59783,63926,53,50565,53,allow,260,102,158,2,31,1,1
59784,65183,53,44616,53,allow,718,94,624,2,31,1,1
59785,59124,443,60758,443,allow,27431,19413,8018,71,175,36,35
59786,63627,443,58785,443,allow,17242,3015,14227,19,143,5,14
59787,63584,443,24147,443,allow,3182,1568,1614,8,120,4,4
59788,6881,51413,35496,51413,allow,475,150,325,2,1200,1,1
59789,49664,443,7925,443,allow,134,60,74,3,6,2,1
59790,52495,443,36037,443,allow,32875,8836,24039,37,16,15,22
59791,63425,443,8137,443,allow,22815,20019,2796,55,81,31,24
59792,50913,80,46319,80,allow,12767608,157856,12609752,11936,135,2227,9709
59793,50906,80,26380,80,allow,13949172,164502,13784670,11537,135,2287,9250
59794,58837,3389,58837,3389,allow,4429,2581,1848,21,33,11,10
59795,56680,8100,35918,8100,allow,78,78,0,1,5,1,0
59796,53544,22051,5386,22051,allow,70,70,0,1,5,1,0
59797,50488,443,22994,443,allow,9765,2106,7659,27,83,14,13
59798,49449,80,5830,80,allow,1948,912,1036,13,56,7,6
59799,50382,443,9728,443,allow,10423,2542,7881,48,20,24,24
59800,50897,80,4903,80,allow,13981183,155668,13825515,11482,136,2194,9288
59801,44187,53,44187,53,allow,233,90,143,2,32,1,1
59802,65367,443,29972,443,allow,5666,4417,1249,23,86,12,11
59803,50910,80,20207,80,allow,14877069,179445,14697624,12450,135,2531,9919
59804,50900,80,32944,80,allow,14423569,189925,14233644,12194,135,2586,9608
59805,49624,53,37843,53,allow,216,94,122,2,30,1,1
59806,57082,53,1107,53,allow,211,102,109,2,30,1,1
59807,39054,53,31083,53,allow,168,78,90,2,30,1,1
59808,65348,53,40565,53,allow,177,94,83,2,30,1,1
59809,51989,445,0,0,drop,66,66,0,1,0,1,0
59810,35516,22,0,0,deny,60,60,0,1,0,1,0
59811,56564,9571,0,0,deny,78,78,0,1,0,1,0
59812,56567,445,0,0,drop,70,70,0,1,0,1,0
59813,33292,50584,0,0,deny,66,66,0,1,0,1,0
59814,34489,35440,0,0,deny,66,66,0,1,0,1,0
59815,51986,445,0,0,drop,66,66,0,1,0,1,0
59816,62338,50011,0,0,deny,66,66,0,1,0,1,0
59817,62532,57354,0,0,deny,159,159,0,1,0,1,0
59818,47013,37965,0,0,deny,62,62,0,1,0,1,0
59819,51553,445,0,0,drop,70,70,0,1,0,1,0
59820,54976,2273,0,0,deny,60,60,0,1,0,1,0
59821,51977,445,0,0,drop,66,66,0,1,0,1,0
59822,51549,445,0,0,drop,70,70,0,1,0,1,0
59823,51975,445,0,0,drop,66,66,0,1,0,1,0
59824,51548,445,0,0,drop,70,70,0,1,0,1,0
59825,51547,445,0,0,drop,70,70,0,1,0,1,0
59826,12694,12446,0,0,deny,62,62,0,1,0,1,0
59827,56703,50584,0,0,deny,66,66,0,1,0,1,0
59828,51546,445,0,0,deny,70,70,0,1,0,1,0
59829,51328,30228,0,0,deny,109,109,0,1,0,1,0
59830,58003,1433,0,0,deny,60,60,0,1,0,1,0
59831,51544,445,0,0,drop,70,70,0,1,0,1,0
59832,51540,445,0,0,drop,70,70,0,1,0,1,0
59833,51191,26467,0,0,deny,66,66,0,1,0,1,0
59834,63583,37965,0,0,deny,66,66,0,1,0,1,0
59835,30599,46824,0,0,deny,66,66,0,1,0,1,0
59836,56556,445,0,0,drop,70,70,0,1,0,1,0
59837,56555,445,0,0,drop,70,70,0,1,0,1,0
59838,51528,445,0,0,drop,70,70,0,1,0,1,0
59839,51527,445,0,0,drop,70,70,0,1,0,1,0
59840,51961,445,0,0,drop,66,66,0,1,0,1,0
59841,51962,445,0,0,drop,66,66,0,1,0,1,0
59842,51963,445,0,0,deny,66,66,0,1,0,1,0
59843,51960,445,0,0,drop,66,66,0,1,0,1,0
59844,51959,445,0,0,drop,66,66,0,1,0,1,0
59845,51957,445,0,0,drop,66,66,0,1,0,1,0
59846,51956,445,0,0,drop,66,66,0,1,0,1,0
59847,3964,51505,0,0,deny,62,62,0,1,0,1,0
59848,51525,445,0,0,drop,70,70,0,1,0,1,0
59849,64166,35440,0,0,deny,62,62,0,1,0,1,0
59850,51517,445,0,0,drop,70,70,0,1,0,1,0
59851,51518,445,0,0,drop,70,70,0,1,0,1,0
59852,64219,51050,0,0,deny,66,66,0,1,0,1,0
59853,51953,37965,0,0,deny,66,66,0,1,0,1,0
59854,42128,54532,0,0,deny,60,60,0,1,0,1,0
59855,39823,36237,0,0,deny,66,66,0,1,0,1,0
59856,57098,1,0,0,deny,78,78,0,1,0,1,0
59857,34531,23117,0,0,deny,62,62,0,1,0,1,0
59858,61845,11392,0,0,deny,62,62,0,1,0,1,0
59859,56553,445,0,0,drop,70,70,0,1,0,1,0
59860,56547,445,0,0,drop,70,70,0,1,0,1,0
59861,56539,445,0,0,drop,70,70,0,1,0,1,0
59862,51506,445,0,0,drop,70,70,0,1,0,1,0
59863,8622,64147,0,0,deny,66,66,0,1,0,1,0
59864,51943,445,0,0,drop,66,66,0,1,0,1,0
59865,51940,445,0,0,drop,66,66,0,1,0,1,0
59866,51941,445,0,0,drop,66,66,0,1,0,1,0
59867,56537,445,0,0,drop,70,70,0,1,0,1,0
59868,58598,50584,0,0,deny,66,66,0,1,0,1,0
59869,56535,445,0,0,drop,70,70,0,1,0,1,0
59870,49699,64147,0,0,deny,66,66,0,1,0,1,0
59871,51502,445,0,0,drop,70,70,0,1,0,1,0
59872,56531,445,0,0,drop,70,70,0,1,0,1,0
59873,56527,445,0,0,drop,70,70,0,1,0,1,0
59874,56524,445,0,0,drop,70,70,0,1,0,1,0
59875,14613,12446,0,0,deny,66,66,0,1,0,1,0
59876,49664,37965,0,0,deny,66,66,0,1,0,1,0
59877,51999,37965,0,0,deny,62,62,0,1,0,1,0
59878,18085,26467,0,0,deny,62,62,0,1,0,1,0
59879,55296,23718,0,0,deny,66,66,0,1,0,1,0
59880,51491,445,0,0,drop,70,70,0,1,0,1,0
59881,51493,445,0,0,drop,70,70,0,1,0,1,0
59882,42463,56205,0,0,deny,146,146,0,1,0,1,0
59883,51489,445,0,0,drop,70,70,0,1,0,1,0
59884,51488,445,0,0,drop,70,70,0,1,0,1,0
59885,51486,445,0,0,drop,70,70,0,1,0,1,0
59886,8999,43109,0,0,deny,146,146,0,1,0,1,0
59887,46275,64147,0,0,deny,62,62,0,1,0,1,0
59888,64482,64147,0,0,deny,66,66,0,1,0,1,0
59889,56516,445,0,0,drop,70,70,0,1,0,1,0
59890,56514,445,0,0,drop,70,70,0,1,0,1,0
59891,56511,445,0,0,drop,70,70,0,1,0,1,0
59892,24351,57470,0,0,deny,62,62,0,1,0,1,0
59893,51774,29434,0,0,deny,146,146,0,1,0,1,0
59894,51480,445,0,0,drop,70,70,0,1,0,1,0
59895,43129,20220,0,0,deny,62,62,0,1,0,1,0
59896,8999,1,0,0,deny,62,62,0,1,0,1,0
59897,54280,3359,0,0,deny,60,60,0,1,0,1,0
59898,54826,56205,0,0,deny,62,62,0,1,0,1,0
59899,51472,445,0,0,drop,70,70,0,1,0,1,0
59900,51918,445,0,0,drop,66,66,0,1,0,1,0
59901,56510,445,0,0,drop,70,70,0,1,0,1,0
59902,56508,445,0,0,drop,70,70,0,1,0,1,0
59903,51471,445,0,0,drop,70,70,0,1,0,1,0
59904,59918,44847,0,0,deny,66,66,0,1,0,1,0
59905,54471,36237,0,0,deny,66,66,0,1,0,1,0
59906,8999,1,0,0,deny,146,146,0,1,0,1,0
59907,5200,6643,0,0,deny,145,145,0,1,0,1,0
59908,51463,445,0,0,drop,70,70,0,1,0,1,0
59909,50853,50584,0,0,deny,62,62,0,1,0,1,0
59910,51462,445,0,0,drop,70,70,0,1,0,1,0
59911,37571,443,14290,443,allow,499,425,74,4,0,3,1
59912,37574,443,27983,443,allow,499,425,74,4,0,3,1
59913,37573,443,61773,443,allow,499,425,74,4,0,3,1
59914,37572,443,25877,443,allow,499,425,74,4,0,3,1
59915,37570,443,49846,443,allow,499,425,74,4,0,3,1
59916,37569,443,25156,443,allow,499,425,74,4,0,3,1
59917,0,0,0,0,allow,320,320,0,5,0,5,0
59918,51914,445,0,0,drop,66,66,0,1,0,1,0
59919,48087,16069,0,0,deny,66,66,0,1,0,1,0
59920,47962,16069,0,0,deny,62,62,0,1,0,1,0
59921,14309,56205,0,0,deny,62,62,0,1,0,1,0
59922,51911,445,0,0,drop,66,66,0,1,0,1,0
59923,56495,445,0,0,drop,70,70,0,1,0,1,0
59924,58876,57470,0,0,deny,66,66,0,1,0,1,0
59925,56490,445,0,0,drop,70,70,0,1,0,1,0
59926,56489,445,0,0,drop,70,70,0,1,0,1,0
59927,56488,445,0,0,drop,70,70,0,1,0,1,0
59928,51458,445,0,0,drop,70,70,0,1,0,1,0
59929,51908,445,0,0,drop,66,66,0,1,0,1,0
59930,51457,445,0,0,drop,70,70,0,1,0,1,0
59931,56482,445,0,0,drop,70,70,0,1,0,1,0
59932,56480,445,0,0,drop,70,70,0,1,0,1,0
59933,56477,445,0,0,drop,70,70,0,1,0,1,0
59934,56478,445,0,0,drop,70,70,0,1,0,1,0
59935,51534,26467,0,0,deny,62,62,0,1,0,1,0
59936,51902,445,0,0,drop,66,66,0,1,0,1,0
59937,51452,445,0,0,drop,70,70,0,1,0,1,0
59938,51893,445,0,0,drop,66,66,0,1,0,1,0
59939,51896,445,0,0,drop,66,66,0,1,0,1,0
59940,51897,445,0,0,drop,66,66,0,1,0,1,0
59941,51891,445,0,0,drop,66,66,0,1,0,1,0
59942,51892,445,0,0,drop,66,66,0,1,0,1,0
59943,51889,445,0,0,drop,66,66,0,1,0,1,0
59944,42685,51180,0,0,deny,62,62,0,1,0,1,0
59945,56753,44847,0,0,deny,62,62,0,1,0,1,0
59946,49831,30188,0,0,deny,66,66,0,1,0,1,0
59947,64890,51180,0,0,deny,66,66,0,1,0,1,0
59948,50200,44847,0,0,deny,70,70,0,1,0,1,0
59949,56474,445,0,0,drop,70,70,0,1,0,1,0
59950,56471,445,0,0,drop,70,70,0,1,0,1,0
59951,56469,445,0,0,drop,70,70,0,1,0,1,0
59952,51887,445,0,0,drop,66,66,0,1,0,1,0
59953,56467,445,0,0,drop,70,70,0,1,0,1,0
59954,443,10010,0,0,deny,60,60,0,1,0,1,0
59955,51884,445,0,0,drop,66,66,0,1,0,1,0
59956,51882,445,0,0,drop,66,66,0,1,0,1,0
59957,51881,445,0,0,drop,66,66,0,1,0,1,0
59958,37616,443,4256,443,allow,18611,3046,15565,41,362,20,21
59959,61385,80,34601,80,allow,30257,2427,27830,45,255,22,23
59960,61390,80,4844,80,allow,13706,1388,12318,26,255,14,12
59961,51318,443,40980,443,allow,11191,4657,6534,32,129,14,18
59962,57512,80,20735,80,allow,1377,881,496,12,48,7,5
59963,65381,80,14160,80,allow,1630,982,648,13,78,7,6
59964,49736,443,37577,443,allow,378,192,186,7,15,4,3
59965,54688,443,54688,443,allow,149676,25300,124376,220,110,122,98
59966,51265,63960,62847,63960,allow,70,70,0,1,5,1,0
59967,56778,35292,48198,35292,allow,70,70,0,1,5,1,0
59968,65387,443,41173,443,allow,2289,1583,706,14,18,8,6
59969,61389,80,44525,80,allow,17407,1529,15878,30,255,16,14
59970,61388,80,19899,80,allow,14158,1392,12766,26,255,14,12
59971,17750,6881,6103,6881,allow,149,149,0,1,1200,1,0
59972,5938,26428,0,0,allow,60,60,0,1,90,1,0
59973,61706,80,6564,80,allow,1840,1242,598,11,16,6,5
59974,62462,53,62462,53,allow,238,99,139,2,30,1,1
59975,51564,443,53413,443,allow,2888,1566,1322,17,18,9,8
59976,61387,80,56509,80,allow,28791,2297,26494,41,255,20,21
59977,17861,443,17861,443,allow,1155,728,427,11,26,7,4
59978,65362,80,32536,80,allow,1347,771,576,11,86,7,4
59979,58046,53,58046,53,allow,231,88,143,2,32,1,1
59980,7665,80,7665,80,allow,110567,7016,103551,135,46,60,75
59981,42213,443,21488,443,allow,4622,926,3696,18,255,10,8
59982,52629,53,0,0,allow,232,77,155,2,33,1,1
59983,41322,443,7553,443,allow,153,93,60,2,5,1,1
59984,55598,41565,26251,41565,allow,70,70,0,2,8,2,0
59985,52540,443,62112,443,allow,153,93,60,2,5,1,1
59986,49175,2710,9134,2710,allow,66,66,0,1,5,1,0
59987,54614,443,21022,443,allow,36109,16793,19316,62,19,32,30
59988,50475,443,44824,443,allow,3893,1910,1983,36,255,17,19
59989,43422,80,45475,80,allow,3863,875,2988,12,16,8,4
59990,56981,443,53338,443,allow,7238,2601,4637,20,22,10,10
59991,33911,53,0,0,allow,82,82,0,1,30,1,0
59992,5588,5588,0,0,allow,3498,1872,1626,48,205,24,24
59993,51953,443,6688,443,allow,7571,3372,4199,33,88,17,16
59994,52000,80,35865,80,allow,3495,1150,2345,17,18,8,9
59995,55744,80,6834,80,allow,5146,3694,1452,20,249,10,10
59996,61386,80,24052,80,allow,17583,1529,16054,30,255,16,14
59997,56774,39553,10646,39553,allow,70,70,0,2,8,2,0
59998,54105,443,23340,443,allow,2227,1018,1209,17,16,8,9
59999,49285,53,48057,53,allow,168,78,90,2,30,1,1
60000,60419,53,60419,53,allow,217,87,130,2,30,1,1
60001,55890,53,46214,53,allow,711,87,624,2,30,1,1
60002,57568,53,57568,53,allow,235,98,137,2,30,1,1
60003,57371,53,40591,53,allow,728,96,632,2,30,1,1
60004,59204,443,10417,443,allow,9335,3052,6283,25,125,11,14
60005,40631,53,40631,53,allow,262,107,155,2,30,1,1
60006,41426,443,52242,443,allow,3396,1964,1432,16,361,8,8
60007,54397,443,59448,443,allow,1786,172,1614,7,120,3,4
60008,50265,27034,40304,27034,allow,480,149,331,2,1200,1,1
60009,42119,36237,0,0,deny,66,66,0,1,0,1,0
60010,51439,445,0,0,drop,70,70,0,1,0,1,0
60011,51837,37965,0,0,deny,66,66,0,1,0,1,0
60012,51878,445,0,0,drop,66,66,0,1,0,1,0
60013,49386,64147,0,0,deny,62,62,0,1,0,1,0
60014,10262,11392,0,0,deny,62,62,0,1,0,1,0
60015,64767,51221,0,0,deny,62,62,0,1,0,1,0
60016,51464,23,0,0,deny,60,60,0,1,0,1,0
60017,51436,445,0,0,drop,70,70,0,1,0,1,0
60018,8999,15503,0,0,deny,146,146,0,1,0,1,0
60019,1128,44847,0,0,deny,62,62,0,1,0,1,0
60020,50102,17546,0,0,deny,66,66,0,1,0,1,0
60021,45394,443,62065,443,allow,1314,653,661,13,185,7,6
60022,49772,80,25587,80,allow,1155,781,374,10,15,6,4
60023,49526,53,60849,53,allow,402,118,284,2,30,1,1
60024,64998,27037,61288,27037,allow,3287,2072,1215,12,30,6,6
60025,57009,53,8536,53,allow,177,94,83,2,30,1,1
60026,49988,443,49988,443,allow,1466,696,770,20,120,10,10
60027,50896,80,56677,80,allow,11459959,142694,11317265,9719,135,1994,7725
60028,50917,80,57551,80,allow,11626518,135099,11491419,9627,134,1907,7720
60029,50509,443,29330,443,allow,9535,1246,8289,29,77,15,14
60030,53561,35885,64999,35885,allow,70,70,0,2,7,2,0
60031,45540,8100,64668,8100,allow,78,78,0,1,4,1,0
60032,51736,34343,51970,34343,allow,70,70,0,1,5,1,0
60033,65366,443,3510,443,allow,4319,2473,1846,24,85,10,14
60034,53505,8102,48744,8102,allow,1495,843,652,10,30,5,5
60035,21909,53,21909,53,allow,197,90,107,2,30,1,1
60036,50941,443,22406,443,allow,12831,2277,10554,37,145,17,20
60037,57224,53,20310,53,allow,532,198,334,6,50,3,3
60038,55067,443,14245,443,allow,1146,360,786,20,75,7,13
60039,50899,80,62536,80,allow,13974043,173337,13800706,11715,134,2429,9286
60040,50508,443,43933,443,allow,5938,1012,4926,20,77,11,9
60041,43837,443,27944,443,allow,70,70,0,1,4,1,0
60042,50507,443,55208,443,allow,7171,1729,5442,24,78,13,11
60043,60746,40010,7294,40010,allow,316,136,180,6,6,3,3
60044,53543,51819,47777,51819,allow,70,70,0,1,4,1,0
60045,33730,443,53132,443,allow,5947,1579,4368,22,315,12,10
60046,35343,80,43757,80,allow,953,538,415,11,318,6,5
60047,57223,443,27688,443,allow,24283,14945,9338,46,318,26,20
60048,50679,443,24042,443,allow,14172,2714,11458,32,637,13,19
60049,55946,443,34803,443,allow,9274,5282,3992,42,186,22,20
60050,65273,53,14991,53,allow,338,110,228,2,29,1,1
60051,64338,53,55215,53,allow,292,102,190,2,29,1,1
60052,44883,53,44883,53,allow,216,90,126,2,29,1,1
60053,65348,53,17423,53,allow,177,94,83,2,29,1,1
60054,56776,18318,59158,18318,allow,70,70,0,1,5,1,0
60055,43483,443,14734,443,allow,144138,17538,126600,275,300,115,160
60056,58659,53,58909,53,allow,167,78,89,2,30,1,1
60057,54322,27015,10656,27015,allow,924,924,0,3,30,3,0
60058,55154,443,28417,443,allow,1610,771,839,22,120,11,11
60059,56176,53,8371,53,allow,194,102,92,2,30,1,1
60060,65263,80,27562,80,allow,7440,4032,3408,48,629,25,23
60061,56775,20617,28248,20617,allow,70,70,0,2,8,2,0
60062,51748,15177,40687,15177,allow,70,70,0,2,9,2,0
60063,56601,80,22349,80,allow,234,234,0,4,12,4,0
60064,43488,443,22133,443,allow,6817,1221,5596,26,285,14,12
60065,44847,46972,13667,46972,allow,150,150,0,1,1200,1,0
60066,36961,443,20198,443,allow,7326,1399,5927,29,280,15,14
60067,57396,53,39255,53,allow,358,102,256,2,30,1,1
60068,55114,53,53852,53,allow,392,100,292,4,33,2,2
60069,51576,443,13071,443,allow,9753,2821,6932,39,201,22,17
60070,8986,443,12105,443,allow,8062,2804,5258,43,161,20,23
60071,46442,80,6730,80,allow,1373,669,704,10,16,5,5
60072,49774,53,5014,53,allow,236,94,142,2,30,1,1
60073,41418,443,15753,443,allow,6670,1576,5094,23,200,13,10
60074,64706,27065,37449,27065,allow,924,924,0,3,30,3,0
60075,55229,53,55587,53,allow,199,94,105,2,30,1,1
60076,59175,53,63239,53,allow,168,78,90,2,30,1,1
60077,57009,53,48433,53,allow,177,94,83,2,30,1,1
60078,50714,443,52657,443,allow,9477,1950,7527,31,181,14,17
60079,44252,443,6888,443,allow,14455,6007,8448,45,120,26,19
60080,51735,50794,12843,50794,allow,70,70,0,1,5,1,0
60081,56395,443,48597,443,allow,77506,2940,74566,100,80,38,62
60082,39527,443,33957,443,allow,8447,3506,4941,28,333,15,13
60083,54321,27015,6955,27015,allow,924,924,0,3,30,3,0
60084,54320,27016,28839,27016,allow,924,924,0,3,30,3,0
60085,35587,123,5043,123,allow,184,94,90,2,30,1,1
60086,6882,8999,49067,8999,allow,238,118,120,2,1200,1,1
60087,65262,80,27207,80,allow,8814,4800,4014,52,629,27,25
60088,61384,80,43597,80,allow,2526,843,1683,12,255,7,5
60089,63264,53,63264,53,allow,197,90,107,2,30,1,1
60090,49796,53,34008,53,allow,238,102,136,2,30,1,1
60091,61256,443,47931,443,allow,2680,255,2425,9,120,4,5
60092,65427,443,32092,443,allow,14205,1527,12678,13,147,2,11
60093,50901,80,6668,80,allow,14661588,141996,14519592,11768,134,2012,9756
60094,55597,7485,9099,7485,allow,70,70,0,2,8,2,0
60095,50903,80,42549,80,allow,13644327,154437,13489890,11257,134,2201,9056
60096,51752,31677,2687,31677,allow,70,70,0,2,8,2,0
60097,7595,80,7595,80,allow,34707,1796,32911,45,45,20,25
60098,57353,443,32586,443,allow,150,150,0,1,5,1,0
60099,56777,42486,21252,42486,allow,70,70,0,1,5,1,0
60100,56964,53,13707,53,allow,267,87,180,4,57,2,2
60101,28989,53,28989,53,allow,197,90,107,2,29,1,1
60102,61492,80,29860,80,allow,901,398,503,10,15,5,5
60103,62109,443,64847,443,allow,21219,1329,19890,32,122,13,19
60104,65287,53,32403,53,allow,222,86,136,2,30,1,1
60105,56126,53,59441,53,allow,336,110,226,2,29,1,1
60106,55567,53,55567,53,allow,216,90,126,2,30,1,1
60107,49553,53,5635,53,allow,614,239,375,6,53,3,3
60108,58664,53,10827,53,allow,167,78,89,2,29,1,1
60109,49419,53,3552,53,allow,343,100,243,4,52,2,2
60110,43484,443,55073,443,allow,130,70,60,2,15,1,1
60111,49610,53,9285,53,allow,168,78,90,2,30,1,1
60112,57588,443,16925,443,allow,9109,2044,7065,25,22,14,11
60113,50645,53,27805,53,allow,177,94,83,2,30,1,1
60114,50500,443,60385,443,allow,12556,1134,11422,28,78,13,15
60115,50502,443,59383,443,allow,11323,3376,7947,29,77,16,13
60116,50504,443,47105,443,allow,5476,1073,4403,22,78,12,10
60117,52629,53,0,0,allow,418,154,264,4,33,2,2
60118,46641,8100,2386,8100,allow,78,78,0,1,4,1,0
60119,64657,53,35491,53,allow,370,96,274,4,39,2,2
60120,4184,53,4184,53,allow,216,90,126,2,29,1,1
60121,59179,53,29104,53,allow,260,86,174,2,30,1,1
60122,50209,53,40978,53,allow,86,86,0,1,30,1,0
60123,56174,443,33268,443,allow,1310,649,661,13,185,7,6
60124,45392,443,53669,443,allow,1312,651,661,13,185,7,6
60125,65251,80,48445,80,allow,6352,4052,2300,44,630,23,21
60126,65466,443,13984,443,allow,478996,13760,465236,490,16,171,319
60127,61712,80,5502,80,allow,1864,1024,840,10,16,6,4
60128,51667,25826,43364,25826,allow,9372,9372,0,11,30,11,0
60129,56291,53,51569,53,allow,260,102,158,2,30,1,1
60130,58658,53,27150,53,allow,260,86,174,2,30,1,1
60131,46297,80,56497,80,allow,1155,781,374,10,15,6,4
60132,43482,443,29764,443,allow,2316,1280,1036,20,278,11,9
60133,35509,3389,35509,3389,allow,4224,2055,2169,22,21,13,9
60134,50645,53,59508,53,allow,177,94,83,2,30,1,1
60135,54807,53,14408,53,allow,206,86,120,2,30,1,1
60136,50825,443,30672,443,allow,252960,10277,242683,301,209,119,182
60137,52321,443,49472,443,allow,10320,5152,5168,45,15,25,20
60138,43487,443,8725,443,allow,6886,1291,5595,27,285,15,12
60139,41296,80,53379,80,allow,1056,682,374,10,15,6,4
60140,65379,443,56474,443,allow,4514,2844,1670,29,84,14,15
60141,65264,80,41866,80,allow,7440,4032,3408,48,629,25,23
60142,17532,53,17532,53,allow,233,90,143,2,31,1,1
60143,52322,53,58058,53,allow,86,86,0,1,30,1,0
60144,60163,443,11476,443,allow,3041,1745,1296,28,3600,15,13
60145,56176,443,9976,443,allow,1312,651,661,13,185,7,6
60146,55928,443,33892,443,allow,5433,3275,2158,16,135,8,8
60147,53541,59939,18832,59939,allow,70,70,0,1,5,1,0
60148,65465,443,59471,443,allow,92040,4799,87241,107,16,43,64
60149,61835,443,61835,443,allow,21703,2433,19270,44,76,18,26
60150,51797,80,9284,80,allow,1929,796,1133,21,135,11,10
60151,61834,443,61834,443,allow,220115,6038,214077,231,76,78,153
60152,50229,443,13758,443,allow,6846,2479,4367,41,256,19,22
60153,50915,80,27954,80,allow,10548172,142265,10405907,9105,134,1982,7123
60154,63968,53,61368,53,allow,310,142,168,2,30,1,1
60155,58562,3389,58562,3389,allow,5387,1909,3478,22,21,10,12
60156,50911,80,6093,80,allow,13780884,170419,13610465,11542,134,2387,9155
60157,44187,443,10571,443,allow,12382,2688,9694,37,361,19,18
60158,56462,445,0,0,drop,70,70,0,1,0,1,0
60159,56454,445,0,0,drop,70,70,0,1,0,1,0
60160,56450,445,0,0,drop,70,70,0,1,0,1,0
60161,26531,37965,0,0,deny,62,62,0,1,0,1,0
60162,51431,445,0,0,drop,70,70,0,1,0,1,0
60163,50784,52952,0,0,deny,66,66,0,1,0,1,0
60164,37568,443,2020,443,allow,499,425,74,4,0,3,1
60165,37564,443,36169,443,allow,499,425,74,4,0,3,1
60166,37567,443,17651,443,allow,499,425,74,4,0,3,1
60167,37566,443,23464,443,allow,499,425,74,4,0,3,1
60168,37563,443,52126,443,allow,499,425,74,4,0,3,1
60169,37565,443,6723,443,allow,499,425,74,4,0,3,1
60170,55865,64147,0,0,deny,66,66,0,1,0,1,0
60171,61315,48817,0,0,deny,62,62,0,1,0,1,0
60172,51870,445,0,0,drop,66,66,0,1,0,1,0
60173,51430,445,0,0,drop,70,70,0,1,0,1,0
60174,50788,48817,0,0,deny,66,66,0,1,0,1,0
60175,51428,445,0,0,drop,70,70,0,1,0,1,0
60176,34382,26314,0,0,deny,143,143,0,1,0,1,0
60177,51244,16474,0,0,deny,100,100,0,1,0,1,0
60178,59584,36237,0,0,deny,66,66,0,1,0,1,0
60179,51244,21162,0,0,deny,100,100,0,1,0,1,0
60180,58597,35440,0,0,deny,62,62,0,1,0,1,0
60181,51244,29517,0,0,deny,100,100,0,1,0,1,0
60182,51244,52290,0,0,deny,100,100,0,1,0,1,0
60183,36656,64147,0,0,deny,62,62,0,1,0,1,0
60184,51244,14984,0,0,deny,100,100,0,1,0,1,0
60185,30114,65151,0,0,deny,60,60,0,1,0,1,0
60186,51859,445,0,0,drop,66,66,0,1,0,1,0
60187,51244,59353,0,0,deny,100,100,0,1,0,1,0
60188,51244,57099,0,0,deny,100,100,0,1,0,1,0
60189,56439,445,0,0,drop,70,70,0,1,0,1,0
60190,36339,50584,0,0,deny,62,62,0,1,0,1,0
60191,19570,50584,0,0,deny,66,66,0,1,0,1,0
60192,1025,40108,0,0,deny,146,146,0,1,0,1,0
60193,52802,56205,0,0,deny,66,66,0,1,0,1,0
60194,60292,7129,0,0,deny,62,62,0,1,0,1,0
60195,9659,81,0,0,deny,60,60,0,1,0,1,0
60196,51856,445,0,0,drop,66,66,0,1,0,1,0
60197,51421,445,0,0,drop,70,70,0,1,0,1,0
60198,27328,21247,0,0,deny,62,62,0,1,0,1,0
60199,51419,445,0,0,drop,70,70,0,1,0,1,0
60200,54071,50265,0,0,deny,62,62,0,1,0,1,0
60201,51848,445,0,0,drop,66,66,0,1,0,1,0
60202,42128,54532,0,0,deny,60,60,0,1,0,1,0
60203,51418,445,0,0,drop,70,70,0,1,0,1,0
60204,51840,445,0,0,drop,66,66,0,1,0,1,0
60205,51417,445,0,0,drop,70,70,0,1,0,1,0
60206,51416,445,0,0,drop,70,70,0,1,0,1,0
60207,51411,445,0,0,drop,70,70,0,1,0,1,0
60208,54631,44847,0,0,deny,74,74,0,1,0,1,0
60209,62780,35440,0,0,deny,66,66,0,1,0,1,0
60210,11458,2767,0,0,deny,66,66,0,1,0,1,0
60211,51398,445,0,0,drop,70,70,0,1,0,1,0
60212,51397,445,0,0,drop,70,70,0,1,0,1,0
60213,51391,445,0,0,drop,70,70,0,1,0,1,0
60214,27442,44847,0,0,deny,62,62,0,1,0,1,0
60215,26802,50584,0,0,deny,146,146,0,1,0,1,0
60216,47173,35440,0,0,deny,62,62,0,1,0,1,0
60217,51388,445,0,0,drop,70,70,0,1,0,1,0
60218,51387,445,0,0,drop,70,70,0,1,0,1,0
60219,26406,37965,0,0,deny,66,66,0,1,0,1,0
60220,56430,445,0,0,drop,70,70,0,1,0,1,0
60221,56428,445,0,0,drop,70,70,0,1,0,1,0
60222,56427,445,0,0,drop,70,70,0,1,0,1,0
60223,51832,445,0,0,drop,66,66,0,1,0,1,0
60224,51833,445,0,0,drop,66,66,0,1,0,1,0
60225,51834,445,0,0,drop,66,66,0,1,0,1,0
60226,51831,445,0,0,drop,66,66,0,1,0,1,0
60227,51827,445,0,0,drop,66,66,0,1,0,1,0
60228,51829,445,0,0,drop,66,66,0,1,0,1,0
60229,51828,445,0,0,drop,66,66,0,1,0,1,0
60230,51826,445,0,0,drop,66,66,0,1,0,1,0
60231,53475,3389,0,0,deny,66,66,0,1,0,1,0
60232,22683,39210,0,0,deny,60,60,0,1,0,1,0
60233,30443,44847,0,0,deny,62,62,0,1,0,1,0
60234,14615,57866,0,0,deny,66,66,0,1,0,1,0
60235,443,12105,0,0,deny,66,66,0,1,0,1,0
60236,65501,57470,0,0,deny,72,72,0,1,0,1,0
60237,62787,51221,0,0,deny,66,66,0,1,0,1,0
60238,53211,22114,0,0,deny,66,66,0,1,0,1,0
60239,6676,63836,0,0,deny,145,145,0,1,0,1,0
60240,58977,37965,0,0,deny,66,66,0,1,0,1,0
60241,51376,445,0,0,drop,70,70,0,1,0,1,0
60242,53745,443,56954,443,allow,499,425,74,4,0,3,1
60243,53744,443,46972,443,allow,499,425,74,4,0,3,1
60244,7444,57470,0,0,deny,66,66,0,1,0,1,0
60245,7222,57470,0,0,deny,62,62,0,1,0,1,0
60246,6895,57354,0,0,deny,148,148,0,1,0,1,0
60247,56422,445,0,0,drop,70,70,0,1,0,1,0
60248,56417,445,0,0,drop,70,70,0,1,0,1,0
60249,56412,445,0,0,drop,70,70,0,1,0,1,0
60250,58748,80,58748,80,allow,6516,564,5952,16,25,7,9
60251,14082,50584,0,0,deny,66,66,0,1,0,1,0
60252,44258,25,0,0,deny,74,74,0,1,0,1,0
60253,51814,445,0,0,drop,66,66,0,1,0,1,0
60254,51813,445,0,0,drop,66,66,0,1,0,1,0
60255,51812,445,0,0,drop,66,66,0,1,0,1,0
60256,19858,64147,0,0,deny,62,62,0,1,0,1,0
60257,56410,445,0,0,drop,70,70,0,1,0,1,0
60258,33822,57470,0,0,deny,66,66,0,1,0,1,0
60259,7301,14914,0,0,deny,157,157,0,1,0,1,0
60260,51372,445,0,0,drop,70,70,0,1,0,1,0
60261,56407,445,0,0,drop,70,70,0,1,0,1,0
60262,56406,445,0,0,drop,70,70,0,1,0,1,0
60263,56403,445,0,0,drop,70,70,0,1,0,1,0
60264,56395,445,0,0,drop,70,70,0,1,0,1,0
60265,33289,50584,0,0,deny,62,62,0,1,0,1,0
60266,48676,53395,0,0,deny,60,60,0,1,0,1,0
60267,51361,445,0,0,drop,70,70,0,1,0,1,0
60268,51363,445,0,0,drop,70,70,0,1,0,1,0
60269,56778,35440,0,0,deny,66,66,0,1,0,1,0
60270,51359,445,0,0,drop,70,70,0,1,0,1,0
60271,51358,445,0,0,drop,70,70,0,1,0,1,0
60272,8999,57470,0,0,deny,146,146,0,1,0,1,0
60273,51355,445,0,0,drop,70,70,0,1,0,1,0
60274,20961,35440,0,0,deny,62,62,0,1,0,1,0
60275,51074,80,51074,80,allow,168467,7348,161119,184,8,67,117
60276,61241,22114,0,0,deny,66,66,0,1,0,1,0
60277,54684,37965,0,0,deny,62,62,0,1,0,1,0
60278,56453,37965,0,0,deny,66,66,0,1,0,1,0
60279,6889,24748,0,0,deny,143,143,0,1,0,1,0
60280,59156,50584,0,0,deny,66,66,0,1,0,1,0
60281,60894,50584,0,0,deny,62,62,0,1,0,1,0
60282,56390,445,0,0,drop,70,70,0,1,0,1,0
60283,56385,445,0,0,drop,70,70,0,1,0,1,0
60284,56383,445,0,0,drop,70,70,0,1,0,1,0
60285,51350,445,0,0,drop,70,70,0,1,0,1,0
60286,18291,37807,0,0,deny,146,146,0,1,0,1,0
60287,46349,51505,0,0,deny,74,74,0,1,0,1,0
60288,0,0,0,0,allow,480,244,236,4,0,2,2
60289,3225,64147,0,0,deny,66,66,0,1,0,1,0
60290,16221,50584,0,0,deny,62,62,0,1,0,1,0
60291,51342,445,0,0,drop,70,70,0,1,0,1,0
60292,51340,445,0,0,drop,70,70,0,1,0,1,0
60293,51788,445,0,0,drop,66,66,0,1,0,1,0
60294,56380,445,0,0,drop,70,70,0,1,0,1,0
60295,16387,26193,0,0,deny,60,60,0,1,0,1,0
60296,1027,44847,0,0,deny,62,62,0,1,0,1,0
60297,50355,43890,0,0,deny,66,66,0,1,0,1,0
60298,16387,35308,0,0,deny,60,60,0,1,0,1,0
60299,16387,56995,0,0,deny,60,60,0,1,0,1,0
60300,6712,123,0,0,deny,90,90,0,1,0,1,0
60301,16524,22114,0,0,deny,62,62,0,1,0,1,0
60302,61524,23,0,0,deny,60,60,0,1,0,1,0
60303,51335,445,0,0,drop,70,70,0,1,0,1,0
60304,51334,445,0,0,drop,70,70,0,1,0,1,0
60305,5379,37965,0,0,deny,66,66,0,1,0,1,0
60306,38926,37965,0,0,deny,62,62,0,1,0,1,0
60307,1811,35440,0,0,deny,62,62,0,1,0,1,0
60308,1024,64147,0,0,deny,109,109,0,1,0,1,0
60309,51783,445,0,0,drop,66,66,0,1,0,1,0
60310,1284,50584,0,0,deny,66,66,0,1,0,1,0
60311,35269,61903,0,0,deny,145,145,0,1,0,1,0
60312,28584,37965,0,0,deny,62,62,0,1,0,1,0
60313,20844,64147,0,0,deny,66,66,0,1,0,1,0
60314,64788,43890,0,0,deny,66,66,0,1,0,1,0
60315,51782,445,0,0,drop,66,66,0,1,0,1,0
60316,51330,445,0,0,drop,70,70,0,1,0,1,0
60317,56368,445,0,0,drop,70,70,0,1,0,1,0
60318,13188,35440,0,0,deny,62,62,0,1,0,1,0
60319,56364,445,0,0,drop,70,70,0,1,0,1,0
60320,56361,445,0,0,drop,70,70,0,1,0,1,0
60321,56360,445,0,0,drop,70,70,0,1,0,1,0
60322,51329,445,0,0,drop,70,70,0,1,0,1,0
60323,51781,445,0,0,drop,66,66,0,1,0,1,0
60324,45941,23388,0,0,deny,60,60,0,1,0,1,0
60325,45941,23388,0,0,deny,60,60,0,1,0,1,0
60326,59523,37965,0,0,deny,62,62,0,1,0,1,0
60327,49516,35894,0,0,deny,62,62,0,1,0,1,0
60328,63433,57866,0,0,deny,62,62,0,1,0,1,0
60329,55618,56205,0,0,deny,62,62,0,1,0,1,0
60330,56354,445,0,0,drop,70,70,0,1,0,1,0
60331,56352,445,0,0,drop,70,70,0,1,0,1,0
60332,56351,445,0,0,drop,70,70,0,1,0,1,0
60333,56348,445,0,0,drop,70,70,0,1,0,1,0
60334,51324,445,0,0,drop,70,70,0,1,0,1,0
60335,57750,37965,0,0,deny,146,146,0,1,0,1,0
60336,39475,443,29487,443,allow,3310,2291,1019,17,16,10,7
60337,33968,443,15691,443,allow,10073,4379,5694,33,42,17,16
60338,50306,443,54494,443,allow,9889,2800,7089,28,82,17,11
60339,63750,63343,38388,63343,allow,66,66,0,2,8,2,0
60340,51731,39392,29228,39392,allow,66,66,0,1,5,1,0
60341,59738,443,4655,443,allow,510,164,346,2,31,1,1
60342,57849,443,35072,443,allow,11893,6064,5829,29,92,15,14
60343,39473,443,25041,443,allow,11226,3340,7886,28,16,16,12
60344,43071,80,63845,80,allow,808,480,328,13,158,9,4
60345,50696,80,3909,80,allow,55872,28838,27034,234,175,117,117
60346,47932,443,21603,443,allow,9467,2741,6726,24,20,15,9
60347,61622,80,61622,80,allow,48702,2799,45903,74,110,38,36
60348,38283,443,38283,443,allow,6981,948,6033,17,54,10,7
60349,50574,80,53098,80,allow,2734,1250,1484,16,15,10,6
60350,60391,47212,53433,47212,allow,258,70,188,4,8,2,2
60351,38085,443,1147,443,allow,78,78,0,1,5,1,0
60352,56964,53,45347,53,allow,267,87,180,4,54,2,2
60353,49465,443,57765,443,allow,11184,6821,4363,27,53,14,13
60354,123,123,62754,123,allow,184,94,90,2,30,1,1
60355,50692,80,35406,80,allow,57678,29714,27964,241,175,120,121
60356,52452,80,35444,80,allow,5582,591,4991,14,75,7,7
60357,50693,80,37544,80,allow,56849,29352,27497,239,175,120,119
60358,39477,443,24151,443,allow,3655,2308,1347,18,15,10,8
60359,60392,1134,52281,1134,allow,70,70,0,2,8,2,0
60360,61836,443,61836,443,allow,132180,4407,127773,146,75,51,95
60361,64530,53,55254,53,allow,261,87,174,4,45,2,2
60362,49523,53,10736,53,allow,728,96,632,2,30,1,1
60363,50695,80,60576,80,allow,58726,30286,28440,246,175,123,123
60364,56559,443,41687,443,allow,2723,1564,1159,15,17,9,6
60365,23317,443,22656,443,allow,2227,1018,1209,17,15,8,9
60366,57470,44224,31554,44224,allow,480,149,331,2,1200,1,1
60367,52454,80,19961,80,allow,2425,529,1896,11,75,6,5
60368,52065,80,16889,80,allow,81670,2359,79311,89,621,30,59
60369,50685,80,30111,80,allow,60374,30984,29390,250,175,123,127
60370,53112,29258,11040,29258,allow,70,70,0,2,8,2,0
60371,49171,443,1136,443,allow,15437,8368,7069,40,361,19,21
60372,51946,443,31314,443,allow,2666,1542,1124,17,17,9,8
60373,62111,443,62044,443,allow,3262,256,3006,9,121,4,5
60374,51749,1408,51950,1408,allow,70,70,0,1,5,1,0
60375,59737,53,18837,53,allow,382,164,218,2,31,1,1
60376,61340,443,7462,443,allow,31549,6352,25197,64,206,26,38
60377,56923,53,49262,53,allow,711,87,624,2,30,1,1
60378,56772,61424,18304,61424,allow,70,70,0,2,8,2,0
60379,39871,53,52816,53,allow,198,93,105,2,31,1,1
60380,30960,45683,56128,45683,allow,330,330,0,6,3609,6,0
60381,30960,45670,41313,45670,allow,462,462,0,8,3632,8,0
60382,61030,443,16792,443,allow,109010,37307,71703,152,895,62,90
60383,21365,23718,0,0,deny,62,62,0,1,0,1,0
60384,51773,445,0,0,drop,66,66,0,1,0,1,0
60385,51769,445,0,0,drop,66,66,0,1,0,1,0
60386,51768,445,0,0,drop,66,66,0,1,0,1,0
60387,51764,445,0,0,drop,66,66,0,1,0,1,0
60388,52514,23,0,0,deny,60,60,0,1,0,1,0
60389,28914,26296,0,0,deny,159,159,0,1,0,1,0
60390,51763,445,0,0,drop,66,66,0,1,0,1,0
60391,51762,445,0,0,drop,66,66,0,1,0,1,0
60392,51761,445,0,0,drop,66,66,0,1,0,1,0
60393,46495,4607,0,0,deny,60,60,0,1,0,1,0
60394,1182,23,0,0,deny,60,60,0,1,0,1,0
60395,61693,443,50704,443,allow,12203,3519,8684,65,18,35,30
60396,50689,80,10754,80,allow,54757,28216,26541,229,175,114,115
60397,50697,80,44763,80,allow,54775,28230,26545,230,175,115,115
60398,50582,80,62835,80,allow,53959,2683,51276,69,16,30,39
60399,31871,53,40960,53,allow,209,86,123,2,29,1,1
60400,64375,53,1918,53,allow,228,110,118,2,29,1,1
60401,57305,53,63466,53,allow,177,94,83,2,30,1,1
60402,55054,443,7526,443,allow,6903,1481,5422,33,612,12,21
60403,43214,443,49896,443,allow,1563663,41030,1522633,1538,40,479,1059
60404,56734,45086,42195,45086,allow,1640,460,1180,8,30,4,4
60405,50909,80,20271,80,allow,12826704,145724,12680980,10558,133,2024,8534
60406,50902,80,26223,80,allow,12578792,132594,12446198,10198,133,1845,8353
60407,52453,443,8871,443,allow,6650,950,5700,18,75,9,9
60408,51733,30688,11073,30688,allow,70,70,0,1,4,1,0
60409,53539,6881,61115,6881,allow,492,306,186,8,14,5,3
60410,42922,80,60551,80,allow,78,78,0,1,4,1,0
60411,52210,443,33908,443,allow,6294,1716,4578,27,23,16,11
60412,51604,443,37096,443,allow,7086,2173,4913,20,16,10,10
60413,57747,80,27520,80,allow,2754,1602,1152,17,22,9,8
60414,34760,443,55387,443,allow,70,70,0,1,4,1,0
60415,39948,5223,55367,5223,allow,5551,1338,4213,28,1323,11,17
60416,64882,53,49587,53,allow,279,126,153,2,30,1,1
60417,57470,8100,10100,8100,allow,3281,894,2387,14,1200,7,7
60418,49848,53,60109,53,allow,260,102,158,2,30,1,1
60419,60380,55125,31447,55125,allow,70,70,0,1,5,1,0
60420,60382,62582,16978,62582,allow,70,70,0,1,5,1,0
60421,51266,16103,3760,16103,allow,70,70,0,2,8,2,0
60422,60062,53,61702,53,allow,168,78,90,2,30,1,1
60423,38321,80,40490,80,allow,543,469,74,6,16,5,1
60424,64530,53,18888,53,allow,261,87,174,4,45,2,2
60425,64573,53,58393,53,allow,558,104,454,4,49,2,2
60426,60385,59696,6029,59696,allow,70,70,0,1,5,1,0
60427,43215,443,55751,443,allow,3245691,49693,3195998,2856,38,666,2190
60428,59016,443,23931,443,allow,12676,4222,8454,36,87,20,16
60429,50501,123,36469,123,allow,184,94,90,2,30,1,1
60430,49621,443,55607,443,allow,46983,4167,42816,66,44,28,38
60431,57305,53,33562,53,allow,177,94,83,2,30,1,1
60432,60895,443,6009,443,allow,9387,2961,6426,38,18,23,15
60433,9129,53,56648,53,allow,205,86,119,2,30,1,1
60434,59739,443,20531,443,allow,304,86,218,2,30,1,1
60435,12433,53,7842,53,allow,208,86,122,2,30,1,1
60436,55339,443,4853,443,allow,2552065,30474,2521591,2074,129,236,1838
60437,23560,53,25867,53,allow,219,86,133,2,30,1,1
60438,60381,26312,40513,26312,allow,70,70,0,1,5,1,0
60439,51734,59825,48074,59825,allow,70,70,0,1,5,1,0
60440,51582,443,29660,443,allow,9080,2186,6894,27,108,14,13
60441,62947,53,18275,53,allow,213,86,127,2,30,1,1
60442,55596,53,49236,53,allow,177,94,83,2,30,1,1
60443,51233,443,5696,443,allow,9925,2939,6986,30,46,17,13
60444,39640,53,64225,53,allow,168,78,90,2,30,1,1
60445,15503,42638,40530,42638,allow,1367,664,703,16,1200,9,7
60446,50908,80,37284,80,allow,14077960,171956,13906004,11755,133,2437,9318
60447,50694,80,5032,80,allow,54760,27837,26923,229,175,114,115
60448,52455,443,34682,443,allow,7356,1014,6342,20,75,10,10
60449,59419,80,51819,80,allow,3442,1672,1770,19,22,10,9
60450,36065,443,10379,443,allow,3171,1490,1681,22,21,12,10
60451,34856,443,47870,443,allow,7524,1903,5621,31,22,18,13
60452,51750,54567,18193,54567,allow,70,70,0,2,7,2,0
60453,46167,80,23731,80,allow,234,234,0,4,11,4,0
60454,57416,66,12942,66,allow,70,70,0,1,4,1,0
60455,7322,80,9945,80,allow,950,485,465,9,16,5,4
60456,50824,443,63186,443,allow,337727,11283,326444,367,208,126,241
60457,56964,53,17076,53,allow,267,87,180,4,53,2,2
60458,61837,443,61837,443,allow,18398,2360,16038,39,75,17,22
60459,47110,80,30489,80,allow,436,222,214,7,19,4,3
60460,50602,443,33341,443,allow,572966,109738,463228,1277,624,639,638
60461,33649,123,62077,123,allow,184,94,90,2,30,1,1
60462,65248,53,8659,53,allow,197,94,103,2,30,1,1
60463,64218,53,41220,53,allow,212,94,118,2,30,1,1
60464,49915,53,47403,53,allow,225,102,123,2,30,1,1
60465,34285,53,45642,53,allow,168,78,90,2,30,1,1
60466,51798,80,50477,80,allow,1825,824,1001,21,134,11,10
60467,56661,53,1967,53,allow,900,110,790,2,30,1,1
60468,48362,443,23544,443,allow,8075,1766,6309,22,78,13,9
60469,57165,53,9169,53,allow,216,102,114,2,30,1,1
60470,41882,53,0,0,allow,86,86,0,1,29,1,0
60471,28481,53,51837,53,allow,205,86,119,2,30,1,1
60472,59740,53,42403,53,allow,304,86,218,2,30,1,1
60473,52495,443,27354,443,allow,787462,10645,776817,653,131,87,566
60474,59727,443,28777,443,allow,304,86,218,2,31,1,1
60475,59725,443,21996,443,allow,304,86,218,2,31,1,1
60476,37965,40840,26004,40840,allow,150,150,0,1,1199,1,0
60477,49501,443,35522,443,allow,13077,4380,8697,34,1881,17,17
60478,59731,443,4869,443,allow,384,166,218,2,31,1,1
60479,51732,54299,38142,54299,allow,70,70,0,1,5,1,0
60480,52907,80,17763,80,allow,1659,653,1006,10,16,6,4
60481,44929,443,44929,443,allow,5469,2222,3247,22,38,13,9
60482,41811,443,11732,443,allow,28899,3134,25765,66,271,32,34
60483,59742,53,55013,53,allow,448,166,282,2,30,1,1
60484,56207,53,30514,53,allow,260,102,158,2,30,1,1
60485,39039,443,46475,443,allow,3159,1237,1922,14,19,8,6
60486,56773,28093,5962,28093,allow,70,70,0,2,8,2,0
60487,53220,80,25607,80,allow,17976,840,17136,21,16,6,15
60488,56964,53,61136,53,allow,267,87,180,4,59,2,2
60489,59741,443,12538,443,allow,384,166,218,2,30,1,1
60490,54743,443,47896,443,allow,166136,7244,158892,202,149,76,126
60491,52784,443,47288,443,allow,2802,1626,1176,18,72,9,9
60492,64720,53,3807,53,allow,216,102,114,2,30,1,1
60493,60044,443,17036,443,allow,15769,1619,14150,17,141,4,13
60494,53069,443,18651,443,allow,13074,8472,4602,31,135,16,15
60495,36936,443,13188,443,allow,490,210,280,8,131,4,4
60496,36934,443,62872,443,allow,490,210,280,8,131,4,4
60497,63171,5228,60967,5228,allow,3535,1973,1562,36,3961,18,18
60498,62110,443,43597,443,allow,10390,3051,7339,16,121,6,10
60499,53562,8999,49942,8999,allow,320,140,180,6,6,3,3
60500,53540,34134,25153,34134,allow,70,70,0,1,5,1,0
60501,50609,80,26280,80,allow,4163,2891,1272,17,17,9,8
60502,50691,80,17442,80,allow,55050,28089,26961,228,175,112,116
60503,42451,443,55087,443,allow,4886,895,3991,16,31,9,7
60504,57264,53,9791,53,allow,214,102,112,2,30,1,1
60505,50112,123,33230,123,allow,184,94,90,2,30,1,1
60506,52493,443,57807,443,allow,32907,8900,24007,38,16,16,22
60507,64530,53,39688,53,allow,261,87,174,4,46,2,2
60508,63733,47013,29294,47013,allow,70,70,0,1,5,1,0
60509,39486,80,4046,80,allow,1184,524,660,7,78,4,3
60510,63530,3389,63530,3389,allow,3489,1534,1955,17,19,9,8
60511,50482,443,21793,443,allow,2520,1267,1253,17,83,9,8
60512,50481,443,21430,443,allow,1258,716,542,13,83,7,6
60513,50684,80,24128,80,allow,57576,29602,27974,239,175,118,121
60514,53214,80,58168,80,allow,19877,856,19021,22,16,6,16
60515,123,123,8140,123,allow,184,94,90,2,30,1,1
60516,56378,53,11573,53,allow,214,102,112,2,30,1,1
60517,123,123,42021,123,allow,184,94,90,2,30,1,1
60518,55704,53,11582,53,allow,260,102,158,2,30,1,1
60519,59733,53,57614,53,allow,384,166,218,2,30,1,1
60520,49777,443,42531,443,allow,35152,27056,8096,56,104,31,25
60521,53556,1024,53867,1024,allow,70,70,0,2,8,2,0
60522,63732,40642,2876,40642,allow,70,70,0,1,5,1,0
60523,50703,80,3596,80,allow,54304,27807,26497,227,175,113,114
60524,50978,80,46474,80,allow,1442,700,742,12,35,6,6
60525,2980,53,2980,53,allow,216,90,126,2,30,1,1
60526,62113,443,7270,443,allow,3262,256,3006,9,121,4,5
60527,33109,443,18483,443,allow,6749,1593,5156,23,123,12,11
60528,62865,443,23097,443,allow,21313,7245,14068,48,128,22,26
60529,56345,445,0,0,drop,70,70,0,1,0,1,0
60530,56343,445,0,0,drop,70,70,0,1,0,1,0
60531,56342,445,0,0,drop,70,70,0,1,0,1,0
60532,51948,37965,0,0,deny,62,62,0,1,0,1,0
60533,51759,445,0,0,drop,66,66,0,1,0,1,0
60534,52401,623,0,0,deny,60,60,0,1,0,1,0
60535,56339,445,0,0,drop,70,70,0,1,0,1,0
60536,51755,445,0,0,drop,66,66,0,1,0,1,0
60537,51311,445,0,0,drop,70,70,0,1,0,1,0
60538,57165,34101,0,0,deny,66,66,0,1,0,1,0
60539,51753,445,0,0,drop,66,66,0,1,0,1,0
60540,51752,445,0,0,drop,66,66,0,1,0,1,0
60541,5180,57866,0,0,deny,62,62,0,1,0,1,0
60542,53298,26467,0,0,deny,66,66,0,1,0,1,0
60543,49501,11392,0,0,deny,62,62,0,1,0,1,0
60544,51749,445,0,0,drop,66,66,0,1,0,1,0
60545,51308,445,0,0,drop,70,70,0,1,0,1,0
60546,59315,35440,0,0,deny,66,66,0,1,0,1,0
60547,5223,5025,0,0,deny,220,220,0,1,0,1,0
60548,6916,9822,0,0,deny,100,100,0,1,0,1,0
60549,56335,445,0,0,drop,70,70,0,1,0,1,0
60550,52650,36237,0,0,deny,62,62,0,1,0,1,0
60551,56330,445,0,0,drop,70,70,0,1,0,1,0
60552,56324,445,0,0,drop,70,70,0,1,0,1,0
60553,55286,37965,0,0,deny,66,66,0,1,0,1,0
60554,17177,64147,0,0,deny,62,62,0,1,0,1,0
60555,29682,44847,0,0,deny,62,62,0,1,0,1,0
60556,62148,37965,0,0,deny,62,62,0,1,0,1,0
60557,51304,445,0,0,drop,70,70,0,1,0,1,0
60558,51829,36134,0,0,deny,66,66,0,1,0,1,0
60559,51302,445,0,0,drop,70,70,0,1,0,1,0
60560,21998,51221,0,0,deny,62,62,0,1,0,1,0
60561,51737,445,0,0,drop,66,66,0,1,0,1,0
60562,51300,445,0,0,drop,70,70,0,1,0,1,0
60563,4910,2149,0,0,deny,66,66,0,1,0,1,0
60564,8999,50432,0,0,deny,62,62,0,1,0,1,0
60565,42128,54532,0,0,deny,60,60,0,1,0,1,0
60566,36538,64147,0,0,deny,62,62,0,1,0,1,0
60567,4594,35993,0,0,deny,66,66,0,1,0,1,0
60568,45941,23386,0,0,deny,60,60,0,1,0,1,0
60569,62392,15503,0,0,deny,146,146,0,1,0,1,0
60570,12471,31573,0,0,deny,62,62,0,1,0,1,0
60571,51730,445,0,0,drop,66,66,0,1,0,1,0
60572,28832,36237,0,0,deny,62,62,0,1,0,1,0
60573,56311,445,0,0,drop,70,70,0,1,0,1,0
60574,64776,50584,0,0,deny,66,66,0,1,0,1,0
60575,1025,64147,0,0,deny,62,62,0,1,0,1,0
60576,51293,445,0,0,drop,70,70,0,1,0,1,0
60577,51727,445,0,0,drop,66,66,0,1,0,1,0
60578,51291,445,0,0,drop,70,70,0,1,0,1,0
60579,25565,54864,0,0,deny,60,60,0,1,0,1,0
60580,52676,53733,0,0,deny,66,66,0,1,0,1,0
60581,57837,64147,0,0,deny,62,62,0,1,0,1,0
60582,51290,445,0,0,drop,70,70,0,1,0,1,0
60583,51289,445,0,0,drop,70,70,0,1,0,1,0
60584,51720,445,0,0,drop,66,66,0,1,0,1,0
60585,51288,445,0,0,drop,70,70,0,1,0,1,0
60586,63379,36237,0,0,deny,66,66,0,1,0,1,0
60587,20650,26467,0,0,deny,66,66,0,1,0,1,0
60588,51286,445,0,0,drop,70,70,0,1,0,1,0
60589,51283,445,0,0,drop,70,70,0,1,0,1,0
60590,58849,64147,0,0,deny,62,62,0,1,0,1,0
60591,51713,445,0,0,drop,66,66,0,1,0,1,0
60592,58486,57470,0,0,deny,66,66,0,1,0,1,0
60593,9067,44847,0,0,deny,62,62,0,1,0,1,0
60594,41908,1433,0,0,deny,60,60,0,1,0,1,0
60595,53743,443,64755,443,allow,495,421,74,4,1,3,1
60596,51270,445,0,0,drop,70,70,0,1,0,1,0
60597,51268,445,0,0,drop,70,70,0,1,0,1,0
60598,52439,35894,0,0,deny,74,74,0,1,0,1,0
60599,51264,445,0,0,drop,70,70,0,1,0,1,0
60600,51260,445,0,0,drop,70,70,0,1,0,1,0
60601,51259,445,0,0,drop,70,70,0,1,0,1,0
60602,52135,2790,0,0,deny,66,66,0,1,0,1,0
60603,56303,445,0,0,drop,70,70,0,1,0,1,0
60604,56301,445,0,0,drop,70,70,0,1,0,1,0
60605,56299,445,0,0,drop,70,70,0,1,0,1,0
60606,4041,50584,0,0,deny,62,62,0,1,0,1,0
60607,51702,445,0,0,drop,66,66,0,1,0,1,0
60608,51704,445,0,0,drop,66,66,0,1,0,1,0
60609,51701,445,0,0,drop,66,66,0,1,0,1,0
60610,51699,445,0,0,drop,66,66,0,1,0,1,0
60611,51697,445,0,0,drop,66,66,0,1,0,1,0
60612,51705,445,0,0,drop,66,66,0,1,0,1,0
60613,51700,445,0,0,drop,66,66,0,1,0,1,0
60614,51698,445,0,0,drop,66,66,0,1,0,1,0
60615,51085,56205,0,0,deny,66,66,0,1,0,1,0
60616,27084,50584,0,0,deny,66,66,0,1,0,1,0
60617,60184,37965,0,0,deny,66,66,0,1,0,1,0
60618,3352,50584,0,0,deny,62,62,0,1,0,1,0
60619,51248,445,0,0,drop,70,70,0,1,0,1,0
60620,64024,57470,0,0,deny,66,66,0,1,0,1,0
60621,64341,57470,0,0,deny,62,62,0,1,0,1,0
60622,54305,35440,0,0,deny,62,62,0,1,0,1,0
60623,7889,48817,0,0,deny,146,146,0,1,0,1,0
60624,52208,43890,0,0,deny,66,66,0,1,0,1,0
60625,56298,445,0,0,drop,70,70,0,1,0,1,0
60626,56292,445,0,0,drop,70,70,0,1,0,1,0
60627,56285,445,0,0,drop,70,70,0,1,0,1,0
60628,14397,37965,0,0,deny,62,62,0,1,0,1,0
60629,51685,445,0,0,drop,66,66,0,1,0,1,0
60630,51684,445,0,0,drop,66,66,0,1,0,1,0
60631,51682,445,0,0,drop,66,66,0,1,0,1,0
60632,3802,55777,0,0,deny,66,66,0,1,0,1,0
60633,31845,55777,0,0,deny,62,62,0,1,0,1,0
60634,50292,62413,0,0,deny,146,146,0,1,0,1,0
60635,51244,445,0,0,drop,70,70,0,1,0,1,0
60636,56282,445,0,0,drop,70,70,0,1,0,1,0
60637,45941,23388,0,0,deny,60,60,0,1,0,1,0
60638,56279,445,0,0,drop,70,70,0,1,0,1,0
60639,51235,445,0,0,drop,70,70,0,1,0,1,0
60640,51233,445,0,0,drop,70,70,0,1,0,1,0
60641,56278,445,0,0,drop,70,70,0,1,0,1,0
60642,56269,445,0,0,drop,70,70,0,1,0,1,0
60643,56267,445,0,0,drop,70,70,0,1,0,1,0
60644,51229,445,0,0,drop,70,70,0,1,0,1,0
60645,51231,445,0,0,drop,70,70,0,1,0,1,0
60646,1114,37965,0,0,deny,62,62,0,1,0,1,0
60647,51227,445,0,0,drop,70,70,0,1,0,1,0
60648,1024,44847,0,0,deny,146,146,0,1,0,1,0
60649,55749,37965,0,0,deny,66,66,0,1,0,1,0
60650,59411,37965,0,0,deny,66,66,0,1,0,1,0
60651,53300,37807,0,0,deny,66,66,0,1,0,1,0
60652,51745,30188,0,0,deny,66,66,0,1,0,1,0
60653,22541,64147,0,0,deny,66,66,0,1,0,1,0
60654,10003,64147,0,0,deny,62,62,0,1,0,1,0
60655,8999,49001,0,0,deny,146,146,0,1,0,1,0
60656,57360,18375,0,0,deny,66,66,0,1,0,1,0
60657,51222,445,0,0,drop,70,70,0,1,0,1,0
60658,32710,22114,0,0,deny,62,62,0,1,0,1,0
60659,56262,445,0,0,drop,70,70,0,1,0,1,0
60660,56259,445,0,0,drop,70,70,0,1,0,1,0
60661,56255,445,0,0,drop,70,70,0,1,0,1,0
60662,62970,44847,0,0,deny,62,62,0,1,0,1,0
60663,53542,9192,0,0,deny,148,148,0,1,0,1,0
60664,25091,64147,0,0,deny,66,66,0,1,0,1,0
60665,52519,44847,0,0,deny,66,66,0,1,0,1,0
60666,25602,64147,0,0,deny,62,62,0,1,0,1,0
60667,1749,64147,0,0,deny,66,66,0,1,0,1,0
60668,51214,445,0,0,drop,70,70,0,1,0,1,0
60669,51212,445,0,0,drop,70,70,0,1,0,1,0
60670,53960,30041,0,0,deny,62,62,0,1,0,1,0
60671,25772,7302,0,0,deny,66,66,0,1,0,1,0
60672,54894,9571,0,0,deny,66,66,0,1,0,1,0
60673,11967,57470,0,0,deny,62,62,0,1,0,1,0
60674,55413,37965,0,0,deny,66,66,0,1,0,1,0
60675,10586,37965,0,0,deny,62,62,0,1,0,1,0
60676,51661,445,0,0,drop,66,66,0,1,0,1,0
60677,56279,23,0,0,deny,60,60,0,1,0,1,0
60678,56251,445,0,0,drop,70,70,0,1,0,1,0
60679,56246,445,0,0,drop,70,70,0,1,0,1,0
60680,51207,445,0,0,drop,70,70,0,1,0,1,0
60681,61185,54532,0,0,deny,62,62,0,1,0,1,0
60682,51206,445,0,0,drop,70,70,0,1,0,1,0
60683,61185,54532,0,0,deny,145,145,0,1,0,1,0
60684,2522,64147,0,0,deny,62,62,0,1,0,1,0
60685,51151,64147,0,0,deny,66,66,0,1,0,1,0
60686,51202,445,0,0,drop,70,70,0,1,0,1,0
60687,49744,80,36258,80,allow,2455,475,1980,9,81,5,4
60688,50478,443,64929,443,allow,36345,2308,34037,52,83,23,29
60689,52494,443,23008,443,allow,5782,1008,4774,17,15,8,9
60690,64663,53,18610,53,allow,578,286,292,9,15,5,4
60691,51139,80,1947,80,allow,124,64,60,2,15,1,1
60692,49841,80,51896,80,allow,3126,469,2657,9,75,5,4
60693,39474,443,60202,443,allow,9766,2050,7716,23,15,12,11
60694,30960,45679,3682,45679,allow,396,396,0,7,3615,7,0
60695,48817,6881,48817,6881,allow,490,149,341,2,1200,1,1
60696,61696,443,54803,443,allow,9097,2123,6974,25,16,15,10
60697,44910,443,16825,443,allow,2841,1916,925,18,26,10,8
60698,50700,80,20685,80,allow,55825,28792,27033,234,174,117,117
60699,54033,443,51149,443,allow,43491,8521,34970,69,50,34,35
60700,50698,80,42687,80,allow,54871,28320,26551,231,174,116,115
60701,50690,80,44292,80,allow,56951,28706,28245,236,174,116,120
60702,24208,53,24208,53,allow,231,88,143,2,32,1,1
60703,56769,11155,9985,11155,allow,70,70,0,2,8,2,0
60704,50702,80,54989,80,allow,55224,28254,26970,230,174,114,116
60705,22680,443,22680,443,allow,18490,7811,10679,47,81,27,20
60706,55596,53,61686,53,allow,170,87,83,2,30,1,1
60707,53533,22642,24303,22642,allow,612,306,306,10,16,5,5
60708,60521,443,45323,443,allow,45001,3799,41202,74,331,35,39
60709,39472,443,61496,443,allow,9767,2138,7629,22,16,12,10
60710,43014,53,60826,53,allow,198,93,105,2,30,1,1
60711,59729,53,2967,53,allow,303,85,218,2,30,1,1
60712,56321,443,18769,443,allow,4704,2423,2281,16,135,8,8
60713,53557,39731,46000,39731,allow,70,70,0,2,8,2,0
60714,51378,3027,51378,3027,allow,156,156,0,3,8,3,0
60715,50477,443,35054,443,allow,2604,1413,1191,15,83,9,6
60716,51357,80,45603,80,allow,124,64,60,2,16,1,1
60717,59730,443,46246,443,allow,303,85,218,2,30,1,1
60718,44654,80,35775,80,allow,2121,1558,563,13,16,7,6
60719,56704,53,33003,53,allow,711,87,624,2,30,1,1
60720,51655,445,0,0,drop,66,66,0,1,0,1,0
60721,21492,51505,0,0,deny,62,62,0,1,0,1,0
60722,51653,445,0,0,drop,66,66,0,1,0,1,0
60723,993,4281,0,0,deny,66,66,0,1,0,1,0
60724,56239,445,0,0,drop,70,70,0,1,0,1,0
60725,51200,445,0,0,drop,70,70,0,1,0,1,0
60726,61013,41705,0,0,deny,66,66,0,1,0,1,0
60727,49711,14984,0,0,deny,66,66,0,1,0,1,0
60728,56237,445,0,0,drop,70,70,0,1,0,1,0
60729,56234,445,0,0,drop,70,70,0,1,0,1,0
60730,56232,445,0,0,drop,70,70,0,1,0,1,0
60731,7842,23,0,0,deny,60,60,0,1,0,1,0
60732,51651,445,0,0,drop,66,66,0,1,0,1,0
60733,6666,3389,0,0,deny,60,60,0,1,0,1,0
60734,38484,48637,0,0,deny,60,60,0,1,0,1,0
60735,51105,50584,0,0,deny,66,66,0,1,0,1,0
60736,53233,51221,0,0,deny,66,66,0,1,0,1,0
60737,62331,61689,0,0,deny,62,62,0,1,0,1,0
60738,35957,51185,0,0,deny,60,60,0,1,0,1,0
60739,50994,35974,0,0,deny,60,60,0,1,0,1,0
60740,51196,445,0,0,drop,70,70,0,1,0,1,0
60741,56225,445,0,0,drop,70,70,0,1,0,1,0
60742,42745,50011,0,0,deny,62,62,0,1,0,1,0
60743,56224,445,0,0,drop,70,70,0,1,0,1,0
60744,56222,445,0,0,drop,70,70,0,1,0,1,0
60745,56220,445,0,0,drop,70,70,0,1,0,1,0
60746,62338,50011,0,0,deny,66,66,0,1,0,1,0
60747,51643,445,0,0,drop,66,66,0,1,0,1,0
60748,30598,46824,0,0,deny,62,62,0,1,0,1,0
60749,51641,445,0,0,drop,66,66,0,1,0,1,0
60750,51640,445,0,0,drop,66,66,0,1,0,1,0
60751,51639,445,0,0,drop,66,66,0,1,0,1,0
60752,20371,35440,0,0,deny,62,62,0,1,0,1,0
60753,51634,445,0,0,drop,66,66,0,1,0,1,0
60754,51632,445,0,0,drop,66,66,0,1,0,1,0
60755,51633,445,0,0,drop,66,66,0,1,0,1,0
60756,52910,51221,0,0,deny,78,78,0,1,0,1,0
60757,52975,23718,0,0,deny,66,66,0,1,0,1,0
60758,50422,50584,0,0,deny,66,66,0,1,0,1,0
60759,50734,37965,0,0,deny,62,62,0,1,0,1,0
60760,56703,50584,0,0,deny,66,66,0,1,0,1,0
60761,56218,445,0,0,drop,70,70,0,1,0,1,0
60762,11582,41599,40027,41599,allow,70,70,0,1,5,1,0
60763,51643,80,38570,80,allow,499,192,307,6,38,4,2
60764,49836,53,62893,53,allow,168,78,90,2,30,1,1
60765,6881,19215,41309,19215,allow,509,150,359,2,1199,1,1
60766,50699,80,28391,80,allow,54318,27824,26494,227,174,113,114
60767,34692,443,49759,443,allow,3386,1833,1553,17,255,9,8
60768,63734,28221,28610,28221,allow,70,70,0,1,4,1,0
60769,53536,34200,55165,34200,allow,70,70,0,1,4,1,0
60770,50662,443,7273,443,allow,4606,3263,1343,19,304,10,9
60771,65426,443,27740,443,allow,14205,1527,12678,13,145,2,11
60772,59379,443,58325,443,allow,4518,1784,2734,30,23,15,15
60773,53213,80,60340,80,allow,18040,904,17136,22,15,7,15
60774,51657,80,10496,80,allow,318,192,126,6,37,4,2
60775,49565,443,37074,443,allow,378,192,186,7,14,4,3
60776,53563,17355,37621,17355,allow,320,140,180,6,5,3,3
60777,14422,443,38791,443,allow,1857,1218,639,18,95,11,7
60778,51658,80,29469,80,allow,318,192,126,6,37,4,2
60779,56770,52920,52041,52920,allow,70,70,0,2,8,2,0
60780,53559,58968,7595,58968,allow,70,70,0,2,7,2,0
60781,51645,80,57006,80,allow,318,192,126,6,38,4,2
60782,51632,80,60453,80,allow,502,256,246,9,39,5,4
60783,55878,53,24199,53,allow,260,102,158,2,29,1,1
60784,59736,53,9602,53,allow,571,166,405,2,29,1,1
60785,59735,443,11235,443,allow,512,166,346,2,29,1,1
60786,55596,53,19558,53,allow,177,94,83,2,30,1,1
60787,56046,53,22169,53,allow,289,160,129,3,29,2,1
60788,62112,443,63604,443,allow,4655,1649,3006,10,120,5,5
60789,56732,10271,46976,10271,allow,3090,1706,1384,16,30,10,6
60790,51650,80,16811,80,allow,312,192,120,6,37,4,2
60791,51635,80,49291,80,allow,318,192,126,6,39,4,2
60792,56665,53,16180,53,allow,216,102,114,2,30,1,1
60793,56546,53,5266,53,allow,177,94,83,2,30,1,1
60794,56060,53,26992,53,allow,224,102,122,2,30,1,1
60795,64945,53,32076,53,allow,733,94,639,2,30,1,1
60796,51654,80,46130,80,allow,318,192,126,6,37,4,2
60797,48297,443,9986,443,allow,7320,1817,5503,41,106,16,25
60798,53715,443,59918,443,allow,70,70,0,1,5,1,0
60799,53111,50809,36816,50809,allow,70,70,0,2,8,2,0
60800,56600,80,32176,80,allow,234,234,0,4,12,4,0
60801,46415,443,41654,443,allow,9307,2265,7042,31,325,13,18
60802,36676,443,44727,443,allow,7636,3367,4269,24,319,13,11
60803,51634,80,59507,80,allow,378,192,186,7,39,4,3
60804,59166,123,2980,123,allow,184,94,90,2,30,1,1
60805,56912,53,43272,53,allow,216,94,122,2,30,1,1
60806,35688,53,49808,53,allow,199,94,105,2,30,1,1
60807,47302,53,19968,53,allow,168,78,90,2,30,1,1
60808,33196,53,25269,53,allow,181,86,95,2,30,1,1
60809,53864,53,19118,53,allow,168,78,90,2,30,1,1
60810,56546,53,1301,53,allow,177,94,83,2,30,1,1
60811,36932,443,8229,443,allow,280,140,140,5,130,3,2
60812,39458,443,56911,443,allow,1053,566,487,10,31,6,4
60813,51647,80,60876,80,allow,378,192,186,7,38,4,3
60814,51444,443,44166,443,allow,7658,1309,6349,24,75,13,11
60815,49723,80,53474,80,allow,2367,557,1810,10,82,6,4
60816,39310,53,33057,53,allow,199,94,105,2,30,1,1
60817,63628,53,35423,53,allow,289,86,203,2,30,1,1
60818,53772,53,7783,53,allow,70,70,0,1,30,1,0
60819,56920,53,48525,53,allow,184,78,106,2,30,1,1
60820,51646,80,56559,80,allow,378,192,186,7,38,4,3
60821,50483,443,29109,443,allow,10050,1192,8858,28,81,14,14
60822,65371,443,38245,443,allow,34653,2523,32130,65,83,26,39
60823,51653,80,24193,80,allow,454,262,192,8,37,5,3
60824,29176,7000,29176,7000,allow,4731,2270,2461,18,15,10,8
60825,54418,443,37950,443,allow,3350,1804,1546,19,255,10,9
60826,48000,443,53560,443,allow,7193,1890,5303,22,37,15,7
60827,40360,443,31288,443,allow,3146,766,2380,10,120,5,5
60828,52965,443,12004,443,allow,8602,1050,7552,16,120,7,9
60829,10976,22,10976,22,allow,9240,3413,5827,59,37,26,33
60830,51637,80,27014,80,allow,378,192,186,7,39,4,3
60831,39532,443,10682,443,allow,345779,9537,336242,359,26,123,236
60832,35710,443,47207,443,allow,1053,566,487,10,31,6,4
60833,30188,59035,2297,59035,allow,1794,750,1044,12,4220,6,6
60834,53462,443,47212,443,allow,6384,1091,5293,18,30,10,8
60835,35897,443,1439,443,allow,6692,1642,5050,24,275,11,13
60836,51659,80,25484,80,allow,318,192,126,6,37,4,2
60837,51102,443,49198,443,allow,3402,1258,2144,13,135,6,7
60838,50014,80,33183,80,allow,810,670,140,6,34,4,2
60839,51652,80,59640,80,allow,454,262,192,8,37,5,3
60840,51644,80,3834,80,allow,499,192,307,6,38,4,2
60841,50064,443,33198,443,allow,6376,2499,3877,20,16,10,10
60842,60195,80,26973,80,allow,3059,1869,1190,17,105,13,4
60843,51655,80,54219,80,allow,318,192,126,6,37,4,2
60844,64530,53,20478,53,allow,261,87,174,4,44,2,2
60845,35422,443,35422,443,allow,5172,1925,3247,22,39,13,9
60846,39983,80,39983,80,allow,6416,997,5419,17,30,8,9
60847,51636,80,6805,80,allow,318,192,126,6,39,4,2
60848,52735,443,43904,443,allow,41870,3567,38303,68,15,34,34
60849,53553,2297,8843,2297,allow,70,70,0,2,7,2,0
60850,53215,443,56280,443,allow,6983,1629,5354,17,15,9,8
60851,52064,80,62647,80,allow,65658,3155,62503,76,621,26,50
60852,60393,46347,14352,46347,allow,320,140,180,6,7,3,3
60853,51638,80,60451,80,allow,318,192,126,6,39,4,2
60854,55596,53,2008,53,allow,177,94,83,2,29,1,1
60855,48006,443,61488,443,allow,1429,1295,134,10,30,8,2
60856,51497,443,32306,443,allow,4710,699,4011,12,15,8,4
60857,53566,80,56289,80,allow,2270749,47314,2223435,2132,99,651,1481
60858,58711,53,20725,53,allow,277,78,199,2,30,1,1
60859,65235,53,39902,53,allow,216,94,122,2,30,1,1
60860,59734,443,60915,443,allow,512,166,346,2,29,1,1
60861,59178,53,27947,53,allow,260,86,174,2,30,1,1
60862,59732,53,64408,53,allow,384,166,218,2,30,1,1
60863,57629,443,51109,443,allow,14555,5048,9507,82,134,33,49
60864,55877,47528,12404,47528,allow,491,150,341,2,1200,1,1
60865,59728,53,43809,53,allow,304,86,218,2,30,1,1
60866,59726,53,53950,53,allow,304,86,218,2,30,1,1
60867,44979,443,39259,443,allow,10311,2186,8125,26,186,14,12
60868,41039,443,10141,443,allow,1053,566,487,10,31,6,4
60869,58046,443,22923,443,allow,1536,1089,447,11,56,7,4
60870,56421,53,8309,53,allow,177,94,83,2,30,1,1
60871,49160,51413,10192,51413,allow,800,150,650,4,1200,2,2
60872,44404,443,27524,443,allow,9060,3523,5537,27,319,15,12
60873,51633,80,4651,80,allow,502,256,246,9,39,5,4
60874,46236,53,38054,53,allow,199,94,105,2,30,1,1
60875,56261,53,65402,53,allow,199,94,105,2,30,1,1
60876,11295,40033,17184,40033,allow,156,94,62,2,30,1,1
60877,49872,53,15358,53,allow,216,94,122,2,30,1,1
60878,51640,80,25604,80,allow,2895,1428,1467,12,38,7,5
60879,52657,80,31996,80,allow,26073,2868,23205,41,110,17,24
60880,51656,80,3808,80,allow,318,192,126,6,37,4,2
60881,56771,43648,30018,43648,allow,70,70,0,2,8,2,0
60882,50479,443,28335,443,allow,1654,1011,643,16,82,9,7
60883,59724,53,63001,53,allow,304,86,218,2,30,1,1
60884,59723,443,40207,443,allow,304,86,218,2,30,1,1
60885,57173,53,39121,53,allow,168,78,90,2,30,1,1
60886,55008,53,19602,53,allow,215,102,113,2,30,1,1
60887,46970,443,52704,443,allow,8394,3155,5239,28,271,16,12
60888,51221,65264,24402,65264,allow,870,330,540,12,1573,6,6
60889,63744,47106,38855,47106,allow,66,66,0,2,8,2,0
60890,60740,80,7735,80,allow,254,128,126,5,16,3,2
60891,65109,53,42813,53,allow,229,102,127,2,30,1,1
60892,56759,53,36247,53,allow,733,94,639,2,31,1,1
60893,50353,443,35772,443,allow,7397,1784,5613,27,306,13,14
60894,63741,36776,34457,36776,allow,66,66,0,2,8,2,0
60895,57076,5222,34364,5222,allow,15600,7789,7811,155,169,82,73
60896,51198,443,22207,443,allow,8075,2723,5352,42,117,24,18
60897,57880,80,31507,80,allow,13028,3246,9782,29,30,16,13
60898,7068,53,7068,53,allow,197,90,107,2,30,1,1
60899,35132,53,35132,53,allow,469,165,304,4,31,2,2
60900,51514,443,43958,443,allow,2188,1329,859,23,19,13,10
60901,58701,27030,9286,27030,allow,70,70,0,1,5,1,0
60902,65388,80,37790,80,allow,1498,392,1106,10,16,5,5
60903,51466,443,4846,443,allow,1878,1050,828,9,16,5,4
60904,49923,53,8519,53,allow,702,194,508,6,67,3,3
60905,53785,53,12230,53,allow,167,78,89,2,31,1,1
60906,56215,445,0,0,drop,70,70,0,1,0,1,0
60907,56212,445,0,0,drop,70,70,0,1,0,1,0
60908,45964,7778,0,0,deny,60,60,0,1,0,1,0
60909,51183,445,0,0,drop,70,70,0,1,0,1,0
60910,63583,37965,0,0,deny,66,66,0,1,0,1,0
60911,51191,26467,0,0,deny,66,66,0,1,0,1,0
60912,51628,445,0,0,drop,66,66,0,1,0,1,0
60913,30599,46824,0,0,deny,66,66,0,1,0,1,0
60914,56211,445,0,0,drop,70,70,0,1,0,1,0
60915,53030,56205,0,0,deny,66,66,0,1,0,1,0
60916,51625,445,0,0,drop,66,66,0,1,0,1,0
60917,60960,49049,0,0,deny,66,66,0,1,0,1,0
60918,62930,21247,0,0,deny,66,66,0,1,0,1,0
60919,51623,445,0,0,drop,66,66,0,1,0,1,0
60920,51622,445,0,0,drop,66,66,0,1,0,1,0
60921,51180,445,0,0,drop,70,70,0,1,0,1,0
60922,2904,44847,0,0,deny,78,78,0,1,0,1,0
60923,46116,51505,0,0,deny,62,62,0,1,0,1,0
60924,51619,445,0,0,drop,66,66,0,1,0,1,0
60925,21294,57470,0,0,deny,62,62,0,1,0,1,0
60926,46849,36237,0,0,deny,66,66,0,1,0,1,0
60927,64219,51050,0,0,deny,66,66,0,1,0,1,0
60928,48815,22114,0,0,deny,146,146,0,1,0,1,0
60929,14084,43890,0,0,deny,62,62,0,1,0,1,0
60930,37234,44847,0,0,deny,62,62,0,1,0,1,0
60931,56206,445,0,0,drop,70,70,0,1,0,1,0
60932,51176,445,0,0,drop,70,70,0,1,0,1,0
60933,39823,36237,0,0,deny,66,66,0,1,0,1,0
60934,51174,445,0,0,drop,70,70,0,1,0,1,0
60935,56200,445,0,0,drop,70,70,0,1,0,1,0
60936,56192,445,0,0,drop,70,70,0,1,0,1,0
60937,1987,26467,0,0,deny,62,62,0,1,0,1,0
60938,11716,37965,0,0,deny,62,62,0,1,0,1,0
60939,10736,6112,0,0,deny,60,60,0,1,0,1,0
60940,51172,445,0,0,drop,70,70,0,1,0,1,0
60941,6666,8530,0,0,deny,60,60,0,1,0,1,0
60942,51608,445,0,0,drop,66,66,0,1,0,1,0
60943,34916,51185,0,0,deny,62,62,0,1,0,1,0
60944,51601,445,0,0,drop,66,66,0,1,0,1,0
60945,60923,49903,0,0,deny,66,66,0,1,0,1,0
60946,51165,445,0,0,drop,70,70,0,1,0,1,0
60947,56183,445,0,0,drop,70,70,0,1,0,1,0
60948,35657,48637,0,0,deny,62,62,0,1,0,1,0
60949,25523,35974,0,0,deny,62,62,0,1,0,1,0
60950,48478,49903,0,0,deny,62,62,0,1,0,1,0
60951,51163,445,0,0,drop,70,70,0,1,0,1,0
60952,33405,37965,0,0,deny,62,62,0,1,0,1,0
60953,51599,445,0,0,drop,66,66,0,1,0,1,0
60954,58715,57470,0,0,deny,62,62,0,1,0,1,0
60955,51162,445,0,0,drop,70,70,0,1,0,1,0
60956,51161,445,0,0,drop,70,70,0,1,0,1,0
60957,51160,445,0,0,drop,70,70,0,1,0,1,0
60958,51157,445,0,0,drop,70,70,0,1,0,1,0
60959,51156,445,0,0,drop,70,70,0,1,0,1,0
60960,1036,64147,0,0,deny,62,62,0,1,0,1,0
60961,51590,445,0,0,drop,66,66,0,1,0,1,0
60962,62452,21247,0,0,deny,66,66,0,1,0,1,0
60963,51586,445,0,0,drop,66,66,0,1,0,1,0
60964,13279,10387,0,0,deny,159,159,0,1,0,1,0
60965,6057,51221,0,0,deny,62,62,0,1,0,1,0
60966,53737,443,15661,443,allow,499,425,74,4,0,3,1
60967,53738,443,58635,443,allow,499,425,74,4,0,3,1
60968,53739,443,35645,443,allow,499,425,74,4,0,3,1
60969,53735,443,34476,443,allow,499,425,74,4,0,3,1
60970,53736,443,20137,443,allow,499,425,74,4,0,3,1
60971,53733,443,35168,443,allow,499,425,74,4,0,3,1
60972,53734,443,22403,443,allow,499,425,74,4,0,3,1
60973,53732,443,58255,443,allow,499,425,74,4,0,3,1
60974,53730,443,15340,443,allow,499,425,74,4,0,3,1
60975,53729,443,15910,443,allow,499,425,74,4,0,3,1
60976,53731,443,61889,443,allow,499,425,74,4,0,3,1
60977,53727,443,53687,443,allow,499,425,74,4,0,3,1
60978,35092,22,0,0,deny,60,60,0,1,0,1,0
60979,51142,445,0,0,drop,70,70,0,1,0,1,0
60980,51140,445,0,0,drop,70,70,0,1,0,1,0
60981,51136,445,0,0,drop,70,70,0,1,0,1,0
60982,51132,445,0,0,drop,70,70,0,1,0,1,0
60983,51131,445,0,0,drop,70,70,0,1,0,1,0
60984,53728,443,11260,443,allow,499,425,74,4,0,3,1
60985,53725,443,12003,443,allow,499,425,74,4,0,3,1
60986,53726,443,39961,443,allow,499,425,74,4,0,3,1
60987,53721,443,9349,443,allow,499,425,74,4,0,3,1
60988,53724,443,54768,443,allow,499,425,74,4,0,3,1
60989,53723,443,16354,443,allow,499,425,74,4,0,3,1
60990,53722,443,25032,443,allow,499,425,74,4,0,3,1
60991,53720,443,24279,443,allow,499,425,74,4,0,3,1
60992,53716,443,47571,443,allow,499,425,74,4,0,3,1
60993,53717,443,51020,443,allow,499,425,74,4,0,3,1
60994,53718,443,3459,443,allow,499,425,74,4,0,3,1
60995,53719,443,17807,443,allow,499,425,74,4,0,3,1
60996,56967,35440,0,0,deny,66,66,0,1,0,1,0
60997,61600,56205,0,0,deny,62,62,0,1,0,1,0
60998,56174,445,0,0,drop,70,70,0,1,0,1,0
60999,56173,445,0,0,drop,70,70,0,1,0,1,0
61000,56171,445,0,0,drop,70,70,0,1,0,1,0
61001,51576,445,0,0,drop,66,66,0,1,0,1,0
61002,51568,445,0,0,drop,66,66,0,1,0,1,0
61003,51575,445,0,0,drop,66,66,0,1,0,1,0
61004,51574,445,0,0,drop,66,66,0,1,0,1,0
61005,51573,445,0,0,drop,66,66,0,1,0,1,0
61006,51570,445,0,0,drop,66,66,0,1,0,1,0
61007,51571,445,0,0,drop,66,66,0,1,0,1,0
61008,51569,445,0,0,drop,66,66,0,1,0,1,0
61009,50668,58833,0,0,deny,66,66,0,1,0,1,0
61010,30920,64147,0,0,deny,62,62,0,1,0,1,0
61011,51120,445,0,0,drop,70,70,0,1,0,1,0
61012,6666,21,0,0,deny,60,60,0,1,0,1,0
61013,2791,7302,0,0,deny,62,62,0,1,0,1,0
61014,46557,57866,0,0,deny,66,66,0,1,0,1,0
61015,56327,44512,0,0,deny,66,66,0,1,0,1,0
61016,56168,445,0,0,drop,70,70,0,1,0,1,0
61017,56165,445,0,0,drop,70,70,0,1,0,1,0
61018,56156,445,0,0,drop,70,70,0,1,0,1,0
61019,53771,37965,0,0,deny,66,66,0,1,0,1,0
61020,56703,22,0,0,deny,60,60,0,1,0,1,0
61021,51115,445,0,0,drop,70,70,0,1,0,1,0
61022,25570,35440,0,0,deny,62,62,0,1,0,1,0
61023,51553,445,0,0,drop,66,66,0,1,0,1,0
61024,51555,445,0,0,drop,66,66,0,1,0,1,0
61025,51554,445,0,0,drop,66,66,0,1,0,1,0
61026,45941,23386,0,0,deny,60,60,0,1,0,1,0
61027,54346,44847,0,0,deny,62,62,0,1,0,1,0
61028,14309,56205,0,0,deny,62,62,0,1,0,1,0
61029,56153,445,0,0,drop,70,70,0,1,0,1,0
61030,51103,445,0,0,drop,70,70,0,1,0,1,0
61031,51104,445,0,0,drop,70,70,0,1,0,1,0
61032,51101,445,0,0,drop,70,70,0,1,0,1,0
61033,51100,445,0,0,drop,70,70,0,1,0,1,0
61034,43129,20220,0,0,deny,62,62,0,1,0,1,0
61035,56151,445,0,0,drop,70,70,0,1,0,1,0
61036,51097,445,0,0,drop,70,70,0,1,0,1,0
61037,5637,23,0,0,deny,60,60,0,1,0,1,0
61038,31061,23,0,0,deny,60,60,0,1,0,1,0
61039,56148,445,0,0,drop,70,70,0,1,0,1,0
61040,56145,445,0,0,drop,70,70,0,1,0,1,0
61041,56144,445,0,0,drop,70,70,0,1,0,1,0
61042,57226,51505,0,0,deny,66,66,0,1,0,1,0
61043,57723,45129,0,0,deny,148,148,0,1,0,1,0
61044,40480,30317,0,0,deny,146,146,0,1,0,1,0
61045,63786,35440,0,0,deny,62,62,0,1,0,1,0
61046,62569,44847,0,0,deny,66,66,0,1,0,1,0
61047,51090,445,0,0,drop,70,70,0,1,0,1,0
61048,56753,44847,0,0,deny,62,62,0,1,0,1,0
61049,49831,30188,0,0,deny,66,66,0,1,0,1,0
61050,15274,19473,0,0,deny,62,62,0,1,0,1,0
61051,1114,37965,0,0,deny,62,62,0,1,0,1,0
61052,56131,445,0,0,drop,70,70,0,1,0,1,0
61053,56129,445,0,0,drop,70,70,0,1,0,1,0
61054,56128,445,0,0,drop,70,70,0,1,0,1,0
61055,60192,35440,0,0,deny,66,66,0,1,0,1,0
61056,57729,19750,0,0,deny,66,66,0,1,0,1,0
61057,51083,445,0,0,drop,70,70,0,1,0,1,0
61058,51080,445,0,0,drop,70,70,0,1,0,1,0
61059,59914,65473,0,0,deny,145,145,0,1,0,1,0
61060,51076,445,0,0,drop,70,70,0,1,0,1,0
61061,53395,50321,40284,50321,allow,7546,4168,3378,37,53,24,13
61062,61460,80,11498,80,allow,1507,1184,323,11,79,7,4
61063,58429,53,0,0,allow,1254,160,1094,4,49,2,2
61064,57470,31381,16195,31381,allow,792,792,0,13,1200,13,0
61065,57356,53,56372,53,allow,815,95,720,2,30,1,1
61066,45434,443,37816,443,allow,74123,16210,57913,106,57,52,54
61067,51730,33399,18349,33399,allow,66,66,0,1,5,1,0
61068,61458,443,40730,443,allow,3505,2042,1463,27,82,15,12
61069,42090,443,46273,443,allow,5041,817,4224,20,373,8,12
61070,43098,443,63074,443,allow,3133,1883,1250,19,16,9,10
61071,51745,2572,13644,2572,allow,70,70,0,2,8,2,0
61072,49308,53,0,0,allow,180,80,100,2,30,1,1
61073,51724,25807,42911,25807,allow,66,66,0,1,5,1,0
61074,43735,53,43735,53,allow,216,88,128,2,30,1,1
61075,49650,53,63255,53,allow,322,110,212,4,30,2,2
61076,56421,53,23965,53,allow,170,87,83,2,30,1,1
61077,51870,53,51870,53,allow,825,99,726,2,30,1,1
61078,57061,53,26951,53,allow,711,87,624,2,30,1,1
61079,53227,443,53227,443,allow,4107,2486,1621,20,24,10,10
61080,53228,443,53228,443,allow,4456,2436,2020,19,24,10,9
61081,38363,15000,1161,15000,allow,130,70,60,2,6,1,1
61082,63751,17102,12860,17102,allow,312,132,180,6,6,3,3
61083,49045,80,27391,80,allow,1105,624,481,13,316,7,6
61084,54817,443,47884,443,allow,12861,6761,6100,34,164,20,14
61085,54818,443,9214,443,allow,13069,6969,6100,37,164,23,14
61086,51727,1024,54726,1024,allow,66,66,0,1,5,1,0
61087,51744,1678,51884,1678,allow,70,70,0,2,8,2,0
61088,50068,53,50068,53,allow,240,96,144,2,30,1,1
61089,49650,53,21786,53,allow,216,110,106,2,30,1,1
61090,56980,53,43925,53,allow,701,88,613,2,30,1,1
61091,60913,443,14058,443,allow,18805,1162,17643,28,135,11,17
61092,54032,53,0,0,allow,195,79,116,2,31,1,1
61093,64933,53,1484,53,allow,738,86,652,2,31,1,1
61094,19229,53,19229,53,allow,213,87,126,2,31,1,1
61095,57281,53,58597,53,allow,711,87,624,2,31,1,1
61096,56760,53,60380,53,allow,760,96,664,2,31,1,1
61097,61716,443,60379,443,allow,3168,1038,2130,16,136,8,8
61098,30960,45682,63379,45682,allow,330,330,0,6,3609,6,0
61099,15503,27645,52952,27645,allow,480,149,331,2,1200,1,1
61100,6881,6881,14545,6881,allow,492,150,342,2,1200,1,1
61101,51075,445,0,0,drop,70,70,0,1,0,1,0
61102,51530,445,0,0,drop,66,66,0,1,0,1,0
61103,38484,48637,0,0,deny,60,60,0,1,0,1,0
61104,56124,445,0,0,drop,70,70,0,1,0,1,0
61105,56118,445,0,0,drop,70,70,0,1,0,1,0
61106,42119,36237,0,0,deny,66,66,0,1,0,1,0
61107,41156,53,41156,53,allow,216,82,134,2,31,1,1
61108,49162,53,61794,53,allow,371,94,277,2,29,1,1
61109,49650,53,24810,53,allow,216,110,106,2,29,1,1
61110,123,123,13833,123,allow,184,94,90,2,30,1,1
61111,57470,43155,32052,43155,allow,594,594,0,10,1199,10,0
61112,58429,53,0,0,allow,360,160,200,4,49,2,2
61113,64114,443,8780,443,allow,1411,852,559,13,24,7,6
61114,51751,80,4770,80,allow,1854,1360,494,12,15,7,5
61115,54350,443,6406,443,allow,2402,1444,958,18,167,10,8
61116,60078,80,2527,80,allow,1114,534,580,12,15,7,5
61117,54535,80,13360,80,allow,4162,3455,707,14,15,8,6
61118,64574,53,64558,53,allow,388,95,293,4,32,2,2
61119,60377,65054,58961,65054,allow,624,318,306,10,15,5,5
61120,63743,46081,59158,46081,allow,66,66,0,2,7,2,0
61121,55787,53,59622,53,allow,229,102,127,2,29,1,1
61122,55488,53,31385,53,allow,210,94,116,2,29,1,1
61123,49650,53,11402,53,allow,216,110,106,2,30,1,1
61124,64742,53,25271,53,allow,165,86,79,2,29,1,1
61125,52996,443,47538,443,allow,22513,15188,7325,69,517,31,38
61126,61448,443,1765,443,allow,6109,1902,4207,33,141,19,14
61127,34499,443,29656,443,allow,19518,11774,7744,46,168,26,20
61128,50413,80,12074,80,allow,8388,2010,6378,17,23,8,9
61129,50338,80,9655,80,allow,2668,870,1798,13,47,7,6
61130,43206,443,34471,443,allow,4550611,95139,4455472,4046,217,935,3111
61131,61953,443,64547,443,allow,15246,5574,9672,60,391,27,33
61132,56143,53,42893,53,allow,195,94,101,2,30,1,1
61133,52466,443,10561,443,allow,5082,896,4186,16,70,8,8
61134,56356,2710,17176,2710,allow,1222,747,475,10,23,5,5
61135,50409,443,27908,443,allow,5386,4374,1012,18,34,11,7
61136,52944,53,19420,53,allow,168,78,90,2,30,1,1
61137,53287,80,8055,80,allow,2881,1001,1880,12,52,7,5
61138,56939,53,33751,53,allow,351,94,257,2,30,1,1
61139,36390,443,36390,443,allow,4563,1656,2907,19,28,11,8
61140,56998,53,2449,53,allow,199,94,105,2,30,1,1
61141,64746,53,10441,53,allow,260,86,174,2,30,1,1
61142,65313,53,33070,53,allow,193,102,91,2,30,1,1
61143,59613,443,9064,443,allow,10366,4530,5836,21,135,10,11
61144,53111,80,26592,80,allow,45904,3904,42000,65,16,33,32
61145,49501,80,23659,80,allow,183116,16652,166464,279,486,59,220
61146,8430,53,21349,53,allow,80361,77433,2928,946,89,930,16
61147,64676,53,19072,53,allow,276,94,182,2,30,1,1
61148,58853,443,38782,443,allow,59754,9493,50261,131,367,68,63
61149,54954,443,24434,443,allow,469752,21060,448692,589,64,265,324
61150,40890,53,0,0,allow,86,86,0,1,30,1,0
61151,64123,53,16597,53,allow,325,102,223,2,30,1,1
61152,60376,58302,44068,58302,allow,624,318,306,10,15,5,5
61153,33588,443,49965,443,allow,6382,2331,4051,24,109,13,11
61154,49268,443,60948,443,allow,77368,9874,67494,139,100,65,74
61155,52711,443,64979,443,allow,107997,3957,104040,135,80,51,84
61156,63742,26305,43986,26305,allow,66,66,0,2,7,2,0
61157,49735,443,35310,443,allow,6292,1682,4610,21,15,9,12
61158,51401,443,9077,443,allow,130,70,60,2,4,1,1
61159,51729,63553,6792,63553,allow,70,70,0,1,5,1,0
61160,52127,443,33029,443,allow,18360,1198,17162,27,25,9,18
61161,56799,443,34365,443,allow,5057,880,4177,16,70,8,8
61162,59636,80,29464,80,allow,1352,848,504,13,169,8,5
61163,60807,443,39155,443,allow,9127,2506,6621,38,146,20,18
61164,60874,443,2065,443,allow,777438,37182,740256,940,64,407,533
61165,64742,53,28467,53,allow,173,94,79,2,29,1,1
61166,60517,53,55123,53,allow,215,94,121,2,29,1,1
61167,50408,443,29487,443,allow,5638,4258,1380,19,34,11,8
61168,56421,53,33128,53,allow,177,94,83,2,29,1,1
61169,64021,53,10744,53,allow,339,118,221,2,29,1,1
61170,49308,53,0,0,allow,627,80,547,2,29,1,1
61171,55367,443,46972,443,allow,101466,17775,83691,225,74,112,113
61172,65313,53,6135,53,allow,193,102,91,2,30,1,1
61173,64747,53,25665,53,allow,167,78,89,2,30,1,1
61174,49397,53,28669,53,allow,365,94,271,2,30,1,1
61175,1100,27540,17868,27540,allow,132,70,62,2,30,1,1
61176,39312,443,51370,443,allow,10148,2203,7945,37,120,19,18
61177,57238,53,58179,53,allow,165,86,79,2,30,1,1
61178,49603,53,2204,53,allow,238,110,128,2,30,1,1
61179,49965,53,21038,53,allow,285,110,175,2,30,1,1
61180,50415,443,63011,443,allow,2542,1504,1038,16,20,9,7
61181,51465,80,10875,80,allow,913,410,503,10,15,5,5
61182,46799,443,46799,443,allow,22215,2460,19755,39,198,15,24
61183,60390,56494,64175,56494,allow,70,70,0,2,8,2,0
61184,51725,32787,46505,32787,allow,70,70,0,1,5,1,0
61185,40648,443,10699,443,allow,130,70,60,3,5,2,1
61186,55588,49737,20798,49737,allow,504,318,186,8,15,5,3
61187,49503,80,52162,80,allow,121857,7431,114426,166,486,38,128
61188,49500,80,17093,80,allow,309313,41646,267667,433,486,113,320
61189,65527,53,57886,53,allow,194,94,100,2,30,1,1
61190,41858,53,0,0,allow,86,86,0,1,30,1,0
61191,35132,53,35132,53,allow,86,86,0,1,30,1,0
61192,50265,55637,31401,55637,allow,528,528,0,9,1200,9,0
61193,50417,80,26233,80,allow,1658,1247,411,8,15,5,3
61194,60742,20010,30698,20010,allow,70,70,0,1,5,1,0
61195,49493,80,3964,80,allow,143422,12598,130824,226,487,52,174
61196,35287,443,46797,443,allow,47587,20536,27051,345,581,173,172
61197,33444,53,33346,53,allow,168,78,90,2,30,1,1
61198,55800,53,32257,53,allow,177,94,83,2,30,1,1
61199,55800,53,5218,53,allow,177,94,83,2,30,1,1
61200,6881,6881,60771,6881,allow,150,150,0,1,1200,1,0
61201,51689,80,35961,80,allow,16205,2525,13680,31,139,15,16
61202,55450,53,40253,53,allow,213,102,111,2,30,1,1
61203,57238,53,29243,53,allow,165,86,79,2,30,1,1
61204,56421,53,57015,53,allow,177,94,83,2,30,1,1
61205,57240,53,54621,53,allow,180,94,86,2,30,1,1
61206,33823,443,20715,443,allow,8237,1724,6513,31,270,16,15
61207,39545,443,12909,443,allow,5596,3797,1799,27,96,14,13
61208,65382,53,20411,53,allow,274,94,180,2,30,1,1
61209,63847,443,57992,443,allow,8012,4410,3602,20,135,10,10
61210,64655,53,25772,53,allow,225,102,123,2,30,1,1
61211,55545,53,22001,53,allow,177,94,83,2,30,1,1
61212,58932,53,21682,53,allow,168,78,90,2,31,1,1
61213,44725,443,58969,443,allow,7998,1347,6651,49,1647,10,39
61214,6881,6881,40959,6881,allow,238,118,120,2,1200,1,1
61215,57470,64919,63117,64919,allow,594,594,0,10,1199,10,0
61216,57470,56432,6012,56432,allow,132,132,0,3,1199,3,0
61217,64966,53,51667,53,allow,458,188,270,6,31,3,3
61218,53554,8999,6458,8999,allow,130,70,60,3,6,2,1
61219,60745,40010,27877,40010,allow,316,136,180,6,6,3,3
61220,48975,443,52782,443,allow,130,70,60,3,5,2,1
61221,49767,80,33888,80,allow,70,70,0,2,8,2,0
61222,63422,443,21466,443,allow,10617247,317598,10299649,11317,243,4141,7176
61223,49435,443,3627,443,allow,10377,3140,7237,23,52,11,12
61224,64631,53,54731,53,allow,351,93,258,4,50,2,2
61225,64399,53,19303,53,allow,373,90,283,4,53,2,2
61226,52731,443,19807,443,allow,10819,5326,5493,45,16,27,18
61227,52277,80,52277,80,allow,259496,6676,252820,249,28,74,175
61228,53548,23310,1766,23310,allow,70,70,0,2,8,2,0
61229,55545,53,60601,53,allow,177,94,83,2,30,1,1
61230,65276,53,46929,53,allow,212,102,110,2,30,1,1
61231,49853,53,48467,53,allow,811,94,717,2,30,1,1
61232,35957,51185,0,0,deny,60,60,0,1,0,1,0
61233,1431,30041,0,0,deny,62,62,0,1,0,1,0
61234,50994,35974,0,0,deny,60,60,0,1,0,1,0
61235,6881,55108,0,0,deny,148,148,0,1,0,1,0
61236,59584,36237,0,0,deny,66,66,0,1,0,1,0
61237,55056,56205,0,0,deny,66,66,0,1,0,1,0
61238,51071,445,0,0,drop,70,70,0,1,0,1,0
61239,13567,23684,0,0,deny,168,168,0,1,0,1,0
61240,40500,48817,0,0,deny,143,143,0,1,0,1,0
61241,51070,445,0,0,drop,70,70,0,1,0,1,0
61242,51528,445,0,0,drop,66,66,0,1,0,1,0
61243,50877,30041,0,0,deny,66,66,0,1,0,1,0
61244,50784,52952,0,0,deny,66,66,0,1,0,1,0
61245,1128,44847,0,0,deny,62,62,0,1,0,1,0
61246,1128,44847,0,0,deny,146,146,0,1,0,1,0
61247,51524,445,0,0,drop,66,66,0,1,0,1,0
61248,56115,445,0,0,drop,70,70,0,1,0,1,0
61249,56109,445,0,0,drop,70,70,0,1,0,1,0
61250,56105,445,0,0,drop,70,70,0,1,0,1,0
61251,56104,445,0,0,drop,70,70,0,1,0,1,0
61252,11842,35440,0,0,deny,62,62,0,1,0,1,0
61253,51522,445,0,0,drop,66,66,0,1,0,1,0
61254,58912,11392,0,0,deny,62,62,0,1,0,1,0
61255,51065,445,0,0,drop,70,70,0,1,0,1,0
61256,36339,50584,0,0,deny,62,62,0,1,0,1,0
61257,17702,6881,0,0,deny,62,62,0,1,0,1,0
61258,56098,445,0,0,drop,70,70,0,1,0,1,0
61259,56096,445,0,0,drop,70,70,0,1,0,1,0
61260,56095,445,0,0,drop,70,70,0,1,0,1,0
61261,56092,445,0,0,drop,70,70,0,1,0,1,0
61262,51514,445,0,0,drop,66,66,0,1,0,1,0
61263,57351,62413,0,0,deny,66,66,0,1,0,1,0
61264,51511,445,0,0,drop,66,66,0,1,0,1,0
61265,51510,445,0,0,drop,66,66,0,1,0,1,0
61266,51505,445,0,0,drop,66,66,0,1,0,1,0
61267,18461,19473,0,0,deny,66,66,0,1,0,1,0
61268,51503,445,0,0,drop,66,66,0,1,0,1,0
61269,51504,445,0,0,drop,66,66,0,1,0,1,0
61270,51502,445,0,0,drop,66,66,0,1,0,1,0
61271,64106,64147,0,0,deny,62,62,0,1,0,1,0
61272,45964,7776,0,0,deny,60,60,0,1,0,1,0
61273,17916,48817,0,0,deny,148,148,0,1,0,1,0
61274,51052,445,0,0,drop,70,70,0,1,0,1,0
61275,56090,445,0,0,drop,70,70,0,1,0,1,0
61276,56089,445,0,0,drop,70,70,0,1,0,1,0
61277,56086,445,0,0,drop,70,70,0,1,0,1,0
61278,51499,445,0,0,drop,66,66,0,1,0,1,0
61279,56083,445,0,0,drop,70,70,0,1,0,1,0
61280,51049,445,0,0,drop,70,70,0,1,0,1,0
61281,62780,35440,0,0,deny,66,66,0,1,0,1,0
61282,51495,445,0,0,drop,66,66,0,1,0,1,0
61283,53406,44847,0,0,deny,66,66,0,1,0,1,0
61284,26531,37965,0,0,deny,62,62,0,1,0,1,0
61285,11458,2767,0,0,deny,66,66,0,1,0,1,0
61286,61865,35440,0,0,deny,66,66,0,1,0,1,0
61287,51494,445,0,0,drop,66,66,0,1,0,1,0
61288,51491,445,0,0,drop,66,66,0,1,0,1,0
61289,26406,37965,0,0,deny,66,66,0,1,0,1,0
61290,59477,36829,0,0,deny,62,62,0,1,0,1,0
61291,51490,445,0,0,drop,66,66,0,1,0,1,0
61292,14615,57866,0,0,deny,66,66,0,1,0,1,0
61293,30443,44847,0,0,deny,62,62,0,1,0,1,0
61294,55196,10387,0,0,deny,159,159,0,1,0,1,0
61295,53475,3389,0,0,deny,66,66,0,1,0,1,0
61296,51535,64147,0,0,deny,62,62,0,1,0,1,0
61297,4366,51505,0,0,deny,62,62,0,1,0,1,0
61298,51043,445,0,0,drop,70,70,0,1,0,1,0
61299,51041,445,0,0,drop,70,70,0,1,0,1,0
61300,50113,51505,0,0,deny,62,62,0,1,0,1,0
61301,56077,445,0,0,drop,70,70,0,1,0,1,0
61302,60292,7129,0,0,deny,62,62,0,1,0,1,0
61303,51038,445,0,0,drop,70,70,0,1,0,1,0
61304,53211,22114,0,0,deny,66,66,0,1,0,1,0
61305,56074,445,0,0,drop,70,70,0,1,0,1,0
61306,56069,445,0,0,drop,70,70,0,1,0,1,0
61307,19394,44847,0,0,deny,62,62,0,1,0,1,0
61308,20706,37965,0,0,deny,62,62,0,1,0,1,0
61309,65501,57470,0,0,deny,72,72,0,1,0,1,0
61310,50972,443,8971,443,allow,469,403,66,4,0,3,1
61311,37906,37965,0,0,deny,62,62,0,1,0,1,0
61312,50081,57470,0,0,deny,66,66,0,1,0,1,0
61313,6890,34729,0,0,deny,146,146,0,1,0,1,0
61314,51480,445,0,0,drop,66,66,0,1,0,1,0
61315,2467,2767,0,0,deny,66,66,0,1,0,1,0
61316,45941,23386,0,0,deny,60,60,0,1,0,1,0
61317,20133,2767,0,0,deny,62,62,0,1,0,1,0
61318,58977,37965,0,0,deny,66,66,0,1,0,1,0
61319,12668,42707,0,0,deny,62,62,0,1,0,1,0
61320,51973,44847,0,0,deny,62,62,0,1,0,1,0
61321,10262,11392,0,0,deny,62,62,0,1,0,1,0
61322,1114,37965,0,0,deny,62,62,0,1,0,1,0
61323,51031,445,0,0,drop,70,70,0,1,0,1,0
61324,31136,50584,0,0,deny,62,62,0,1,0,1,0
61325,51471,445,0,0,drop,66,66,0,1,0,1,0
61326,51029,445,0,0,drop,70,70,0,1,0,1,0
61327,56056,445,0,0,drop,70,70,0,1,0,1,0
61328,61566,44847,0,0,deny,66,66,0,1,0,1,0
61329,51028,445,0,0,drop,70,70,0,1,0,1,0
61330,51027,445,0,0,drop,70,70,0,1,0,1,0
61331,51468,445,0,0,drop,66,66,0,1,0,1,0
61332,51026,445,0,0,drop,70,70,0,1,0,1,0
61333,51023,445,0,0,drop,70,70,0,1,0,1,0
61334,51020,445,0,0,drop,70,70,0,1,0,1,0
61335,62696,50584,0,0,deny,66,66,0,1,0,1,0
61336,51461,445,0,0,drop,66,66,0,1,0,1,0
61337,13164,39033,0,0,deny,145,145,0,1,0,1,0
61338,51008,445,0,0,drop,70,70,0,1,0,1,0
61339,51007,445,0,0,drop,70,70,0,1,0,1,0
61340,51453,445,0,0,drop,66,66,0,1,0,1,0
61341,51001,445,0,0,drop,70,70,0,1,0,1,0
61342,20961,35440,0,0,deny,62,62,0,1,0,1,0
61343,50997,445,0,0,drop,70,70,0,1,0,1,0
61344,50998,445,0,0,drop,70,70,0,1,0,1,0
61345,59156,50584,0,0,deny,66,66,0,1,0,1,0
61346,5200,6643,0,0,deny,145,145,0,1,0,1,0
61347,56047,445,0,0,drop,70,70,0,1,0,1,0
61348,56045,445,0,0,drop,70,70,0,1,0,1,0
61349,56043,445,0,0,drop,70,70,0,1,0,1,0
61350,3225,64147,0,0,deny,66,66,0,1,0,1,0
61351,51443,445,0,0,drop,66,66,0,1,0,1,0
61352,51446,445,0,0,drop,66,66,0,1,0,1,0
61353,51444,445,0,0,drop,66,66,0,1,0,1,0
61354,51438,445,0,0,drop,66,66,0,1,0,1,0
61355,51445,445,0,0,drop,66,66,0,1,0,1,0
61356,51439,445,0,0,drop,66,66,0,1,0,1,0
61357,51441,445,0,0,drop,66,66,0,1,0,1,0
61358,51440,445,0,0,drop,66,66,0,1,0,1,0
61359,1873,37965,0,0,deny,62,62,0,1,0,1,0
61360,50986,445,0,0,drop,70,70,0,1,0,1,0
61361,3407,57866,0,0,deny,66,66,0,1,0,1,0
61362,63503,42707,0,0,deny,66,66,0,1,0,1,0
61363,64191,44847,0,0,deny,62,62,0,1,0,1,0
61364,45964,2666,0,0,deny,60,60,0,1,0,1,0
61365,47910,7454,0,0,deny,60,60,0,1,0,1,0
61366,1025,35447,0,0,deny,62,62,0,1,0,1,0
61367,5223,44091,0,0,deny,220,220,0,1,0,1,0
61368,56041,445,0,0,drop,70,70,0,1,0,1,0
61369,56040,445,0,0,drop,70,70,0,1,0,1,0
61370,56028,445,0,0,drop,70,70,0,1,0,1,0
61371,50982,445,0,0,drop,70,70,0,1,0,1,0
61372,1284,50584,0,0,deny,66,66,0,1,0,1,0
61373,51426,445,0,0,drop,66,66,0,1,0,1,0
61374,51425,445,0,0,drop,66,66,0,1,0,1,0
61375,51423,445,0,0,drop,66,66,0,1,0,1,0
61376,45941,23388,0,0,deny,60,60,0,1,0,1,0
61377,64788,43890,0,0,deny,66,66,0,1,0,1,0
61378,50973,445,0,0,drop,70,70,0,1,0,1,0
61379,50971,445,0,0,drop,70,70,0,1,0,1,0
61380,56025,445,0,0,drop,70,70,0,1,0,1,0
61381,50969,445,0,0,drop,70,70,0,1,0,1,0
61382,50970,445,0,0,drop,70,70,0,1,0,1,0
61383,50964,445,0,0,drop,70,70,0,1,0,1,0
61384,56023,445,0,0,drop,70,70,0,1,0,1,0
61385,20844,64147,0,0,deny,66,66,0,1,0,1,0
61386,19858,64147,0,0,deny,62,62,0,1,0,1,0
61387,56013,445,0,0,drop,70,70,0,1,0,1,0
61388,56012,445,0,0,drop,70,70,0,1,0,1,0
61389,56014,445,0,0,drop,70,70,0,1,0,1,0
61390,30654,51221,0,0,deny,72,72,0,1,0,1,0
61391,63925,37965,0,0,deny,66,66,0,1,0,1,0
61392,33215,37965,0,0,deny,62,62,0,1,0,1,0
61393,40885,23,0,0,deny,60,60,0,1,0,1,0
61394,32974,37965,0,0,deny,66,66,0,1,0,1,0
61395,21365,23718,0,0,deny,62,62,0,1,0,1,0
61396,52802,56205,0,0,deny,66,66,0,1,0,1,0
61397,53535,1393,14227,1393,allow,70,70,0,1,5,1,0
61398,50285,80,56429,80,allow,4064,607,3457,12,45,6,6
61399,57240,53,16899,53,allow,176,90,86,2,30,1,1
61400,49708,443,54037,443,allow,456387,11878,444509,427,81,121,306
61401,56759,55201,40009,55201,allow,66,66,0,1,5,1,0
61402,53799,80,41607,80,allow,1056,682,374,10,15,6,4
61403,50283,80,41911,80,allow,5689,1015,4674,16,45,8,8
61404,59401,443,58968,443,allow,3010,1892,1118,16,15,8,8
61405,51689,443,47234,443,allow,8488,2174,6314,23,255,12,11
61406,51946,443,39002,443,allow,8670,1805,6865,28,26,15,13
61407,40662,443,40662,443,allow,4624,1717,2907,19,28,11,8
61408,59404,443,10904,443,allow,2962,1844,1118,16,15,8,8
61409,63846,443,9201,443,allow,3811,1538,2273,20,135,10,10
61410,34885,443,20315,443,allow,80828,20592,60236,124,180,54,70
61411,51464,443,29786,443,allow,575,326,249,10,15,6,4
61412,39338,443,49574,443,allow,7624,1384,6240,23,17,12,11
61413,25150,53,25150,53,allow,217,87,130,2,30,1,1
61414,52273,80,52273,80,allow,156876,7015,149861,158,28,49,109
61415,60534,80,60534,80,allow,84558,3469,81089,94,16,34,60
61416,52275,80,52275,80,allow,210890,8286,202604,208,28,64,144
61417,52276,80,52276,80,allow,222010,7236,214774,216,28,66,150
61418,60531,80,48244,80,allow,2122,1559,563,13,16,7,6
61419,59402,443,55166,443,allow,4821,1882,2939,19,15,9,10
61420,53892,443,40316,443,allow,9312,4088,5224,23,76,13,10
61421,52274,80,52274,80,allow,852970,14195,838775,769,28,207,562
61422,46858,15000,17792,15000,allow,130,70,60,2,5,1,1
61423,2487,53,2487,53,allow,235,90,145,2,33,1,1
61424,44956,443,44956,443,allow,5220,1973,3247,22,38,13,9
61425,47388,443,27845,443,allow,350,210,140,6,15,4,2
61426,41793,53,3227,53,allow,168,78,90,2,30,1,1
61427,55545,53,10302,53,allow,170,87,83,2,30,1,1
61428,55450,443,1835,443,allow,4275,2479,1796,22,316,11,11
61429,60855,443,10736,443,allow,598135,40549,557586,873,251,326,547
61430,15792,3478,30536,3478,allow,428935914,213443641,215492273,635946,2242,308738,327208
61431,59403,443,13461,443,allow,2866,1684,1182,16,15,8,8
61432,53550,1,56985,1,allow,70,70,0,2,8,2,0
61433,59399,443,48462,443,allow,66108,6145,59963,93,16,41,52
61434,49705,443,51038,443,allow,156357,6403,149954,155,81,44,111
61435,50116,22,50116,22,allow,184,120,64,4,11,3,1
61436,37460,443,55415,443,allow,2885,1732,1153,16,256,9,7
61437,43681,443,58156,443,allow,7235,1097,6138,21,27,10,11
61438,59400,443,43611,443,allow,6489,2731,3758,19,16,10,9
61439,65261,53,13380,53,allow,168,86,82,2,30,1,1
61440,55926,53,35022,53,allow,184,94,90,2,30,1,1
61441,55401,53,40210,53,allow,168,86,82,2,31,1,1
61442,60320,443,1355,443,allow,4679,2232,2447,15,136,7,8
61443,63626,443,34704,443,allow,15769,1619,14150,17,138,4,13
61444,53983,443,37079,443,allow,2571,330,2241,12,135,5,7
61445,46663,53,46663,53,allow,209,83,126,2,30,1,1
61446,40603,53,40603,53,allow,240,96,144,2,31,1,1
61447,39166,53,0,0,allow,82,82,0,1,31,1,0
61448,64180,53,16774,53,allow,176,90,86,2,31,1,1
61449,51584,443,13301,443,allow,12641,5741,6900,26,362,12,14
61450,65428,443,7165,443,allow,14203,1525,12678,13,143,2,11
61451,39414,443,32057,443,allow,4179,1480,2699,18,124,9,9
61452,51160,8090,0,0,deny,60,60,0,1,0,1,0
61453,50958,445,0,0,drop,70,70,0,1,0,1,0
61454,51159,8090,0,0,deny,60,60,0,1,0,1,0
61455,21332,23,0,0,deny,60,60,0,1,0,1,0
61456,46090,50584,0,0,deny,62,62,0,1,0,1,0
61457,64382,44847,0,0,deny,62,62,0,1,0,1,0
61458,50486,443,8859,443,allow,5791,3692,2099,21,78,13,8
61459,61681,443,6029,443,allow,5922,1917,4005,24,18,14,10
61460,38484,48637,0,0,deny,60,60,0,1,0,1,0
61461,35957,51185,0,0,deny,60,60,0,1,0,1,0
61462,50994,35974,0,0,deny,60,60,0,1,0,1,0
61463,56006,445,0,0,drop,70,70,0,1,0,1,0
61464,56005,445,0,0,drop,70,70,0,1,0,1,0
61465,56001,445,0,0,drop,70,70,0,1,0,1,0
61466,50951,445,0,0,drop,70,70,0,1,0,1,0
61467,61216,12250,0,0,deny,148,148,0,1,0,1,0
61468,50949,445,0,0,drop,70,70,0,1,0,1,0
61469,33289,50584,0,0,deny,62,62,0,1,0,1,0
61470,59037,51505,0,0,deny,62,62,0,1,0,1,0
61471,57165,34101,0,0,deny,66,66,0,1,0,1,0
61472,29706,50584,0,0,deny,66,66,0,1,0,1,0
61473,50944,445,0,0,drop,70,70,0,1,0,1,0
61474,50943,445,0,0,drop,70,70,0,1,0,1,0
61475,39161,17,0,0,deny,60,60,0,1,0,1,0
61476,46640,3780,0,0,deny,60,60,0,1,0,1,0
61477,7744,32480,0,0,deny,62,62,0,1,0,1,0
61478,51403,445,0,0,drop,66,66,0,1,0,1,0
61479,45908,3383,0,0,deny,60,60,0,1,0,1,0
61480,55997,445,0,0,drop,70,70,0,1,0,1,0
61481,55990,445,0,0,drop,70,70,0,1,0,1,0
61482,44147,64147,0,0,deny,62,62,0,1,0,1,0
61483,29682,44847,0,0,deny,62,62,0,1,0,1,0
61484,50937,445,0,0,drop,70,70,0,1,0,1,0
61485,48600,23718,0,0,deny,66,66,0,1,0,1,0
61486,23807,44847,0,0,deny,62,62,0,1,0,1,0
61487,6881,10104,0,0,deny,107,107,0,1,0,1,0
61488,52650,36237,0,0,deny,62,62,0,1,0,1,0
61489,59523,37965,0,0,deny,62,62,0,1,0,1,0
61490,50902,80,25107,80,allow,5166,1278,3888,14,144,8,6
61491,57936,443,57936,443,allow,18738,1904,16834,33,17,17,16
61492,45987,123,19536,123,allow,184,94,90,2,30,1,1
61493,64169,53,57112,53,allow,212,102,110,2,30,1,1
61494,57344,53,65328,53,allow,177,94,83,2,30,1,1
61495,8430,53,61822,53,allow,239209,233954,5255,2850,88,2822,28
61496,52272,80,52272,80,allow,237488,7574,229914,231,27,71,160
61497,57240,53,32655,53,allow,180,94,86,2,29,1,1
61498,51880,8001,48278,8001,allow,86,86,0,1,29,1,0
61499,50238,53,16273,53,allow,164,78,86,2,29,1,1
61500,49563,53,57038,53,allow,199,94,105,2,29,1,1
61501,56236,443,26673,443,allow,9597,2488,7109,32,287,16,16
61502,42385,443,55838,443,allow,321621,14025,307596,408,41,185,223
61503,56326,80,40390,80,allow,2541,689,1852,13,60,8,5
61504,49513,80,22592,80,allow,476333,9582,466751,453,225,135,318
61505,49567,443,12074,443,allow,6260,3089,3171,27,142,13,14
61506,52128,443,43146,443,allow,16113,2152,13961,35,20,18,17
61507,54971,443,20430,443,allow,13124,8442,4682,40,43,24,16
61508,55926,53,47769,53,allow,184,94,90,2,29,1,1
61509,65074,53,7213,53,allow,227,94,133,2,29,1,1
61510,57046,53,24095,53,allow,234,94,140,2,29,1,1
61511,65330,53,59699,53,allow,766,102,664,2,29,1,1
61512,53110,8830,31632,8830,allow,70,70,0,2,8,2,0
61513,58478,53,13215,53,allow,332,102,230,2,29,1,1
61514,53552,8999,58202,8999,allow,70,70,0,2,7,2,0
61515,51880,8000,41455,8000,allow,172,94,78,2,29,1,1
61516,49722,53,29083,53,allow,215,94,121,2,30,1,1
61517,49477,53,25866,53,allow,183,86,97,2,30,1,1
61518,61680,443,50542,443,allow,12015,3771,8244,41,18,23,18
61519,56950,53,15623,53,allow,363,109,254,4,46,2,2
61520,53529,17130,52813,17130,allow,492,306,186,8,15,5,3
61521,37202,53,37202,53,allow,216,90,126,2,30,1,1
61522,26900,443,4352,443,allow,24703,16382,8321,49,21,28,21
61523,57902,443,28629,443,allow,20509,7660,12849,54,131,28,26
61524,49930,53,51940,53,allow,258,110,148,2,30,1,1
61525,38009,443,41561,443,allow,130,70,60,3,5,2,1
61526,56424,80,11869,80,allow,17135,1507,15628,24,22,9,15
61527,57344,53,21861,53,allow,177,94,83,2,30,1,1
61528,54761,443,53919,443,allow,103367,3730,99637,117,170,42,75
61529,65405,53,15243,53,allow,210,102,108,2,30,1,1
61530,53108,80,57072,80,allow,1797,1070,727,10,15,5,5
61531,52492,443,60482,443,allow,33131,9092,24039,41,15,19,22
61532,46342,53,46342,53,allow,220,90,130,2,30,1,1
61533,50903,80,4352,80,allow,8600,1437,7163,18,144,10,8
61534,50575,443,24477,443,allow,5197,3181,2016,50,261,26,24
61535,45396,53,7036,53,allow,168,78,90,2,30,1,1
61536,49496,53,24067,53,allow,194,102,92,2,30,1,1
61537,64806,53,2007,53,allow,273,94,179,2,30,1,1
61538,57339,53,58719,53,allow,248,94,154,2,30,1,1
61539,10151,6881,61137,6881,allow,469,150,319,2,1200,1,1
61540,55314,53,61384,53,allow,279,110,169,2,30,1,1
61541,57584,443,53316,443,allow,915797,52405,863392,1231,269,604,627
61542,50934,443,50934,443,allow,5661,2414,3247,22,37,13,9
61543,56755,53,8890,53,allow,663,212,451,6,63,3,3
61544,64137,53,55466,53,allow,228,94,134,2,30,1,1
61545,49787,53,45265,53,allow,196,94,102,2,30,1,1
61546,60097,53,60097,53,allow,193,90,103,2,30,1,1
61547,64874,53,41940,53,allow,324,94,230,2,30,1,1
61548,62119,53,18352,53,allow,239,102,137,2,30,1,1
61549,52706,53,0,0,allow,82,82,0,2,40,2,0
61550,46056,80,34041,80,allow,5066,4404,662,11,30,6,5
61551,61417,80,18297,80,allow,214,140,74,4,55,3,1
61552,50320,53,20919,53,allow,168,78,90,2,30,1,1
61553,56785,53,13080,53,allow,213,102,111,2,30,1,1
61554,65466,53,26406,53,allow,248,94,154,2,30,1,1
61555,63016,53,49407,53,allow,243,94,149,2,30,1,1
61556,15503,11731,3627,11731,allow,1188,1188,0,19,2298,19,0
61557,64566,443,6952,443,allow,8573,2039,6534,25,31,14,11
61558,42440,443,11681,443,allow,9412,2994,6418,27,48,16,11
61559,58753,443,28125,443,allow,70,70,0,1,5,1,0
61560,51405,80,23596,80,allow,1510,481,1029,11,20,6,5
61561,50208,1688,32119,1688,allow,70,70,0,2,8,2,0
61562,55586,17332,8583,17332,allow,70,70,0,1,5,1,0
61563,56464,443,4268,443,allow,5058,913,4145,17,25,10,7
61564,53448,5223,10796,5223,allow,134,60,74,3,4,2,1
61565,57183,53,5484,53,allow,199,94,105,2,29,1,1
61566,49496,53,27238,53,allow,194,102,92,2,30,1,1
61567,65016,53,63384,53,allow,215,94,121,2,29,1,1
61568,57340,53,50973,53,allow,258,110,148,2,30,1,1
61569,56782,53,60829,53,allow,227,94,133,2,29,1,1
61570,64277,53,1694,53,allow,337,110,227,2,30,1,1
61571,50000,53,40875,53,allow,263,110,153,2,30,1,1
61572,49602,53,44779,53,allow,247,102,145,2,30,1,1
61573,55926,53,60455,53,allow,184,94,90,2,30,1,1
61574,55545,53,31002,53,allow,177,94,83,2,30,1,1
61575,49430,53,18362,53,allow,279,94,185,2,30,1,1
61576,55401,53,24581,53,allow,168,86,82,2,30,1,1
61577,49973,53,45350,53,allow,309,110,199,2,30,1,1
61578,36061,4500,28501,4500,allow,12526,5944,6582,24,3599,11,13
61579,55635,53,55876,53,allow,177,94,83,2,30,1,1
61580,64180,53,29611,53,allow,180,94,86,2,31,1,1
61581,53109,80,20052,80,allow,8176,1443,6733,20,15,10,10
61582,56599,80,32983,80,allow,234,234,0,4,12,4,0
61583,59669,80,64457,80,allow,2026957,42480,1984477,1975,80,655,1320
61584,50491,443,45806,443,allow,1304,878,426,12,78,7,5
61585,55665,53,45679,53,allow,229,94,135,2,30,1,1
61586,50433,53,61618,53,allow,770,102,668,2,30,1,1
61587,65261,53,34538,53,allow,168,86,82,2,30,1,1
61588,50870,80,58385,80,allow,7313,1684,5629,15,148,8,7
61589,53526,45046,24762,45046,allow,552,306,246,9,15,5,4
61590,63729,6969,28915,6969,allow,70,70,0,1,5,1,0
61591,63725,80,55530,80,allow,374,192,182,7,15,4,3
61592,52488,443,19422,443,allow,7165,1099,6066,16,18,9,7
61593,58392,3389,58392,3389,allow,4624,1524,3100,17,17,9,8
61594,50490,443,43169,443,allow,1353,903,450,12,78,7,5
61595,55585,48063,18600,48063,allow,70,70,0,1,5,1,0
61596,50542,443,10876,443,allow,86426,3497,82929,102,170,38,64
61597,53521,8999,10502,8999,allow,312,186,126,5,15,3,2
61598,40252,443,46211,443,allow,543828,50144,493684,682,172,254,428
61599,44414,123,11306,123,allow,184,94,90,2,30,1,1
61600,56103,53,56052,53,allow,279,94,185,2,30,1,1
61601,57240,53,1415,53,allow,180,94,86,2,30,1,1
61602,57123,53,38680,53,allow,811,94,717,2,30,1,1
61603,55447,53,41152,53,allow,194,102,92,2,30,1,1
61604,51221,57254,65381,57254,allow,491,150,341,2,1200,1,1
61605,57347,443,57555,443,allow,1081375,19607,1061768,921,122,142,779
61606,49722,53,50235,53,allow,168,78,90,2,30,1,1
61607,49444,53,27495,53,allow,199,94,105,2,30,1,1
61608,55317,53,59583,53,allow,244,94,150,2,31,1,1
61609,57071,53,47529,53,allow,274,110,164,2,31,1,1
61610,57366,53,60542,53,allow,458,188,270,6,31,3,3
61611,55184,53,55740,53,allow,443,92,351,4,31,2,2
61612,45726,443,49906,443,allow,3068,1678,1390,17,242,9,8
61613,52292,443,35142,443,allow,21680,2897,18783,35,120,15,20
61614,58143,443,15049,443,allow,17812,8128,9684,55,343,27,28
61615,64611,53,46299,53,allow,189,102,87,2,30,1,1
61616,43542,53,13639,53,allow,168,78,90,2,30,1,1
61617,56631,53,31631,53,allow,199,94,105,2,30,1,1
61618,50691,443,45100,443,allow,152,86,66,2,6,1,1
61619,52491,443,12140,443,allow,22753,7559,15194,31,16,16,15
61620,56970,53,18773,53,allow,230,110,120,2,30,1,1
61621,55151,53,16947,53,allow,285,102,183,2,30,1,1
61622,55956,53,7528,53,allow,200,94,106,2,30,1,1
61623,51408,443,60315,443,allow,8774,3355,5419,19,36,11,8
61624,38495,443,26566,443,allow,7778,1724,6054,29,17,16,13
61625,65170,53,60576,53,allow,771,102,669,2,30,1,1
61626,65414,53,10727,53,allow,197,102,95,2,31,1,1
61627,64825,53,28794,53,allow,184,94,90,2,31,1,1
61628,20389,64147,0,0,deny,66,66,0,1,0,1,0
61629,11404,64147,0,0,deny,62,62,0,1,0,1,0
61630,55286,37965,0,0,deny,66,66,0,1,0,1,0
61631,41271,50584,0,0,deny,146,146,0,1,0,1,0
61632,51130,61689,0,0,deny,62,62,0,1,0,1,0
61633,50936,445,0,0,drop,70,70,0,1,0,1,0
61634,44411,37965,0,0,deny,62,62,0,1,0,1,0
61635,51397,445,0,0,drop,66,66,0,1,0,1,0
61636,4594,35993,0,0,deny,66,66,0,1,0,1,0
61637,51393,445,0,0,drop,66,66,0,1,0,1,0
61638,55984,445,0,0,drop,70,70,0,1,0,1,0
61639,43815,50584,0,0,deny,146,146,0,1,0,1,0
61640,55979,445,0,0,drop,70,70,0,1,0,1,0
61641,55978,445,0,0,drop,70,70,0,1,0,1,0
61642,55976,445,0,0,drop,70,70,0,1,0,1,0
61643,64000,44847,0,0,deny,66,66,0,1,0,1,0
61644,50931,445,0,0,drop,70,70,0,1,0,1,0
61645,51389,445,0,0,drop,66,66,0,1,0,1,0
61646,60246,44612,0,0,deny,66,66,0,1,0,1,0
61647,11136,15503,0,0,deny,62,62,0,1,0,1,0
61648,52676,53733,0,0,deny,66,66,0,1,0,1,0
61649,61495,37965,0,0,deny,66,66,0,1,0,1,0
61650,55972,445,0,0,drop,70,70,0,1,0,1,0
61651,64776,50584,0,0,deny,66,66,0,1,0,1,0
61652,14360,64147,0,0,deny,145,145,0,1,0,1,0
61653,55968,445,0,0,drop,70,70,0,1,0,1,0
61654,55967,445,0,0,drop,70,70,0,1,0,1,0
61655,55964,445,0,0,drop,70,70,0,1,0,1,0
61656,51383,445,0,0,drop,66,66,0,1,0,1,0
61657,59597,37965,0,0,deny,66,66,0,1,0,1,0
61658,4431,32480,0,0,deny,66,66,0,1,0,1,0
61659,51380,445,0,0,drop,66,66,0,1,0,1,0
61660,51378,445,0,0,drop,66,66,0,1,0,1,0
61661,51375,445,0,0,drop,66,66,0,1,0,1,0
61662,47132,1433,0,0,deny,60,60,0,1,0,1,0
61663,59241,62413,0,0,deny,62,62,0,1,0,1,0
61664,53051,44847,0,0,deny,62,62,0,1,0,1,0
61665,51372,445,0,0,drop,66,66,0,1,0,1,0
61666,51373,445,0,0,drop,66,66,0,1,0,1,0
61667,51371,445,0,0,drop,66,66,0,1,0,1,0
61668,50917,445,0,0,drop,70,70,0,1,0,1,0
61669,20650,26467,0,0,deny,66,66,0,1,0,1,0
61670,42995,26467,0,0,deny,62,62,0,1,0,1,0
61671,50914,445,0,0,drop,70,70,0,1,0,1,0
61672,55962,445,0,0,drop,70,70,0,1,0,1,0
61673,55960,445,0,0,drop,70,70,0,1,0,1,0
61674,55956,445,0,0,drop,70,70,0,1,0,1,0
61675,51369,445,0,0,drop,66,66,0,1,0,1,0
61676,54204,443,58891,443,allow,499,425,74,4,0,3,1
61677,54196,443,33780,443,allow,499,425,74,4,0,3,1
61678,54195,443,37622,443,allow,499,425,74,4,0,3,1
61679,54199,443,31908,443,allow,499,425,74,4,0,3,1
61680,54198,443,37713,443,allow,499,425,74,4,0,3,1
61681,52439,35894,0,0,deny,74,74,0,1,0,1,0
61682,36906,50584,0,0,deny,146,146,0,1,0,1,0
61683,55955,445,0,0,drop,70,70,0,1,0,1,0
61684,42252,33303,0,0,deny,60,60,0,1,0,1,0
61685,49516,35894,0,0,deny,62,62,0,1,0,1,0
61686,443,48120,0,0,deny,97,97,0,1,0,1,0
61687,51365,445,0,0,drop,66,66,0,1,0,1,0
61688,49516,35894,0,0,deny,145,145,0,1,0,1,0
61689,38681,15503,0,0,deny,74,74,0,1,0,1,0
61690,51963,22114,0,0,deny,66,66,0,1,0,1,0
61691,51363,445,0,0,drop,66,66,0,1,0,1,0
61692,51362,445,0,0,drop,66,66,0,1,0,1,0
61693,37998,26467,0,0,deny,66,66,0,1,0,1,0
61694,47132,1433,0,0,deny,60,60,0,1,0,1,0
61695,50910,445,0,0,drop,70,70,0,1,0,1,0
61696,50908,445,0,0,drop,70,70,0,1,0,1,0
61697,65016,37965,0,0,deny,66,66,0,1,0,1,0
61698,42075,36237,0,0,deny,62,62,0,1,0,1,0
61699,43099,5900,0,0,deny,60,60,0,1,0,1,0
61700,50906,445,0,0,drop,70,70,0,1,0,1,0
61701,17777,30188,0,0,deny,62,62,0,1,0,1,0
61702,55953,445,0,0,drop,70,70,0,1,0,1,0
61703,55940,445,0,0,drop,70,70,0,1,0,1,0
61704,55938,445,0,0,drop,70,70,0,1,0,1,0
61705,54202,443,43752,443,allow,499,425,74,4,0,3,1
61706,54203,443,21798,443,allow,499,425,74,4,0,3,1
61707,54201,443,55731,443,allow,499,425,74,4,0,3,1
61708,54200,443,47040,443,allow,499,425,74,4,0,3,1
61709,54197,443,1352,443,allow,499,425,74,4,0,3,1
61710,54194,443,16208,443,allow,499,425,74,4,0,3,1
61711,54305,35440,0,0,deny,62,62,0,1,0,1,0
61712,58248,50584,0,0,deny,66,66,0,1,0,1,0
61713,52208,43890,0,0,deny,66,66,0,1,0,1,0
61714,61148,37965,0,0,deny,66,66,0,1,0,1,0
61715,51351,445,0,0,drop,66,66,0,1,0,1,0
61716,42917,52952,0,0,deny,62,62,0,1,0,1,0
61717,33822,57470,0,0,deny,66,66,0,1,0,1,0
61718,54094,5900,0,0,deny,60,60,0,1,0,1,0
61719,50899,445,0,0,drop,70,70,0,1,0,1,0
61720,52788,64147,0,0,deny,66,66,0,1,0,1,0
61721,50897,445,0,0,drop,70,70,0,1,0,1,0
61722,55966,57866,0,0,deny,66,66,0,1,0,1,0
61723,51341,445,0,0,drop,66,66,0,1,0,1,0
61724,55929,445,0,0,drop,70,70,0,1,0,1,0
61725,57107,64147,0,0,deny,62,62,0,1,0,1,0
61726,50896,445,0,0,drop,70,70,0,1,0,1,0
61727,50895,445,0,0,drop,70,70,0,1,0,1,0
61728,50894,445,0,0,drop,70,70,0,1,0,1,0
61729,43398,25604,0,0,deny,146,146,0,1,0,1,0
61730,50888,445,0,0,drop,70,70,0,1,0,1,0
61731,50889,445,0,0,drop,70,70,0,1,0,1,0
61732,51339,50584,0,0,deny,66,66,0,1,0,1,0
61733,51338,445,0,0,drop,66,66,0,1,0,1,0
61734,59411,37965,0,0,deny,66,66,0,1,0,1,0
61735,0,0,0,0,deny,156,156,0,2,0,2,0
61736,0,0,0,0,deny,156,156,0,2,0,2,0
61737,0,0,0,0,deny,156,156,0,2,0,2,0
61738,0,0,0,0,deny,156,156,0,2,0,2,0
61739,53300,37807,0,0,deny,66,66,0,1,0,1,0
61740,55749,37965,0,0,deny,66,66,0,1,0,1,0
61741,14397,37965,0,0,deny,62,62,0,1,0,1,0
61742,50876,445,0,0,drop,70,70,0,1,0,1,0
61743,50875,445,0,0,drop,70,70,0,1,0,1,0
61744,50872,445,0,0,drop,70,70,0,1,0,1,0
61745,51330,445,0,0,drop,66,66,0,1,0,1,0
61746,50866,445,0,0,drop,70,70,0,1,0,1,0
61747,50865,445,0,0,drop,70,70,0,1,0,1,0
61748,52690,7302,0,0,deny,66,66,0,1,0,1,0
61749,51325,445,0,0,drop,66,66,0,1,0,1,0
61750,62970,44847,0,0,deny,62,62,0,1,0,1,0
61751,52451,56205,0,0,deny,66,66,0,1,0,1,0
61752,56006,23,0,0,deny,60,60,0,1,0,1,0
61753,46389,27098,0,0,deny,66,66,0,1,0,1,0
61754,41852,35440,0,0,deny,62,62,0,1,0,1,0
61755,25091,64147,0,0,deny,66,66,0,1,0,1,0
61756,25602,64147,0,0,deny,62,62,0,1,0,1,0
61757,16387,56995,0,0,deny,60,60,0,1,0,1,0
61758,55918,445,0,0,drop,70,70,0,1,0,1,0
61759,55915,445,0,0,drop,70,70,0,1,0,1,0
61760,55916,445,0,0,drop,70,70,0,1,0,1,0
61761,14484,39004,0,0,deny,145,145,0,1,0,1,0
61762,50854,445,0,0,drop,70,70,0,1,0,1,0
61763,14255,2767,0,0,deny,62,62,0,1,0,1,0
61764,51310,445,0,0,drop,66,66,0,1,0,1,0
61765,51311,445,0,0,drop,66,66,0,1,0,1,0
61766,51313,445,0,0,drop,66,66,0,1,0,1,0
61767,51312,445,0,0,drop,66,66,0,1,0,1,0
61768,51315,445,0,0,drop,66,66,0,1,0,1,0
61769,51314,445,0,0,drop,66,66,0,1,0,1,0
61770,51308,445,0,0,drop,66,66,0,1,0,1,0
61771,51309,445,0,0,drop,66,66,0,1,0,1,0
61772,45964,14444,0,0,deny,60,60,0,1,0,1,0
61773,35347,20238,0,0,deny,66,66,0,1,0,1,0
61774,50849,445,0,0,drop,70,70,0,1,0,1,0
61775,49555,443,34197,443,allow,740109,22948,717161,800,54,311,489
61776,49963,53,30474,53,allow,279,96,183,4,58,2,2
61777,59774,443,17301,443,allow,846,420,426,15,29,8,7
61778,59791,443,43640,443,allow,6603,1085,5518,23,28,11,12
61779,59398,443,65413,443,allow,3730,1956,1774,16,15,8,8
61780,42821,53,25927,53,allow,168,78,90,2,30,1,1
61781,59759,443,40820,443,allow,13342,1221,12121,33,41,15,18
61782,59747,443,56102,443,allow,1991,1190,801,21,32,11,10
61783,49475,80,53528,80,allow,1548,847,701,10,16,5,5
61784,52791,80,25328,80,allow,82430,3774,78656,108,67,49,59
61785,53831,80,61237,80,allow,5774,1483,4291,14,162,8,6
61786,51945,443,60723,443,allow,8830,1950,6880,27,25,14,13
61787,46654,80,33249,80,allow,1518,954,564,14,320,8,6
61788,59798,443,49371,443,allow,1887,1152,735,18,28,9,9
61789,55920,53,58162,53,allow,770,102,668,2,30,1,1
61790,59397,443,43163,443,allow,3218,1700,1518,16,15,8,8
61791,35112,8635,35112,8635,allow,138,78,60,2,5,1,1
61792,63728,11785,51708,11785,allow,66,66,0,1,5,1,0
61793,51667,80,5248,80,allow,20457,4742,15715,37,139,20,17
61794,54649,443,1081,443,allow,355822,186974,168848,1039,1626,433,606
61795,59757,443,13672,443,allow,11663,1141,10522,30,41,14,16
61796,52309,80,52309,80,allow,450,246,204,8,29,5,3
61797,59775,443,41953,443,allow,4951,711,4240,15,29,8,7
61798,52308,80,52308,80,allow,14704,1558,13146,25,29,11,14
61799,49476,80,51976,80,allow,5000,4058,942,15,15,8,7
61800,59770,443,53384,443,allow,9630,1304,8326,28,30,14,14
61801,59646,5223,55530,5223,allow,70,70,0,1,5,1,0
61802,56689,53,22159,53,allow,738,86,652,2,30,1,1
61803,59624,443,22456,443,allow,18261,2059,16202,40,31,20,20
61804,42566,53,42566,53,allow,216,98,118,2,30,1,1
61805,52311,80,52311,80,allow,450,246,204,8,29,5,3
61806,49498,443,36900,443,allow,267319,11446,255873,336,192,117,219
61807,56520,53,14015,53,allow,757,98,659,2,30,1,1
61808,56223,53,26065,53,allow,768,99,669,2,30,1,1
61809,52175,443,52175,443,allow,506908,20303,486605,548,25,204,344
61810,64825,53,38972,53,allow,184,94,90,2,30,1,1
61811,41974,443,41974,443,allow,214163,29159,185004,242,20,108,134
61812,53208,443,19606,443,allow,11664,7921,3743,23,16,14,9
61813,58077,36653,2343,36653,allow,204,64,140,4,10,2,2
61814,59787,443,40007,443,allow,1457,816,641,15,28,7,8
61815,9278,23,9278,23,allow,146,60,86,2,10,1,1
61816,59805,443,46522,443,allow,2334,1113,1221,19,27,9,10
61817,59777,443,29457,443,allow,966,480,486,17,29,9,8
61818,59771,443,63690,443,allow,7672,1164,6508,24,30,12,12
61819,59799,443,7688,443,allow,10642,1102,9540,25,27,11,14
61820,55635,53,27124,53,allow,170,87,83,2,30,1,1
61821,55048,53,59185,53,allow,780,104,676,2,30,1,1
61822,56176,53,4646,53,allow,188,96,92,2,30,1,1
61823,6882,59689,61028,59689,allow,221,111,110,2,1200,1,1
61824,43096,443,6075,443,allow,3063,1813,1250,18,16,8,10
61825,50851,80,30396,80,allow,1123758,19319,1104439,1037,133,278,759
61826,64706,443,64706,443,allow,274,132,142,5,76,3,2
61827,56727,53,56099,53,allow,168,86,82,3,50,2,1
61828,52095,443,20736,443,allow,325846,10609,315237,326,38,106,220
61829,53398,443,48527,443,allow,5196,2308,2888,34,137,16,18
61830,50802,80,54812,80,allow,3874,684,3190,11,141,6,5
61831,52100,443,47301,443,allow,298527,11814,286713,310,37,107,203
61832,60745,123,31928,123,allow,184,94,90,2,30,1,1
61833,49846,443,59260,443,allow,278883,9002,269881,313,72,115,198
61834,55732,53,62249,53,allow,188,96,92,2,31,1,1
61835,63965,53,30693,53,allow,192,90,102,2,31,1,1
61836,58770,53,51678,53,allow,168,78,90,2,31,1,1
61837,57334,53,29836,53,allow,204,104,100,2,31,1,1
61838,64989,53,14791,53,allow,756,95,661,2,31,1,1
61839,49892,443,11967,443,allow,5930,910,5020,18,36,9,9
61840,49848,443,21903,443,allow,5997,976,5021,19,72,10,9
61841,49850,443,7446,443,allow,147320,5771,141549,184,72,73,111
61842,57372,53,34702,53,allow,756,95,661,2,31,1,1
61843,50265,61668,33376,61668,allow,132,132,0,3,1201,3,0
61844,54753,443,7702,443,allow,84945,5052,79893,120,360,61,59
61845,65349,53,30593,53,allow,772,103,669,2,31,1,1
61846,56050,53,45848,53,allow,172,88,84,2,30,1,1
61847,64359,53,39260,53,allow,192,98,94,2,31,1,1
61848,49847,443,53706,443,allow,6117,976,5141,21,72,10,11
61849,49849,443,49569,443,allow,6117,976,5141,21,72,10,11
61850,49866,443,16607,443,allow,6058,1038,5020,20,56,11,9
61851,49865,443,25068,443,allow,6177,1038,5139,22,56,11,11
61852,57173,53,42104,53,allow,216,110,106,2,31,1,1
61853,55896,53,50702,53,allow,184,94,90,2,31,1,1
61854,53006,443,46019,443,allow,17711,5894,11817,47,96,24,23
61855,52968,80,9235,80,allow,4004,1347,2657,29,114,15,14
61856,52868,80,24153,80,allow,54968,1915,53053,71,125,24,47
61857,52902,443,33545,443,allow,13263,7381,5882,51,118,26,25
61858,49824,53,9699,53,allow,172,88,84,2,31,1,1
61859,65049,53,32515,53,allow,204,104,100,2,31,1,1
61860,57173,53,12903,53,allow,216,110,106,2,31,1,1
61861,49864,443,13446,443,allow,5930,910,5020,18,56,9,9
61862,49859,443,23944,443,allow,6065,1045,5020,20,60,11,9
61863,55605,53,47383,53,allow,772,103,669,2,31,1,1
61864,49862,443,63314,443,allow,819841,23462,796379,897,56,298,599
61865,49863,443,31339,443,allow,6057,1038,5019,20,56,11,9
61866,49861,443,11860,443,allow,5995,974,5021,19,56,10,9
61867,49844,443,42026,443,allow,6117,976,5141,21,72,10,11
61868,49845,443,44493,443,allow,5996,976,5020,19,72,10,9
61869,56478,53,58747,53,allow,200,102,98,2,31,1,1
61870,55921,53,12219,53,allow,747,92,655,2,31,1,1
61871,50111,443,14390,443,allow,60978,3794,57184,73,137,26,47
61872,55907,445,0,0,drop,70,70,0,1,0,1,0
61873,55906,445,0,0,drop,70,70,0,1,0,1,0
61874,55900,445,0,0,drop,70,70,0,1,0,1,0
61875,50839,445,0,0,drop,70,70,0,1,0,1,0
61876,50840,445,0,0,drop,70,70,0,1,0,1,0
61877,56103,21247,0,0,deny,66,66,0,1,0,1,0
61878,51296,445,0,0,drop,66,66,0,1,0,1,0
61879,51295,445,0,0,drop,66,66,0,1,0,1,0
61880,51293,445,0,0,drop,66,66,0,1,0,1,0
61881,50838,445,0,0,drop,70,70,0,1,0,1,0
61882,50837,445,0,0,drop,70,70,0,1,0,1,0
61883,10965,22114,0,0,deny,62,62,0,1,0,1,0
61884,58012,5555,0,0,deny,60,60,0,1,0,1,0
61885,29623,37807,0,0,deny,146,146,0,1,0,1,0
61886,50833,445,0,0,drop,70,70,0,1,0,1,0
61887,5222,21212,0,0,deny,66,66,0,1,0,1,0
61888,61013,41705,0,0,deny,66,66,0,1,0,1,0
61889,55897,445,0,0,drop,70,70,0,1,0,1,0
61890,32520,50265,0,0,deny,145,145,0,1,0,1,0
61891,6889,41615,0,0,deny,143,143,0,1,0,1,0
61892,38484,48637,0,0,deny,60,60,0,1,0,1,0
61893,53314,64097,0,0,deny,62,62,0,1,0,1,0
61894,35957,51185,0,0,deny,60,60,0,1,0,1,0
61895,55895,445,0,0,drop,70,70,0,1,0,1,0
61896,53330,443,1024,443,allow,5454,1157,4297,15,22,9,6
61897,56176,53,62297,53,allow,102,102,0,1,30,1,0
61898,55926,53,56818,53,allow,184,94,90,2,29,1,1
61899,49567,53,58916,53,allow,244,94,150,2,29,1,1
61900,64858,53,57701,53,allow,196,102,94,2,30,1,1
61901,50994,35974,0,0,deny,60,60,0,1,0,1,0
61902,29145,8168,0,0,deny,62,62,0,1,0,1,0
61903,60617,64147,0,0,deny,62,62,0,1,0,1,0
61904,45908,3383,0,0,deny,60,60,0,1,0,1,0
61905,57959,21247,0,0,deny,66,66,0,1,0,1,0
61906,55892,445,0,0,drop,70,70,0,1,0,1,0
61907,55888,445,0,0,drop,70,70,0,1,0,1,0
61908,55883,445,0,0,drop,70,70,0,1,0,1,0
61909,52611,9571,0,0,deny,62,62,0,1,0,1,0
61910,50827,445,0,0,drop,70,70,0,1,0,1,0
61911,20371,35440,0,0,deny,62,62,0,1,0,1,0
61912,8889,60297,0,0,deny,60,60,0,1,0,1,0
61913,47013,37965,0,0,deny,62,62,0,1,0,1,0
61914,39244,36829,0,0,deny,146,146,0,1,0,1,0
61915,52975,23718,0,0,deny,66,66,0,1,0,1,0
61916,50820,445,0,0,drop,70,70,0,1,0,1,0
61917,50818,445,0,0,drop,70,70,0,1,0,1,0
61918,50422,50584,0,0,deny,66,66,0,1,0,1,0
61919,55875,445,0,0,drop,70,70,0,1,0,1,0
61920,55874,445,0,0,drop,70,70,0,1,0,1,0
61921,55873,445,0,0,drop,70,70,0,1,0,1,0
61922,64177,44847,0,0,deny,62,62,0,1,0,1,0
61923,56798,9571,0,0,deny,62,62,0,1,0,1,0
61924,33469,61903,0,0,deny,145,145,0,1,0,1,0
61925,443,10010,0,0,deny,60,60,0,1,0,1,0
61926,43271,50584,0,0,deny,146,146,0,1,0,1,0
61927,3964,51505,0,0,deny,62,62,0,1,0,1,0
61928,61357,64147,0,0,deny,62,62,0,1,0,1,0
61929,50813,445,0,0,drop,70,70,0,1,0,1,0
61930,2404,35440,0,0,deny,146,146,0,1,0,1,0
61931,46849,36237,0,0,deny,66,66,0,1,0,1,0
61932,50812,445,0,0,drop,70,70,0,1,0,1,0
61933,60960,49049,0,0,deny,66,66,0,1,0,1,0
61934,62930,21247,0,0,deny,66,66,0,1,0,1,0
61935,53353,26467,0,0,deny,62,62,0,1,0,1,0
61936,64166,35440,0,0,deny,66,66,0,1,0,1,0
61937,46116,51505,0,0,deny,62,62,0,1,0,1,0
61938,51953,37965,0,0,deny,66,66,0,1,0,1,0
61939,51273,445,0,0,drop,66,66,0,1,0,1,0
61940,50808,445,0,0,drop,70,70,0,1,0,1,0
61941,55868,445,0,0,drop,70,70,0,1,0,1,0
61942,55862,445,0,0,drop,70,70,0,1,0,1,0
61943,51570,443,51570,443,allow,11204,3773,7431,29,132,12,17
61944,49275,53,23304,53,allow,212,102,110,2,30,1,1
61945,52490,443,51639,443,allow,23518,8884,14634,32,15,15,17
61946,57863,443,52780,443,allow,1981,1155,826,19,86,10,9
61947,53209,80,42720,80,allow,1452,484,968,8,15,5,3
61948,57413,443,19121,443,allow,16749,7614,9135,74,17,34,40
61949,55635,53,55478,53,allow,177,94,83,2,29,1,1
61950,55776,53,11095,53,allow,272,110,162,2,29,1,1
61951,64611,53,9832,53,allow,181,94,87,2,29,1,1
61952,58771,80,64938,80,allow,2062,904,1158,10,258,6,4
61953,64762,53,23924,53,allow,200,94,106,2,30,1,1
61954,57486,80,57486,80,allow,1248,535,713,10,20,5,5
61955,55732,53,1656,53,allow,194,102,92,2,30,1,1
61956,33057,80,61093,80,allow,1151,711,440,10,15,5,5
61957,56481,443,31113,443,allow,1853,1214,639,18,134,11,7
61958,51715,29358,11619,29358,allow,414,136,278,6,16,3,3
61959,52313,80,52313,80,allow,450,246,204,8,29,5,3
61960,51771,80,34714,80,allow,76066,3663,72403,92,24,40,52
61961,56624,53,50985,53,allow,196,102,94,2,30,1,1
61962,56730,53,45534,53,allow,210,110,100,2,30,1,1
61963,65464,443,36070,443,allow,395647,11870,383777,409,16,144,265
61964,59781,443,23445,443,allow,546,180,366,10,28,4,6
61965,43055,80,43055,80,allow,1246,533,713,10,20,5,5
61966,59752,443,31611,443,allow,12150,1262,10888,29,41,13,16
61967,53196,443,1285,443,allow,4371,1115,3256,19,19,9,10
61968,49939,53,36312,53,allow,384,103,281,4,50,2,2
61969,51739,62163,31026,62163,allow,70,70,0,2,8,2,0
61970,51118,80,26346,80,allow,1952,1118,834,21,365,11,10
61971,55635,53,13643,53,allow,177,94,83,2,30,1,1
61972,49963,53,54838,53,allow,279,96,183,4,59,2,2
61973,64946,53,45329,53,allow,210,102,108,2,30,1,1
61974,49614,53,48437,53,allow,258,110,148,2,30,1,1
61975,55217,53,21902,53,allow,189,102,87,2,30,1,1
61976,37984,443,32167,443,allow,3149,1829,1320,22,315,12,10
61977,52730,443,26039,443,allow,8040,2587,5453,39,16,23,16
61978,60368,443,14990,443,allow,10483,4072,6411,20,26,9,11
61979,39036,443,62520,443,allow,1768,541,1227,11,20,7,4
61980,64858,53,5118,53,allow,819,102,717,2,30,1,1
61981,65298,53,31126,53,allow,277,110,167,2,30,1,1
61982,56602,53,21237,53,allow,197,102,95,2,30,1,1
61983,35338,443,9775,443,allow,7504,2762,4742,35,61,17,18
61984,51773,80,63744,80,allow,40993,2984,38009,57,24,28,29
61985,56768,10880,3397,10880,allow,70,70,0,1,5,1,0
61986,55879,53,32478,53,allow,200,94,106,2,30,1,1
61987,53049,443,20030,443,allow,7393,2050,5343,34,92,16,18
61988,52997,443,41046,443,allow,10754,4129,6625,42,112,20,22
61989,51768,80,6690,80,allow,211684,9903,201781,247,27,109,138
61990,38891,80,9037,80,allow,5491,2690,2801,13,15,7,6
61991,51770,80,6696,80,allow,135293,6214,129079,161,24,71,90
61992,50970,80,27517,80,allow,1123476,15099,1108377,963,39,223,740
61993,56482,443,53337,443,allow,10788,6521,4267,61,134,31,30
61994,57414,443,40284,443,allow,103144,2997,100147,114,16,36,78
61995,38305,443,38305,443,allow,5510,2263,3247,22,40,13,9
61996,51738,47483,28405,47483,allow,70,70,0,2,8,2,0
61997,51723,10622,28735,10622,allow,70,70,0,1,5,1,0
61998,34157,443,57470,443,allow,154,94,60,2,5,1,1
61999,59789,443,31655,443,allow,5520,1212,4308,18,28,9,9
62000,46734,53,46734,53,allow,314,98,216,2,29,1,1
62001,33022,443,32074,443,allow,162,102,60,2,5,1,1
62002,55447,53,22356,53,allow,194,102,92,2,29,1,1
62003,55769,53,28226,53,allow,373,103,270,4,43,2,2
62004,56925,53,26704,53,allow,275,110,165,2,29,1,1
62005,52310,80,52310,80,allow,450,246,204,8,29,5,3
62006,59779,443,65358,443,allow,18360,1734,16626,32,28,13,19
62007,64489,53,3033,53,allow,320,97,223,4,50,2,2
62008,36452,53,36452,53,allow,226,106,120,2,29,1,1
62009,51675,53,24941,53,allow,168,78,90,2,29,1,1
62010,64742,53,25545,53,allow,761,102,659,2,29,1,1
62011,49446,80,49446,80,allow,5724,3966,1758,25,38,14,11
62012,60306,53,57588,53,allow,168,78,90,2,29,1,1
62013,64890,53,55634,53,allow,210,110,100,2,29,1,1
62014,52312,80,52312,80,allow,450,246,204,8,29,5,3
62015,49557,53,50413,53,allow,272,110,162,2,29,1,1
62016,59780,443,27949,443,allow,19224,2358,16866,38,28,15,23
62017,65025,53,29192,53,allow,786,110,676,2,29,1,1
62018,64890,53,13860,53,allow,210,110,100,2,30,1,1
62019,55896,53,65305,53,allow,184,94,90,2,30,1,1
62020,56154,53,34116,53,allow,291,94,197,2,29,1,1
62021,56730,53,53565,53,allow,210,110,100,2,30,1,1
62022,55217,53,28752,53,allow,189,102,87,2,30,1,1
62023,41923,53,17859,53,allow,168,78,90,2,30,1,1
62024,55498,53,3379,53,allow,340,134,206,2,30,1,1
62025,56793,53,24911,53,allow,196,102,94,2,30,1,1
62026,49864,53,65077,53,allow,212,102,110,2,30,1,1
62027,64359,53,44275,53,allow,196,102,94,2,30,1,1
62028,50921,443,40184,443,allow,9516,1896,7620,21,127,11,10
62029,49959,443,21643,443,allow,102240,4349,97891,128,136,46,82
62030,56050,53,45376,53,allow,178,94,84,2,30,1,1
62031,49896,443,43604,443,allow,5996,976,5020,19,35,10,9
62032,19473,44929,9531,44929,allow,481,150,331,2,1200,1,1
62033,50683,443,25335,443,allow,6414,1372,5042,19,171,9,10
62034,50893,443,25118,443,allow,9452,1832,7620,20,130,10,10
62035,59494,443,29596,443,allow,338,278,60,2,5,1,1
62036,53107,44060,27368,44060,allow,70,70,0,1,5,1,0
62037,40375,443,13030,443,allow,130,70,60,3,5,2,1
62038,37450,443,11367,443,allow,617919,23432,594487,706,39,297,409
62039,64188,53,11006,53,allow,299,98,201,4,57,2,2
62040,56624,53,20436,53,allow,819,102,717,2,30,1,1
62041,64487,53,6176,53,allow,225,110,115,2,30,1,1
62042,49213,53,21489,53,allow,272,94,178,2,30,1,1
62043,57235,53,3428,53,allow,212,102,110,2,30,1,1
62044,33806,443,17179,443,allow,37541,4945,32596,69,127,31,38
62045,52993,443,38783,443,allow,10754,4129,6625,42,112,20,22
62046,57879,80,31290,80,allow,318,192,126,6,27,4,2
62047,51772,80,5918,80,allow,93693,4469,89224,115,24,53,62
62048,51294,443,42258,443,allow,162,102,60,2,5,1,1
62049,49612,80,42484,80,allow,1388,562,826,11,315,6,5
62050,59776,443,24367,443,allow,966,480,486,17,29,9,8
62051,57334,53,43556,53,allow,210,110,100,2,30,1,1
62052,55403,53,28747,53,allow,211,102,109,2,30,1,1
62053,56176,53,42328,53,allow,194,102,92,2,30,1,1
62054,46865,80,11797,80,allow,662,600,62,12,495,11,1
62055,50841,443,31504,443,allow,10475,1518,8957,24,139,11,13
62056,59778,443,33771,443,allow,6723,1014,5709,19,29,10,9
62057,46186,443,59452,443,allow,10103,3482,6621,59,16,29,30
62058,40576,443,40576,443,allow,4433,1526,2907,19,27,11,8
62059,49522,53,16817,53,allow,688,185,503,6,45,3,3
62060,49128,443,6577,443,allow,3062,1747,1315,17,16,9,8
62061,52797,443,22094,443,allow,8355,1923,6432,32,16,18,14
62062,43634,80,30485,80,allow,1151,711,440,10,15,5,5
62063,65414,53,34166,53,allow,197,102,95,2,30,1,1
62064,56268,53,23212,53,allow,210,102,108,2,30,1,1
62065,57334,53,14690,53,allow,210,110,100,2,30,1,1
62066,56793,53,12485,53,allow,196,102,94,2,30,1,1
62067,64153,53,64829,53,allow,340,134,206,2,30,1,1
62068,56478,53,62940,53,allow,200,102,98,2,30,1,1
62069,44847,6881,59803,6881,allow,484,150,334,2,1200,1,1
62070,55649,443,18027,443,allow,7045,2145,4900,18,136,8,10
62071,50939,443,38504,443,allow,8058,1136,6922,19,126,9,10
62072,50680,443,16561,443,allow,7066,1129,5937,19,172,9,10
62073,60880,443,53335,443,allow,12278,1931,10347,32,56,18,14
62074,60873,443,47153,443,allow,60954,33730,27224,101,63,50,51
62075,50894,80,58930,80,allow,5900,751,5149,15,130,7,8
62076,56050,53,26569,53,allow,178,94,84,2,30,1,1
62077,56522,53,58867,53,allow,322,134,188,2,30,1,1
62078,55384,53,33566,53,allow,212,102,110,2,30,1,1
62079,65246,53,1802,53,allow,209,102,107,2,30,1,1
62080,49854,443,54861,443,allow,5089,1037,4052,20,61,11,9
62081,65049,53,22516,53,allow,210,110,100,2,30,1,1
62082,64513,53,7726,53,allow,396,102,294,2,31,1,1
62083,57173,53,30572,53,allow,322,110,212,4,31,2,2
62084,57294,443,32624,443,allow,122959,4611,118348,142,150,51,91
62085,49473,53,57880,53,allow,290,118,172,2,30,1,1
62086,64865,53,41424,53,allow,423,102,321,2,30,1,1
62087,39569,443,64666,443,allow,125906,21096,104810,172,130,68,104
62088,55313,443,62411,443,allow,4005,1162,2843,17,142,8,9
62089,60849,443,12589,443,allow,3364,1737,1627,15,360,8,7
62090,65496,123,10878,123,allow,184,94,90,2,30,1,1
62091,55896,53,44537,53,allow,184,94,90,2,30,1,1
62092,56997,123,16433,123,allow,184,94,90,2,30,1,1
62093,49679,53,54923,53,allow,166,86,80,2,30,1,1
62094,65418,53,64332,53,allow,211,102,109,2,30,1,1
62095,56050,53,44342,53,allow,178,94,84,2,30,1,1
62096,59278,53,0,0,allow,86,86,0,1,30,1,0
62097,54369,53,50744,53,allow,168,78,90,2,31,1,1
62098,55732,53,61011,53,allow,194,102,92,2,30,1,1
62099,56602,53,29182,53,allow,197,102,95,2,30,1,1
62100,57334,53,19722,53,allow,210,110,100,2,30,1,1
62101,64825,53,52627,53,allow,184,94,90,2,30,1,1
62102,64056,53,57608,53,allow,383,94,289,2,30,1,1
62103,45614,123,42191,123,allow,184,94,90,2,30,1,1
62104,49540,53,39432,53,allow,198,110,88,2,31,1,1
62105,63965,53,54423,53,allow,180,94,86,2,31,1,1
62106,57470,20014,49843,20014,allow,528,528,0,9,1200,9,0
62107,65423,443,16318,443,allow,5854,1796,4058,21,142,10,11
62108,48344,443,10226,443,allow,68467,4750,63717,100,276,48,52
62109,42934,443,36835,443,allow,4514,1928,2586,17,241,8,9
62110,49540,53,53210,53,allow,198,110,88,2,30,1,1
62111,49890,443,45754,443,allow,6068,1047,5021,20,50,11,9
62112,49885,443,59973,443,allow,37539,4310,33229,63,51,27,36
62113,49858,443,16431,443,allow,2027955,75406,1952549,2104,60,564,1540
62114,55951,53,13243,53,allow,197,102,95,2,31,1,1
62115,57173,53,19613,53,allow,216,110,106,2,31,1,1
62116,49889,443,5001,443,allow,214782,13389,201393,277,50,98,179
62117,49177,53,40047,53,allow,184,94,90,2,31,1,1
62118,64643,443,21220,443,allow,3433,1192,2241,13,136,6,7
62119,49873,443,58284,443,allow,14476,2843,11633,45,55,22,23
62120,49876,443,4745,443,allow,5993,974,5019,19,54,10,9
62121,47534,443,60052,443,allow,291717,11752,279965,319,137,123,196
62122,51221,53239,19108,53239,allow,1487,594,893,19,1571,10,9
62123,55292,53,33154,53,allow,211,102,109,2,31,1,1
62124,46866,80,59082,80,allow,662,600,62,12,495,11,1
62125,53330,443,46161,443,allow,3701,1232,2469,13,136,6,7
62126,56727,53,55377,53,allow,250,86,164,4,52,2,2
62127,49963,53,15871,53,allow,279,96,183,4,58,2,2
62128,49963,53,58470,53,allow,564,191,373,6,62,3,3
62129,55922,53,46699,53,allow,423,102,321,2,30,1,1
62130,56983,53,28765,53,allow,424,108,316,4,55,2,2
62131,64180,53,4267,53,allow,180,94,86,2,30,1,1
62132,64825,53,49543,53,allow,184,94,90,2,31,1,1
62133,50031,53,36003,53,allow,386,134,252,2,30,1,1
62134,49679,53,7089,53,allow,166,86,80,2,31,1,1
62135,64297,53,33648,53,allow,199,94,105,2,30,1,1
62136,56478,53,14582,53,allow,200,102,98,2,30,1,1
62137,49839,443,14297,443,allow,5026,973,4053,19,72,10,9
62138,56341,443,32673,443,allow,49417,5511,43906,108,439,54,54
62139,55732,53,40584,53,allow,194,102,92,2,31,1,1
62140,56366,443,56718,443,allow,7234,4345,2889,27,235,15,12
62141,65049,53,4020,53,allow,210,110,100,2,31,1,1
62142,49842,443,41562,443,allow,5309,1043,4266,22,72,11,11
62143,55033,53,37383,53,allow,182,94,88,2,31,1,1
62144,36902,443,18209,443,allow,10252,2152,8100,38,126,18,20
62145,37264,443,36936,443,allow,3068,1678,1390,17,241,9,8
62146,50692,443,11802,443,allow,152,86,66,2,5,1,1
62147,53527,45626,13998,45626,allow,70,70,0,1,5,1,0
62148,61705,80,47319,80,allow,134,60,74,3,11,2,1
62149,50865,443,45042,443,allow,6883,1378,5505,19,131,9,10
62150,49511,80,32515,80,allow,1693924,34466,1659458,1627,230,522,1105
62151,50804,443,11310,443,allow,6337,1378,4959,19,140,9,10
62152,50840,443,34565,443,allow,8057,1135,6922,19,139,9,10
62153,53530,8999,1234,8999,allow,70,70,0,1,5,1,0
62154,56736,53,58809,53,allow,283,94,189,4,41,2,2
62155,56793,53,43867,53,allow,196,102,94,2,30,1,1
62156,49824,53,46232,53,allow,178,94,84,2,30,1,1
62157,64256,53,5483,53,allow,334,94,240,2,31,1,1
62158,55896,53,45886,53,allow,184,94,90,2,31,1,1
62159,49824,53,29358,53,allow,178,94,84,2,31,1,1
62160,49883,443,3067,443,allow,4960,1114,3846,21,51,12,9
62161,49894,443,1865,443,allow,8633,2099,6534,29,35,15,14
62162,49875,443,6451,443,allow,31715,20427,11288,103,54,54,49
62163,49827,443,61208,443,allow,5523,3016,2507,36,75,20,16
62164,56524,53,60434,53,allow,182,102,80,2,31,1,1
62165,13826,53,57057,53,allow,200,94,106,2,31,1,1
62166,50265,64304,32485,64304,allow,970,598,372,14,1201,8,6
62167,56430,443,5643,443,allow,2274816,85295,2189521,2305,127,825,1480
62168,55049,5228,10544,5228,allow,9193,2770,6423,51,5193,28,23
62169,55548,443,42567,443,allow,12205,2036,10169,33,138,18,15
62170,53528,20485,28809,20485,allow,70,70,0,1,5,1,0
62171,50864,443,18823,443,allow,6663,1556,5107,21,132,10,11
62172,50919,443,47767,443,allow,6412,1370,5042,19,129,9,10
62173,50828,443,49506,443,allow,6337,1378,4959,19,140,9,10
62174,50867,443,26907,443,allow,6351,1370,4981,18,131,9,9
62175,50914,443,19872,443,allow,8058,1136,6922,19,129,9,10
62176,50800,443,31236,443,allow,7067,1129,5938,19,141,9,10
62177,14084,43890,0,0,deny,62,62,0,1,0,1,0
62178,56100,57470,0,0,deny,62,62,0,1,0,1,0
62179,61845,11392,0,0,deny,66,66,0,1,0,1,0
62180,50806,445,0,0,drop,70,70,0,1,0,1,0
62181,12694,12446,0,0,deny,62,62,0,1,0,1,0
62182,26573,44847,0,0,deny,62,62,0,1,0,1,0
62183,6889,55108,0,0,deny,143,143,0,1,0,1,0
62184,51413,54351,0,0,deny,136,136,0,1,0,1,0
62185,49298,18593,0,0,deny,145,145,0,1,0,1,0
62186,1987,26467,0,0,deny,62,62,0,1,0,1,0
62187,51413,1,0,0,deny,72,72,0,1,0,1,0
62188,49386,64147,0,0,deny,62,62,0,1,0,1,0
62189,30951,50584,0,0,deny,62,62,0,1,0,1,0
62190,51266,445,0,0,drop,66,66,0,1,0,1,0
62191,14993,50584,0,0,deny,62,62,0,1,0,1,0
62192,51263,445,0,0,drop,66,66,0,1,0,1,0
62193,55855,445,0,0,drop,70,70,0,1,0,1,0
62194,9775,30188,0,0,deny,62,62,0,1,0,1,0
62195,50802,445,0,0,drop,70,70,0,1,0,1,0
62196,8999,42873,0,0,deny,146,146,0,1,0,1,0
62197,55851,445,0,0,drop,70,70,0,1,0,1,0
62198,55850,445,0,0,drop,70,70,0,1,0,1,0
62199,55847,445,0,0,drop,70,70,0,1,0,1,0
62200,51262,445,0,0,drop,66,66,0,1,0,1,0
62201,6069,45680,0,0,deny,159,159,0,1,0,1,0
62202,48478,49903,0,0,deny,62,62,0,1,0,1,0
62203,60923,49903,0,0,deny,66,66,0,1,0,1,0
62204,58486,57470,0,0,deny,66,66,0,1,0,1,0
62205,16275,23117,0,0,deny,146,146,0,1,0,1,0
62206,55842,445,0,0,drop,70,70,0,1,0,1,0
62207,14613,12446,0,0,deny,66,66,0,1,0,1,0
62208,55840,445,0,0,drop,70,70,0,1,0,1,0
62209,55838,445,0,0,drop,70,70,0,1,0,1,0
62210,55836,445,0,0,drop,70,70,0,1,0,1,0
62211,52666,40108,0,0,deny,148,148,0,1,0,1,0
62212,51254,445,0,0,drop,66,66,0,1,0,1,0
62213,18085,26467,0,0,deny,66,66,0,1,0,1,0
62214,51247,445,0,0,drop,66,66,0,1,0,1,0
62215,51248,445,0,0,drop,66,66,0,1,0,1,0
62216,51245,445,0,0,drop,66,66,0,1,0,1,0
62217,50789,445,0,0,drop,70,70,0,1,0,1,0
62218,51233,43890,0,0,deny,66,66,0,1,0,1,0
62219,23379,57866,0,0,deny,146,146,0,1,0,1,0
62220,51243,445,0,0,drop,66,66,0,1,0,1,0
62221,51244,445,0,0,drop,66,66,0,1,0,1,0
62222,51241,445,0,0,drop,66,66,0,1,0,1,0
62223,59586,57470,0,0,deny,66,66,0,1,0,1,0
62224,62452,21247,0,0,deny,66,66,0,1,0,1,0
62225,50786,445,0,0,drop,70,70,0,1,0,1,0
62226,19838,23,0,0,deny,60,60,0,1,0,1,0
62227,55835,445,0,0,drop,70,70,0,1,0,1,0
62228,55833,445,0,0,drop,70,70,0,1,0,1,0
62229,55828,445,0,0,drop,70,70,0,1,0,1,0
62230,51240,445,0,0,drop,66,66,0,1,0,1,0
62231,55827,445,0,0,drop,70,70,0,1,0,1,0
62232,56967,35440,0,0,deny,66,66,0,1,0,1,0
62233,51236,445,0,0,drop,66,66,0,1,0,1,0
62234,51234,445,0,0,drop,66,66,0,1,0,1,0
62235,51233,445,0,0,drop,66,66,0,1,0,1,0
62236,55262,44847,0,0,deny,62,62,0,1,0,1,0
62237,50781,445,0,0,drop,70,70,0,1,0,1,0
62238,26888,23,0,0,deny,60,60,0,1,0,1,0
62239,50780,445,0,0,drop,70,70,0,1,0,1,0
62240,51230,445,0,0,drop,66,66,0,1,0,1,0
62241,50668,58833,0,0,deny,66,66,0,1,0,1,0
62242,50778,445,0,0,drop,70,70,0,1,0,1,0
62243,25151,58833,0,0,deny,146,146,0,1,0,1,0
62244,25342,8168,0,0,deny,62,62,0,1,0,1,0
62245,54826,56205,0,0,deny,66,66,0,1,0,1,0
62246,55821,445,0,0,drop,70,70,0,1,0,1,0
62247,24351,57470,0,0,deny,62,62,0,1,0,1,0
62248,55818,445,0,0,drop,70,70,0,1,0,1,0
62249,55815,445,0,0,drop,70,70,0,1,0,1,0
62250,46557,57866,0,0,deny,66,66,0,1,0,1,0
62251,50853,50584,0,0,deny,66,66,0,1,0,1,0
62252,50771,445,0,0,drop,70,70,0,1,0,1,0
62253,51221,445,0,0,drop,66,66,0,1,0,1,0
62254,25570,35440,0,0,deny,62,62,0,1,0,1,0
62255,0,0,0,0,allow,156,156,0,2,0,2,0
62256,0,0,0,0,allow,244,244,0,2,0,2,0
62257,50769,445,0,0,drop,70,70,0,1,0,1,0
62258,49359,64147,0,0,deny,66,66,0,1,0,1,0
62259,6889,30170,0,0,deny,143,143,0,1,0,1,0
62260,40990,10387,0,0,deny,148,148,0,1,0,1,0
62261,50768,445,0,0,drop,70,70,0,1,0,1,0
62262,50767,445,0,0,drop,70,70,0,1,0,1,0
62263,50,64147,0,0,deny,62,62,0,1,0,1,0
62264,51212,445,0,0,drop,66,66,0,1,0,1,0
62265,50766,445,0,0,drop,70,70,0,1,0,1,0
62266,58876,57470,0,0,deny,66,66,0,1,0,1,0
62267,55800,445,0,0,drop,70,70,0,1,0,1,0
62268,50761,445,0,0,drop,70,70,0,1,0,1,0
62269,50760,445,0,0,drop,70,70,0,1,0,1,0
62270,37213,36237,0,0,deny,66,66,0,1,0,1,0
62271,6890,11204,0,0,deny,146,146,0,1,0,1,0
62272,56411,50584,0,0,deny,62,62,0,1,0,1,0
62273,51209,445,0,0,drop,66,66,0,1,0,1,0
62274,50748,445,0,0,drop,70,70,0,1,0,1,0
62275,50747,445,0,0,drop,70,70,0,1,0,1,0
62276,53957,35440,0,0,deny,146,146,0,1,0,1,0
62277,50745,445,0,0,drop,70,70,0,1,0,1,0
62278,60132,50584,0,0,deny,62,62,0,1,0,1,0
62279,25973,26467,0,0,deny,66,66,0,1,0,1,0
62280,50738,445,0,0,drop,70,70,0,1,0,1,0
62281,50737,445,0,0,drop,70,70,0,1,0,1,0
62282,56327,44512,0,0,deny,66,66,0,1,0,1,0
62283,23650,37807,0,0,deny,62,62,0,1,0,1,0
62284,51201,445,0,0,drop,66,66,0,1,0,1,0
62285,35657,48637,0,0,deny,62,62,0,1,0,1,0
62286,34916,51185,0,0,deny,62,62,0,1,0,1,0
62287,25523,35974,0,0,deny,62,62,0,1,0,1,0
62288,51194,445,0,0,drop,66,66,0,1,0,1,0
62289,25523,35974,0,0,deny,145,145,0,1,0,1,0
62290,50200,44847,0,0,deny,74,74,0,1,0,1,0
62291,60192,35440,0,0,deny,66,66,0,1,0,1,0
62292,10753,22114,0,0,deny,146,146,0,1,0,1,0
62293,50726,445,0,0,drop,70,70,0,1,0,1,0
62294,25470,24748,0,0,deny,143,143,0,1,0,1,0
62295,6890,27520,0,0,deny,146,146,0,1,0,1,0
62296,52941,443,58388,443,allow,14630,5941,8689,52,115,26,26
62297,60189,443,11334,443,allow,10816,1112,9704,22,125,10,12
62298,50332,80,19945,80,allow,2862,1465,1397,11,47,6,5
62299,60309,443,17740,443,allow,130,70,60,3,5,2,1
62300,49860,443,20445,443,allow,10754,2778,7976,38,59,19,19
62301,49893,443,34865,443,allow,7115,1670,5445,24,35,13,11
62302,53138,443,56360,443,allow,7141,2507,4634,28,42,13,15
62303,52912,443,9289,443,allow,41094,14929,26165,126,116,69,57
62304,52942,443,55996,443,allow,14696,5947,8749,53,115,26,27
62305,52921,443,44773,443,allow,36892,20283,16609,191,116,77,114
62306,52879,443,43280,443,allow,286404,12478,273926,379,118,130,249
62307,52887,80,9477,80,allow,5694,2514,3180,36,118,19,17
62308,52918,443,11338,443,allow,326078,45627,280451,737,116,252,485
62309,47744,443,50454,443,allow,7761,2376,5385,24,256,12,12
62310,52928,443,12845,443,allow,56910,3384,53526,85,115,33,52
62311,52940,443,39271,443,allow,14640,5951,8689,52,115,26,26
62312,52938,443,4484,443,allow,14896,6021,8875,56,115,27,29
62313,60187,443,13141,443,allow,9875,1112,8763,21,125,10,11
62314,37066,443,58040,443,allow,9705,4332,5373,32,321,17,15
62315,61714,443,30943,443,allow,134,60,74,3,10,2,1
62316,53194,443,63620,443,allow,1462,965,497,13,18,7,6
62317,53127,443,49935,443,allow,68982,15774,53208,113,45,42,71
62318,53128,443,36411,443,allow,72734,14614,58120,112,44,39,73
62319,52880,443,45002,443,allow,1695880,25777,1670103,1423,118,264,1159
62320,53018,443,30354,443,allow,48877,5205,43672,95,93,32,63
62321,52931,443,32527,443,allow,23112,6278,16834,140,115,55,85
62322,60190,443,8550,443,allow,10178,1101,9077,22,125,10,12
62323,53525,34759,11727,34759,allow,70,70,0,1,5,1,0
62324,53195,443,48069,443,allow,1462,965,497,13,18,7,6
62325,53179,80,43162,80,allow,1628,828,800,10,25,6,4
62326,52943,443,54392,443,allow,14640,5951,8689,52,115,26,26
62327,52930,443,54761,443,allow,21194,5779,15415,118,115,47,71
62328,53115,443,63976,443,allow,9616,6956,2660,39,47,21,18
62329,52898,80,57619,80,allow,3020,1414,1606,30,118,16,14
62330,51411,443,64614,443,allow,7842,1155,6687,19,105,10,9
62331,51265,63960,52529,63960,allow,70,70,0,2,8,2,0
62332,45426,80,3986,80,allow,416,210,206,7,28,4,3
62333,49175,2710,30746,2710,allow,70,70,0,2,8,2,0
62334,44481,443,29524,443,allow,6336,1633,4703,22,256,12,10
62335,49662,443,55920,443,allow,9534,4029,5505,22,59,12,10
62336,48360,3389,48360,3389,allow,4085,1916,2169,21,19,12,9
62337,45428,80,14591,80,allow,350,210,140,6,28,4,2
62338,49649,443,64805,443,allow,5964,674,5290,16,60,7,9
62339,55951,53,16889,53,allow,194,99,95,2,31,1,1
62340,46980,443,8668,443,allow,7633,5620,2013,31,60,19,12
62341,45427,80,37690,80,allow,350,210,140,6,28,4,2
62342,50571,80,64124,80,allow,300,174,126,5,15,3,2
62343,38306,443,65032,443,allow,4580,1210,3370,17,28,10,7
62344,50848,80,48215,80,allow,1213557,27203,1186354,1120,133,327,793
62345,50863,80,47507,80,allow,5874,744,5130,14,131,7,7
62346,53524,45395,27489,45395,allow,70,70,0,1,5,1,0
62347,49674,443,62205,443,allow,8656,2060,6596,20,57,10,10
62348,56420,443,51933,443,allow,5220,922,4298,17,135,10,7
62349,49722,443,17749,443,allow,5943,850,5093,16,50,7,9
62350,60188,443,15594,443,allow,9811,1112,8699,21,125,10,11
62351,52896,80,13613,80,allow,3020,1414,1606,30,118,16,14
62352,45119,443,36541,443,allow,5082,969,4113,18,30,10,8
62353,52904,443,65264,443,allow,17521,6560,10961,55,117,28,27
62354,52903,443,57569,443,allow,253281,6271,247010,276,117,66,210
62355,52939,443,34090,443,allow,16053,6801,9252,51,115,26,25
62356,52876,443,35265,443,allow,501046,7967,493079,419,118,69,350
62357,49894,443,19598,443,allow,7418,2721,4697,23,20,12,11
62358,38808,443,46954,443,allow,25120,1874,23246,39,171,17,22
62359,57595,443,62180,443,allow,291,171,120,4,16,2,2
62360,50795,443,7705,443,allow,18444,12288,6156,36,149,20,16
62361,64915,443,15491,443,allow,4659604,120303,4539301,4651,74,1586,3065
62362,49177,53,33754,53,allow,184,94,90,2,31,1,1
62363,49851,443,11118,443,allow,6058,1038,5020,20,71,11,9
62364,59950,53,51206,53,allow,395,115,280,2,30,1,1
62365,5938,47968,0,0,allow,60,60,0,1,91,1,0
62366,57737,443,13855,443,allow,15625,4662,10963,25,123,11,14
62367,52865,443,62658,443,allow,120290,2988,117302,123,132,32,91
62368,52901,443,37617,443,allow,87558,4155,83403,115,117,41,74
62369,52895,443,23981,443,allow,18795,10297,8498,56,118,29,27
62370,53137,443,3588,443,allow,7648,3641,4007,29,42,13,16
62371,53131,443,52675,443,allow,33229,7810,25419,63,44,24,39
62372,50214,53,34671,53,allow,789,110,679,2,31,1,1
62373,49364,53,62830,53,allow,180,92,88,2,31,1,1
62374,54952,5228,14099,5228,allow,12140,3028,9112,54,4653,28,26
62375,53005,443,10690,443,allow,13028,4115,8913,45,95,23,22
62376,52897,80,31689,80,allow,4292,1932,2360,32,118,17,15
62377,53002,443,30088,443,allow,16537,4585,11952,46,96,24,22
62378,53129,443,62080,443,allow,51742,10734,41008,85,44,33,52
62379,43568,80,8531,80,allow,2277,1521,756,16,16,10,6
62380,56215,53,26623,53,allow,216,110,106,2,31,1,1
62381,64914,443,15488,443,allow,6120028,157580,5962448,6108,75,2083,4025
62382,39381,53,0,0,allow,82,82,0,1,31,1,0
62383,47504,53,47504,53,allow,174,77,97,2,30,1,1
62384,63945,53,52680,53,allow,216,110,106,2,31,1,1
62385,65127,53,26912,53,allow,188,96,92,2,31,1,1
62386,56322,53,7412,53,allow,202,103,99,2,31,1,1
62387,57470,46772,63151,46772,allow,528,528,0,9,1201,9,0
62388,57356,443,4225,443,allow,7802,4189,3613,22,136,11,11
62389,55478,443,16411,443,allow,23029908,732047,22297861,24550,183,8143,16407
62390,52925,5555,0,0,deny,60,60,0,1,0,1,0
62391,55791,445,0,0,drop,70,70,0,1,0,1,0
62392,30920,64147,0,0,deny,62,62,0,1,0,1,0
62393,55788,445,0,0,drop,70,70,0,1,0,1,0
62394,55787,445,0,0,drop,70,70,0,1,0,1,0
62395,51187,445,0,0,drop,66,66,0,1,0,1,0
62396,51185,445,0,0,drop,66,66,0,1,0,1,0
62397,51186,445,0,0,drop,66,66,0,1,0,1,0
62398,51184,445,0,0,drop,66,66,0,1,0,1,0
62399,51182,445,0,0,drop,66,66,0,1,0,1,0
62400,51183,445,0,0,drop,66,66,0,1,0,1,0
62401,51181,445,0,0,drop,66,66,0,1,0,1,0
62402,51179,445,0,0,drop,66,66,0,1,0,1,0
62403,18655,50584,0,0,deny,146,146,0,1,0,1,0
62404,64767,51221,0,0,deny,62,62,0,1,0,1,0
62405,50722,445,0,0,drop,70,70,0,1,0,1,0
62406,50102,17546,0,0,deny,66,66,0,1,0,1,0
62407,13743,33720,0,0,deny,159,159,0,1,0,1,0
62408,52917,443,43916,443,allow,7148,2358,4790,40,116,18,22
62409,52952,443,15638,443,allow,9381,3074,6307,47,114,24,23
62410,52924,443,50522,443,allow,21789,7672,14117,78,115,39,39
62411,50404,80,8357,80,allow,4242,3615,627,15,32,8,7
62412,50403,80,8423,80,allow,4332,3596,736,14,32,8,6
62413,46346,35440,0,0,deny,66,66,0,1,0,1,0
62414,56405,62413,0,0,deny,66,66,0,1,0,1,0
62415,27517,23,0,0,deny,60,60,0,1,0,1,0
62416,50712,445,0,0,drop,70,70,0,1,0,1,0
62417,50711,445,0,0,drop,70,70,0,1,0,1,0
62418,60192,35440,0,0,deny,62,62,0,1,0,1,0
62419,55056,56205,0,0,deny,66,66,0,1,0,1,0
62420,55779,445,0,0,drop,70,70,0,1,0,1,0
62421,55776,445,0,0,drop,70,70,0,1,0,1,0
62422,55772,445,0,0,drop,70,70,0,1,0,1,0
62423,50707,445,0,0,drop,70,70,0,1,0,1,0
62424,50708,445,0,0,drop,70,70,0,1,0,1,0
62425,1431,30041,0,0,deny,62,62,0,1,0,1,0
62426,50877,30041,0,0,deny,66,66,0,1,0,1,0
62427,61329,51505,0,0,deny,62,62,0,1,0,1,0
62428,50705,445,0,0,drop,70,70,0,1,0,1,0
62429,51167,445,0,0,drop,66,66,0,1,0,1,0
62430,51164,445,0,0,drop,66,66,0,1,0,1,0
62431,51166,445,0,0,drop,66,66,0,1,0,1,0
62432,55770,445,0,0,drop,70,70,0,1,0,1,0
62433,58597,35440,0,0,deny,66,66,0,1,0,1,0
62434,55767,445,0,0,drop,70,70,0,1,0,1,0
62435,55762,445,0,0,drop,70,70,0,1,0,1,0
62436,55761,445,0,0,drop,70,70,0,1,0,1,0
62437,50875,53,15135,53,allow,234,234,0,4,47,4,0
62438,49870,443,21099,443,allow,6062,1042,5020,20,55,11,9
62439,49882,443,51154,443,allow,79524,18512,61012,205,50,101,104
62440,56847,53,25632,53,allow,225,86,139,2,30,1,1
62441,55190,53,57289,53,allow,311,94,217,2,30,1,1
62442,55951,53,4112,53,allow,197,102,95,2,30,1,1
62443,42853,443,43627,443,allow,3508,2120,1388,20,241,10,10
62444,50265,33734,14802,33734,allow,132,132,0,3,1200,3,0
62445,52975,443,20822,443,allow,291803,6522,285281,284,113,58,226
62446,50771,80,8237,80,allow,6420,677,5743,13,151,6,7
62447,50852,80,1179,80,allow,1118864,18787,1100077,1036,132,280,756
62448,50859,443,27316,443,allow,6886,1380,5506,19,132,9,10
62449,50895,443,56217,443,allow,6354,1373,4981,18,129,9,9
62450,50866,443,31244,443,allow,9517,1897,7620,21,130,11,10
62451,55947,53,33524,53,allow,311,108,203,4,42,2,2
62452,48017,443,12876,443,allow,198,78,120,4,6,2,2
62453,53543,51819,43192,51819,allow,70,70,0,2,7,2,0
62454,50689,443,50217,443,allow,152,86,66,2,4,1,1
62455,64991,443,64991,443,allow,9107,1499,7608,20,75,11,9
62456,52965,443,44159,443,allow,86041,4656,81385,102,113,34,68
62457,50849,80,37869,80,allow,1218354,26709,1191645,1128,133,332,796
62458,50739,443,62875,443,allow,6335,1376,4959,19,165,9,10
62459,56727,53,4531,53,allow,250,86,164,4,46,2,2
62460,50770,443,41782,443,allow,6350,1369,4981,18,151,9,9
62461,50682,80,52857,80,allow,5237,680,4557,12,170,6,6
62462,49897,443,23230,443,allow,33013,21249,11764,151,492,79,72
62463,50972,80,5146,80,allow,1095399,7129,1088270,832,37,106,726
62464,50686,443,29049,443,allow,6340,1381,4959,19,170,9,10
62465,50746,443,7838,443,allow,6354,1372,4982,18,161,9,9
62466,60871,443,15673,443,allow,95311,21869,73442,140,62,61,79
62467,50720,443,25123,443,allow,6336,1377,4959,19,169,9,10
62468,50064,443,49945,443,allow,4118,2209,1909,36,239,21,15
62469,50744,443,22315,443,allow,6854,1380,5474,18,161,9,9
62470,50769,443,26960,443,allow,6882,1377,5505,19,151,9,10
62471,50965,443,11513,443,allow,8949,1200,7749,21,85,10,11
62472,50843,443,54645,443,allow,6337,1378,4959,19,135,9,10
62473,57348,443,22476,443,allow,6250,1312,4938,23,315,12,11
62474,61828,443,31671,443,allow,7490,2688,4802,23,383,10,13
62475,50920,443,55566,443,allow,6273,1375,4898,18,127,9,9
62476,56135,53,22804,53,allow,542,112,430,4,34,2,2
62477,53544,22051,5953,22051,allow,70,70,0,2,7,2,0
62478,49727,443,58320,443,allow,4116,972,3144,15,50,8,7
62479,53522,24116,50290,24116,allow,70,70,0,1,4,1,0
62480,49673,443,32250,443,allow,6404,829,5575,18,57,9,9
62481,53203,443,27595,443,allow,3656,2345,1311,18,17,9,9
62482,52846,80,43511,80,allow,3626,1778,1848,36,143,19,17
62483,52990,443,9852,443,allow,7093,2235,4858,39,111,20,19
62484,53081,443,13924,443,allow,16157,6478,9679,46,83,23,23
62485,52951,443,13326,443,allow,628801,19603,609198,708,114,227,481
62486,53163,443,16194,443,allow,7432,1694,5738,23,27,12,11
62487,53027,443,45299,443,allow,26309,3035,23274,69,92,27,42
62488,49499,443,13640,443,allow,87970,5355,82615,141,483,55,86
62489,49775,53,55039,53,allow,399,93,306,4,41,2,2
62490,49689,443,55526,443,allow,1179,655,524,13,56,7,6
62491,49881,443,45580,443,allow,5997,978,5019,19,53,10,9
62492,49900,443,21992,443,allow,6896,2139,4757,31,33,15,16
62493,63927,53,30501,53,allow,196,94,102,2,30,1,1
62494,65412,53,14297,53,allow,305,118,187,2,30,1,1
62495,55281,53,43570,53,allow,210,102,108,2,30,1,1
62496,43444,53,43444,53,allow,314,98,216,2,30,1,1
62497,64694,53,57973,53,allow,209,102,107,2,30,1,1
62498,64018,53,10598,53,allow,229,94,135,2,30,1,1
62499,61060,53,61060,53,allow,257,106,151,2,30,1,1
62500,53052,443,60187,443,allow,8476,2030,6446,38,91,19,19
62501,56363,443,4827,443,allow,4864,3011,1853,20,234,12,8
62502,53063,80,2438,80,allow,2725,1228,1497,24,90,13,11
62503,53023,443,2353,443,allow,9625,3512,6113,41,92,21,20
62504,53022,443,29069,443,allow,15099,7828,7271,45,92,24,21
62505,53204,443,30061,443,allow,3655,2344,1311,18,17,9,9
62506,53093,443,27460,443,allow,6774,3651,3123,35,80,18,17
62507,53004,443,34423,443,allow,18064,5135,12929,108,95,44,64
62508,52949,443,60761,443,allow,9564,2054,7510,42,114,20,22
62509,53010,443,23300,443,allow,31660,3248,28412,58,93,23,35
62510,53037,80,8932,80,allow,2906,1233,1673,24,92,13,11
62511,52948,443,49245,443,allow,9629,2119,7510,42,114,20,22
62512,51736,34343,5872,34343,allow,70,70,0,2,8,2,0
62513,52955,443,58633,443,allow,23572,2063,21509,46,114,20,26
62514,53201,443,51458,443,allow,3655,2344,1311,18,17,9,9
62515,41059,443,46382,443,allow,1248874,30382,1218492,1261,111,425,836
62516,53165,443,14639,443,allow,7434,1695,5739,23,27,12,11
62517,49901,443,3004,443,allow,4949,1047,3902,22,33,11,11
62518,53207,443,15704,443,allow,3655,2344,1311,18,17,9,9
62519,49884,443,63837,443,allow,5998,978,5020,19,50,10,9
62520,53156,443,62340,443,allow,3814,2664,1150,22,28,12,10
62521,53199,443,19271,443,allow,1582,965,617,15,18,7,8
62522,49869,443,47117,443,allow,7910,1967,5943,30,55,15,15
62523,53187,443,36781,443,allow,5244,1925,3319,33,21,17,16
62524,49857,443,36785,443,allow,4221,1038,3183,19,59,11,8
62525,19236,53,19236,53,allow,235,90,145,2,33,1,1
62526,53193,443,17954,443,allow,1462,965,497,13,18,7,6
62527,49895,443,39538,443,allow,6060,1040,5020,20,34,11,9
62528,58677,28678,3047,28678,allow,1806,1806,0,22,225,22,0
62529,49826,443,4711,443,allow,1738,1159,579,16,74,10,6
62530,53055,443,19489,443,allow,17225,7769,9456,71,91,34,37
62531,35900,443,35900,443,allow,5661,2414,3247,22,39,13,9
62532,49650,53,42506,53,allow,248,110,138,2,30,1,1
62533,52944,443,11890,443,allow,58499,47163,11336,106,115,59,47
62534,34989,80,37174,80,allow,350,210,140,6,28,4,2
62535,54309,80,4585,80,allow,552,280,272,9,30,5,4
62536,52886,80,7195,80,allow,5688,2508,3180,36,118,19,17
62537,64371,53,21841,53,allow,181,86,95,2,30,1,1
62538,49721,443,52287,443,allow,4588,843,3745,14,52,7,7
62539,64701,53,54317,53,allow,195,94,101,2,30,1,1
62540,50244,80,52530,80,allow,136475,59298,77177,166,53,78,88
62541,55033,53,44325,53,allow,182,94,88,2,30,1,1
62542,49724,443,6596,443,allow,7226,844,6382,19,50,9,10
62543,51667,21391,14607,21391,allow,1345,679,666,9,30,5,4
62544,51666,45702,58433,45702,allow,1201,577,624,8,30,4,4
62545,52985,80,52009,80,allow,3111,1364,1747,28,112,15,13
62546,53206,443,65067,443,allow,3656,2345,1311,18,17,9,9
62547,52957,443,8095,443,allow,38149,4388,33761,68,113,26,42
62548,53064,443,10926,443,allow,8095,2586,5509,38,90,19,19
62549,53154,443,28335,443,allow,3947,2796,1151,22,28,12,10
62550,53160,443,52369,443,allow,2738,1904,834,18,28,10,8
62551,60881,443,31300,443,allow,31109,2922,28187,54,52,26,28
62552,41657,443,13161,443,allow,122547,6414,116133,160,81,61,99
62553,36262,443,11222,443,allow,678861,22499,656362,749,19,290,459
62554,53241,443,45177,443,allow,1950,1176,774,18,103,11,7
62555,50405,80,63982,80,allow,4530,3395,1135,15,32,8,7
62556,49872,443,32419,443,allow,4595,1038,3557,19,54,11,8
62557,49877,443,32997,443,allow,37364,16799,20565,189,53,87,102
62558,49828,443,7626,443,allow,1737,1158,579,16,74,10,6
62559,56362,443,29740,443,allow,12746,7725,5021,39,234,24,15
62560,57424,53,8409,53,allow,210,102,108,2,30,1,1
62561,56215,53,24448,53,allow,216,110,106,2,30,1,1
62562,64749,53,21766,53,allow,227,110,117,2,30,1,1
62563,63965,53,11899,53,allow,180,94,86,2,30,1,1
62564,64029,443,14573,443,allow,252,70,182,3,120,1,2
62565,35459,443,42175,443,allow,2350,1392,958,17,275,9,8
62566,63127,55860,37307,55860,allow,316,190,126,5,15,3,2
62567,49718,443,25229,443,allow,4524,779,3745,13,52,6,7
62568,49723,443,63349,443,allow,6780,710,6070,16,50,7,9
62569,49668,443,23437,443,allow,7978,2204,5774,20,58,10,10
62570,49715,443,43667,443,allow,4418,789,3629,13,54,6,7
62571,53035,443,38723,443,allow,20048,9134,10914,96,92,39,57
62572,53161,443,30923,443,allow,2731,1895,836,18,28,10,8
62573,52973,443,33521,443,allow,9294,2728,6566,43,113,22,21
62574,52852,80,35656,80,allow,7572,3232,4340,42,140,23,19
62575,53197,443,58160,443,allow,1462,965,497,13,18,7,6
62576,53012,443,44779,443,allow,13938,3220,10718,44,93,21,23
62577,49824,53,4911,53,allow,392,88,304,4,53,2,2
62578,34988,80,55946,80,allow,416,210,206,7,28,4,3
62579,35106,443,63708,443,allow,309321,13076,296245,368,189,150,218
62580,49853,443,20017,443,allow,11534,2076,9458,43,60,21,22
62581,54310,80,7871,80,allow,552,280,272,9,30,5,4
62582,9707,3389,9707,3389,allow,3441,1552,1889,17,21,10,7
62583,57917,443,1119,443,allow,6520,1550,4970,19,54,11,8
62584,60878,443,38028,443,allow,764899,31427,733472,883,60,368,515
62585,50868,80,40174,80,allow,12388,742,11646,18,130,7,11
62586,50803,443,31091,443,allow,6417,1376,5041,19,140,9,10
62587,50918,80,48461,80,allow,9643,812,8831,18,128,8,10
62588,50681,443,36673,443,allow,6888,1380,5508,19,171,9,10
62589,50801,443,41271,443,allow,6893,1384,5509,19,140,9,10
62590,60840,443,45920,443,allow,54975,32043,22932,71,319,40,31
62591,50745,80,27446,80,allow,2977,680,2297,11,161,6,5
62592,60872,443,25312,443,allow,27204,15677,11527,59,62,30,29
62593,50873,443,21465,443,allow,6889,1381,5508,19,129,9,10
62594,50892,443,40533,443,allow,8057,1135,6922,19,129,9,10
62595,50878,80,60118,80,allow,325925,18062,307863,377,146,161,216
62596,50898,443,1887,443,allow,6883,1378,5505,19,128,9,10
62597,51721,35426,54780,35426,allow,70,70,0,1,5,1,0
62598,50944,443,36385,443,allow,9517,1898,7619,21,85,11,10
62599,50850,443,34368,443,allow,6341,1382,4959,19,132,9,10
62600,62705,443,21442,443,allow,357841,77119,280722,646,142,316,330
62601,51735,50794,43847,50794,allow,70,70,0,2,8,2,0
62602,36261,443,56856,443,allow,1269784,41489,1228295,1339,37,478,861
62603,65463,443,25060,443,allow,92752,4519,88233,105,15,39,66
62604,50690,443,9122,443,allow,152,86,66,2,4,1,1
62605,53520,37553,29607,37553,allow,70,70,0,1,4,1,0
62606,53531,48908,42269,48908,allow,70,70,0,1,4,1,0
62607,40521,28678,47764,28678,allow,1806,1806,0,22,225,22,0
62608,52640,443,13563,443,allow,70,70,0,1,5,1,0
62609,49720,443,54089,443,allow,4936,855,4081,17,52,7,10
62610,42925,443,37247,443,allow,5617,1559,4058,22,138,13,9
62611,60191,443,1843,443,allow,7292,950,6342,19,125,9,10
62612,49726,443,2292,443,allow,3941,902,3039,13,50,7,6
62613,53155,443,52565,443,allow,3866,2774,1092,21,28,12,9
62614,36256,443,38729,443,allow,3936219,107920,3828299,3880,132,1208,2672
62615,53152,443,44569,443,allow,16706,6162,10544,39,29,19,20
62616,52913,443,33752,443,allow,50739,5508,45231,100,116,36,64
62617,49719,443,28042,443,allow,4717,849,3868,15,52,7,8
62618,53079,443,11081,443,allow,8233,5537,2696,40,84,21,19
62619,53192,443,46060,443,allow,35788,2073,33715,54,21,20,34
62620,52857,443,23236,443,allow,10234,2550,7684,47,139,23,24
62621,53164,443,1379,443,allow,7434,1695,5739,23,27,12,11
62622,53140,443,40797,443,allow,8349,1987,6362,23,30,12,11
62623,52853,80,51325,80,allow,7502,3168,4334,41,140,22,19
62624,52959,443,64973,443,allow,9257,2079,7178,39,113,19,20
62625,52891,443,27899,443,allow,320255,9207,311048,343,117,107,236
62626,52866,80,44619,80,allow,6022,2590,3432,37,131,20,17
62627,53198,443,2334,443,allow,1462,965,497,13,18,7,6
62628,53186,443,23298,443,allow,10332,2735,7597,36,21,17,19
62629,52961,443,6824,443,allow,925322,25097,900225,971,113,287,684
62630,52956,443,14626,443,allow,15659,3294,12365,60,114,25,35
62631,52970,443,47039,443,allow,19221,5366,13855,88,113,36,52
62632,53159,443,33030,443,allow,9711,3950,5761,38,28,22,16
62633,53094,443,6776,443,allow,6726,3603,3123,34,80,17,17
62634,50968,443,54503,443,allow,13683,6075,7608,58,5113,23,35
62635,50974,80,21113,80,allow,1095989,7833,1088156,841,37,117,724
62636,49880,443,51797,443,allow,1087632,32231,1055401,1112,53,334,778
62637,49868,443,19461,443,allow,11578,2375,9203,47,55,22,25
62638,49856,443,10855,443,allow,5512,978,4534,20,60,10,10
62639,49879,443,31980,443,allow,6121,1042,5079,21,53,11,10
62640,64359,53,14911,53,allow,196,102,94,2,30,1,1
62641,56524,53,26224,53,allow,182,102,80,2,30,1,1
62642,55853,53,62979,53,allow,228,110,118,2,30,1,1
62643,65361,53,62352,53,allow,211,102,109,2,30,1,1
62644,64614,53,60972,53,allow,168,86,82,2,31,1,1
62645,49855,443,64909,443,allow,28887,9850,19037,96,60,41,55
62646,49871,443,47130,443,allow,615040,25597,589443,704,54,245,459
62647,49829,443,43793,443,allow,3026,1775,1251,23,74,14,9
62648,56364,443,28728,443,allow,10427,6311,4116,33,234,20,13
62649,65432,53,33110,53,allow,448,184,264,6,30,3,3
62650,56215,53,5017,53,allow,216,110,106,2,30,1,1
62651,37297,443,18068,443,allow,4514,1928,2586,17,240,8,9
62652,21133,59392,22505,59392,allow,481,150,331,2,1199,1,1
62653,49961,53,9720,53,allow,327,126,201,2,30,1,1
62654,50977,80,25806,80,allow,1111949,11633,1100316,906,37,173,733
62655,52473,443,5513,443,allow,1625,1038,587,14,28,8,6
62656,48252,443,55839,443,allow,60300,47341,12959,192,39,108,84
62657,49671,443,7194,443,allow,1485,940,545,13,57,7,6
62658,51685,80,11134,80,allow,1516,481,1035,11,15,6,5
62659,54307,443,65534,443,allow,5661,1444,4217,19,135,11,8
62660,56598,80,2431,80,allow,234,234,0,4,12,4,0
62661,38171,443,40043,443,allow,1649,980,669,14,28,7,7
62662,49725,443,45081,443,allow,7162,780,6382,18,50,8,10
62663,53043,443,3283,443,allow,11020,3760,7260,56,92,25,31
62664,52397,443,10007,443,allow,9680,2399,7281,47,136,27,20
62665,52919,443,28761,443,allow,7573,1986,5587,40,115,19,21
62666,53080,443,53725,443,allow,108155,4527,103628,115,83,30,85
62667,52888,443,11223,443,allow,12876,2739,10137,44,118,21,23
62668,52932,443,63575,443,allow,13165,3626,9539,56,115,30,26
62669,52967,443,11017,443,allow,9893,2231,7662,42,113,21,21
62670,53200,443,25558,443,allow,1462,965,497,13,18,7,6
62671,52875,443,25381,443,allow,89335,4699,84636,107,118,32,75
62672,52894,443,46843,443,allow,5424,1445,3979,29,117,14,15
62673,52937,443,42865,443,allow,22218,12408,9810,66,115,33,33
62674,53202,443,64942,443,allow,3655,2344,1311,18,17,9,9
62675,29029,53,43871,53,allow,323,77,246,4,30,2,2
62676,55081,53,46160,53,allow,209,102,107,2,30,1,1
62677,57341,3389,57341,3389,allow,3428,1714,1714,16,33,8,8
62678,49691,443,33512,443,allow,1183,659,524,13,56,7,6
62679,49684,443,64157,443,allow,9083,2300,6783,19,56,10,9
62680,50402,80,18324,80,allow,5981,3589,2392,15,32,8,7
62681,53114,443,33125,443,allow,15277,10027,5250,36,46,21,15
62682,52861,443,16498,443,allow,3633587,34615,3598972,2964,137,514,2450
62683,52874,443,59388,443,allow,392514,41757,350757,626,118,209,417
62684,52966,80,53251,80,allow,2974,1352,1622,28,113,15,13
62685,53184,443,16399,443,allow,13515,3057,10458,40,21,20,20
62686,52872,443,5601,443,allow,110507,3940,106567,129,118,37,92
62687,53205,443,46818,443,allow,3658,2347,1311,18,17,9,9
62688,53026,443,50319,443,allow,14051,6332,7719,43,92,21,22
62689,65079,53,34794,53,allow,272,94,178,2,30,1,1
62690,65049,53,16377,53,allow,210,110,100,2,30,1,1
62691,49878,443,52783,443,allow,5997,978,5019,19,53,10,9
62692,49841,443,32376,443,allow,7084,1611,5473,29,71,15,14
62693,49840,443,9507,443,allow,58656,12994,45662,148,71,64,84
62694,50403,53,9932,53,allow,749,94,655,2,30,1,1
62695,56478,53,64286,53,allow,200,102,98,2,30,1,1
62696,65218,53,47163,53,allow,276,126,150,2,30,1,1
62697,49874,443,3516,443,allow,6058,1037,5021,20,54,11,9
62698,49886,443,23328,443,allow,7488,1598,5890,25,50,13,12
62699,45402,443,57057,443,allow,7710,3375,4335,32,131,18,14
62700,56758,40000,5881,40000,allow,70,70,0,1,5,1,0
62701,34990,80,31222,80,allow,350,210,140,6,28,4,2
62702,49716,443,56032,443,allow,4653,785,3868,14,52,6,8
62703,49717,443,52321,443,allow,4876,855,4021,16,52,7,9
62704,53019,443,6559,443,allow,30012,3461,26551,72,93,28,44
62705,53121,443,1605,443,allow,10893,7149,3744,31,45,18,13
62706,53031,443,7092,443,allow,16055,5856,10199,97,92,42,55
62707,52885,80,48034,80,allow,5688,2508,3180,36,118,19,17
62708,53047,443,44730,443,allow,13229,3527,9702,56,91,28,28
62709,53077,443,28917,443,allow,6715,1415,5300,27,84,14,13
62710,36563,6851,45259,6851,allow,7584,4075,3509,51,169,27,24
62711,52870,443,27625,443,allow,113894,15573,98321,182,119,67,115
62712,52920,443,54361,443,allow,31161,4934,26227,73,115,32,41
62713,49756,53,22675,53,allow,243,118,125,2,30,1,1
62714,56881,53,21712,53,allow,181,86,95,2,30,1,1
62715,49413,53,52444,53,allow,231,110,121,2,30,1,1
62716,52989,443,57788,443,allow,182945,23135,159810,191,111,63,128
62717,59988,443,59988,443,allow,8589,2809,5780,30,16,15,15
62718,52428,80,60172,80,allow,2516,1929,587,15,16,9,6
62719,56365,443,42336,443,allow,4850,2997,1853,20,234,12,8
62720,56215,53,1097,53,allow,216,110,106,2,30,1,1
62721,65127,53,45861,53,allow,194,102,92,2,30,1,1
62722,56322,53,2088,53,allow,209,110,99,2,30,1,1
62723,57074,53,27906,53,allow,259,78,181,2,30,1,1
62724,49177,53,24852,53,allow,184,94,90,2,30,1,1
62725,49627,53,57352,53,allow,288,110,178,2,31,1,1
62726,64835,53,56147,53,allow,200,102,98,2,31,1,1
62727,32299,40015,23096,40015,allow,188,70,118,2,31,1,1
62728,5588,5588,0,0,allow,3562,1936,1626,48,196,24,24
62729,64077,53,54964,53,allow,199,94,105,2,30,1,1
62730,58981,443,5501,443,allow,3155,836,2319,13,135,6,7
62731,57470,6881,59936,6881,allow,132,132,0,3,1199,3,0
62732,6881,1564,62594,1564,allow,324,150,174,2,1200,1,1
62733,57470,25089,59334,25089,allow,132,132,0,3,1199,3,0
62734,52994,443,57845,443,allow,10694,4129,6565,41,111,20,21
62735,52910,443,4102,443,allow,179433,12614,166819,217,116,78,139
62736,52998,443,44367,443,allow,22480,2705,19775,49,109,22,27
62737,56727,53,51350,53,allow,250,86,164,4,54,2,2
62738,53029,443,57596,443,allow,9246,1808,7438,35,92,17,18
62739,65056,53,43061,53,allow,211,102,109,2,30,1,1
62740,41095,443,28178,443,allow,108842,88940,19902,313,255,159,154
62741,52329,53,12571,53,allow,294,86,208,2,30,1,1
62742,40682,443,13381,443,allow,10010,4051,5959,32,346,17,15
62743,49897,443,33898,443,allow,8586,1352,7234,27,34,13,14
62744,64814,53,5615,53,allow,243,94,149,2,30,1,1
62745,56367,443,5869,443,allow,4863,3011,1852,20,234,12,8
62746,64359,53,62943,53,allow,196,102,94,2,30,1,1
62747,56617,53,16257,53,allow,286,94,192,2,30,1,1
62748,55972,53,36064,53,allow,193,102,91,2,30,1,1
62749,55559,53,59475,53,allow,182,94,88,2,30,1,1
62750,65020,53,52884,53,allow,289,102,187,2,30,1,1
62751,55951,53,63735,53,allow,197,102,95,2,31,1,1
62752,59946,443,42319,443,allow,11836,3531,8305,37,121,19,18
62753,60046,443,51072,443,allow,8241,2346,5895,18,136,8,10
62754,47274,5223,2647,5223,allow,4269,1451,2818,22,3002,13,9
62755,65277,53,17756,53,allow,819,102,717,2,31,1,1
62756,55972,53,18787,53,allow,193,102,91,2,31,1,1
62757,63945,53,11861,53,allow,216,110,106,2,31,1,1
62758,60303,443,45517,443,allow,7914400,166459,7747941,6839,775,1138,5701
62759,39615,443,10074,443,allow,6133,1343,4790,22,275,12,10
62760,64742,53,40488,53,allow,194,94,100,2,31,1,1
62761,57470,1,27948,1,allow,132,132,0,3,1199,3,0
62762,57470,51413,17602,51413,allow,330,330,0,6,1199,6,0
62763,57470,46501,13184,46501,allow,132,132,0,3,1199,3,0
62764,50265,24387,12796,24387,allow,132,132,0,3,1200,3,0
62765,50265,42698,16471,42698,allow,726,726,0,12,1200,12,0
62766,58612,443,21355,443,allow,154,94,60,2,5,1,1
62767,55759,445,0,0,drop,70,70,0,1,0,1,0
62768,50699,445,0,0,drop,70,70,0,1,0,1,0
62769,30114,65151,0,0,deny,60,60,0,1,0,1,0
62770,43840,50265,0,0,deny,72,72,0,1,0,1,0
62771,27328,21247,0,0,deny,66,66,0,1,0,1,0
62772,44258,25,0,0,deny,74,74,0,1,0,1,0
62773,54071,50265,0,0,deny,66,66,0,1,0,1,0
62774,50692,445,0,0,drop,70,70,0,1,0,1,0
62775,26792,37965,0,0,deny,62,62,0,1,0,1,0
62776,42285,57470,0,0,deny,62,62,0,1,0,1,0
62777,50689,445,0,0,drop,70,70,0,1,0,1,0
62778,55746,445,0,0,drop,70,70,0,1,0,1,0
62779,55745,445,0,0,drop,70,70,0,1,0,1,0
62780,55743,445,0,0,drop,70,70,0,1,0,1,0
62781,11136,15503,0,0,deny,62,62,0,1,0,1,0
62782,50685,445,0,0,drop,70,70,0,1,0,1,0
62783,50684,445,0,0,drop,70,70,0,1,0,1,0
62784,4366,51505,0,0,deny,62,62,0,1,0,1,0
62785,61865,35440,0,0,deny,66,66,0,1,0,1,0
62786,53406,44847,0,0,deny,66,66,0,1,0,1,0
62787,50680,445,0,0,drop,70,70,0,1,0,1,0
62788,1042,64147,0,0,deny,145,145,0,1,0,1,0
62789,51144,445,0,0,drop,66,66,0,1,0,1,0
62790,55741,445,0,0,drop,70,70,0,1,0,1,0
62791,55734,445,0,0,drop,70,70,0,1,0,1,0
62792,50678,445,0,0,drop,70,70,0,1,0,1,0
62793,50386,22114,0,0,deny,62,62,0,1,0,1,0
62794,1027,65473,0,0,deny,159,159,0,1,0,1,0
62795,36945,23,0,0,deny,60,60,0,1,0,1,0
62796,22683,39210,0,0,deny,60,60,0,1,0,1,0
62797,50081,57470,0,0,deny,66,66,0,1,0,1,0
62798,2467,2767,0,0,deny,66,66,0,1,0,1,0
62799,25412,23,0,0,deny,60,60,0,1,0,1,0
62800,51137,445,0,0,drop,66,66,0,1,0,1,0
62801,50674,445,0,0,drop,70,70,0,1,0,1,0
62802,37042,48983,0,0,deny,159,159,0,1,0,1,0
62803,2919,57866,0,0,deny,62,62,0,1,0,1,0
62804,51134,445,0,0,drop,66,66,0,1,0,1,0
62805,25739,64147,0,0,deny,62,62,0,1,0,1,0
62806,55731,445,0,0,drop,70,70,0,1,0,1,0
62807,62787,51221,0,0,deny,66,66,0,1,0,1,0
62808,62632,35440,0,0,deny,66,66,0,1,0,1,0
62809,55726,445,0,0,drop,70,70,0,1,0,1,0
62810,55724,445,0,0,drop,70,70,0,1,0,1,0
62811,55721,445,0,0,drop,70,70,0,1,0,1,0
62812,51132,445,0,0,drop,66,66,0,1,0,1,0
62813,17070,48817,0,0,deny,140,140,0,1,0,1,0
62814,31136,50584,0,0,deny,62,62,0,1,0,1,0
62815,39480,8055,0,0,deny,148,148,0,1,0,1,0
62816,6057,51221,0,0,deny,78,78,0,1,0,1,0
62817,61566,44847,0,0,deny,66,66,0,1,0,1,0
62818,55714,445,0,0,drop,70,70,0,1,0,1,0
62819,15793,64147,0,0,deny,66,66,0,1,0,1,0
62820,55712,445,0,0,drop,70,70,0,1,0,1,0
62821,55710,445,0,0,drop,70,70,0,1,0,1,0
62822,55708,445,0,0,drop,70,70,0,1,0,1,0
62823,50661,445,0,0,drop,70,70,0,1,0,1,0
62824,51125,445,0,0,drop,66,66,0,1,0,1,0
62825,60894,50584,0,0,deny,66,66,0,1,0,1,0
62826,63331,51221,0,0,deny,62,62,0,1,0,1,0
62827,2182,57354,0,0,deny,145,145,0,1,0,1,0
62828,51121,445,0,0,drop,66,66,0,1,0,1,0
62829,51117,445,0,0,drop,66,66,0,1,0,1,0
62830,51120,445,0,0,drop,66,66,0,1,0,1,0
62831,51114,445,0,0,drop,66,66,0,1,0,1,0
62832,51113,445,0,0,drop,66,66,0,1,0,1,0
62833,51112,445,0,0,drop,66,66,0,1,0,1,0
62834,50658,445,0,0,drop,70,70,0,1,0,1,0
62835,62696,50584,0,0,deny,66,66,0,1,0,1,0
62836,58318,15503,0,0,deny,66,66,0,1,0,1,0
62837,17760,50584,0,0,deny,62,62,0,1,0,1,0
62838,33822,57470,0,0,deny,66,66,0,1,0,1,0
62839,55707,445,0,0,drop,70,70,0,1,0,1,0
62840,55705,445,0,0,drop,70,70,0,1,0,1,0
62841,55703,445,0,0,drop,70,70,0,1,0,1,0
62842,58326,50584,0,0,deny,146,146,0,1,0,1,0
62843,51110,445,0,0,drop,66,66,0,1,0,1,0
62844,55699,445,0,0,drop,70,70,0,1,0,1,0
62845,50653,445,0,0,drop,70,70,0,1,0,1,0
62846,51106,445,0,0,drop,66,66,0,1,0,1,0
62847,50652,445,0,0,drop,70,70,0,1,0,1,0
62848,51105,445,0,0,drop,66,66,0,1,0,1,0
62849,51104,445,0,0,drop,66,66,0,1,0,1,0
62850,50650,445,0,0,drop,70,70,0,1,0,1,0
62851,0,0,0,0,allow,320,320,0,5,0,5,0
62852,51101,445,0,0,drop,66,66,0,1,0,1,0
62853,50116,22,0,0,deny,60,60,0,1,0,1,0
62854,43129,20220,0,0,deny,62,62,0,1,0,1,0
62855,55694,445,0,0,drop,70,70,0,1,0,1,0
62856,45908,3383,0,0,deny,60,60,0,1,0,1,0
62857,52459,33890,0,0,deny,60,60,0,1,0,1,0
62858,6881,9074,0,0,deny,143,143,0,1,0,1,0
62859,55685,445,0,0,drop,70,70,0,1,0,1,0
62860,55684,445,0,0,drop,70,70,0,1,0,1,0
62861,50643,445,0,0,drop,70,70,0,1,0,1,0
62862,45941,23386,0,0,deny,60,60,0,1,0,1,0
62863,50641,445,0,0,drop,70,70,0,1,0,1,0
62864,51092,445,0,0,drop,66,66,0,1,0,1,0
62865,49818,37965,0,0,deny,62,62,0,1,0,1,0
62866,26198,64147,0,0,deny,62,62,0,1,0,1,0
62867,13188,35440,0,0,deny,66,66,0,1,0,1,0
62868,50640,445,0,0,drop,70,70,0,1,0,1,0
62869,50639,445,0,0,drop,70,70,0,1,0,1,0
62870,50638,445,0,0,drop,70,70,0,1,0,1,0
62871,50635,445,0,0,drop,70,70,0,1,0,1,0
62872,50632,445,0,0,drop,70,70,0,1,0,1,0
62873,51083,445,0,0,drop,66,66,0,1,0,1,0
62874,16948,990,0,0,deny,60,60,0,1,0,1,0
62875,55672,445,0,0,drop,70,70,0,1,0,1,0
62876,33457,27015,0,0,deny,67,67,0,1,0,1,0
62877,55878,7302,0,0,deny,62,62,0,1,0,1,0
62878,1446,35440,0,0,deny,62,62,0,1,0,1,0
62879,50620,445,0,0,drop,70,70,0,1,0,1,0
62880,50619,445,0,0,drop,70,70,0,1,0,1,0
62881,50613,445,0,0,drop,70,70,0,1,0,1,0
62882,63864,23,0,0,deny,60,60,0,1,0,1,0
62883,63925,37965,0,0,deny,66,66,0,1,0,1,0
62884,1873,37965,0,0,deny,62,62,0,1,0,1,0
62885,63433,57866,0,0,deny,66,66,0,1,0,1,0
62886,51080,445,0,0,drop,66,66,0,1,0,1,0
62887,50610,445,0,0,drop,70,70,0,1,0,1,0
62888,50609,445,0,0,drop,70,70,0,1,0,1,0
62889,51073,445,0,0,drop,66,66,0,1,0,1,0
62890,2995,26467,0,0,deny,62,62,0,1,0,1,0
62891,123,123,15561,123,allow,184,94,90,2,30,1,1
62892,64614,53,55255,53,allow,168,86,82,2,30,1,1
62893,56117,53,10364,53,allow,757,98,659,2,30,1,1
62894,55479,53,3977,53,allow,789,110,679,2,30,1,1
62895,43095,443,16830,443,allow,3067,1817,1250,18,16,8,10
62896,52089,443,15915,443,allow,6032,3616,2416,39,187,20,19
62897,61399,80,3299,80,allow,5518,527,4991,13,75,6,7
62898,56755,31774,8678,31774,allow,378,192,186,7,15,4,3
62899,45377,443,49244,443,allow,5291,3987,1304,19,255,11,8
62900,51719,13715,9141,13715,allow,66,66,0,1,5,1,0
62901,64756,53,24462,53,allow,757,98,659,2,30,1,1
62902,52933,80,52933,80,allow,98765,5293,93472,131,199,48,83
62903,63720,55027,38364,55027,allow,1233,902,331,12,17,8,4
62904,54853,443,64447,443,allow,7689,3574,4115,65,308,32,33
62905,61397,80,22347,80,allow,2500,531,1969,11,75,6,5
62906,38807,443,45968,443,allow,99092,3694,95398,115,170,43,72
62907,50537,5223,31982,5223,allow,12710,4688,8022,44,2961,19,25
62908,57108,53,22880,53,allow,186,95,91,2,30,1,1
62909,55972,53,10428,53,allow,186,95,91,2,30,1,1
62910,45937,443,35765,443,allow,4592,697,3895,14,25,8,6
62911,53546,17203,56777,17203,allow,320,140,180,6,7,3,3
62912,51717,63436,58721,63436,allow,66,66,0,1,5,1,0
62913,50807,443,17833,443,allow,9328,1709,7619,18,139,8,10
62914,57594,443,61887,443,allow,291,171,120,4,15,2,2
62915,44036,443,28418,443,allow,6599,3950,2649,36,186,20,16
62916,56617,3389,56617,3389,allow,3425,1470,1955,16,17,8,8
62917,51718,55003,59957,55003,allow,66,66,0,1,5,1,0
62918,61398,80,45091,80,allow,2425,529,1896,11,75,6,5
62919,23228,443,23228,443,allow,20540,5514,15026,52,76,29,23
62920,5588,5588,0,0,allow,3498,1872,1626,48,200,24,24
62921,50061,443,9312,443,allow,7199,2528,4671,18,76,10,8
62922,48965,443,50088,443,allow,9519,4377,5142,33,354,17,16
62923,22452,443,22452,443,allow,5785,2575,3210,24,76,14,10
62924,53545,27700,24861,27700,allow,320,140,180,6,7,3,3
62925,63808,53,2452,53,allow,578,286,292,9,15,5,4
62926,38809,443,49064,443,allow,79659,3269,76390,96,170,37,59
62927,37570,443,53443,443,allow,986,499,487,9,17,5,4
62928,64835,53,1399,53,allow,200,102,98,2,30,1,1
62929,56243,53,64458,53,allow,762,101,661,2,30,1,1
62930,55559,53,26431,53,allow,180,92,88,2,30,1,1
62931,50870,5228,4125,5228,allow,7069,1804,5265,20,3602,11,9
62932,16387,29288,0,0,allow,60,60,0,1,61,1,0
62933,16387,64374,0,0,allow,60,60,0,1,61,1,0
62934,16387,25523,0,0,allow,60,60,0,1,61,1,0
62935,65460,53,42143,53,allow,194,99,95,2,31,1,1
62936,51066,445,0,0,drop,66,66,0,1,0,1,0
62937,1025,64147,0,0,deny,62,62,0,1,0,1,0
62938,443,43775,0,0,deny,97,97,0,1,0,1,0
62939,49418,57470,0,0,deny,62,62,0,1,0,1,0
62940,62673,34159,0,0,deny,66,66,0,1,0,1,0
62941,46495,4607,0,0,deny,60,60,0,1,0,1,0
62942,56296,53,43298,53,allow,216,110,106,2,30,1,1
62943,50582,53,45109,53,allow,216,110,106,2,30,1,1
62944,65277,53,20067,53,allow,196,102,94,2,30,1,1
62945,65127,53,38412,53,allow,194,102,92,2,30,1,1
62946,50119,443,16718,443,allow,15168,5689,9479,51,34,27,24
62947,49160,28890,3522,28890,allow,830,150,680,4,1200,2,2
62948,57122,53,32018,53,allow,216,110,106,2,30,1,1
62949,50120,443,54666,443,allow,29503,9695,19808,55,34,30,25
62950,49364,53,61563,53,allow,182,94,88,2,30,1,1
62951,49769,443,1740,443,allow,13455,1982,11473,29,31,16,13
62952,56897,7003,14885,7003,allow,1098,672,426,14,734,8,6
62953,64950,53,11191,53,allow,326,88,238,4,52,2,2
62954,65460,53,26483,53,allow,197,102,95,2,30,1,1
62955,51716,57137,20087,57137,allow,70,70,0,1,5,1,0
62956,51720,51388,35731,51388,allow,70,70,0,1,5,1,0
62957,49364,53,40148,53,allow,182,94,88,2,30,1,1
62958,57108,53,35898,53,allow,193,102,91,2,30,1,1
62959,55824,53,60939,53,allow,819,102,717,2,30,1,1
62960,64614,53,52648,53,allow,168,86,82,2,31,1,1
62961,36448,80,28179,80,allow,1325,336,989,10,15,5,5
62962,51734,59825,40402,59825,allow,70,70,0,2,8,2,0
62963,60385,59696,28455,59696,allow,70,70,0,2,8,2,0
62964,34155,443,36605,443,allow,154,94,60,2,5,1,1
62965,23270,443,23270,443,allow,5802,2592,3210,24,76,14,10
62966,60382,62582,18649,62582,allow,70,70,0,2,8,2,0
62967,56435,53,21877,53,allow,193,102,91,2,30,1,1
62968,40804,8434,40804,8434,allow,156,156,0,3,8,3,0
62969,64580,53,23762,53,allow,199,102,97,2,30,1,1
62970,35666,443,50206,443,allow,3389452,85022,3304430,3290,159,997,2293
62971,55824,53,12441,53,allow,196,102,94,2,30,1,1
62972,57108,53,37838,53,allow,193,102,91,2,30,1,1
62973,19840,7000,19840,7000,allow,3610,2043,1567,16,17,9,7
62974,56234,443,33837,443,allow,8971,2446,6525,50,347,23,27
62975,65134,53,31124,53,allow,229,110,119,2,30,1,1
62976,36924,53,36924,53,allow,257,106,151,2,30,1,1
62977,57122,53,3566,53,allow,216,110,106,2,30,1,1
62978,65403,53,24512,53,allow,249,102,147,2,30,1,1
62979,50561,53,34475,53,allow,763,102,661,2,30,1,1
62980,63582,443,11318,443,allow,6178,1669,4509,19,15,11,8
62981,50969,80,54293,80,allow,921711,12229,909482,780,37,172,608
62982,52489,443,60427,443,allow,32975,9028,23947,39,15,18,21
62983,60744,40010,53059,40010,allow,316,136,180,6,5,3,3
62984,60381,26312,6064,26312,allow,70,70,0,2,8,2,0
62985,48016,443,47269,443,allow,138,78,60,2,5,1,1
62986,60306,443,28741,443,allow,9188,3421,5767,43,83,19,24
62987,50973,80,49428,80,allow,1095221,7065,1088156,829,36,105,724
62988,60380,55125,53805,55125,allow,70,70,0,2,8,2,0
62989,53156,51689,64576,51689,allow,546,306,240,9,142,5,4
62990,53541,59939,24806,59939,allow,70,70,0,2,7,2,0
62991,37523,443,28556,443,allow,154,94,60,2,4,1,1
62992,22352,443,22352,443,allow,6899,3403,3496,27,76,16,11
62993,51733,30688,48958,30688,allow,70,70,0,2,8,2,0
62994,57416,66,17429,66,allow,70,70,0,2,7,2,0
62995,56712,53,4721,53,allow,448,184,264,6,29,3,3
62996,50572,80,46272,80,allow,62,62,0,1,5,1,0
62997,64968,53,11604,53,allow,448,98,350,4,41,2,2
62998,52849,443,32844,443,allow,7735,1260,6475,16,133,7,9
62999,65123,53,24943,53,allow,307,110,197,2,29,1,1
63000,23276,443,23276,443,allow,4668,1745,2923,21,76,12,9
63001,55559,53,16251,53,allow,182,94,88,2,30,1,1
63002,49177,53,27104,53,allow,184,94,90,2,30,1,1
63003,55559,53,6941,53,allow,182,94,88,2,29,1,1
63004,55017,53,20456,53,allow,288,110,178,2,29,1,1
63005,64580,53,13673,53,allow,199,102,97,2,30,1,1
63006,57108,53,1595,53,allow,193,102,91,2,30,1,1
63007,56322,53,24189,53,allow,209,110,99,2,30,1,1
63008,64835,53,60535,53,allow,200,102,98,2,31,1,1
63009,60047,443,20320,443,allow,229060,38515,190545,283,135,113,170
63010,52155,80,42520,80,allow,1056,682,374,10,15,6,4
63011,56862,53,7245,53,allow,198,94,104,2,30,1,1
63012,49364,53,15202,53,allow,182,94,88,2,30,1,1
63013,56829,53,48980,53,allow,199,102,97,2,30,1,1
63014,33048,443,57285,443,allow,90054,6681,83373,104,133,33,71
63015,49168,443,13690,443,allow,519325,13798,505527,535,18,193,342
63016,55342,443,55342,443,allow,5593,2346,3247,22,39,13,9
63017,49648,7275,24792,7275,allow,8962,1625,7337,28,16,15,13
63018,48632,443,58774,443,allow,12433,4515,7918,32,136,17,15
63019,48631,443,20403,443,allow,42910,5005,37905,72,136,36,36
63020,50582,53,14787,53,allow,216,110,106,2,30,1,1
63021,57330,53,31519,53,allow,228,94,134,2,30,1,1
63022,65049,443,55584,443,allow,12674,1396,11278,12,139,2,10
63023,17750,30022,45838,30022,allow,481,150,331,2,1200,1,1
63024,51732,54299,27558,54299,allow,70,70,0,2,8,2,0
63025,64586,80,64586,80,allow,123115,6863,116252,160,29,76,84
63026,56435,53,33982,53,allow,193,102,91,2,30,1,1
63027,64615,53,40640,53,allow,198,94,104,2,30,1,1
63028,56829,53,59229,53,allow,199,102,97,2,30,1,1
63029,55535,53,57254,53,allow,199,102,97,2,30,1,1
63030,58082,443,14473,443,allow,45314943,1391230,43923713,47149,303,15196,31953
63031,49249,443,43033,443,allow,35406,17785,17621,79,141,40,39
63032,55535,53,2360,53,allow,199,102,97,2,31,1,1
63033,50265,6881,13047,6881,allow,491,150,341,2,1200,1,1
63034,50008,53,47667,53,allow,193,102,91,2,31,1,1
63035,63733,47013,45780,47013,allow,66,66,0,2,8,2,0
63036,48408,443,3268,443,allow,115036,11567,103469,189,103,92,97
63037,64357,53,38839,53,allow,469,103,366,4,43,2,2
63038,43078,80,13694,80,allow,1052,612,440,10,15,5,5
63039,50971,80,41640,80,allow,1094437,6233,1088204,817,36,92,725
63040,63945,53,38413,53,allow,216,110,106,2,30,1,1
63041,27999,443,45047,443,allow,5577,1390,4187,19,15,9,10
63042,61676,443,64478,443,allow,6353,1520,4833,20,17,12,8
63043,60900,443,23820,443,allow,134,60,74,3,6,2,1
63044,45540,8100,25472,8100,allow,234,234,0,4,12,4,0
63045,64659,53,14647,53,allow,464,99,365,4,39,2,2
63046,45227,80,43141,80,allow,1114,534,580,12,16,7,5
63047,43175,53,11498,53,allow,194,86,108,2,30,1,1
63048,50598,445,0,0,drop,70,70,0,1,0,1,0
63049,25565,55690,0,0,deny,60,60,0,1,0,1,0
63050,52668,51221,0,0,deny,66,66,0,1,0,1,0
63051,55664,445,0,0,drop,70,70,0,1,0,1,0
63052,55660,445,0,0,drop,70,70,0,1,0,1,0
63053,55659,445,0,0,drop,70,70,0,1,0,1,0
63054,51948,37965,0,0,deny,62,62,0,1,0,1,0
63055,51052,445,0,0,drop,66,66,0,1,0,1,0
63056,51054,445,0,0,drop,66,66,0,1,0,1,0
63057,51057,445,0,0,drop,66,66,0,1,0,1,0
63058,51051,445,0,0,drop,66,66,0,1,0,1,0
63059,51058,445,0,0,drop,66,66,0,1,0,1,0
63060,51055,445,0,0,drop,66,66,0,1,0,1,0
63061,51056,445,0,0,drop,66,66,0,1,0,1,0
63062,51050,445,0,0,drop,66,66,0,1,0,1,0
63063,5180,57866,0,0,deny,66,66,0,1,0,1,0
63064,48544,44847,0,0,deny,146,146,0,1,0,1,0
63065,49501,11392,0,0,deny,66,66,0,1,0,1,0
63066,57896,1,0,0,deny,100,100,0,1,0,1,0
63067,55618,56205,0,0,deny,66,66,0,1,0,1,0
63068,29706,50584,0,0,deny,66,66,0,1,0,1,0
63069,5121,35440,0,0,deny,62,62,0,1,0,1,0
63070,25151,58833,0,0,deny,62,62,0,1,0,1,0
63071,50594,445,0,0,drop,70,70,0,1,0,1,0
63072,56564,9571,0,0,deny,78,78,0,1,0,1,0
63073,44933,26467,0,0,deny,62,62,0,1,0,1,0
63074,28584,37965,0,0,deny,62,62,0,1,0,1,0
63075,41836,23,0,0,deny,60,60,0,1,0,1,0
63076,47910,7454,0,0,deny,60,60,0,1,0,1,0
63077,9471,23,0,0,deny,60,60,0,1,0,1,0
63078,50583,445,0,0,drop,70,70,0,1,0,1,0
63079,50585,445,0,0,drop,70,70,0,1,0,1,0
63080,6889,47807,0,0,deny,143,143,0,1,0,1,0
63081,50581,445,0,0,drop,70,70,0,1,0,1,0
63082,50579,445,0,0,drop,70,70,0,1,0,1,0
63083,62148,37965,0,0,deny,62,62,0,1,0,1,0
63084,50578,445,0,0,drop,70,70,0,1,0,1,0
63085,1025,35447,0,0,deny,62,62,0,1,0,1,0
63086,55654,445,0,0,drop,70,70,0,1,0,1,0
63087,55649,445,0,0,drop,70,70,0,1,0,1,0
63088,55644,445,0,0,drop,70,70,0,1,0,1,0
63089,44318,51180,0,0,deny,74,74,0,1,0,1,0
63090,51038,445,0,0,drop,66,66,0,1,0,1,0
63091,51037,445,0,0,drop,66,66,0,1,0,1,0
63092,51035,445,0,0,drop,66,66,0,1,0,1,0
63093,26379,23,0,0,deny,60,60,0,1,0,1,0
63094,6980,48543,0,0,deny,139,139,0,1,0,1,0
63095,20389,64147,0,0,deny,66,66,0,1,0,1,0
63096,55641,445,0,0,drop,70,70,0,1,0,1,0
63097,11404,64147,0,0,deny,62,62,0,1,0,1,0
63098,64000,44847,0,0,deny,66,66,0,1,0,1,0
63099,60246,44612,0,0,deny,66,66,0,1,0,1,0
63100,11136,15503,0,0,deny,145,145,0,1,0,1,0
63101,11136,17500,0,0,deny,62,62,0,1,0,1,0
63102,11136,57587,0,0,deny,62,62,0,1,0,1,0
63103,55639,445,0,0,drop,70,70,0,1,0,1,0
63104,50572,445,0,0,drop,70,70,0,1,0,1,0
63105,28832,36237,0,0,deny,66,66,0,1,0,1,0
63106,55635,445,0,0,drop,70,70,0,1,0,1,0
63107,55634,445,0,0,drop,70,70,0,1,0,1,0
63108,55632,445,0,0,drop,70,70,0,1,0,1,0
63109,30923,12883,0,0,deny,157,157,0,1,0,1,0
63110,57837,64147,0,0,deny,66,66,0,1,0,1,0
63111,50564,445,0,0,drop,70,70,0,1,0,1,0
63112,50563,445,0,0,drop,70,70,0,1,0,1,0
63113,59597,37965,0,0,deny,66,66,0,1,0,1,0
63114,5223,44091,0,0,deny,220,220,0,1,0,1,0
63115,50558,445,0,0,drop,70,70,0,1,0,1,0
63116,6975,29028,0,0,deny,139,139,0,1,0,1,0
63117,55621,445,0,0,drop,70,70,0,1,0,1,0
63118,55619,445,0,0,drop,70,70,0,1,0,1,0
63119,55615,445,0,0,deny,70,70,0,1,0,1,0
63120,6975,26543,0,0,deny,139,139,0,1,0,1,0
63121,50556,445,0,0,drop,70,70,0,1,0,1,0
63122,5637,37965,0,0,deny,62,62,0,1,0,1,0
63123,58486,57470,0,0,deny,66,66,0,1,0,1,0
63124,38681,15503,0,0,deny,74,74,0,1,0,1,0
63125,9756,26467,0,0,deny,62,62,0,1,0,1,0
63126,50052,65008,0,0,deny,60,60,0,1,0,1,0
63127,50552,445,0,0,drop,70,70,0,1,0,1,0
63128,51963,22114,0,0,deny,66,66,0,1,0,1,0
63129,4041,50584,0,0,deny,62,62,0,1,0,1,0
63130,58849,64147,0,0,deny,66,66,0,1,0,1,0
63131,51085,56205,0,0,deny,66,66,0,1,0,1,0
63132,42075,36237,0,0,deny,62,62,0,1,0,1,0
63133,50551,445,0,0,drop,70,70,0,1,0,1,0
63134,65016,37965,0,0,deny,66,66,0,1,0,1,0
63135,51014,445,0,0,drop,66,66,0,1,0,1,0
63136,42252,33303,0,0,deny,60,60,0,1,0,1,0
63137,24504,37965,0,0,deny,62,62,0,1,0,1,0
63138,55613,445,0,0,drop,70,70,0,1,0,1,0
63139,55606,445,0,0,drop,70,70,0,1,0,1,0
63140,60184,37965,0,0,deny,66,66,0,1,0,1,0
63141,3352,50584,0,0,deny,66,66,0,1,0,1,0
63142,50546,445,0,0,drop,70,70,0,1,0,1,0
63143,3052,20421,0,0,deny,104,104,0,1,0,1,0
63144,21998,51221,0,0,deny,62,62,0,1,0,1,0
63145,51009,445,0,0,drop,66,66,0,1,0,1,0
63146,61148,37965,0,0,deny,66,66,0,1,0,1,0
63147,42917,52952,0,0,deny,62,62,0,1,0,1,0
63148,51006,445,0,0,drop,66,66,0,1,0,1,0
63149,55601,445,0,0,drop,70,70,0,1,0,1,0
63150,55595,445,0,0,drop,70,70,0,1,0,1,0
63151,55591,445,0,0,drop,70,70,0,1,0,1,0
63152,55592,445,0,0,drop,70,70,0,1,0,1,0
63153,52788,64147,0,0,deny,66,66,0,1,0,1,0
63154,51004,445,0,0,drop,66,66,0,1,0,1,0
63155,55966,57866,0,0,deny,66,66,0,1,0,1,0
63156,36538,64147,0,0,deny,62,62,0,1,0,1,0
63157,53927,64147,0,0,deny,66,66,0,1,0,1,0
63158,11136,15503,0,0,deny,62,62,0,1,0,1,0
63159,5661,37965,0,0,deny,62,62,0,1,0,1,0
63160,52934,26467,0,0,deny,66,66,0,1,0,1,0
63161,9532,56205,0,0,deny,146,146,0,1,0,1,0
63162,56793,53,56695,53,allow,192,98,94,2,0,1,1
63163,50533,445,0,0,drop,70,70,0,1,0,1,0
63164,55586,445,0,0,drop,70,70,0,1,0,1,0
63165,49711,14984,0,0,deny,66,66,0,1,0,1,0
63166,5200,6643,0,0,deny,145,145,0,1,0,1,0
63167,52328,44847,0,0,deny,62,62,0,1,0,1,0
63168,51339,50584,0,0,deny,66,66,0,1,0,1,0
63169,55584,445,0,0,drop,70,70,0,1,0,1,0
63170,55582,445,0,0,drop,70,70,0,1,0,1,0
63171,55580,445,0,0,drop,70,70,0,1,0,1,0
63172,50995,445,0,0,deny,66,66,0,1,0,1,0
63173,9265,37965,0,0,deny,62,62,0,1,0,1,0
63174,50530,445,0,0,drop,70,70,0,1,0,1,0
63175,50994,445,0,0,drop,66,66,0,1,0,1,0
63176,50993,445,0,0,drop,66,66,0,1,0,1,0
63177,50989,445,0,0,drop,66,66,0,1,0,1,0
63178,33822,57470,0,0,deny,66,66,0,1,0,1,0
63179,50987,445,0,0,drop,66,66,0,1,0,1,0
63180,50985,445,0,0,drop,66,66,0,1,0,1,0
63181,50984,445,0,0,drop,66,66,0,1,0,1,0
63182,52690,7302,0,0,deny,66,66,0,1,0,1,0
63183,57954,48817,0,0,deny,78,78,0,1,0,1,0
63184,51353,46314,0,0,deny,145,145,0,1,0,1,0
63185,15056,2222,0,0,deny,60,60,0,1,0,1,0
63186,57360,18375,0,0,deny,66,66,0,1,0,1,0
63187,443,10010,0,0,deny,60,60,0,1,0,1,0
63188,50525,445,0,0,drop,70,70,0,1,0,1,0
63189,19367,35440,0,0,deny,146,146,0,1,0,1,0
63190,55578,445,0,0,drop,70,70,0,1,0,1,0
63191,55572,445,0,0,drop,70,70,0,1,0,1,0
63192,55573,445,0,0,drop,70,70,0,1,0,1,0
63193,50524,445,0,0,drop,70,70,0,1,0,1,0
63194,50982,445,0,0,drop,66,66,0,1,0,1,0
63195,55571,445,0,0,drop,70,70,0,1,0,1,0
63196,40898,5555,0,0,deny,60,60,0,1,0,1,0
63197,50979,445,0,0,drop,66,66,0,1,0,1,0
63198,1028,64147,0,0,deny,62,62,0,1,0,1,0
63199,50522,445,0,0,drop,70,70,0,1,0,1,0
63200,11552,44847,0,0,deny,62,62,0,1,0,1,0
63201,50977,445,0,0,drop,66,66,0,1,0,1,0
63202,50975,445,0,0,drop,66,66,0,1,0,1,0
63203,53957,35440,0,0,deny,62,62,0,1,0,1,0
63204,14255,2767,0,0,deny,62,62,0,1,0,1,0
63205,50973,445,0,0,drop,66,66,0,1,0,1,0
63206,53960,30041,0,0,deny,66,66,0,1,0,1,0
63207,49502,44847,0,0,deny,66,66,0,1,0,1,0
63208,7307,23,0,0,deny,60,60,0,1,0,1,0
63209,55566,445,0,0,drop,70,70,0,1,0,1,0
63210,32051,37965,0,0,deny,62,62,0,1,0,1,0
63211,50515,445,0,0,drop,70,70,0,1,0,1,0
63212,46389,27098,0,0,deny,66,66,0,1,0,1,0
63213,45964,55559,0,0,deny,60,60,0,1,0,1,0
63214,55559,445,0,0,drop,70,70,0,1,0,1,0
63215,55554,445,0,0,drop,70,70,0,1,0,1,0
63216,35347,20238,0,0,deny,66,66,0,1,0,1,0
63217,50513,445,0,0,drop,70,70,0,1,0,1,0
63218,7377,57470,0,0,deny,62,62,0,1,0,1,0
63219,54165,443,54165,443,allow,147750,13521,134229,182,92,84,98
63220,23406,443,23406,443,allow,5368,1609,3759,21,75,12,9
63221,58520,443,24680,443,allow,9429,3621,5808,60,80,26,34
63222,53912,3478,60537,3478,allow,3532,1792,1740,58,88,29,29
63223,65114,53,35237,53,allow,192,98,94,2,30,1,1
63224,60272,443,24375,443,allow,1853,1214,639,18,87,11,7
63225,54887,443,54887,443,allow,5573,2326,3247,22,40,13,9
63226,65154,443,37170,443,allow,5753,3034,2719,52,281,25,27
63227,50967,443,62336,443,allow,5841,1986,3855,19,17,11,8
63228,62306,443,62306,443,allow,5442,2195,3247,22,39,13,9
63229,60387,32087,24462,32087,allow,320,140,180,6,7,3,3
63230,63166,443,63166,443,allow,5407,2160,3247,22,38,13,9
63231,53436,443,59367,443,allow,7941,2678,5263,25,122,12,13
63232,64289,53,24247,53,allow,198,101,97,2,30,1,1
63233,50387,443,41513,443,allow,8507,1945,6562,21,33,10,11
63234,58884,15000,25949,15000,allow,138,78,60,2,5,1,1
63235,59395,443,39581,443,allow,5817,1995,3822,19,16,10,9
63236,53109,41661,38343,41661,allow,320,140,180,6,8,3,3
63237,37965,24475,30249,24475,allow,480,149,331,2,1200,1,1
63238,52173,443,52173,443,allow,201007,10015,190992,239,22,100,139
63239,64600,80,64600,80,allow,98859,6426,92433,136,27,68,68
63240,49430,443,47050,443,allow,18859,5795,13064,62,3666,28,34
63241,49660,53,64845,53,allow,186,95,91,2,30,1,1
63242,50172,443,51694,443,allow,3756,1914,1842,19,361,9,10
63243,57547,80,39933,80,allow,32368,2187,30181,45,337,23,22
63244,46477,443,29699,443,allow,4900,904,3996,16,97,9,7
63245,46478,443,23649,443,allow,493,280,213,8,97,5,3
63246,65176,53,13076,53,allow,299,103,196,4,51,2,2
63247,41624,15000,41127,15000,allow,130,70,60,2,5,1,1
63248,50008,53,29808,53,allow,186,95,91,2,30,1,1
63249,49154,80,61897,80,allow,2438,565,1873,10,75,6,4
63250,63403,443,54530,443,allow,4470,1597,2873,16,138,8,8
63251,49866,443,40314,443,allow,2937,717,2220,14,136,6,8
63252,30960,45676,24387,45676,allow,396,396,0,7,3616,7,0
63253,53151,29500,62396,29500,allow,514,274,240,8,143,4,4
63254,64926,53,43197,53,allow,192,98,94,2,40,1,1
63255,50012,7000,50012,7000,allow,3132,815,2317,14,16,7,7
63256,51731,39392,6820,39392,allow,70,70,0,2,8,2,0
63257,51709,40705,29645,40705,allow,66,66,0,1,5,1,0
63258,59396,443,16679,443,allow,5801,1995,3806,19,16,10,9
63259,55535,53,31917,53,allow,198,101,97,2,30,1,1
63260,52174,443,52174,443,allow,55503,7279,48224,79,22,32,47
63261,60271,443,5474,443,allow,10324,8406,1918,44,87,26,18
63262,65201,53,7188,53,allow,216,110,106,2,30,1,1
63263,55090,53,47013,53,allow,192,98,94,2,30,1,1
63264,54387,5228,7370,5228,allow,7019,1592,5427,25,3600,14,11
63265,56296,53,27962,53,allow,216,110,106,2,30,1,1
63266,59649,443,47146,443,allow,11784,7785,3999,55,120,28,27
63267,38603,5228,52662,5228,allow,3534,1679,1855,30,3640,11,19
63268,50965,445,0,0,drop,66,66,0,1,0,1,0
63269,50512,445,0,0,drop,70,70,0,1,0,1,0
63270,39100,2767,0,0,deny,62,62,0,1,0,1,0
63271,50511,445,0,0,drop,70,70,0,1,0,1,0
63272,50510,445,0,0,drop,70,70,0,1,0,1,0
63273,50507,445,0,0,drop,70,70,0,1,0,1,0
63274,50506,445,0,0,drop,70,70,0,1,0,1,0
63275,55142,26467,0,0,deny,62,62,0,1,0,1,0
63276,17777,30188,0,0,deny,62,62,0,1,0,1,0
63277,10965,22114,0,0,deny,62,62,0,1,0,1,0
63278,10965,22114,0,0,deny,146,146,0,1,0,1,0
63279,50955,445,0,0,drop,66,66,0,1,0,1,0
63280,65201,53,5294,53,allow,216,110,106,2,30,1,1
63281,62331,61689,0,0,deny,66,66,0,1,0,1,0
63282,55543,445,0,0,drop,70,70,0,1,0,1,0
63283,53233,51221,0,0,deny,66,66,0,1,0,1,0
63284,50492,445,0,0,drop,70,70,0,1,0,1,0
63285,50490,445,0,0,drop,70,70,0,1,0,1,0
63286,50485,445,0,0,drop,70,70,0,1,0,1,0
63287,50482,445,0,0,drop,70,70,0,1,0,1,0
63288,50481,445,0,0,drop,70,70,0,1,0,1,0
63289,38363,5900,0,0,deny,60,60,0,1,0,1,0
63290,50953,445,0,0,drop,66,66,0,1,0,1,0
63291,45912,44847,0,0,deny,62,62,0,1,0,1,0
63292,50945,445,0,0,drop,66,66,0,1,0,1,0
63293,56973,443,44291,443,allow,7481,2264,5217,22,135,10,12
63294,64869,443,59977,443,allow,6454,1227,5227,18,122,9,9
63295,52916,443,43880,443,allow,5455,1388,4067,17,15,9,8
63296,44633,443,21223,443,allow,5715,1536,4179,24,16,13,11
63297,50869,80,23647,80,allow,28291,3346,24945,46,144,25,21
63298,53540,34134,43313,34134,allow,70,70,0,2,7,2,0
63299,37987,49152,22842,49152,allow,156,156,0,3,7,3,0
63300,41995,80,63213,80,allow,1105,634,471,11,15,6,5
63301,52171,443,52171,443,allow,154883,8710,146173,182,23,69,113
63302,55535,53,24278,53,allow,199,102,97,2,29,1,1
63303,56322,53,19228,53,allow,209,110,99,2,29,1,1
63304,50008,53,33522,53,allow,193,102,91,2,29,1,1
63305,56615,443,6112,443,allow,22938,14436,8502,43,41,23,20
63306,47856,443,54908,443,allow,7816,2371,5445,34,255,18,16
63307,63734,28221,59198,28221,allow,66,66,0,2,7,2,0
63308,63732,40642,31051,40642,allow,66,66,0,2,7,2,0
63309,53536,34200,55904,34200,allow,70,70,0,2,7,2,0
63310,46641,8100,62793,8100,allow,234,234,0,4,11,4,0
63311,39953,80,18059,80,allow,1035,564,471,10,15,5,5
63312,48015,443,20608,443,allow,138,78,60,2,4,1,1
63313,55972,53,35969,53,allow,193,102,91,2,29,1,1
63314,55090,53,34414,53,allow,196,102,94,2,29,1,1
63315,55090,53,59676,53,allow,196,102,94,2,29,1,1
63316,56296,53,37666,53,allow,216,110,106,2,30,1,1
63317,53041,443,62358,443,allow,2881,346,2535,12,120,5,7
63318,17735,53,27345,53,allow,223,86,137,2,29,1,1
63319,64835,53,33008,53,allow,200,102,98,2,29,1,1
63320,56296,53,12716,53,allow,216,110,106,2,29,1,1
63321,57455,123,24910,123,allow,184,94,90,2,29,1,1
63322,55090,53,17815,53,allow,196,102,94,2,30,1,1
63323,56597,80,61984,80,allow,234,234,0,4,12,4,0
63324,51712,53203,62336,53203,allow,70,70,0,1,5,1,0
63325,51710,43069,28929,43069,allow,70,70,0,1,5,1,0
63326,53106,59478,22060,59478,allow,70,70,0,1,5,1,0
63327,49413,443,7382,443,allow,44505,6962,37543,64,48,21,43
63328,65114,53,28927,53,allow,196,102,94,2,30,1,1
63329,49173,27402,64212,27402,allow,70,70,0,1,5,1,0
63330,56764,45797,41990,45797,allow,164,70,94,2,5,1,1
63331,47975,443,46443,443,allow,8301,2172,6129,25,255,12,13
63332,60942,443,40230,443,allow,5081,896,4185,16,70,8,8
63333,65208,53,46888,53,allow,637,178,459,6,70,3,3
63334,56847,443,59529,443,allow,35160,6404,28756,82,196,31,51
63335,46550,443,33261,443,allow,7330,4420,2910,31,316,16,15
63336,34994,443,34994,443,allow,5046,2069,2977,20,15,11,9
63337,37234,53,61804,53,allow,168,78,90,2,30,1,1
63338,52176,443,52176,443,allow,126525,6370,120155,147,22,56,91
63339,50008,53,59037,53,allow,359,95,264,4,46,2,2
63340,63964,53,52901,53,allow,196,94,102,2,30,1,1
63341,57780,53,53500,53,allow,70,70,0,1,30,1,0
63342,6881,6881,26370,6881,allow,502,150,352,2,1200,1,1
63343,49542,443,62121,443,allow,40423,35897,4526,52,16,33,19
63344,65460,53,30831,53,allow,197,102,95,2,30,1,1
63345,53542,50321,25266,50321,allow,320,140,180,6,6,3,3
63346,56765,1841,2876,1841,allow,70,70,0,1,5,1,0
63347,45214,443,34615,443,allow,6641,4617,2024,34,80,18,16
63348,57470,34617,39417,34617,allow,481,150,331,2,1199,1,1
63349,39348,443,17067,443,allow,28301,21778,6523,88,125,49,39
63350,59683,443,22150,443,allow,13310,4422,8888,47,136,27,20
63351,57582,80,30299,80,allow,370,222,148,6,48,4,2
63352,60156,443,49389,443,allow,178,118,60,2,15,1,1
63353,50900,80,42676,80,allow,26867,2743,24124,45,140,23,22
63354,52088,443,13388,443,allow,16165,3877,12288,53,186,25,28
63355,50975,80,56708,80,allow,1095845,7641,1088204,839,35,114,725
63356,50976,80,46012,80,allow,1094127,5977,1088150,812,35,88,724
63357,37988,49152,27635,49152,allow,156,156,0,3,7,3,0
63358,27998,443,50249,443,allow,5515,1388,4127,18,15,9,9
63359,52917,443,10403,443,allow,5583,1390,4193,19,14,9,10
63360,56925,80,48459,80,allow,214,140,74,4,25,3,1
63361,50385,443,20761,443,allow,11098,2853,8245,25,33,12,13
63362,53715,443,45128,443,allow,70,70,0,2,8,2,0
63363,56680,8100,25887,8100,allow,234,234,0,4,11,4,0
63364,62729,51558,61898,51558,allow,70,70,0,1,4,1,0
63365,53517,48019,30847,48019,allow,70,70,0,1,4,1,0
63366,54964,443,18537,443,allow,24232,10141,14091,74,76,39,35
63367,50378,443,15906,443,allow,8663,1983,6680,21,33,10,11
63368,65176,53,64803,53,allow,299,103,196,4,51,2,2
63369,49660,53,23772,53,allow,193,102,91,2,30,1,1
63370,63945,53,51432,53,allow,216,110,106,2,29,1,1
63371,49450,53,27588,53,allow,227,94,133,2,29,1,1
63372,65127,53,53558,53,allow,194,102,92,2,29,1,1
63373,64416,53,53808,53,allow,211,94,117,2,30,1,1
63374,64414,53,58315,53,allow,406,142,264,2,30,1,1
63375,11582,41599,27860,41599,allow,70,70,0,2,8,2,0
63376,60715,80,28604,80,allow,198,78,120,4,11,2,2
63377,52485,443,22795,443,allow,22817,7615,15202,30,16,16,14
63378,56315,123,48493,123,allow,184,94,90,2,30,1,1
63379,43374,443,52439,443,allow,10176,2162,8014,25,186,14,11
63380,51713,33724,27696,33724,allow,70,70,0,1,5,1,0
63381,56756,13973,64423,13973,allow,70,70,0,1,5,1,0
63382,64614,53,61495,53,allow,538,179,359,6,63,3,3
63383,64289,53,50043,53,allow,199,102,97,2,30,1,1
63384,58984,443,13660,443,allow,4874459,114404,4760055,4469,188,1112,3357
63385,64289,53,28932,53,allow,199,102,97,2,30,1,1
63386,65201,53,42204,53,allow,216,110,106,2,30,1,1
63387,64289,53,64357,53,allow,199,102,97,2,30,1,1
63388,56536,443,9088,443,allow,8866,2743,6123,23,139,11,12
63389,51711,1027,5156,1027,allow,70,70,0,1,5,1,0
63390,52848,443,15385,443,allow,6218,1239,4979,14,133,7,7
63391,56926,80,46037,80,allow,214,140,74,4,25,3,1
63392,49820,123,49820,123,allow,184,94,90,2,30,1,1
63393,65460,53,40464,53,allow,197,102,95,2,30,1,1
63394,65201,53,38349,53,allow,216,110,106,2,30,1,1
63395,61178,53,58018,53,allow,290,86,204,2,30,1,1
63396,49222,53,61468,53,allow,418,150,268,2,30,1,1
63397,48555,53,5829,53,allow,215,86,129,2,30,1,1
63398,65114,53,27541,53,allow,196,102,94,2,31,1,1
63399,57947,443,51760,443,allow,3282,781,2501,17,136,8,9
63400,54631,443,52521,443,allow,2352,1394,958,17,275,9,8
63401,51077,80,9544,80,allow,9133,1055,8078,17,151,8,9
63402,6881,7560,34838,7560,allow,509,150,359,2,1199,1,1
63403,51610,443,19441,443,allow,6952,3608,3344,27,21,14,13
63404,60379,34301,5453,34301,allow,320,140,180,6,7,3,3
63405,58701,27030,51697,27030,allow,70,70,0,2,9,2,0
63406,42157,443,25655,443,allow,4819,2903,1916,29,81,15,14
63407,49660,53,56463,53,allow,193,102,91,2,31,1,1
63408,65515,53,22832,53,allow,338,107,231,4,39,2,2
63409,60318,80,34962,80,allow,2714,2154,560,12,26,7,5
63410,61382,443,28176,443,allow,32082,12801,19281,62,150,25,37
63411,42922,80,41285,80,allow,234,234,0,4,12,4,0
63412,49701,443,31912,443,allow,13022,1500,11522,30,23,15,15
63413,3964,51505,0,0,deny,62,62,0,1,0,1,0
63414,50939,445,0,0,drop,66,66,0,1,0,1,0
63415,50470,445,0,0,drop,70,70,0,1,0,1,0
63416,59196,34962,0,0,deny,148,148,0,1,0,1,0
63417,443,39878,0,0,deny,74,74,0,1,0,1,0
63418,49680,26467,0,0,deny,146,146,0,1,0,1,0
63419,443,32698,0,0,deny,89,89,0,1,0,1,0
63420,11020,62413,0,0,deny,62,62,0,1,0,1,0
63421,11967,57470,0,0,deny,62,62,0,1,0,1,0
63422,53030,56205,0,0,deny,66,66,0,1,0,1,0
63423,13947,37965,0,0,deny,145,145,0,1,0,1,0
63424,55536,445,0,0,drop,70,70,0,1,0,1,0
63425,55532,445,0,0,drop,70,70,0,1,0,1,0
63426,55531,445,0,0,drop,70,70,0,1,0,1,0
63427,50926,445,0,0,drop,66,66,0,1,0,1,0
63428,50928,445,0,0,drop,66,66,0,1,0,1,0
63429,50929,445,0,0,drop,66,66,0,1,0,1,0
63430,50925,445,0,0,drop,66,66,0,1,0,1,0
63431,4607,6004,0,0,deny,70,70,0,1,0,1,0
63432,50927,445,0,0,drop,66,66,0,1,0,1,0
63433,50930,445,0,0,drop,66,66,0,1,0,1,0
63434,50924,445,0,0,drop,66,66,0,1,0,1,0
63435,50923,445,0,0,drop,66,66,0,1,0,1,0
63436,50466,445,0,0,drop,70,70,0,1,0,1,0
63437,64166,35440,0,0,deny,66,66,0,1,0,1,0
63438,47013,37965,0,0,deny,62,62,0,1,0,1,0
63439,51953,37965,0,0,deny,66,66,0,1,0,1,0
63440,50457,445,0,0,drop,70,70,0,1,0,1,0
63441,50455,445,0,0,drop,70,70,0,1,0,1,0
63442,50453,445,0,0,drop,70,70,0,1,0,1,0
63443,50454,445,0,0,drop,70,70,0,1,0,1,0
63444,61845,11392,0,0,deny,66,66,0,1,0,1,0
63445,50449,445,0,0,drop,70,70,0,1,0,1,0
63446,37234,44847,0,0,deny,66,66,0,1,0,1,0
63447,38041,10104,0,0,deny,146,146,0,1,0,1,0
63448,21294,57470,0,0,deny,62,62,0,1,0,1,0
63449,38664,37965,0,0,deny,145,145,0,1,0,1,0
63450,55523,445,0,0,drop,70,70,0,1,0,1,0
63451,55520,445,0,0,drop,70,70,0,1,0,1,0
63452,55516,445,0,0,drop,70,70,0,1,0,1,0
63453,41852,35440,0,0,deny,62,62,0,1,0,1,0
63454,49717,666,0,0,deny,60,60,0,1,0,1,0
63455,51413,1,0,0,deny,72,72,0,1,0,1,0
63456,30303,30303,0,0,deny,171,171,0,1,0,1,0
63457,14993,50584,0,0,deny,62,62,0,1,0,1,0
63458,50910,445,0,0,drop,66,66,0,1,0,1,0
63459,50908,445,0,0,drop,66,66,0,1,0,1,0
63460,50907,445,0,0,drop,66,66,0,1,0,1,0
63461,2904,44847,0,0,deny,78,78,0,1,0,1,0
63462,53869,56205,0,0,deny,62,62,0,1,0,1,0
63463,55514,445,0,0,drop,70,70,0,1,0,1,0
63464,30399,44847,0,0,deny,146,146,0,1,0,1,0
63465,50444,445,0,0,drop,70,70,0,1,0,1,0
63466,58715,57470,0,0,deny,66,66,0,1,0,1,0
63467,55511,445,0,0,drop,70,70,0,1,0,1,0
63468,55504,445,0,0,drop,70,70,0,1,0,1,0
63469,55502,445,0,0,drop,70,70,0,1,0,1,0
63470,55500,445,0,0,drop,70,70,0,1,0,1,0
63471,58486,57470,0,0,deny,66,66,0,1,0,1,0
63472,50436,445,0,0,drop,70,70,0,1,0,1,0
63473,50971,443,37029,443,allow,469,403,66,4,0,3,1
63474,50970,443,47824,443,allow,469,403,66,4,0,3,1
63475,14613,12446,0,0,deny,66,66,0,1,0,1,0
63476,12694,12446,0,0,deny,62,62,0,1,0,1,0
63477,50433,445,0,0,drop,70,70,0,1,0,1,0
63478,6881,6881,0,0,deny,146,146,0,1,0,1,0
63479,6057,51221,0,0,deny,78,78,0,1,0,1,0
63480,18085,26467,0,0,deny,66,66,0,1,0,1,0
63481,8239,37965,0,0,deny,146,146,0,1,0,1,0
63482,33405,37965,0,0,deny,62,62,0,1,0,1,0
63483,50140,44847,0,0,deny,62,62,0,1,0,1,0
63484,53796,17546,0,0,deny,62,62,0,1,0,1,0
63485,50429,445,0,0,drop,70,70,0,1,0,1,0
63486,37316,22114,0,0,deny,62,62,0,1,0,1,0
63487,50428,445,0,0,drop,70,70,0,1,0,1,0
63488,55491,445,0,0,drop,70,70,0,1,0,1,0
63489,55489,445,0,0,drop,70,70,0,1,0,1,0
63490,55487,445,0,0,drop,70,70,0,1,0,1,0
63491,45908,3383,0,0,deny,60,60,0,1,0,1,0
63492,60617,64147,0,0,deny,62,62,0,1,0,1,0
63493,50424,445,0,0,drop,70,70,0,1,0,1,0
63494,61600,56205,0,0,deny,66,66,0,1,0,1,0
63495,50052,65008,0,0,deny,60,60,0,1,0,1,0
63496,50423,445,0,0,drop,70,70,0,1,0,1,0
63497,50886,445,0,0,drop,66,66,0,1,0,1,0
63498,56103,21247,0,0,deny,66,66,0,1,0,1,0
63499,57434,50584,0,0,deny,62,62,0,1,0,1,0
63500,55485,445,0,0,drop,70,70,0,1,0,1,0
63501,55483,445,0,0,drop,70,70,0,1,0,1,0
63502,54826,56205,0,0,deny,66,66,0,1,0,1,0
63503,40611,9571,0,0,deny,72,72,0,1,0,1,0
63504,51514,50584,0,0,deny,62,62,0,1,0,1,0
63505,50418,445,0,0,drop,70,70,0,1,0,1,0
63506,32124,30188,0,0,deny,62,62,0,1,0,1,0
63507,50853,50584,0,0,deny,66,66,0,1,0,1,0
63508,2791,7302,0,0,deny,62,62,0,1,0,1,0
63509,50881,445,0,0,drop,66,66,0,1,0,1,0
63510,1027,9822,0,0,deny,146,146,0,1,0,1,0
63511,50878,445,0,0,drop,66,66,0,1,0,1,0
63512,53771,37965,0,0,deny,66,66,0,1,0,1,0
63513,55471,445,0,0,drop,70,70,0,1,0,1,0
63514,55466,445,0,0,drop,70,70,0,1,0,1,0
63515,55467,445,0,0,drop,70,70,0,1,0,1,0
63516,55463,445,0,0,drop,70,70,0,1,0,1,0
63517,54346,44847,0,0,deny,66,66,0,1,0,1,0
63518,50875,445,0,0,drop,66,66,0,1,0,1,0
63519,45766,2323,0,0,deny,60,60,0,1,0,1,0
63520,58876,57470,0,0,deny,66,66,0,1,0,1,0
63521,24351,57470,0,0,deny,62,62,0,1,0,1,0
63522,18592,44612,0,0,deny,62,62,0,1,0,1,0
63523,6909,57470,0,0,deny,62,62,0,1,0,1,0
63524,50405,445,0,0,drop,70,70,0,1,0,1,0
63525,55458,445,0,0,drop,70,70,0,1,0,1,0
63526,2704,37,0,0,deny,60,60,0,1,0,1,0
63527,57226,51505,0,0,deny,66,66,0,1,0,1,0
63528,63287,44847,0,0,deny,62,62,0,1,0,1,0
63529,50402,445,0,0,drop,70,70,0,1,0,1,0
63530,56411,50584,0,0,deny,62,62,0,1,0,1,0
63531,55456,445,0,0,drop,70,70,0,1,0,1,0
63532,55454,445,0,0,drop,70,70,0,1,0,1,0
63533,55453,445,0,0,drop,70,70,0,1,0,1,0
63534,1036,64147,0,0,deny,62,62,0,1,0,1,0
63535,50868,445,0,0,drop,66,66,0,1,0,1,0
63536,25973,26467,0,0,deny,66,66,0,1,0,1,0
63537,50865,445,0,0,drop,66,66,0,1,0,1,0
63538,50863,445,0,0,drop,66,66,0,1,0,1,0
63539,50861,445,0,0,drop,66,66,0,1,0,1,0
63540,50856,445,0,0,drop,66,66,0,1,0,1,0
63541,50859,445,0,0,drop,66,66,0,1,0,1,0
63542,50858,445,0,0,drop,66,66,0,1,0,1,0
63543,63786,35440,0,0,deny,66,66,0,1,0,1,0
63544,62569,44847,0,0,deny,66,66,0,1,0,1,0
63545,58238,23,0,0,deny,60,60,0,1,0,1,0
63546,50397,445,0,0,drop,70,70,0,1,0,1,0
63547,35657,48637,0,0,deny,145,145,0,1,0,1,0
63548,50396,445,0,0,drop,70,70,0,1,0,1,0
63549,50200,44847,0,0,deny,74,74,0,1,0,1,0
63550,55450,445,0,0,drop,70,70,0,1,0,1,0
63551,55448,445,0,0,drop,70,70,0,1,0,1,0
63552,55446,445,0,0,drop,70,70,0,1,0,1,0
63553,50394,445,0,0,drop,70,70,0,1,0,1,0
63554,50854,445,0,0,drop,66,66,0,1,0,1,0
63555,52034,26467,0,0,deny,62,62,0,1,0,1,0
63556,55443,445,0,0,drop,70,70,0,1,0,1,0
63557,56783,43890,0,0,deny,66,66,0,1,0,1,0
63558,15274,19473,0,0,deny,62,62,0,1,0,1,0
63559,54540,22,0,0,deny,60,60,0,1,0,1,0
63560,50850,445,0,0,drop,66,66,0,1,0,1,0
63561,50971,44847,0,0,deny,62,62,0,1,0,1,0
63562,58916,21247,0,0,deny,146,146,0,1,0,1,0
63563,50849,445,0,0,drop,66,66,0,1,0,1,0
63564,50848,445,0,0,drop,66,66,0,1,0,1,0
63565,50584,51748,57588,51748,allow,1356,300,1056,6,1200,3,3
63566,56526,80,57143,80,allow,1056,682,374,10,15,6,4
63567,57149,443,55393,443,allow,1647,1375,272,9,37,5,4
63568,60069,443,60069,443,allow,5610,2363,3247,22,40,13,9
63569,60323,443,19514,443,allow,1743,1164,579,16,25,10,6
63570,60324,443,7520,443,allow,1743,1164,579,16,25,10,6
63571,62238,443,62238,443,allow,58141,3051,55090,78,78,29,49
63572,51648,80,61615,80,allow,3227,2425,802,9,31,5,4
63573,63383,53,63383,53,allow,235,90,145,2,33,1,1
63574,2267,53,19148,53,allow,826,826,0,8,44,8,0
63575,38085,443,21750,443,allow,234,234,0,4,12,4,0
63576,49573,80,24541,80,allow,180917,5183,175734,175,65,49,126
63577,51730,33399,62466,33399,allow,70,70,0,2,8,2,0
63578,64565,443,57848,443,allow,24984,2042,22942,41,33,19,22
63579,49579,80,10648,80,allow,277736,7810,269926,277,65,91,186
63580,49577,80,46203,80,allow,147113,4021,143092,144,65,41,103
63581,60321,443,49674,443,allow,1743,1164,579,16,25,10,6
63582,50047,443,50047,443,allow,4534,1627,2907,19,27,11,8
63583,56014,443,56014,443,allow,4334,1427,2907,19,30,11,8
63584,60320,443,16711,443,allow,1743,1164,579,16,25,10,6
63585,51704,9266,12391,9266,allow,66,66,0,1,5,1,0
63586,61692,443,18049,443,allow,126,60,66,3,10,2,1
63587,51727,1024,33037,1024,allow,70,70,0,2,8,2,0
63588,51705,59244,12307,59244,allow,66,66,0,1,5,1,0
63589,62235,443,62235,443,allow,16675,2296,14379,37,78,17,20
63590,63102,443,30669,443,allow,8848,3081,5767,56,335,26,30
63591,60832,5222,60932,5222,allow,3848,1039,2809,37,662,11,26
63592,56465,443,52483,443,allow,6081,844,5237,17,15,9,8
63593,63976,53,34685,53,allow,200,102,98,2,30,1,1
63594,5588,5588,0,0,allow,3562,1936,1626,48,194,24,24
63595,57256,443,52300,443,allow,47762,39522,8240,77,332,43,34
63596,50121,443,24047,443,allow,307104860,2750998,304353862,234597,6122,15017,219580
63597,56177,443,61837,443,allow,6826,5299,1527,22,330,12,10
63598,50060,80,8335,80,allow,2425,529,1896,11,75,6,5
63599,60322,443,12700,443,allow,1743,1164,579,16,25,10,6
63600,22419,1433,22419,1433,allow,146,60,86,2,9,1,1
63601,49576,80,6202,80,allow,174140,4942,169198,166,65,47,119
63602,30960,45656,54549,45656,allow,66,66,0,1,3600,1,0
63603,48817,6889,48817,6889,allow,480,149,331,2,1200,1,1
63604,50584,6881,63450,6881,allow,1320,300,1020,6,1200,3,3
63605,50584,62833,22282,62833,allow,1275,300,975,6,1200,3,3
63606,56597,53,9477,53,allow,197,197,0,3,60,3,0
63607,62102,443,60782,443,allow,3182,1568,1614,8,121,4,4
63608,50584,54321,2526,54321,allow,1275,300,975,6,1200,3,3
63609,50584,30773,22058,30773,allow,1356,300,1056,6,1200,3,3
63610,50584,45270,4666,45270,allow,1377,300,1077,6,1200,3,3
63611,30960,45665,23931,45665,allow,462,462,0,8,3632,8,0
63612,50845,445,0,0,drop,66,66,0,1,0,1,0
63613,51062,1433,0,0,deny,60,60,0,1,0,1,0
63614,57750,37965,0,0,deny,62,62,0,1,0,1,0
63615,50387,445,0,0,drop,70,70,0,1,0,1,0
63616,55440,445,0,0,drop,70,70,0,1,0,1,0
63617,50385,445,0,0,drop,70,70,0,1,0,1,0
63618,50102,17546,0,0,deny,66,66,0,1,0,1,0
63619,55432,445,0,0,drop,70,70,0,1,0,1,0
63620,55428,445,0,0,drop,70,70,0,1,0,1,0
63621,50384,445,0,0,drop,70,70,0,1,0,1,0
63622,443,25740,0,0,deny,131,131,0,1,0,1,0
63623,50383,445,0,0,drop,70,70,0,1,0,1,0
63624,27889,32480,0,0,deny,100,100,0,1,0,1,0
63625,50382,445,0,0,drop,70,70,0,1,0,1,0
63626,60192,35440,0,0,deny,62,62,0,1,0,1,0
63627,50378,445,0,0,drop,70,70,0,1,0,1,0
63628,50377,445,0,0,drop,70,70,0,1,0,1,0
63629,50837,445,0,0,drop,66,66,0,1,0,1,0
63630,443,10010,0,0,deny,60,60,0,1,0,1,0
63631,44258,25,0,0,deny,74,74,0,1,0,1,0
63632,45941,23386,0,0,deny,60,60,0,1,0,1,0
63633,6881,26296,0,0,deny,157,157,0,1,0,1,0
63634,59371,22114,0,0,deny,62,62,0,1,0,1,0
63635,11842,35440,0,0,deny,66,66,0,1,0,1,0
63636,50362,445,0,0,drop,70,70,0,1,0,1,0
63637,50361,445,0,0,drop,70,70,0,1,0,1,0
63638,50359,445,0,0,drop,70,70,0,1,0,1,0
63639,50827,445,0,0,drop,66,66,0,1,0,1,0
63640,58912,11392,0,0,deny,66,66,0,1,0,1,0
63641,55415,445,0,0,drop,70,70,0,1,0,1,0
63642,50351,445,0,0,drop,70,70,0,1,0,1,0
63643,50210,26467,0,0,deny,62,62,0,1,0,1,0
63644,5223,44091,0,0,deny,66,66,0,1,0,1,0
63645,58597,35440,0,0,deny,66,66,0,1,0,1,0
63646,61173,2323,0,0,deny,60,60,0,1,0,1,0
63647,50824,445,0,0,drop,66,66,0,1,0,1,0
63648,47398,7302,0,0,deny,62,62,0,1,0,1,0
63649,39839,67,0,0,deny,60,60,0,1,0,1,0
63650,43271,50584,0,0,deny,62,62,0,1,0,1,0
63651,17702,6881,0,0,deny,66,66,0,1,0,1,0
63652,27328,21247,0,0,deny,66,66,0,1,0,1,0
63653,60292,7129,0,0,deny,62,62,0,1,0,1,0
63654,43840,50265,0,0,deny,72,72,0,1,0,1,0
63655,62092,35440,0,0,deny,66,66,0,1,0,1,0
63656,54071,50265,0,0,deny,66,66,0,1,0,1,0
63657,64106,64147,0,0,deny,66,66,0,1,0,1,0
63658,50818,445,0,0,drop,66,66,0,1,0,1,0
63659,50340,445,0,0,drop,70,70,0,1,0,1,0
63660,50807,445,0,0,drop,66,66,0,1,0,1,0
63661,50336,445,0,0,drop,70,70,0,1,0,1,0
63662,55407,445,0,0,drop,70,70,0,1,0,1,0
63663,55403,445,0,0,drop,70,70,0,1,0,1,0
63664,55404,445,0,0,drop,70,70,0,1,0,1,0
63665,53472,17,0,0,deny,60,60,0,1,0,1,0
63666,59969,443,49407,443,allow,6655,1166,5489,21,360,11,10
63667,45001,443,55898,443,allow,570,318,252,10,20,6,4
63668,50584,6889,64241,6889,allow,1326,300,1026,6,1200,3,3
63669,50584,28020,62483,28020,allow,1302,300,1002,6,1200,3,3
63670,50584,54993,58004,54993,allow,652,300,352,4,1200,3,1
63671,58248,53,0,0,allow,633,83,550,2,30,1,1
63672,50880,80,36202,80,allow,395978,13168,382810,411,143,151,260
63673,59779,443,2318,443,allow,5834,1810,4024,24,17,13,11
63674,50535,22,50535,22,allow,6292,2375,3917,35,20,19,16
63675,57594,443,55656,443,allow,614577,24675,589902,673,149,228,445
63676,51737,54691,48488,54691,allow,316,136,180,6,5,3,3
63677,65476,53,44080,53,allow,226,110,116,2,29,1,1
63678,65304,53,52702,53,allow,194,86,108,2,29,1,1
63679,50056,27018,43222,27018,allow,468,390,78,5,29,4,1
63680,62678,53,62678,53,allow,216,90,126,2,30,1,1
63681,50584,51413,45972,51413,allow,1275,300,975,6,1200,3,3
63682,59162,80,16258,80,allow,1031,314,717,13,175,3,10
63683,65176,53,35354,53,allow,511,195,316,6,56,3,3
63684,42500,443,20918,443,allow,8932,2039,6893,23,24,12,11
63685,49885,443,30250,443,allow,4626083,113708,4512375,4382,213,1198,3184
63686,43210,443,51289,443,allow,5960402,99613,5860789,5017,133,952,4065
63687,52314,443,46456,443,allow,3448,1612,1836,31,36,17,14
63688,35498,80,39354,80,allow,1270,387,883,16,392,4,12
63689,49608,80,59432,80,allow,145752,3240,142512,128,61,23,105
63690,62237,443,62237,443,allow,169315,5255,164060,190,77,66,124
63691,60742,20010,63644,20010,allow,70,70,0,2,8,2,0
63692,51729,63553,13105,63553,allow,70,70,0,2,8,2,0
63693,63106,443,7897,443,allow,8712,3748,4964,51,255,23,28
63694,49577,53,54563,53,allow,384,94,290,2,30,1,1
63695,49703,80,27292,80,allow,71256,962,70294,63,52,11,52
63696,49700,80,44971,80,allow,71320,1026,70294,64,52,12,52
63697,49702,80,5138,80,allow,71256,962,70294,63,52,11,52
63698,60961,443,5669,443,allow,75122,4244,70878,101,45,48,53
63699,60239,53,53135,53,allow,219,102,117,2,30,1,1
63700,55610,53,9648,53,allow,265,91,174,4,36,2,2
63701,57170,53,13134,53,allow,298,102,196,4,36,2,2
63702,60777,443,22998,443,allow,10417,2617,7800,32,15,17,15
63703,50618,443,50618,443,allow,4351,1444,2907,19,28,11,8
63704,54810,80,61461,80,allow,6098,1916,4182,31,357,16,15
63705,60959,443,46440,443,allow,17149,2543,14606,40,46,22,18
63706,49634,443,7107,443,allow,1575,988,587,13,35,7,6
63707,50318,80,21534,80,allow,3855,828,3027,11,15,5,6
63708,60960,443,48167,443,allow,7488,1552,5936,23,46,13,10
63709,49359,53,57768,53,allow,102,102,0,1,60,1,0
63710,58248,53,0,0,allow,186,83,103,2,30,1,1
63711,60989,443,62484,443,allow,3182,1568,1614,8,120,4,4
63712,57798,443,21508,443,allow,12877,5188,7689,27,130,12,15
63713,65005,53,2818,53,allow,239,94,145,2,30,1,1
63714,50584,54741,14563,54741,allow,868,150,718,4,1200,2,2
63715,50584,15926,55734,15926,allow,1377,300,1077,6,1200,3,3
63716,49711,80,42345,80,allow,2269,821,1448,15,51,8,7
63717,49701,80,63516,80,allow,70321,956,69365,62,52,11,51
63718,62236,443,62236,443,allow,28126,3114,25012,50,77,22,28
63719,51708,21278,38128,21278,allow,70,70,0,1,5,1,0
63720,55581,64301,29198,64301,allow,316,190,126,5,15,3,2
63721,65008,53,8162,53,allow,312,94,218,2,30,1,1
63722,57266,53,22077,53,allow,209,102,107,2,30,1,1
63723,2267,53,3037,53,allow,826,826,0,8,44,8,0
63724,49891,443,20308,443,allow,1820,1101,719,18,73,10,8
63725,51571,443,51571,443,allow,1724,916,808,17,128,7,10
63726,52315,443,14653,443,allow,24304,2974,21330,57,34,31,26
63727,49609,80,24955,80,allow,11534,719,10815,18,61,7,11
63728,51572,443,51572,443,allow,1724,916,808,17,128,7,10
63729,53188,443,8819,443,allow,7878,3197,4681,22,18,11,11
63730,56009,53,4440,53,allow,232,94,138,2,30,1,1
63731,50584,25935,2865,25935,allow,1377,300,1077,6,1200,3,3
63732,50584,55624,58737,55624,allow,1326,300,1026,6,1200,3,3
63733,44847,6881,3655,6881,allow,324,150,174,2,1201,1,1
63734,50584,51413,47261,51413,allow,1275,300,975,6,1200,3,3
63735,55104,443,37071,443,allow,10470,3626,6844,20,131,9,11
63736,55385,443,7012,443,allow,11771,2624,9147,50,20,25,25
63737,44586,443,61467,443,allow,122708,5797,116911,169,132,75,94
63738,55036,443,41925,443,allow,10001,2547,7454,27,35,14,13
63739,50929,80,17624,80,allow,9630744,98097,9532647,7804,123,1387,6417
63740,60319,80,61391,80,allow,194,128,66,4,25,3,1
63741,52177,443,52177,443,allow,38013,6855,31158,58,21,25,33
63742,62233,443,62233,443,allow,41941,3388,38553,67,77,26,41
63743,63976,53,54161,53,allow,200,102,98,2,33,1,1
63744,51703,3010,58034,3010,allow,70,70,0,1,5,1,0
63745,56463,443,48725,443,allow,6364,1147,5217,19,24,11,8
63746,49892,443,65121,443,allow,1820,1101,719,18,73,10,8
63747,64584,80,64584,80,allow,142674,8057,134617,192,27,94,98
63748,65176,53,60246,53,allow,299,103,196,4,53,2,2
63749,49698,80,3522,80,allow,140258,1720,138538,117,52,18,99
63750,24009,53,46041,53,allow,223,86,137,2,29,1,1
63751,61669,443,27122,443,allow,12453,3460,8993,43,18,24,19
63752,49660,53,59057,53,allow,193,102,91,2,29,1,1
63753,53392,53,53392,53,allow,832,106,726,2,30,1,1
63754,65073,53,55415,53,allow,325,102,223,2,29,1,1
63755,65114,53,15041,53,allow,196,102,94,2,29,1,1
63756,7060,53,45870,53,allow,197,94,103,2,30,1,1
63757,58409,53,57147,53,allow,307,86,221,2,30,1,1
63758,56459,53,55165,53,allow,392,86,306,2,30,1,1
63759,49412,443,56019,443,allow,46271,6834,39437,63,47,19,44
63760,27393,53,7301,53,allow,168,78,90,2,30,1,1
63761,55330,53,4334,53,allow,216,102,114,2,30,1,1
63762,50584,56112,8598,56112,allow,1377,300,1077,6,1200,3,3
63763,50584,61467,32483,61467,allow,1377,300,1077,6,1200,3,3
63764,50584,11888,51615,11888,allow,1356,300,1056,6,1200,3,3
63765,59970,443,18481,443,allow,6720,1166,5554,22,360,11,11
63766,50584,40420,46560,40420,allow,868,150,718,4,1200,2,2
63767,50584,8999,18180,8999,allow,1356,300,1056,6,1200,3,3
63768,50584,49376,27285,49376,allow,1320,300,1020,6,1200,3,3
63769,50584,54157,4800,54157,allow,1377,300,1077,6,1200,3,3
63770,50584,6889,7914,6889,allow,1326,300,1026,6,1200,3,3
63771,13971,53,13971,53,allow,220,90,130,2,30,1,1
63772,63976,53,50670,53,allow,200,102,98,2,30,1,1
63773,49538,53,56684,53,allow,258,102,156,2,30,1,1
63774,50584,21094,39450,21094,allow,1356,300,1056,6,1200,3,3
63775,63542,3389,63542,3389,allow,3504,1790,1714,17,32,9,8
63776,54525,80,24122,80,allow,50436663,1205750,49230913,49415,198,16827,32588
63777,51725,32787,39792,32787,allow,70,70,0,2,8,2,0
63778,51706,30673,17118,30673,allow,70,70,0,1,5,1,0
63779,49630,443,54596,443,allow,7776,2266,5510,17,35,9,8
63780,65278,53,45335,53,allow,264,110,154,2,30,1,1
63781,58828,53,32002,53,allow,215,102,113,2,30,1,1
63782,50584,38578,41911,38578,allow,1377,300,1077,6,1200,3,3
63783,50584,16455,26852,16455,allow,1356,300,1056,6,1200,3,3
63784,55584,34914,32488,34914,allow,504,318,186,8,15,5,3
63785,43817,53,0,0,allow,82,82,0,2,40,2,0
63786,49688,443,44354,443,allow,318,192,126,6,53,4,2
63787,63718,80,18056,80,allow,314,192,122,6,15,4,2
63788,64038,53,4227,53,allow,321,102,219,2,30,1,1
63789,58562,53,31864,53,allow,215,102,113,2,30,1,1
63790,41267,443,45130,443,allow,8248,876,7372,25,186,9,16
63791,50584,51413,31560,51413,allow,800,150,650,4,1200,2,2
63792,50584,49001,36650,49001,allow,1290,300,990,6,1200,3,3
63793,50584,47174,17468,47174,allow,300,300,0,3,1200,3,0
63794,55877,62071,53667,62071,allow,481,150,331,2,1200,1,1
63795,53936,443,5510,443,allow,886,70,816,14,166,2,12
63796,49782,80,13908,80,allow,1661,1147,514,9,210,5,4
63797,50584,8569,42866,8569,allow,1356,300,1056,6,1200,3,3
63798,50584,6889,50435,6889,allow,1326,300,1026,6,1200,3,3
63799,6881,666,16595,666,allow,268,150,118,2,1199,1,1
63800,19987,53,54747,53,allow,208,86,122,2,30,1,1
63801,64745,53,11106,53,allow,196,94,102,2,31,1,1
63802,38770,5228,21583,5228,allow,6033,1874,4159,33,4073,11,22
63803,46999,993,56009,993,allow,45153,20621,24532,323,43,165,158
63804,50939,80,16478,80,allow,1375,1038,337,7,137,4,3
63805,54366,443,39148,443,allow,17629,5828,11801,39,41,20,19
63806,50933,80,44380,80,allow,9932735,85391,9847344,7875,123,1237,6638
63807,64602,80,64602,80,allow,18594,5204,13390,42,26,25,17
63808,52482,443,8869,443,allow,26154,6874,19280,35,17,16,19
63809,36716,53,54815,53,allow,224,78,146,2,31,1,1
63810,50796,445,0,0,drop,66,66,0,1,0,1,0
63811,50802,445,0,0,drop,66,66,0,1,0,1,0
63812,50800,445,0,0,drop,66,66,0,1,0,1,0
63813,50795,445,0,0,drop,66,66,0,1,0,1,0
63814,50798,445,0,0,drop,66,66,0,1,0,1,0
63815,50799,445,0,0,drop,66,66,0,1,0,1,0
63816,50797,445,0,0,drop,66,66,0,1,0,1,0
63817,50794,445,0,0,drop,66,66,0,1,0,1,0
63818,27125,51221,0,0,deny,62,62,0,1,0,1,0
63819,51535,64147,0,0,deny,66,66,0,1,0,1,0
63820,59477,36829,0,0,deny,66,66,0,1,0,1,0
63821,50327,445,0,0,drop,70,70,0,1,0,1,0
63822,50325,445,0,0,drop,70,70,0,1,0,1,0
63823,50322,445,0,0,drop,70,70,0,1,0,1,0
63824,50321,445,0,0,drop,70,70,0,1,0,1,0
63825,55704,64097,0,0,deny,66,66,0,1,0,1,0
63826,58338,3369,0,0,deny,60,60,0,1,0,1,0
63827,50319,445,0,0,drop,70,70,0,1,0,1,0
63828,50113,51505,0,0,deny,66,66,0,1,0,1,0
63829,19394,44847,0,0,deny,66,66,0,1,0,1,0
63830,35718,20238,0,0,deny,62,62,0,1,0,1,0
63831,55397,445,0,0,drop,70,70,0,1,0,1,0
63832,55394,445,0,0,drop,70,70,0,1,0,1,0
63833,55387,445,0,0,drop,70,70,0,1,0,1,0
63834,64767,51221,0,0,deny,62,62,0,1,0,1,0
63835,62787,51221,0,0,deny,66,66,0,1,0,1,0
63836,37538,37965,0,0,deny,66,66,0,1,0,1,0
63837,35377,43890,0,0,deny,62,62,0,1,0,1,0
63838,50780,445,0,0,drop,66,66,0,1,0,1,0
63839,50782,445,0,0,drop,66,66,0,1,0,1,0
63840,50779,445,0,0,drop,66,66,0,1,0,1,0
63841,55663,44847,0,0,deny,62,62,0,1,0,1,0
63842,50313,445,0,0,drop,70,70,0,1,0,1,0
63843,20706,37965,0,0,deny,62,62,0,1,0,1,0
63844,50626,43890,0,0,deny,62,62,0,1,0,1,0
63845,42969,8146,0,0,deny,62,62,0,1,0,1,0
63846,19963,2767,0,0,deny,66,66,0,1,0,1,0
63847,55386,445,0,0,drop,70,70,0,1,0,1,0
63848,51973,44847,0,0,deny,66,66,0,1,0,1,0
63849,62663,35253,0,0,deny,66,66,0,1,0,1,0
63850,55383,445,0,0,drop,70,70,0,1,0,1,0
63851,55377,445,0,0,drop,70,70,0,1,0,1,0
63852,55375,445,0,0,drop,70,70,0,1,0,1,0
63853,55373,445,0,0,drop,70,70,0,1,0,1,0
63854,50306,445,0,0,drop,70,70,0,1,0,1,0
63855,50304,445,0,0,drop,70,70,0,1,0,1,0
63856,6057,51221,0,0,deny,78,78,0,1,0,1,0
63857,64059,30188,0,0,deny,62,62,0,1,0,1,0
63858,58014,39004,0,0,deny,62,62,0,1,0,1,0
63859,12668,42707,0,0,deny,62,62,0,1,0,1,0
63860,9520,32480,0,0,deny,62,62,0,1,0,1,0
63861,50299,445,0,0,drop,70,70,0,1,0,1,0
63862,50298,445,0,0,drop,70,70,0,1,0,1,0
63863,59374,51505,0,0,deny,62,62,0,1,0,1,0
63864,55364,445,0,0,drop,70,70,0,1,0,1,0
63865,55360,445,0,0,drop,70,70,0,1,0,1,0
63866,55359,445,0,0,drop,70,70,0,1,0,1,0
63867,50294,445,0,0,drop,70,70,0,1,0,1,0
63868,60894,50584,0,0,deny,66,66,0,1,0,1,0
63869,11136,57587,0,0,deny,145,145,0,1,0,1,0
63870,17760,50584,0,0,deny,62,62,0,1,0,1,0
63871,60092,51505,0,0,deny,62,62,0,1,0,1,0
63872,50293,445,0,0,drop,70,70,0,1,0,1,0
63873,50840,57470,0,0,deny,66,66,0,1,0,1,0
63874,11825,38338,0,0,deny,86,86,0,1,0,1,0
63875,58036,443,0,0,deny,1097,1097,0,1,0,1,0
63876,0,0,0,0,allow,134,64,70,2,0,1,1
63877,64191,44847,0,0,deny,66,66,0,1,0,1,0
63878,443,50755,0,0,deny,102,102,0,1,0,1,0
63879,1256,50584,0,0,deny,146,146,0,1,0,1,0
63880,443,10010,0,0,deny,60,60,0,1,0,1,0
63881,3407,57866,0,0,deny,66,66,0,1,0,1,0
63882,50759,445,0,0,drop,66,66,0,1,0,1,0
63883,5195,64147,0,0,deny,66,66,0,1,0,1,0
63884,63503,42707,0,0,deny,66,66,0,1,0,1,0
63885,55358,445,0,0,drop,70,70,0,1,0,1,0
63886,55357,445,0,0,drop,70,70,0,1,0,1,0
63887,50288,445,0,0,drop,70,70,0,1,0,1,0
63888,56216,50584,0,0,deny,62,62,0,1,0,1,0
63889,50753,445,0,0,drop,66,66,0,1,0,1,0
63890,26795,6881,0,0,deny,146,146,0,1,0,1,0
63891,50750,445,0,0,drop,66,66,0,1,0,1,0
63892,55344,445,0,0,drop,70,70,0,1,0,1,0
63893,13188,35440,0,0,deny,66,66,0,1,0,1,0
63894,11777,37965,0,0,deny,62,62,0,1,0,1,0
63895,55341,445,0,0,drop,70,70,0,1,0,1,0
63896,55339,445,0,0,drop,70,70,0,1,0,1,0
63897,55335,445,0,0,drop,70,70,0,1,0,1,0
63898,50748,445,0,0,drop,66,66,0,1,0,1,0
63899,50274,445,0,0,drop,70,70,0,1,0,1,0
63900,45941,23386,0,0,deny,60,60,0,1,0,1,0
63901,63888,57470,0,0,deny,62,62,0,1,0,1,0
63902,50271,445,0,0,drop,70,70,0,1,0,1,0
63903,60524,64147,0,0,deny,66,66,0,1,0,1,0
63904,11651,64147,0,0,deny,145,145,0,1,0,1,0
63905,55330,445,0,0,drop,70,70,0,1,0,1,0
63906,5223,61002,0,0,deny,161,161,0,1,0,1,0
63907,63433,57866,0,0,deny,66,66,0,1,0,1,0
63908,64616,53,29802,53,allow,184,80,104,2,30,1,1
63909,61046,443,61046,443,allow,5830,2583,3247,22,40,13,9
63910,40710,5228,9746,5228,allow,4065,2585,1480,28,40,14,14
63911,40709,53,32661,53,allow,221,75,146,2,30,1,1
63912,50968,80,19228,80,allow,109660,1992,107668,99,35,20,79
63913,5588,5588,0,0,allow,3498,1872,1626,48,195,24,24
63914,993,54634,0,0,allow,66,66,0,1,90,1,0
63915,52765,443,14674,443,allow,283,163,120,4,16,2,2
63916,47740,443,62722,443,allow,6234,4369,1865,25,316,12,13
63917,50967,80,65454,80,allow,1439,697,742,12,35,6,6
63918,56149,80,45182,80,allow,1286,403,883,16,400,4,12
63919,50312,80,15679,80,allow,17102,1099,16003,19,16,5,14
63920,54368,443,18976,443,allow,10707,2548,8159,27,39,15,12
63921,34338,443,23040,443,allow,8152,3395,4757,27,18,15,12
63922,56896,80,32594,80,allow,2684,2550,134,7,16,5,2
63923,46488,443,7780,443,allow,87129,6924,80205,126,258,49,77
63924,54360,443,12392,443,allow,7723,2282,5441,22,255,11,11
63925,23293,443,23293,443,allow,50236,37417,12819,67,19,41,26
63926,56759,55201,4487,55201,allow,70,70,0,2,8,2,0
63927,24037,443,24037,443,allow,3611,2177,1434,24,17,13,11
63928,53535,1393,2385,1393,allow,70,70,0,2,8,2,0
63929,57595,80,57595,80,allow,254,120,134,5,26,3,2
63930,51724,25807,54569,25807,allow,70,70,0,2,8,2,0
63931,48381,53,16694,53,allow,221,75,146,2,30,1,1
63932,59808,443,49702,443,allow,147637,6160,141477,164,121,56,108
63933,65404,443,46166,443,allow,63040,3063,59977,78,129,30,48
63934,42298,40030,5035,40030,allow,146,84,62,2,31,1,1
63935,50073,443,21032,443,allow,9873,2384,7489,25,242,14,11
63936,55328,445,0,0,drop,70,70,0,1,0,1,0
63937,55326,445,0,0,drop,70,70,0,1,0,1,0
63938,55324,445,0,0,drop,70,70,0,1,0,1,0
63939,50282,37965,0,0,deny,66,66,0,1,0,1,0
63940,50739,445,0,0,drop,66,66,0,1,0,1,0
63941,33215,37965,0,0,deny,62,62,0,1,0,1,0
63942,32974,37965,0,0,deny,66,66,0,1,0,1,0
63943,50962,5900,0,0,deny,60,60,0,1,0,1,0
63944,50736,445,0,0,drop,66,66,0,1,0,1,0
63945,50733,445,0,0,drop,66,66,0,1,0,1,0
63946,50732,445,0,0,drop,66,66,0,1,0,1,0
63947,50731,445,0,0,drop,66,66,0,1,0,1,0
63948,50730,445,0,0,drop,66,66,0,1,0,1,0
63949,50728,445,0,0,drop,66,66,0,1,0,1,0
63950,50266,445,0,0,drop,70,70,0,1,0,1,0
63951,46090,50584,0,0,deny,66,66,0,1,0,1,0
63952,50265,445,0,0,drop,70,70,0,1,0,1,0
63953,443,29326,0,0,deny,82,82,0,1,0,1,0
63954,63729,6969,55353,6969,allow,66,66,0,2,8,2,0
63955,48203,80,21963,80,allow,946,531,415,11,315,6,5
63956,1924,80,29370,80,allow,214,140,74,4,15,3,1
63957,50263,445,0,0,drop,70,70,0,1,0,1,0
63958,57493,443,0,0,deny,60,60,0,1,0,1,0
63959,55323,445,0,0,drop,70,70,0,1,0,1,0
63960,55318,445,0,0,drop,70,70,0,1,0,1,0
63961,55320,445,0,0,drop,70,70,0,1,0,1,0
63962,50725,445,0,0,drop,66,66,0,1,0,1,0
63963,40703,5900,0,0,deny,60,60,0,1,0,1,0
63964,24311,22617,0,0,deny,60,60,0,1,0,1,0
63965,55315,445,0,0,drop,70,70,0,1,0,1,0
63966,34716,23,0,0,deny,60,60,0,1,0,1,0
63967,58338,3362,0,0,deny,60,60,0,1,0,1,0
63968,58338,3362,0,0,deny,60,60,0,1,0,1,0
63969,50723,445,0,0,drop,66,66,0,1,0,1,0
63970,49057,5900,0,0,deny,60,60,0,1,0,1,0
63971,50721,445,0,0,drop,66,66,0,1,0,1,0
63972,50720,445,0,0,drop,66,66,0,1,0,1,0
63973,23061,23,0,0,deny,60,60,0,1,0,1,0
63974,59037,51505,0,0,deny,66,66,0,1,0,1,0
63975,60435,35440,0,0,deny,62,62,0,1,0,1,0
63976,50717,445,0,0,drop,66,66,0,1,0,1,0
63977,5180,57866,0,0,deny,66,66,0,1,0,1,0
63978,49501,11392,0,0,deny,66,66,0,1,0,1,0
63979,50256,445,0,0,drop,70,70,0,1,0,1,0
63980,5223,1210,0,0,deny,103,103,0,1,0,1,0
63981,55618,56205,0,0,deny,66,66,0,1,0,1,0
63982,50254,445,0,0,drop,70,70,0,1,0,1,0
63983,52431,64147,0,0,deny,62,62,0,1,0,1,0
63984,58849,64147,0,0,deny,66,66,0,1,0,1,0
63985,55310,445,0,0,drop,70,70,0,1,0,1,0
63986,51426,52700,0,0,deny,100,100,0,1,0,1,0
63987,50253,445,0,0,drop,70,70,0,1,0,1,0
63988,23807,44847,0,0,deny,66,66,0,1,0,1,0
63989,52910,51221,0,0,deny,78,78,0,1,0,1,0
63990,55302,445,0,0,drop,70,70,0,1,0,1,0
63991,55300,445,0,0,drop,70,70,0,1,0,1,0
63992,50252,445,0,0,drop,70,70,0,1,0,1,0
63993,50251,445,0,0,drop,70,70,0,1,0,1,0
63994,54095,26467,0,0,deny,62,62,0,1,0,1,0
63995,50249,445,0,0,drop,70,70,0,1,0,1,0
63996,50246,445,0,0,drop,70,70,0,1,0,1,0
63997,50438,19426,0,0,deny,62,62,0,1,0,1,0
63998,51130,61689,0,0,deny,66,66,0,1,0,1,0
63999,515,10214,0,0,deny,62,62,0,1,0,1,0
64000,50708,445,0,0,drop,66,66,0,1,0,1,0
64001,7744,32480,0,0,deny,62,62,0,1,0,1,0
64002,443,29326,0,0,deny,82,82,0,1,0,1,0
64003,12232,18593,0,0,deny,139,139,0,1,0,1,0
64004,64277,30188,0,0,deny,62,62,0,1,0,1,0
64005,50233,445,0,0,drop,70,70,0,1,0,1,0
64006,50231,445,0,0,drop,70,70,0,1,0,1,0
64007,50230,445,0,0,drop,70,70,0,1,0,1,0
64008,50222,445,0,0,drop,70,70,0,1,0,1,0
64009,50223,445,0,0,drop,70,70,0,1,0,1,0
64010,65024,51505,0,0,deny,62,62,0,1,0,1,0
64011,5223,44091,0,0,deny,66,66,0,1,0,1,0
64012,5223,44091,0,0,deny,119,119,0,1,0,1,0
64013,5223,44091,0,0,deny,167,167,0,1,0,1,0
64014,6712,161,0,0,deny,82,82,0,1,0,1,0
64015,443,10010,0,0,deny,60,60,0,1,0,1,0
64016,52218,31573,0,0,deny,62,62,0,1,0,1,0
64017,50699,445,0,0,drop,66,66,0,1,0,1,0
64018,443,22238,0,0,deny,112,112,0,1,0,1,0
64019,44147,64147,0,0,deny,62,62,0,1,0,1,0
64020,28832,36237,0,0,deny,66,66,0,1,0,1,0
64021,55288,445,0,0,drop,70,70,0,1,0,1,0
64022,44411,37965,0,0,deny,62,62,0,1,0,1,0
64023,64601,80,64601,80,allow,56887,6820,50067,90,25,49,41
64024,58081,3389,58081,3389,allow,3549,1594,1955,18,16,10,8
64025,60743,40010,9730,40010,allow,316,136,180,6,6,3,3
64026,58438,53,46803,53,allow,246,102,144,2,29,1,1
64027,54373,443,3920,443,allow,16029,6377,9652,46,37,24,22
64028,54363,443,18639,443,allow,23766,10707,13059,80,42,41,39
64029,50316,80,27928,80,allow,1677,862,815,10,15,5,5
64030,54348,443,31489,443,allow,27760,9709,18051,56,45,27,29
64031,53817,443,11999,443,allow,7443,2043,5400,34,255,17,17
64032,53515,39608,40902,39608,allow,70,70,0,1,4,1,0
64033,33637,443,44559,443,allow,24214,18131,6083,81,118,44,37
64034,26758,443,6342,443,allow,20851,15854,4997,36,20,20,16
64035,46985,993,3733,993,allow,9725,3931,5794,46,48,25,21
64036,50028,53,56615,53,allow,323,110,213,2,29,1,1
64037,50013,53,8122,53,allow,662,195,467,6,39,3,3
64038,61670,443,47830,443,allow,5943,1991,3952,23,17,14,9
64039,38413,53,37201,53,allow,199,94,105,2,29,1,1
64040,37752,53,54109,53,allow,220,78,142,2,30,1,1
64041,59437,53,35841,53,allow,215,86,129,2,29,1,1
64042,58602,53,5583,53,allow,197,86,111,2,29,1,1
64043,56763,27734,6083,27734,allow,70,70,0,1,5,1,0
64044,34413,443,27966,443,allow,8107,2200,5907,34,255,16,18
64045,42805,443,52110,443,allow,130,70,60,2,15,1,1
64046,49445,80,19716,80,allow,1586,808,778,13,45,7,6
64047,54374,443,44819,443,allow,9131,3499,5632,39,24,21,18
64048,43221,443,25236,443,allow,72183,3193,68990,89,20,34,55
64049,49166,53,8191,53,allow,468,93,375,4,34,2,2
64050,55580,45817,63033,45817,allow,70,70,0,1,5,1,0
64051,51702,33451,34580,33451,allow,70,70,0,1,5,1,0
64052,55585,48063,46430,48063,allow,70,70,0,2,8,2,0
64053,64593,53,5715,53,allow,602,93,509,4,42,2,2
64054,43532,80,43879,80,allow,1449,364,1085,13,15,6,7
64055,65318,53,16200,53,allow,395,102,293,2,30,1,1
64056,43782,7275,17092,7275,allow,4955,1749,3206,24,16,15,9
64057,57768,7635,57768,7635,allow,138,78,60,2,6,1,1
64058,35105,443,59131,443,allow,639937,14873,625064,627,230,188,439
64059,43402,53,65461,53,allow,241,78,163,2,30,1,1
64060,56762,25080,40998,25080,allow,70,70,0,1,5,1,0
64061,49812,53,37839,53,allow,195,86,109,2,30,1,1
64062,39417,53,53271,53,allow,224,78,146,2,30,1,1
64063,52785,443,33714,443,allow,5806,1059,4747,16,63,8,8
64064,4683,53,49166,53,allow,207,86,121,2,30,1,1
64065,40885,443,32340,443,allow,4014,1592,2422,17,147,9,8
64066,49980,443,59748,443,allow,7227,4437,2790,29,271,16,13
64067,59420,53,63231,53,allow,224,78,146,2,30,1,1
64068,62103,443,43175,443,allow,6345,3495,2850,18,120,9,9
64069,57470,1136,15403,1136,allow,402,132,270,6,1209,3,3
64070,49505,53,46670,53,allow,232,110,122,2,30,1,1
64071,52203,80,56885,80,allow,432,246,186,7,40,4,3
64072,49154,53,7041,53,allow,763,204,559,6,40,3,3
64073,49792,53,58447,53,allow,339,110,229,2,30,1,1
64074,59801,443,35070,443,allow,5678,2820,2858,25,141,11,14
64075,61675,80,46507,80,allow,5108,676,4432,14,15,7,7
64076,60308,443,13749,443,allow,5445,1072,4373,24,80,11,13
64077,55583,14822,28217,14822,allow,70,70,0,1,5,1,0
64078,52402,53,52402,53,allow,212,98,114,2,30,1,1
64079,49230,53,32099,53,allow,195,94,101,2,30,1,1
64080,59943,443,41706,443,allow,2979,914,2065,10,120,5,5
64081,64585,80,64585,80,allow,405673,21057,384616,519,26,252,267
64082,49416,443,60307,443,allow,27484,4857,22627,42,46,15,27
64083,49646,443,41538,443,allow,5647,1832,3815,16,36,9,7
64084,60307,443,42783,443,allow,5574,1200,4374,26,80,13,13
64085,51140,443,48264,443,allow,5759,1904,3855,19,15,11,8
64086,53374,443,16272,443,allow,4317,1134,3183,16,26,9,7
64087,55579,58420,44629,58420,allow,70,70,0,1,5,1,0
64088,53375,443,59892,443,allow,4317,1134,3183,16,26,9,7
64089,65461,443,11386,443,allow,396698,11870,384828,409,16,144,265
64090,33099,443,5841,443,allow,11110,1700,9410,33,750,11,22
64091,56595,80,43530,80,allow,234,234,0,4,12,4,0
64092,39135,443,24335,443,allow,8286,2195,6091,24,256,12,12
64093,44363,443,4525,443,allow,10667,2992,7675,32,560,17,15
64094,33327,53,12719,53,allow,199,94,105,2,29,1,1
64095,51069,80,24367,80,allow,254,128,126,5,15,3,2
64096,47993,443,45711,443,allow,5272,1535,3737,17,35,12,5
64097,53868,53,29458,53,allow,86,86,0,1,30,1,0
64098,53663,80,16666,80,allow,149148,7515,141633,197,20,95,102
64099,55582,26957,64555,26957,allow,70,70,0,1,5,1,0
64100,50377,80,8000,80,allow,1451,796,655,11,31,6,5
64101,63709,21989,3950,21989,allow,696,508,188,10,16,7,3
64102,58866,53,56575,53,allow,355,118,237,2,29,1,1
64103,60425,443,26007,443,allow,1541,1004,537,14,26,8,6
64104,64947,53,12228,53,allow,402,118,284,2,29,1,1
64105,61412,53,24202,53,allow,225,78,147,2,30,1,1
64106,50355,443,60927,443,allow,4137,2232,1905,13,132,8,5
64107,41677,443,61867,443,allow,7292,1489,5803,21,187,11,10
64108,37965,51719,40903,51719,allow,481,150,331,2,1199,1,1
64109,35101,443,31000,443,allow,4988930,161289,4827641,5384,290,1964,3420
64110,51701,24343,49961,24343,allow,70,70,0,1,5,1,0
64111,55578,45682,64868,45682,allow,70,70,0,1,5,1,0
64112,50313,80,63654,80,allow,736,670,66,6,15,5,1
64113,46619,123,26763,123,allow,184,94,90,2,30,1,1
64114,36928,53,43446,53,allow,241,78,163,2,30,1,1
64115,37383,443,62473,443,allow,11389,4837,6552,27,120,13,14
64116,56761,34725,47498,34725,allow,70,70,0,1,5,1,0
64117,53180,443,55711,443,allow,7876,3195,4681,22,20,11,11
64118,5588,5588,0,0,allow,3562,1936,1626,48,192,24,24
64119,60302,443,30801,443,allow,39850,4375,35475,73,80,31,42
64120,57318,53,50520,53,allow,418,88,330,4,41,2,2
64121,55586,17332,63048,17332,allow,70,70,0,2,8,2,0
64122,44674,80,41945,80,allow,1298,624,674,12,16,5,7
64123,60374,17432,21315,17432,allow,564,318,246,9,18,5,4
64124,53283,443,23870,443,allow,9121,2486,6635,22,45,13,9
64125,64772,53,2611,53,allow,633,231,402,6,47,3,3
64126,59793,443,44894,443,allow,41635,3977,37658,63,121,25,38
64127,42025,443,40368,443,allow,2394,1365,1029,18,275,9,9
64128,62101,443,33220,443,allow,1867,250,1617,8,120,4,4
64129,56429,443,9683,443,allow,355939,9284,346655,365,121,125,240
64130,15503,21394,46725,21394,allow,479,150,329,2,1200,1,1
64131,6882,24271,34047,24271,allow,228,118,110,2,1200,1,1
64132,51726,18475,34444,18475,allow,316,136,180,6,7,3,3
64133,40299,443,53474,443,allow,9574,2600,6974,29,136,16,13
64134,64000,53,61132,53,allow,214,102,112,2,30,1,1
64135,51108,53,64155,53,allow,168,78,90,2,30,1,1
64136,57099,53,12968,53,allow,278,102,176,2,31,1,1
64137,52208,80,51352,80,allow,372,246,126,6,28,4,2
64138,56408,443,56408,443,allow,4373,1466,2907,19,28,11,8
64139,10602,3389,10602,3389,allow,3910,1805,2105,20,19,12,8
64140,50961,80,36404,80,allow,5730066,61301,5668765,4686,81,891,3795
64141,50308,80,8289,80,allow,1083,653,430,8,16,5,3
64142,58959,53,45652,53,allow,307,86,221,2,30,1,1
64143,30654,51221,0,0,deny,72,72,0,1,0,1,0
64144,63062,35440,0,0,deny,62,62,0,1,0,1,0
64145,49150,51505,0,0,deny,146,146,0,1,0,1,0
64146,61495,37965,0,0,deny,66,66,0,1,0,1,0
64147,53479,23,0,0,deny,60,60,0,1,0,1,0
64148,50696,445,0,0,drop,66,66,0,1,0,1,0
64149,28584,37965,0,0,deny,62,62,0,1,0,1,0
64150,21173,37965,0,0,deny,145,145,0,1,0,1,0
64151,43704,465,0,0,deny,60,60,0,1,0,1,0
64152,443,29326,0,0,deny,82,82,0,1,0,1,0
64153,64382,44847,0,0,deny,66,66,0,1,0,1,0
64154,50211,445,0,0,drop,70,70,0,1,0,1,0
64155,57837,64147,0,0,deny,66,66,0,1,0,1,0
64156,59241,62413,0,0,deny,66,66,0,1,0,1,0
64157,4431,32480,0,0,deny,66,66,0,1,0,1,0
64158,53051,44847,0,0,deny,66,66,0,1,0,1,0
64159,50681,445,0,0,drop,66,66,0,1,0,1,0
64160,50636,23117,0,0,deny,62,62,0,1,0,1,0
64161,64880,64147,0,0,deny,62,62,0,1,0,1,0
64162,4041,50584,0,0,deny,62,62,0,1,0,1,0
64163,2704,37,0,0,deny,60,60,0,1,0,1,0
64164,64279,23718,0,0,deny,146,146,0,1,0,1,0
64165,50207,445,0,0,drop,70,70,0,1,0,1,0
64166,62148,37965,0,0,deny,62,62,0,1,0,1,0
64167,50968,443,1243,443,allow,469,403,66,4,0,3,1
64168,50969,443,54163,443,allow,469,403,66,4,0,3,1
64169,56942,443,61847,443,allow,494,420,74,4,0,3,1
64170,47063,15503,0,0,deny,62,62,0,1,0,1,0
64171,55278,445,0,0,drop,70,70,0,1,0,1,0
64172,55276,445,0,0,drop,70,70,0,1,0,1,0
64173,55275,445,0,0,drop,70,70,0,1,0,1,0
64174,61706,64147,0,0,deny,62,62,0,1,0,1,0
64175,50674,445,0,0,drop,66,66,0,1,0,1,0
64176,50670,445,0,0,drop,66,66,0,1,0,1,0
64177,50668,445,0,0,drop,66,66,0,1,0,1,0
64178,50673,445,0,0,drop,66,66,0,1,0,1,0
64179,50671,445,0,0,drop,66,66,0,1,0,1,0
64180,50672,445,0,0,drop,66,66,0,1,0,1,0
64181,50666,445,0,0,drop,66,66,0,1,0,1,0
64182,50667,445,0,0,drop,66,66,0,1,0,1,0
64183,50198,445,0,0,drop,70,70,0,1,0,1,0
64184,50196,445,0,0,drop,70,70,0,1,0,1,0
64185,50195,445,0,0,drop,70,70,0,1,0,1,0
64186,50192,445,0,0,drop,70,70,0,1,0,1,0
64187,12694,12446,0,0,deny,145,145,0,1,0,1,0
64188,51085,56205,0,0,deny,66,66,0,1,0,1,0
64189,50191,445,0,0,drop,70,70,0,1,0,1,0
64190,54080,26467,0,0,deny,62,62,0,1,0,1,0
64191,6057,51221,0,0,deny,78,78,0,1,0,1,0
64192,6666,401,0,0,deny,60,60,0,1,0,1,0
64193,60184,37965,0,0,deny,66,66,0,1,0,1,0
64194,51948,37965,0,0,deny,62,62,0,1,0,1,0
64195,443,29326,0,0,deny,82,82,0,1,0,1,0
64196,50561,55777,0,0,deny,62,62,0,1,0,1,0
64197,55273,445,0,0,drop,70,70,0,1,0,1,0
64198,55265,445,0,0,drop,70,70,0,1,0,1,0
64199,55261,445,0,0,drop,70,70,0,1,0,1,0
64200,59059,80,0,0,deny,62,62,0,1,0,1,0
64201,50184,445,0,0,drop,70,70,0,1,0,1,0
64202,50654,445,0,0,drop,66,66,0,1,0,1,0
64203,50652,445,0,0,drop,66,66,0,1,0,1,0
64204,50653,445,0,0,drop,66,66,0,1,0,1,0
64205,3352,50584,0,0,deny,66,66,0,1,0,1,0
64206,55258,445,0,0,drop,70,70,0,1,0,1,0
64207,25151,58833,0,0,deny,62,62,0,1,0,1,0
64208,14903,10387,0,0,deny,159,159,0,1,0,1,0
64209,50177,445,0,0,drop,70,70,0,1,0,1,0
64210,55255,445,0,0,drop,70,70,0,1,0,1,0
64211,50174,445,0,0,drop,70,70,0,1,0,1,0
64212,45941,23386,0,0,deny,60,60,0,1,0,1,0
64213,57107,64147,0,0,deny,66,66,0,1,0,1,0
64214,55252,445,0,0,drop,70,70,0,1,0,1,0
64215,55251,445,0,0,drop,70,70,0,1,0,1,0
64216,55244,445,0,0,drop,70,70,0,1,0,1,0
64217,5223,1210,0,0,deny,103,103,0,1,0,1,0
64218,51716,44847,0,0,deny,62,62,0,1,0,1,0
64219,50065,44847,0,0,deny,62,62,0,1,0,1,0
64220,35849,30188,0,0,deny,146,146,0,1,0,1,0
64221,50170,445,0,0,drop,70,70,0,1,0,1,0
64222,36538,64147,0,0,deny,62,62,0,1,0,1,0
64223,50169,445,0,0,drop,70,70,0,1,0,1,0
64224,0,0,0,0,deny,60,60,0,1,0,1,0
64225,0,0,0,0,allow,480,244,236,4,0,2,2
64226,19416,23,0,0,deny,60,60,0,1,0,1,0
64227,24037,53415,0,0,deny,76,76,0,1,0,1,0
64228,50165,445,0,0,drop,70,70,0,1,0,1,0
64229,57360,18375,0,0,deny,66,66,0,1,0,1,0
64230,55235,445,0,0,drop,70,70,0,1,0,1,0
64231,55236,445,0,0,drop,70,70,0,1,0,1,0
64232,55231,445,0,0,drop,70,70,0,1,0,1,0
64233,60441,5900,0,0,deny,60,60,0,1,0,1,0
64234,50375,50584,0,0,deny,62,62,0,1,0,1,0
64235,50163,445,0,0,drop,70,70,0,1,0,1,0
64236,68,67,0,0,deny,594,594,0,1,0,1,0
64237,53957,35440,0,0,deny,62,62,0,1,0,1,0
64238,42995,26467,0,0,deny,62,62,0,1,0,1,0
64239,11552,44847,0,0,deny,62,62,0,1,0,1,0
64240,53960,30041,0,0,deny,66,66,0,1,0,1,0
64241,50159,445,0,0,drop,70,70,0,1,0,1,0
64242,50632,445,0,0,drop,66,66,0,1,0,1,0
64243,55230,445,0,0,drop,70,70,0,1,0,1,0
64244,55228,445,0,0,drop,70,70,0,1,0,1,0
64245,52451,56205,0,0,deny,66,66,0,1,0,1,0
64246,49386,64147,0,0,deny,62,62,0,1,0,1,0
64247,3777,64097,0,0,deny,146,146,0,1,0,1,0
64248,58446,56205,0,0,deny,62,62,0,1,0,1,0
64249,39100,2767,0,0,deny,62,62,0,1,0,1,0
64250,5223,1210,0,0,deny,66,66,0,1,0,1,0
64251,50626,445,0,0,drop,66,66,0,1,0,1,0
64252,50834,64147,0,0,deny,62,62,0,1,0,1,0
64253,50622,445,0,0,drop,66,66,0,1,0,1,0
64254,57763,52752,0,0,deny,66,66,0,1,0,1,0
64255,42298,40002,11642,40002,allow,724,550,174,4,30,2,2
64256,53471,8118,42759,8118,allow,1745,1091,654,10,31,5,5
64257,57814,443,32836,443,allow,6162,925,5237,18,108,10,8
64258,53004,80,58597,80,allow,9956,2570,7386,21,335,10,11
64259,58700,443,30626,443,allow,8124,1079,7045,16,26,8,8
64260,42298,51408,45869,51408,allow,725,325,400,12,31,6,6
64261,49631,53,0,0,allow,82,82,0,1,30,1,0
64262,52461,443,54450,443,allow,16541,4900,11641,62,131,26,36
64263,57263,443,6071,443,allow,7748,3859,3889,20,148,10,10
64264,52916,80,53748,80,allow,4266,1776,2490,20,367,11,9
64265,60152,80,38610,80,allow,1056,682,374,10,15,6,4
64266,53000,80,5659,80,allow,1991,686,1305,10,335,6,4
64267,52096,443,12292,443,allow,86745,6260,80485,121,32,58,63
64268,42298,40018,26921,40018,allow,148,86,62,2,30,1,1
64269,12299,53,12299,53,allow,229,89,140,2,30,1,1
64270,51167,443,46694,443,allow,13777,1743,12034,26,31,12,14
64271,50301,80,40498,80,allow,7979,802,7177,17,39,8,9
64272,63707,28423,64677,28423,allow,564,382,182,9,16,6,3
64273,38725,80,37134,80,allow,130,70,60,2,15,1,1
64274,49816,80,56471,80,allow,130,70,60,2,15,1,1
64275,43314,443,11137,443,allow,27958,21973,5985,77,403,43,34
64276,37780,443,20085,443,allow,1403708,31893,1371815,1301,162,292,1009
64277,51728,55504,11641,55504,allow,316,136,180,6,6,3,3
64278,39540,80,37629,80,allow,130,70,60,2,15,1,1
64279,63728,11785,52016,11785,allow,66,66,0,2,8,2,0
64280,42298,40031,35344,40031,allow,1346,662,684,8,32,4,4
64281,56753,38028,14806,38028,allow,156,66,90,2,5,1,1
64282,46981,443,34961,443,allow,2809,1884,925,19,25,11,8
64283,51698,63846,26436,63846,allow,66,66,0,1,5,1,0
64284,5588,5588,0,0,allow,3562,1936,1626,48,191,24,24
64285,65045,53,53307,53,allow,194,99,95,2,30,1,1
64286,35905,443,10061,443,allow,8272,2091,6181,25,331,12,13
64287,42298,40001,24361,40001,allow,140,78,62,2,31,1,1
64288,42298,40007,30822,40007,allow,143,81,62,2,31,1,1
64289,50027,80,48247,80,allow,3648,2069,1579,16,85,9,7
64290,53852,80,48149,80,allow,130,70,60,2,15,1,1
64291,52999,80,62826,80,allow,1991,686,1305,10,335,6,4
64292,52930,80,36918,80,allow,76193,2105,74088,75,359,23,52
64293,52928,80,52040,80,allow,1996,691,1305,10,359,6,4
64294,51699,37224,26533,37224,allow,66,66,0,1,5,1,0
64295,57813,443,65376,443,allow,6163,925,5238,18,109,10,8
64296,56754,14715,43516,14715,allow,66,66,0,1,5,1,0
64297,35965,443,35465,443,allow,14940,9434,5506,30,105,17,13
64298,50380,80,4994,80,allow,3190,980,2210,13,30,7,6
64299,39796,443,27327,443,allow,7425,2276,5149,24,16,12,12
64300,56876,443,56876,443,allow,18542,1778,16764,30,17,15,15
64301,42298,40036,17125,40036,allow,141,79,62,2,30,1,1
64302,34717,53,24183,53,allow,168,78,90,2,31,1,1
64303,42298,40006,18530,40006,allow,243,180,63,2,31,1,1
64304,54521,443,4685,443,allow,1574197,46737,1527460,1590,34,557,1033
64305,56524,53,52908,53,allow,711,87,624,2,31,1,1
64306,42298,40002,3434,40002,allow,241,178,63,2,31,1,1
64307,55461,443,39176,443,allow,2341,540,1801,9,121,5,4
64308,33624,443,6639,443,allow,247438,52606,194832,305,237,124,181
64309,63587,443,60950,443,allow,10576,3685,6891,46,92,24,22
64310,35087,443,32747,443,allow,6053,3586,2467,17,135,8,9
64311,42298,40025,58686,40025,allow,140,78,62,2,31,1,1
64312,42298,40019,18664,40019,allow,597,79,518,2,31,1,1
64313,42298,443,10335,443,allow,64,64,0,1,31,1,0
64314,50875,443,41381,443,allow,1786,172,1614,7,121,3,4
64315,123,123,7719,123,allow,184,94,90,2,31,1,1
64316,52797,443,2237,443,allow,6876,3332,3544,22,140,11,11
64317,5938,37145,0,0,allow,60,60,0,1,90,1,0
64318,55216,445,0,0,drop,70,70,0,1,0,1,0
64319,51426,59737,0,0,deny,100,100,0,1,0,1,0
64320,50146,445,0,0,drop,70,70,0,1,0,1,0
64321,55212,445,0,0,drop,70,70,0,1,0,1,0
64322,55211,445,0,0,drop,70,70,0,1,0,1,0
64323,55207,445,0,0,drop,70,70,0,1,0,1,0
64324,50620,445,0,0,drop,66,66,0,1,0,1,0
64325,53314,64097,0,0,deny,66,66,0,1,0,1,0
64326,50143,445,0,0,drop,70,70,0,1,0,1,0
64327,21998,51221,0,0,deny,62,62,0,1,0,1,0
64328,53233,51221,0,0,deny,66,66,0,1,0,1,0
64329,62331,61689,0,0,deny,66,66,0,1,0,1,0
64330,51769,80,52683,80,allow,74039,4367,69672,91,19,40,51
64331,50877,80,27709,80,allow,186520,11545,174975,222,141,96,126
64332,46417,443,30278,443,allow,359878,6703,353175,325,36,88,237
64333,58972,80,64079,80,allow,943,513,430,9,14,6,3
64334,52207,80,29595,80,allow,372,246,126,6,27,4,2
64335,65045,53,16728,53,allow,197,102,95,2,29,1,1
64336,56051,53,2559,53,allow,249,102,147,2,29,1,1
64337,50935,80,3414,80,allow,8167195,108448,8058747,7107,121,1531,5576
64338,34765,5222,48630,5222,allow,10109,3480,6629,72,615,38,34
64339,51567,443,51567,443,allow,1654,916,738,16,126,7,9
64340,49952,53,43225,53,allow,196,94,102,2,30,1,1
64341,35190,80,55473,80,allow,130,70,60,2,14,1,1
64342,50890,80,12548,80,allow,290951,15209,275742,327,141,132,195
64343,52206,80,42642,80,allow,372,246,126,6,27,4,2
64344,29025,53,29025,53,allow,235,90,145,2,31,1,1
64345,61713,80,49521,80,allow,134,60,74,3,5,2,1
64346,61707,80,47062,80,allow,134,60,74,3,4,2,1
64347,53350,80,3605,80,allow,1712,913,799,12,273,7,5
64348,47655,53,46246,53,allow,168,78,90,2,29,1,1
64349,64045,53,1404,53,allow,1011,232,779,6,55,3,3
64350,50876,80,52453,80,allow,121344,7345,113999,144,141,61,83
64351,64735,53,29173,53,allow,350,118,232,2,29,1,1
64352,49811,53,32866,53,allow,308,110,198,2,29,1,1
64353,64382,53,40543,53,allow,278,102,176,2,30,1,1
64354,65450,53,49502,53,allow,336,110,226,2,30,1,1
64355,33954,53,7602,53,allow,168,78,90,2,29,1,1
64356,52182,53,52182,53,allow,832,106,726,2,30,1,1
64357,49232,53,52451,53,allow,242,78,164,2,29,1,1
64358,51723,10622,43836,10622,allow,70,70,0,2,8,2,0
64359,59601,443,24962,443,allow,162,102,60,2,5,1,1
64360,53181,443,19571,443,allow,2309,1443,866,16,17,8,8
64361,52607,80,12616,80,allow,2543,691,1852,13,30,8,5
64362,42298,40022,6562,40022,allow,148,86,62,2,30,1,1
64363,23331,53,23331,53,allow,242,98,144,2,30,1,1
64364,53298,80,1119,80,allow,12660,7492,5168,27,274,14,13
64365,56377,80,8742,80,allow,1633,943,690,15,72,8,7
64366,55887,53,55333,53,allow,212,94,118,2,30,1,1
64367,53002,80,19802,80,allow,1601,761,840,10,334,6,4
64368,50892,80,51133,80,allow,256436,14131,242305,283,141,111,172
64369,56862,443,9641,443,allow,7819,1662,6157,20,76,11,9
64370,46746,443,33868,443,allow,7002,4142,2860,46,1485,29,17
64371,57092,53,3743,53,allow,228,102,126,2,30,1,1
64372,43705,443,47459,443,allow,8060,2001,6059,24,19,14,10
64373,52626,80,56571,80,allow,2820,1466,1354,20,534,11,9
64374,64351,53,15747,53,allow,228,102,126,2,30,1,1
64375,37707,53,28750,53,allow,168,78,90,2,30,1,1
64376,50886,80,22505,80,allow,312952,13869,299083,347,141,138,209
64377,49976,53,5693,53,allow,393,110,283,2,30,1,1
64378,42298,40007,6536,40007,allow,148,86,62,2,30,1,1
64379,54367,3389,54367,3389,allow,4365,2581,1784,20,32,11,9
64380,62768,443,53717,443,allow,30902,6307,24595,86,269,36,50
64381,50883,80,64742,80,allow,204646,11741,192905,240,141,104,136
64382,53006,80,12227,80,allow,1988,742,1246,10,334,6,4
64383,52960,80,43936,80,allow,82011,2937,79074,91,358,34,57
64384,59877,80,9809,80,allow,1306,557,749,10,25,6,4
64385,55179,53,7582,53,allow,194,102,92,2,33,1,1
64386,50873,80,11525,80,allow,173653,9305,164348,189,141,73,116
64387,50414,80,48434,80,allow,1657,1246,411,8,15,5,3
64388,49287,53,21721,53,allow,405,90,315,4,59,2,2
64389,42298,40007,31436,40007,allow,148,86,62,2,30,1,1
64390,65306,53,12072,53,allow,244,94,150,2,30,1,1
64391,45725,443,40804,443,allow,8600,4882,3718,44,225,23,21
64392,55028,443,3475,443,allow,1403116,30089,1373027,1321,32,404,917
64393,43208,443,45939,443,allow,4296557,96359,4200198,3781,143,838,2943
64394,50934,80,52977,80,allow,10213447,100765,10112682,8215,121,1412,6803
64395,42298,40022,48973,40022,allow,730,548,182,4,30,2,2
64396,60193,443,30919,443,allow,677029,102078,574951,1152,455,559,593
64397,63712,21917,18745,21917,allow,504,382,122,8,15,6,2
64398,52481,443,46031,443,allow,6270,1368,4902,22,15,12,10
64399,53206,80,36804,80,allow,2622,1074,1548,14,282,8,6
64400,52209,80,41464,80,allow,372,246,126,6,27,4,2
64401,53107,44060,63943,44060,allow,70,70,0,2,8,2,0
64402,43412,80,13841,80,allow,78,78,0,1,4,1,0
64403,36927,80,32507,80,allow,130,70,60,2,14,1,1
64404,65462,443,5746,443,allow,92384,4519,87865,105,15,39,66
64405,52210,80,30096,80,allow,372,246,126,6,30,4,2
64406,60470,443,16410,443,allow,7289,1899,5390,29,317,16,13
64407,53886,443,35805,443,allow,6074,1579,4495,18,125,11,7
64408,65045,53,56055,53,allow,197,102,95,2,32,1,1
64409,63366,30365,36289,30365,allow,70,70,0,1,4,1,0
64410,63704,28291,53778,28291,allow,504,382,122,8,15,6,2
64411,50889,80,11268,80,allow,397616,15684,381932,419,141,157,262
64412,65233,53,6826,53,allow,448,130,318,4,44,2,2
64413,65169,80,56657,80,allow,1516,481,1035,11,15,6,5
64414,47729,443,6419,443,allow,15600,2166,13434,32,205,16,16
64415,54498,443,44231,443,allow,8060,2001,6059,24,19,14,10
64416,64454,53,61289,53,allow,293,110,183,2,29,1,1
64417,65309,53,47712,53,allow,258,110,148,2,30,1,1
64418,57604,53,48752,53,allow,290,86,204,2,29,1,1
64419,54385,53,14777,53,allow,168,78,90,2,30,1,1
64420,50887,80,30027,80,allow,256649,11414,245235,280,141,111,169
64421,56404,80,13755,80,allow,17376,1687,15689,28,40,12,16
64422,55320,53,12991,53,allow,239,102,137,2,30,1,1
64423,58151,53,58151,53,allow,241,98,143,2,30,1,1
64424,42298,40020,48690,40020,allow,148,86,62,2,30,1,1
64425,41910,443,63630,443,allow,9358,2304,7054,39,120,20,19
64426,60520,53,60520,53,allow,198,90,108,2,30,1,1
64427,55087,53,44618,53,allow,344,110,234,2,30,1,1
64428,50388,53,36843,53,allow,177,94,83,2,30,1,1
64429,42298,40038,63975,40038,allow,148,86,62,2,30,1,1
64430,42298,40031,52392,40031,allow,156,94,62,2,30,1,1
64431,57589,53,7858,53,allow,165,78,87,2,30,1,1
64432,42298,40015,12335,40015,allow,140,78,62,2,31,1,1
64433,42298,40022,41026,40022,allow,717,551,166,4,31,2,2
64434,36567,443,58934,443,allow,2341,1054,1287,20,299,7,13
64435,64575,53,36717,53,allow,268,110,158,2,31,1,1
64436,53028,80,12775,80,allow,3470,1464,2006,21,190,10,11
64437,60735,28080,14759,28080,allow,70,70,0,1,5,1,0
64438,56376,80,29400,80,allow,1635,945,690,15,72,8,7
64439,50884,80,30103,80,allow,238059,13790,224269,276,141,113,163
64440,43465,80,31398,80,allow,1352,848,504,13,255,8,5
64441,5588,5588,0,0,allow,3498,1872,1626,48,195,24,24
64442,42298,40005,19733,40005,allow,148,86,62,2,30,1,1
64443,42298,40017,13967,40017,allow,148,86,62,2,30,1,1
64444,54942,53,0,0,allow,168,74,94,2,30,1,1
64445,52951,80,38288,80,allow,6266,4430,1836,22,358,13,9
64446,51697,60619,59919,60619,allow,70,70,0,1,5,1,0
64447,57802,80,24943,80,allow,2762,2628,134,8,17,6,2
64448,53271,443,53446,443,allow,34908,2650,32258,52,45,23,29
64449,64006,53,16897,53,allow,394,96,298,4,47,2,2
64450,65519,53,27344,53,allow,321,102,219,2,30,1,1
64451,42298,40005,17939,40005,allow,263,182,81,2,30,1,1
64452,42298,40039,50865,40039,allow,602,86,516,2,30,1,1
64453,50882,80,51896,80,allow,207895,10483,197412,229,141,90,139
64454,52946,80,56196,80,allow,4085,2870,1215,23,358,14,9
64455,55004,443,32429,443,allow,1334906,33112,1301794,1315,35,446,869
64456,52959,80,37640,80,allow,122572,3630,118942,128,358,46,82
64457,53534,40960,13903,40960,allow,320,140,180,6,6,3,3
64458,36486,80,36486,80,allow,15249,1015,14234,24,29,9,15
64459,56375,80,51111,80,allow,1609,919,690,15,72,8,7
64460,50874,80,33456,80,allow,331828,15003,316825,363,141,140,223
64461,55350,53,18566,53,allow,315,95,220,4,50,2,2
64462,41776,443,6550,443,allow,32434,15588,16846,164,1128,83,81
64463,42298,40008,62209,40008,allow,148,86,62,2,30,1,1
64464,42298,40042,16142,40042,allow,148,86,62,2,30,1,1
64465,42298,40028,40095,40028,allow,563,86,477,2,30,1,1
64466,10151,51413,40673,51413,allow,460,150,310,2,1200,1,1
64467,42298,40032,22903,40032,allow,720,549,171,4,30,2,2
64468,49899,53,23402,53,allow,718,94,624,2,30,1,1
64469,52824,443,27899,443,allow,4114,2920,1194,19,80,11,8
64470,39508,53,12625,53,allow,78,78,0,1,30,1,0
64471,65454,53,35372,53,allow,218,86,132,2,31,1,1
64472,27269,53,56522,53,allow,199,94,105,2,31,1,1
64473,42298,40010,41895,40010,allow,1082,86,996,2,31,1,1
64474,42298,40030,21853,40030,allow,546,486,60,2,30,1,1
64475,42298,40014,14476,40014,allow,148,86,62,2,31,1,1
64476,52431,443,19671,443,allow,7396,3677,3719,16,120,8,8
64477,64744,53,33076,53,allow,376,118,258,2,30,1,1
64478,42298,40014,10112,40014,allow,140,78,62,2,31,1,1
64479,51221,6881,43660,6881,allow,479,150,329,2,1200,1,1
64480,42298,40010,33875,40010,allow,148,86,62,2,31,1,1
64481,57587,443,4519,443,allow,15613,1408,14205,32,125,15,17
64482,59570,443,54074,443,allow,6713,3052,3661,49,5974,15,34
64483,57588,53,31636,53,allow,165,78,87,2,30,1,1
64484,49428,53,34747,53,allow,267,94,173,2,31,1,1
64485,42298,40020,47579,40020,allow,148,86,62,2,31,1,1
64486,42298,40021,40004,40021,allow,148,86,62,2,31,1,1
64487,39992,443,33603,443,allow,3470,1045,2425,13,121,6,7
64488,53512,23280,49318,23280,allow,1950,957,993,17,17,10,7
64489,50291,80,56837,80,allow,442,250,192,8,45,5,3
64490,59494,443,39878,443,allow,448,78,370,6,25,1,5
64491,50881,80,32099,80,allow,128327,7366,120961,154,141,67,87
64492,51510,443,23309,443,allow,1047,560,487,10,16,6,4
64493,50938,80,32549,80,allow,10272889,104948,10167941,8416,121,1525,6891
64494,49758,443,14307,443,allow,17412,6917,10495,38,63,20,18
64495,44924,53,44924,53,allow,235,90,145,2,32,1,1
64496,53522,24116,32649,24116,allow,70,70,0,2,8,2,0
64497,55640,53,37187,53,allow,797,208,589,6,67,3,3
64498,57959,21247,0,0,deny,66,66,0,1,0,1,0
64499,55203,445,0,0,drop,70,70,0,1,0,1,0
64500,55199,445,0,0,drop,70,70,0,1,0,1,0
64501,55198,445,0,0,drop,70,70,0,1,0,1,0
64502,55196,445,0,0,drop,70,70,0,1,0,1,0
64503,50611,445,0,0,drop,66,66,0,1,0,1,0
64504,50138,445,0,0,drop,70,70,0,1,0,1,0
64505,50604,445,0,0,drop,66,66,0,1,0,1,0
64506,50610,445,0,0,drop,66,66,0,1,0,1,0
64507,50606,445,0,0,drop,66,66,0,1,0,1,0
64508,5223,1210,0,0,deny,66,66,0,1,0,1,0
64509,5223,1210,0,0,deny,103,103,0,1,0,1,0
64510,50137,445,0,0,drop,70,70,0,1,0,1,0
64511,45912,44847,0,0,deny,62,62,0,1,0,1,0
64512,50603,445,0,0,drop,66,66,0,1,0,1,0
64513,50602,445,0,0,drop,66,66,0,1,0,1,0
64514,50601,445,0,0,drop,66,66,0,1,0,1,0
64515,50135,445,0,0,drop,70,70,0,1,0,1,0
64516,1025,64147,0,0,deny,62,62,0,1,0,1,0
64517,31062,50584,0,0,deny,62,62,0,1,0,1,0
64518,64177,44847,0,0,deny,66,66,0,1,0,1,0
64519,55193,445,0,0,drop,70,70,0,1,0,1,0
64520,55191,445,0,0,drop,70,70,0,1,0,1,0
64521,55190,445,0,0,drop,70,70,0,1,0,1,0
64522,52611,9571,0,0,deny,62,62,0,1,0,1,0
64523,59942,22114,0,0,deny,62,62,0,1,0,1,0
64524,50596,445,0,0,drop,66,66,0,1,0,1,0
64525,56798,9571,0,0,deny,66,66,0,1,0,1,0
64526,53030,56205,0,0,deny,66,66,0,1,0,1,0
64527,54827,50432,0,0,deny,109,109,0,1,0,1,0
64528,55187,445,0,0,drop,70,70,0,1,0,1,0
64529,50595,445,0,0,drop,66,66,0,1,0,1,0
64530,10494,23,0,0,deny,60,60,0,1,0,1,0
64531,1773,11392,0,0,deny,62,62,0,1,0,1,0
64532,50593,445,0,0,drop,66,66,0,1,0,1,0
64533,50592,445,0,0,drop,66,66,0,1,0,1,0
64534,55212,53733,0,0,deny,66,66,0,1,0,1,0
64535,50128,445,0,0,drop,70,70,0,1,0,1,0
64536,61670,57470,0,0,deny,74,74,0,1,0,1,0
64537,2704,37,0,0,deny,60,60,0,1,0,1,0
64538,50589,445,0,0,drop,66,66,0,1,0,1,0
64539,4607,6004,0,0,deny,70,70,0,1,0,1,0
64540,50126,445,0,0,drop,70,70,0,1,0,1,0
64541,55919,64147,0,0,deny,62,62,0,1,0,1,0
64542,50125,445,0,0,drop,70,70,0,1,0,1,0
64543,50124,445,0,0,drop,70,70,0,1,0,1,0
64544,55182,445,0,0,drop,70,70,0,1,0,1,0
64545,50123,445,0,0,drop,70,70,0,1,0,1,0
64546,49578,80,61645,80,allow,25846,2486,23360,39,50,16,23
64547,50118,445,0,0,drop,70,70,0,1,0,1,0
64548,50119,445,0,0,drop,70,70,0,1,0,1,0
64549,55172,445,0,0,drop,70,70,0,1,0,1,0
64550,55173,445,0,0,drop,70,70,0,1,0,1,0
64551,26573,44847,0,0,deny,66,66,0,1,0,1,0
64552,42469,30188,0,0,deny,62,62,0,1,0,1,0
64553,29145,8168,0,0,deny,62,62,0,1,0,1,0
64554,9775,30188,0,0,deny,62,62,0,1,0,1,0
64555,50578,445,0,0,drop,66,66,0,1,0,1,0
64556,9544,11392,0,0,deny,62,62,0,1,0,1,0
64557,50105,445,0,0,drop,70,70,0,1,0,1,0
64558,50104,445,0,0,drop,70,70,0,1,0,1,0
64559,50100,445,0,0,drop,70,70,0,1,0,1,0
64560,56564,9571,0,0,deny,78,78,0,1,0,1,0
64561,56100,57470,0,0,deny,62,62,0,1,0,1,0
64562,50095,445,0,0,drop,70,70,0,1,0,1,0
64563,50094,445,0,0,drop,70,70,0,1,0,1,0
64564,20939,60461,0,0,deny,60,60,0,1,0,1,0
64565,61357,64147,0,0,deny,62,62,0,1,0,1,0
64566,37234,44847,0,0,deny,66,66,0,1,0,1,0
64567,20939,60461,0,0,deny,60,60,0,1,0,1,0
64568,2904,44847,0,0,deny,78,78,0,1,0,1,0
64569,50571,445,0,0,drop,66,66,0,1,0,1,0
64570,55160,445,0,0,drop,70,70,0,1,0,1,0
64571,2704,37,0,0,deny,60,60,0,1,0,1,0
64572,45941,23386,0,0,deny,60,60,0,1,0,1,0
64573,50568,445,0,0,drop,66,66,0,1,0,1,0
64574,17916,23,0,0,deny,60,60,0,1,0,1,0
64575,50082,445,0,0,drop,70,70,0,1,0,1,0
64576,21294,57470,0,0,deny,62,62,0,1,0,1,0
64577,58715,57470,0,0,deny,66,66,0,1,0,1,0
64578,58635,51505,0,0,deny,62,62,0,1,0,1,0
64579,53353,26467,0,0,deny,62,62,0,1,0,1,0
64580,25342,8168,0,0,deny,66,66,0,1,0,1,0
64581,7916,23,0,0,deny,60,60,0,1,0,1,0
64582,50562,445,0,0,drop,66,66,0,1,0,1,0
64583,51233,43890,0,0,deny,66,66,0,1,0,1,0
64584,62588,57470,0,0,deny,146,146,0,1,0,1,0
64585,50553,445,0,0,drop,66,66,0,1,0,1,0
64586,50078,445,0,0,drop,70,70,0,1,0,1,0
64587,2791,7302,0,0,deny,62,62,0,1,0,1,0
64588,11967,57470,0,0,deny,62,62,0,1,0,1,0
64589,6057,51221,0,0,deny,78,78,0,1,0,1,0
64590,50067,445,0,0,drop,70,70,0,1,0,1,0
64591,50069,445,0,0,drop,70,70,0,1,0,1,0
64592,13160,7905,0,0,deny,62,62,0,1,0,1,0
64593,50065,445,0,0,drop,70,70,0,1,0,1,0
64594,50064,445,0,0,drop,70,70,0,1,0,1,0
64595,55152,445,0,0,drop,70,70,0,1,0,1,0
64596,55148,445,0,0,drop,70,70,0,1,0,1,0
64597,55147,445,0,0,drop,70,70,0,1,0,1,0
64598,55262,44847,0,0,deny,62,62,0,1,0,1,0
64599,50061,445,0,0,drop,70,70,0,1,0,1,0
64600,50546,445,0,0,drop,66,66,0,1,0,1,0
64601,50544,445,0,0,drop,66,66,0,1,0,1,0
64602,50545,445,0,0,drop,66,66,0,1,0,1,0
64603,50543,445,0,0,drop,66,66,0,1,0,1,0
64604,50542,445,0,0,drop,66,66,0,1,0,1,0
64605,50539,445,0,0,drop,66,66,0,1,0,1,0
64606,50540,445,0,0,drop,66,66,0,1,0,1,0
64607,50538,445,0,0,drop,66,66,0,1,0,1,0
64608,13179,57866,0,0,deny,62,62,0,1,0,1,0
64609,42753,56205,0,0,deny,62,62,0,1,0,1,0
64610,61600,56205,0,0,deny,66,66,0,1,0,1,0
64611,57955,44847,0,0,deny,62,62,0,1,0,1,0
64612,59586,57470,0,0,deny,66,66,0,1,0,1,0
64613,443,63113,0,0,deny,100,100,0,1,0,1,0
64614,11136,17500,0,0,deny,145,145,0,1,0,1,0
64615,50055,445,0,0,drop,70,70,0,1,0,1,0
64616,65528,62413,0,0,deny,62,62,0,1,0,1,0
64617,55145,445,0,0,drop,70,70,0,1,0,1,0
64618,55133,445,0,0,drop,70,70,0,1,0,1,0
64619,55131,445,0,0,drop,70,70,0,1,0,1,0
64620,35940,47808,0,0,deny,60,60,0,1,0,1,0
64621,58023,47808,0,0,deny,60,60,0,1,0,1,0
64622,50526,445,0,0,drop,66,66,0,1,0,1,0
64623,50524,445,0,0,drop,66,66,0,1,0,1,0
64624,50525,445,0,0,drop,66,66,0,1,0,1,0
64625,0,0,0,0,allow,600,306,294,6,0,3,3
64626,0,0,0,0,allow,600,306,294,6,0,3,3
64627,0,0,0,0,allow,600,306,294,6,0,3,3
64628,53771,37965,0,0,deny,66,66,0,1,0,1,0
64629,33405,37965,0,0,deny,62,62,0,1,0,1,0
64630,52321,26467,0,0,deny,62,62,0,1,0,1,0
64631,55129,445,0,0,drop,70,70,0,1,0,1,0
64632,50048,445,0,0,drop,70,70,0,1,0,1,0
64633,65493,51221,0,0,deny,62,62,0,1,0,1,0
64634,1487,35440,0,0,deny,146,146,0,1,0,1,0
64635,54346,44847,0,0,deny,66,66,0,1,0,1,0
64636,50046,445,0,0,drop,70,70,0,1,0,1,0
64637,50,64147,0,0,deny,66,66,0,1,0,1,0
64638,55127,445,0,0,drop,70,70,0,1,0,1,0
64639,18592,44612,0,0,deny,62,62,0,1,0,1,0
64640,55123,445,0,0,drop,70,70,0,1,0,1,0
64641,55120,445,0,0,drop,70,70,0,1,0,1,0
64642,55117,445,0,0,drop,70,70,0,1,0,1,0
64643,46627,36237,0,0,deny,62,62,0,1,0,1,0
64644,45941,23388,0,0,deny,60,60,0,1,0,1,0
64645,37213,36237,0,0,deny,66,66,0,1,0,1,0
64646,50041,445,0,0,drop,70,70,0,1,0,1,0
64647,50040,445,0,0,drop,70,70,0,1,0,1,0
64648,57226,51505,0,0,deny,66,66,0,1,0,1,0
64649,3272,1433,0,0,deny,60,60,0,1,0,1,0
64650,26799,50584,0,0,deny,146,146,0,1,0,1,0
64651,60132,50584,0,0,deny,66,66,0,1,0,1,0
64652,50036,445,0,0,drop,70,70,0,1,0,1,0
64653,23650,37807,0,0,deny,66,66,0,1,0,1,0
64654,49812,26467,0,0,deny,62,62,0,1,0,1,0
64655,63786,35440,0,0,deny,66,66,0,1,0,1,0
64656,62569,44847,0,0,deny,66,66,0,1,0,1,0
64657,62348,51221,0,0,deny,72,72,0,1,0,1,0
64658,50035,445,0,0,drop,70,70,0,1,0,1,0
64659,55109,445,0,0,drop,70,70,0,1,0,1,0
64660,55108,445,0,0,drop,70,70,0,1,0,1,0
64661,55103,445,0,0,drop,70,70,0,1,0,1,0
64662,47832,50584,0,0,deny,62,62,0,1,0,1,0
64663,6666,3389,0,0,deny,60,60,0,1,0,1,0
64664,8999,57470,0,0,deny,146,146,0,1,0,1,0
64665,15313,34068,0,0,deny,146,146,0,1,0,1,0
64666,50030,445,0,0,drop,70,70,0,1,0,1,0
64667,19099,56205,0,0,deny,62,62,0,1,0,1,0
64668,42298,4126,11425,4126,allow,132,64,68,2,30,1,1
64669,50450,80,35672,80,allow,2781,563,2218,11,125,6,5
64670,53189,80,57818,80,allow,1873,713,1160,10,15,5,5
64671,48757,443,52585,443,allow,6353,1075,5278,18,33,10,8
64672,50334,443,44789,443,allow,8863,1567,7296,24,41,12,12
64673,50348,443,42997,443,allow,1385,868,517,12,30,6,6
64674,50017,443,23366,443,allow,56408,47400,9008,88,138,49,39
64675,58196,53,55117,53,allow,578,286,292,9,16,5,4
64676,48758,443,1312,443,allow,6353,1075,5278,18,33,10,8
64677,50388,443,13080,443,allow,6734,4301,2433,21,29,12,9
64678,53525,34759,57554,34759,allow,70,70,0,2,8,2,0
64679,57957,80,26267,80,allow,3524,1945,1579,32,131,17,15
64680,54192,443,18650,443,allow,17821,7006,10815,95,448,48,47
64681,42298,40018,41162,40018,allow,629,83,546,4,31,2,2
64682,57170,53,64269,53,allow,200,102,98,2,31,1,1
64683,50451,80,13158,80,allow,2673,564,2109,11,125,6,5
64684,42298,58000,33594,58000,allow,596,256,340,10,30,5,5
64685,61484,443,59400,443,allow,9479,3507,5972,24,16,12,12
64686,53191,80,63359,80,allow,1871,712,1159,10,15,5,5
64687,42298,40023,18178,40023,allow,1531,729,802,10,31,5,5
64688,42298,40023,34639,40023,allow,1188,567,621,6,31,3,3
64689,59513,53,30834,53,allow,212,92,120,2,30,1,1
64690,57200,53,48391,53,allow,711,87,624,2,30,1,1
64691,35041,80,18613,80,allow,3515,1137,2378,12,30,7,5
64692,42298,40029,57945,40029,allow,652,83,569,4,31,2,2
64693,50391,443,17235,443,allow,5968,985,4983,17,29,8,9
64694,27735,53,27735,53,allow,235,90,145,2,32,1,1
64695,39200,443,57759,443,allow,8918,2361,6557,35,255,18,17
64696,53524,45395,6631,45395,allow,70,70,0,2,8,2,0
64697,49473,80,51676,80,allow,388,262,126,7,29,5,2
64698,48754,443,18594,443,allow,6490,1145,5345,20,33,11,9
64699,50336,443,6025,443,allow,8814,1579,7235,24,41,12,12
64700,50347,443,6764,443,allow,1385,868,517,12,30,6,6
64701,48755,443,25931,443,allow,6423,1145,5278,19,33,11,8
64702,53190,80,50867,80,allow,1873,713,1160,10,15,5,5
64703,49272,7000,49272,7000,allow,3132,815,2317,14,15,7,7
64704,54942,53,0,0,allow,631,74,557,2,30,1,1
64705,50028,443,29629,443,allow,15425,9901,5524,33,84,17,16
64706,57866,53,0,0,allow,216,80,136,2,30,1,1
64707,5588,5588,0,0,allow,3562,1936,1626,48,195,24,24
64708,42298,40009,62202,40009,allow,148,86,62,2,30,1,1
64709,55587,32217,8141,32217,allow,320,140,180,6,6,3,3
64710,50373,443,36496,443,allow,4695,859,3836,17,30,9,8
64711,50374,443,25596,443,allow,4749,859,3890,18,30,9,9
64712,50349,443,62395,443,allow,1385,868,517,12,30,6,6
64713,60424,443,16988,443,allow,1477,940,537,13,26,7,6
64714,50345,443,44342,443,allow,1385,868,517,12,30,6,6
64715,33818,443,39799,443,allow,16265,3132,13133,54,276,26,28
64716,50375,443,20024,443,allow,4707,865,3842,17,30,9,8
64717,50346,443,6974,443,allow,1385,868,517,12,30,6,6
64718,42298,40040,5414,40040,allow,140,78,62,2,30,1,1
64719,48756,443,37837,443,allow,6353,1075,5278,18,33,10,8
64720,42298,40027,29472,40027,allow,144,82,62,2,30,1,1
64721,5588,5588,0,0,allow,3498,1872,1626,48,195,24,24
64722,42298,40008,56571,40008,allow,206,84,122,4,31,2,2
64723,123,123,49338,123,allow,184,94,90,2,30,1,1
64724,59390,53,43106,53,allow,184,86,98,2,31,1,1
64725,49608,53,10158,53,allow,170,87,83,2,31,1,1
64726,55179,53,36377,53,allow,188,96,92,2,31,1,1
64727,49160,9703,22798,9703,allow,842,150,692,4,1200,2,2
64728,61741,443,4502,443,allow,68851,3430,65421,93,121,35,58
64729,57470,5382,65418,5382,allow,2411,1328,1083,19,1200,11,8
64730,53500,443,28730,443,allow,3036,975,2061,14,136,7,7
64731,50503,445,0,0,drop,66,66,0,1,0,1,0
64732,57750,37965,0,0,deny,62,62,0,1,0,1,0
64733,55100,445,0,0,drop,70,70,0,1,0,1,0
64734,55099,445,0,0,drop,70,70,0,1,0,1,0
64735,51197,30188,0,0,deny,66,66,0,1,0,1,0
64736,44746,37965,0,0,deny,62,62,0,1,0,1,0
64737,42298,25161,56288,25161,allow,138,70,68,2,30,1,1
64738,65196,53,4463,53,allow,177,94,83,2,30,1,1
64739,64369,53,59649,53,allow,240,110,130,2,30,1,1
64740,35414,53,44913,53,allow,168,78,90,2,30,1,1
64741,50876,443,55719,443,allow,1786,172,1614,7,120,3,4
64742,55718,27025,19303,27025,allow,1778,1386,392,8,30,4,4
64743,38167,443,36158,443,allow,6150,914,5236,18,16,10,8
64744,48731,443,51910,443,allow,769074,31261,737813,876,165,356,520
64745,51861,53,51861,53,allow,305,160,145,3,33,2,1
64746,63727,61557,39781,61557,allow,312,132,180,6,6,3,3
64747,63976,53,54023,53,allow,200,102,98,2,33,1,1
64748,42298,40028,3543,40028,allow,148,86,62,2,29,1,1
64749,62332,53,0,0,allow,633,75,558,2,29,1,1
64750,65196,53,58386,53,allow,177,94,83,2,30,1,1
64751,49935,53,55130,53,allow,458,111,347,4,59,2,2
64752,50305,80,32825,80,allow,5500,2829,2671,19,34,10,9
64753,53527,45626,48951,45626,allow,70,70,0,2,7,2,0
64754,50875,80,60669,80,allow,141059,7791,133268,168,140,72,96
64755,48726,443,17212,443,allow,6644134,184008,6460126,6659,204,2197,4462
64756,50931,80,59351,80,allow,7978844,97517,7881327,6752,120,1393,5359
64757,60406,443,21053,443,allow,8404,1892,6512,23,30,12,11
64758,33664,80,64127,80,allow,3667,1654,2013,20,189,11,9
64759,53530,8999,38471,8999,allow,70,70,0,2,7,2,0
64760,49838,53,62523,53,allow,866,221,645,6,56,3,3
64761,42298,40005,13329,40005,allow,148,86,62,2,29,1,1
64762,1156,53,45394,53,allow,278,86,192,2,29,1,1
64763,64250,53,22733,53,allow,314,102,212,2,29,1,1
64764,62486,53,33326,53,allow,303,303,0,4,47,4,0
64765,64284,53,35627,53,allow,306,94,212,2,29,1,1
64766,52107,53,0,0,allow,621,77,544,2,29,1,1
64767,65482,53,17558,53,allow,278,126,152,2,30,1,1
64768,42019,443,22698,443,allow,21620,7973,13647,112,488,57,55
64769,55577,80,44269,80,allow,70,70,0,1,5,1,0
64770,56751,32300,2097,32300,allow,70,70,0,1,5,1,0
64771,38258,443,9287,443,allow,5714,1536,4178,24,21,13,11
64772,49901,7000,49901,7000,allow,3310,1535,1775,15,15,8,7
64773,53737,443,33568,443,allow,12192,3674,8518,53,454,26,27
64774,49415,443,33045,443,allow,29561,4857,24704,44,44,15,29
64775,42298,40016,11792,40016,allow,148,86,62,2,30,1,1
64776,42298,40016,13493,40016,allow,148,86,62,2,30,1,1
64777,42298,443,6175,443,allow,70,70,0,1,30,1,0
64778,53182,443,48630,443,allow,6094,1073,5021,19,15,10,9
64779,51499,443,64851,443,allow,43980,3500,40480,65,16,31,34
64780,54991,53,33819,53,allow,177,94,83,2,30,1,1
64781,52021,443,14701,443,allow,7508,2350,5158,37,1323,21,16
64782,42298,40039,27373,40039,allow,148,86,62,2,30,1,1
64783,52394,53,35816,53,allow,168,78,90,2,30,1,1
64784,57353,443,37638,443,allow,150,150,0,1,5,1,0
64785,51498,443,51057,443,allow,29265,2836,26429,47,16,21,26
64786,50893,80,33062,80,allow,149442,8423,141019,177,140,76,101
64787,50390,443,34358,443,allow,1328,876,452,11,29,6,5
64788,50401,443,36442,443,allow,1124,594,530,12,26,6,6
64789,50398,80,47950,80,allow,318,192,126,6,26,4,2
64790,50400,443,29231,443,allow,1124,594,530,12,26,6,6
64791,50379,443,5364,443,allow,6748,1843,4905,21,29,11,10
64792,49472,80,16724,80,allow,318,192,126,6,28,4,2
64793,2582,80,2582,80,allow,8395,700,7695,17,15,8,9
64794,50395,443,41606,443,allow,6205,2761,3444,25,28,14,11
64795,50394,443,25886,443,allow,7584,1848,5736,19,29,10,9
64796,39609,53,46701,53,allow,168,78,90,2,30,1,1
64797,34531,80,18192,80,allow,467664,17895,449769,610,355,265,345
64798,35814,443,26348,443,allow,5205,1251,3954,18,15,10,8
64799,39158,53,23110,53,allow,168,78,90,2,30,1,1
64800,64803,53,24000,53,allow,303,303,0,4,47,4,0
64801,50914,443,65485,443,allow,6813,1729,5084,18,16,10,8
64802,42222,53,45931,53,allow,209,86,123,2,30,1,1
64803,56825,53,3164,53,allow,177,94,83,2,30,1,1
64804,39684,443,56331,443,allow,5150,853,4297,16,34,9,7
64805,57839,53,57631,53,allow,231,231,0,4,47,4,0
64806,42298,40008,65439,40008,allow,140,78,62,2,30,1,1
64807,55776,53,24282,53,allow,168,78,90,2,30,1,1
64808,42298,40001,45646,40001,allow,156,94,62,2,30,1,1
64809,49855,53,54307,53,allow,212,102,110,2,30,1,1
64810,65445,53,5000,53,allow,718,94,624,2,30,1,1
64811,34430,53,54160,53,allow,199,94,105,2,30,1,1
64812,57031,443,21412,443,allow,2963,797,2166,10,120,5,5
64813,42298,40033,43978,40033,allow,245,182,63,2,30,1,1
64814,33107,443,4785,443,allow,3820081,140348,3679733,4457,136,1736,2721
64815,50444,443,13843,443,allow,5593,996,4597,22,127,11,11
64816,49832,443,25686,443,allow,8589,2871,5718,26,46,14,12
64817,50392,443,55310,443,allow,1125,595,530,12,29,6,6
64818,50411,80,65137,80,allow,1657,1246,411,8,15,5,3
64819,61229,53,16392,53,allow,261,261,0,4,47,4,0
64820,59615,53,32493,53,allow,320,94,226,2,30,1,1
64821,56825,53,56167,53,allow,177,94,83,2,30,1,1
64822,42298,40031,8368,40031,allow,157,94,63,2,30,1,1
64823,57170,53,47776,53,allow,200,102,98,2,30,1,1
64824,50393,443,64712,443,allow,1125,595,530,12,29,6,6
64825,50888,80,61019,80,allow,538995,15959,523036,552,140,201,351
64826,50165,80,3536,80,allow,17387,9304,8083,30,56,19,11
64827,41049,443,3441,443,allow,197239,6098,191141,213,170,75,138
64828,50915,443,63177,443,allow,9599,3465,6134,20,16,11,9
64829,40189,80,30791,80,allow,5043,1656,3387,18,205,10,8
64830,50879,80,6049,80,allow,15453,3281,12172,29,140,16,13
64831,56891,53,55899,53,allow,226,110,116,2,30,1,1
64832,64737,53,9334,53,allow,269,110,159,2,30,1,1
64833,42298,40042,19672,40042,allow,148,86,62,2,30,1,1
64834,42298,40016,35583,40016,allow,157,94,63,2,30,1,1
64835,52724,80,24269,80,allow,9532,745,8787,18,113,9,9
64836,42657,443,20758,443,allow,10204,2106,8098,37,255,19,18
64837,51502,443,28500,443,allow,10204,5034,5170,45,16,25,20
64838,56758,40000,32207,40000,allow,70,70,0,2,8,2,0
64839,56568,53,11893,53,allow,306,306,0,4,47,4,0
64840,35497,443,49704,443,allow,162,102,60,2,4,1,1
64841,51695,37590,12016,37590,allow,70,70,0,1,5,1,0
64842,55575,31948,50458,31948,allow,70,70,0,1,5,1,0
64843,47264,80,26226,80,allow,1737,796,941,12,16,7,5
64844,50542,443,16831,443,allow,5347,2537,2810,17,120,8,9
64845,50947,80,65255,80,allow,5427472,61630,5365842,4509,79,894,3615
64846,64842,53,15693,53,allow,340,95,245,4,47,2,2
64847,50945,80,53857,80,allow,6920116,91852,6828264,6765,79,1277,5488
64848,50399,80,19756,80,allow,318,192,126,6,26,4,2
64849,51157,443,53993,443,allow,5378,1423,3955,19,22,11,8
64850,42658,443,41427,443,allow,10170,2072,8098,37,255,19,18
64851,50292,80,5743,80,allow,442,250,192,8,44,5,3
64852,53520,37553,50212,37553,allow,70,70,0,2,7,2,0
64853,53528,20485,38765,20485,allow,70,70,0,2,7,2,0
64854,53531,48908,54109,48908,allow,70,70,0,2,7,2,0
64855,48729,443,23852,443,allow,8504354,221135,8283219,8447,196,2721,5726
64856,51500,443,12798,443,allow,49843,3506,46337,77,16,39,38
64857,65447,53,29961,53,allow,330,105,225,4,37,2,2
64858,51630,80,41968,80,allow,7679,5325,2354,15,29,8,7
64859,62597,53,49610,53,allow,306,306,0,4,47,4,0
64860,49827,443,4607,443,allow,21625,7638,13987,45,48,24,21
64861,50913,443,27670,443,allow,5057,851,4206,15,16,9,6
64862,42298,40009,56378,40009,allow,148,86,62,2,29,1,1
64863,50894,80,18419,80,allow,53024,5569,47455,72,140,35,37
64864,27288,53,2459,53,allow,199,94,105,2,30,1,1
64865,43057,80,9462,80,allow,1195,401,794,9,16,5,4
64866,62332,53,0,0,allow,170,75,95,2,29,1,1
64867,52107,53,0,0,allow,210,77,133,2,29,1,1
64868,57866,53,0,0,allow,627,80,547,2,29,1,1
64869,50388,53,14304,53,allow,177,94,83,2,29,1,1
64870,42298,40012,32444,40012,allow,148,86,62,2,29,1,1
64871,42298,40031,50162,40031,allow,1341,657,684,8,30,4,4
64872,46295,443,11323,443,allow,9938,1398,8540,9,128,1,8
64873,42298,40034,23763,40034,allow,588,86,502,2,30,1,1
64874,42298,40013,37939,40013,allow,205,83,122,4,30,2,2
64875,55875,53,42726,53,allow,228,110,118,2,30,1,1
64876,42298,40023,18406,40023,allow,1487,743,744,10,30,5,5
64877,30188,36914,20864,36914,allow,2668,1950,718,16,7827,14,2
64878,42298,40003,32102,40003,allow,206,84,122,4,30,2,2
64879,51576,443,48626,443,allow,21523,4681,16842,37,149,18,19
64880,44816,80,47339,80,allow,130,70,60,2,15,1,1
64881,56752,43888,19580,43888,allow,70,70,0,1,5,1,0
64882,53185,443,12844,443,allow,8020,1134,6886,23,15,11,12
64883,54951,443,4064,443,allow,30123,21849,8274,65,77,38,27
64884,51496,443,41580,443,allow,1177,624,553,12,16,7,5
64885,53183,443,26366,443,allow,6094,1073,5021,19,15,10,9
64886,50958,53,30226,53,allow,264,264,0,4,47,4,0
64887,53986,53,63410,53,allow,306,306,0,4,47,4,0
64888,42298,40031,17629,40031,allow,148,86,62,2,30,1,1
64889,53789,53,48550,53,allow,168,78,90,2,30,1,1
64890,52074,53,21333,53,allow,199,94,105,2,30,1,1
64891,42298,40022,65114,40022,allow,148,86,62,2,30,1,1
64892,55866,53,14599,53,allow,168,78,90,2,30,1,1
64893,42298,40037,29650,40037,allow,208,86,122,4,30,2,2
64894,50407,80,54250,80,allow,1388,917,471,11,26,6,5
64895,53105,61310,38041,61310,allow,70,70,0,1,5,1,0
64896,51696,14370,13279,14370,allow,70,70,0,1,5,1,0
64897,41050,443,28705,443,allow,137809,4697,133112,153,170,55,98
64898,55593,53,39878,53,allow,288,288,0,4,47,4,0
64899,55610,53,57817,53,allow,181,94,87,2,30,1,1
64900,57171,53,25491,53,allow,214,102,112,2,30,1,1
64901,49197,53,54717,53,allow,214,102,112,2,30,1,1
64902,52838,53,22296,53,allow,168,78,90,2,30,1,1
64903,42140,443,52282,443,allow,12322,3893,8429,28,139,13,15
64904,50891,80,64394,80,allow,136656,9764,126892,162,140,70,92
64905,51721,35426,42015,35426,allow,70,70,0,2,8,2,0
64906,56745,56518,23267,56518,allow,1556,588,968,11,16,6,5
64907,58472,53,35113,53,allow,246,246,0,4,47,4,0
64908,42298,40013,31078,40013,allow,140,78,62,2,30,1,1
64909,42298,40022,27294,40022,allow,156,94,62,2,30,1,1
64910,64237,53,49326,53,allow,227,110,117,2,31,1,1
64911,57470,39608,19893,39608,allow,330,330,0,6,1199,6,0
64912,49608,53,36244,53,allow,177,94,83,2,31,1,1
64913,42632,443,43354,443,allow,4299,1870,2429,17,150,8,9
64914,62197,443,16977,443,allow,3937,1210,2727,18,134,8,10
64915,57470,58210,46855,58210,allow,2118,858,1260,28,1261,14,14
64916,64994,443,32046,443,allow,3547,1351,2196,17,135,8,9
64917,61636,25735,61636,25735,allow,3828,1516,2312,29,5271,18,11
64918,61279,443,45971,443,allow,4076,1378,2698,14,136,7,7
64919,19473,6889,17971,6889,allow,481,150,331,2,1200,1,1
64920,53514,8999,20953,8999,allow,70,70,0,1,5,1,0
64921,49950,80,40840,80,allow,51651,48866,2785,74,20,38,36
64922,56735,53283,31023,53283,allow,4188,1648,2540,17,19,9,8
64923,50922,80,57250,80,allow,9219616,105865,9113751,7687,120,1487,6200
64924,55664,53,23659,53,allow,177,94,83,2,30,1,1
64925,63705,19652,30539,19652,allow,70,70,0,1,5,1,0
64926,45813,5222,28803,5222,allow,5723,3023,2700,58,548,32,26
64927,50872,80,50084,80,allow,54441,4387,50054,75,140,37,38
64928,55708,8060,17338,8060,allow,70,70,0,1,5,1,0
64929,51401,443,22599,443,allow,202,70,132,3,11,1,2
64930,37953,1935,23472,1935,allow,3623810,67493,3556317,3486,35,943,2543
64931,42298,40039,40294,40039,allow,211,89,122,4,30,2,2
64932,42298,40035,3337,40035,allow,207,85,122,4,30,2,2
64933,46346,35440,0,0,deny,66,66,0,1,0,1,0
64934,25363,23,0,0,deny,60,60,0,1,0,1,0
64935,56405,62413,0,0,deny,66,66,0,1,0,1,0
64936,45908,3383,0,0,deny,60,60,0,1,0,1,0
64937,47020,2323,0,0,deny,60,60,0,1,0,1,0
64938,50497,445,0,0,drop,66,66,0,1,0,1,0
64939,50017,445,0,0,drop,70,70,0,1,0,1,0
64940,61329,51505,0,0,deny,66,66,0,1,0,1,0
64941,6881,33720,0,0,deny,157,157,0,1,0,1,0
64942,50494,445,0,0,drop,66,66,0,1,0,1,0
64943,55088,445,0,0,drop,70,70,0,1,0,1,0
64944,6881,6881,0,0,deny,146,146,0,1,0,1,0
64945,55084,445,0,0,drop,70,70,0,1,0,1,0
64946,55083,445,0,0,drop,70,70,0,1,0,1,0
64947,55081,445,0,0,drop,70,70,0,1,0,1,0
64948,50490,445,0,0,drop,66,66,0,1,0,1,0
64949,50014,445,0,0,drop,70,70,0,1,0,1,0
64950,57434,50584,0,0,deny,62,62,0,1,0,1,0
64951,1574,50584,0,0,deny,62,62,0,1,0,1,0
64952,18624,29434,0,0,deny,148,148,0,1,0,1,0
64953,11842,35440,0,0,deny,66,66,0,1,0,1,0
64954,49747,37965,0,0,deny,62,62,0,1,0,1,0
64955,55701,55777,0,0,deny,62,62,0,1,0,1,0
64956,55075,445,0,0,drop,70,70,0,1,0,1,0
64957,34914,25604,0,0,deny,145,145,0,1,0,1,0
64958,59785,14914,0,0,deny,143,143,0,1,0,1,0
64959,50010,445,0,0,drop,70,70,0,1,0,1,0
64960,55072,445,0,0,drop,70,70,0,1,0,1,0
64961,55070,445,0,0,drop,70,70,0,1,0,1,0
64962,55068,445,0,0,drop,70,70,0,1,0,1,0
64963,17702,6881,0,0,deny,66,66,0,1,0,1,0
64964,58912,11392,0,0,deny,66,66,0,1,0,1,0
64965,50008,445,0,0,drop,70,70,0,1,0,1,0
64966,50483,445,0,0,drop,66,66,0,1,0,1,0
64967,43271,50584,0,0,deny,62,62,0,1,0,1,0
64968,6666,21,0,0,deny,60,60,0,1,0,1,0
64969,50482,445,0,0,drop,66,66,0,1,0,1,0
64970,50479,445,0,0,drop,66,66,0,1,0,1,0
64971,50477,445,0,0,drop,66,66,0,1,0,1,0
64972,50006,445,0,0,drop,70,70,0,1,0,1,0
64973,50475,445,0,0,drop,66,66,0,1,0,1,0
64974,50474,445,0,0,drop,66,66,0,1,0,1,0
64975,50472,445,0,0,drop,66,66,0,1,0,1,0
64976,41447,26467,0,0,deny,62,62,0,1,0,1,0
64977,30114,65151,0,0,deny,60,60,0,1,0,1,0
64978,64106,64147,0,0,deny,66,66,0,1,0,1,0
64979,33498,5529,0,0,deny,145,145,0,1,0,1,0
64980,47398,7302,0,0,deny,62,62,0,1,0,1,0
64981,55066,445,0,0,drop,70,70,0,1,0,1,0
64982,55064,445,0,0,drop,70,70,0,1,0,1,0
64983,55060,445,0,0,drop,70,70,0,1,0,1,0
64984,40500,48009,0,0,deny,146,146,0,1,0,1,0
64985,11136,15503,0,0,deny,62,62,0,1,0,1,0
64986,50469,445,0,0,drop,66,66,0,1,0,1,0
64987,55059,445,0,0,drop,70,70,0,1,0,1,0
64988,4817,11392,0,0,deny,146,146,0,1,0,1,0
64989,50467,445,0,0,drop,66,66,0,1,0,1,0
64990,49999,445,0,0,drop,70,70,0,1,0,1,0
64991,50465,445,0,0,drop,66,66,0,1,0,1,0
64992,50464,445,0,0,drop,66,66,0,1,0,1,0
64993,49997,445,0,0,drop,70,70,0,1,0,1,0
64994,443,43775,0,0,deny,97,97,0,1,0,1,0
64995,50461,445,0,0,drop,66,66,0,1,0,1,0
64996,45908,33330,0,0,deny,60,60,0,1,0,1,0
64997,50386,22114,0,0,deny,66,66,0,1,0,1,0
64998,42576,30188,0,0,deny,146,146,0,1,0,1,0
64999,59477,36829,0,0,deny,66,66,0,1,0,1,0
65000,49996,445,0,0,drop,70,70,0,1,0,1,0
65001,9544,7302,0,0,deny,62,62,0,1,0,1,0
65002,49995,445,0,0,drop,70,70,0,1,0,1,0
65003,49994,445,0,0,drop,70,70,0,1,0,1,0
65004,49992,445,0,0,drop,70,70,0,1,0,1,0
65005,49988,445,0,0,drop,70,70,0,1,0,1,0
65006,26792,37965,0,0,deny,62,62,0,1,0,1,0
65007,58725,7302,0,0,deny,66,66,0,1,0,1,0
65008,55055,445,0,0,drop,70,70,0,1,0,1,0
65009,37837,37965,0,0,deny,62,62,0,1,0,1,0
65010,55049,445,0,0,drop,70,70,0,1,0,1,0
65011,55044,445,0,0,drop,70,70,0,1,0,1,0
65012,35718,20238,0,0,deny,62,62,0,1,0,1,0
65013,50113,51505,0,0,deny,66,66,0,1,0,1,0
65014,49976,445,0,0,drop,70,70,0,1,0,1,0
65015,49975,445,0,0,drop,70,70,0,1,0,1,0
65016,19394,44847,0,0,deny,66,66,0,1,0,1,0
65017,53710,443,55386,443,allow,499,425,74,4,0,3,1
65018,53711,443,24841,443,allow,499,425,74,4,0,3,1
65019,53706,443,53579,443,allow,499,425,74,4,0,3,1
65020,53705,443,11151,443,allow,499,425,74,4,0,3,1
65021,49973,445,0,0,drop,70,70,0,1,0,1,0
65022,50453,445,0,0,drop,66,66,0,1,0,1,0
65023,49965,445,0,0,drop,70,70,0,1,0,1,0
65024,49966,445,0,0,drop,70,70,0,1,0,1,0
65025,37538,37965,0,0,deny,66,66,0,1,0,1,0
65026,20706,37965,0,0,deny,62,62,0,1,0,1,0
65027,2919,57866,0,0,deny,66,66,0,1,0,1,0
65028,3428,22,0,0,deny,60,60,0,1,0,1,0
65029,19963,2767,0,0,deny,66,66,0,1,0,1,0
65030,22683,39210,0,0,deny,60,60,0,1,0,1,0
65031,42969,8146,0,0,deny,62,62,0,1,0,1,0
65032,62632,35440,0,0,deny,66,66,0,1,0,1,0
65033,51973,44847,0,0,deny,66,66,0,1,0,1,0
65034,50443,445,0,0,drop,66,66,0,1,0,1,0
65035,42285,57470,0,0,deny,62,62,0,1,0,1,0
65036,55031,445,0,0,drop,70,70,0,1,0,1,0
65037,16762,61689,0,0,deny,62,62,0,1,0,1,0
65038,15793,64147,0,0,deny,66,66,0,1,0,1,0
65039,49954,445,0,0,drop,70,70,0,1,0,1,0
65040,6057,51221,0,0,deny,78,78,0,1,0,1,0
65041,50441,445,0,0,drop,66,66,0,1,0,1,0
65042,52780,37965,0,0,deny,66,66,0,1,0,1,0
65043,50432,445,0,0,drop,66,66,0,1,0,1,0
65044,50424,445,0,0,drop,66,66,0,1,0,1,0
65045,59374,51505,0,0,deny,62,62,0,1,0,1,0
65046,49950,445,0,0,drop,70,70,0,1,0,1,0
65047,56396,5900,0,0,deny,60,60,0,1,0,1,0
65048,58318,15503,0,0,deny,66,66,0,1,0,1,0
65049,63331,51221,0,0,deny,62,62,0,1,0,1,0
65050,49941,445,0,0,drop,70,70,0,1,0,1,0
65051,49939,445,0,0,drop,70,70,0,1,0,1,0
65052,49935,445,0,0,drop,70,70,0,1,0,1,0
65053,49936,445,0,0,drop,70,70,0,1,0,1,0
65054,49570,5900,0,0,deny,60,60,0,1,0,1,0
65055,49934,445,0,0,drop,70,70,0,1,0,1,0
65056,55024,445,0,0,drop,70,70,0,1,0,1,0
65057,55021,445,0,0,drop,70,70,0,1,0,1,0
65058,55019,445,0,0,drop,70,70,0,1,0,1,0
65059,43611,61903,0,0,deny,148,148,0,1,0,1,0
65060,56927,64147,0,0,deny,145,145,0,1,0,1,0
65061,50413,445,0,0,drop,66,66,0,1,0,1,0
65062,50418,445,0,0,drop,66,66,0,1,0,1,0
65063,50416,445,0,0,drop,66,66,0,1,0,1,0
65064,50417,445,0,0,drop,66,66,0,1,0,1,0
65065,50415,445,0,0,drop,66,66,0,1,0,1,0
65066,50414,445,0,0,drop,66,66,0,1,0,1,0
65067,50412,445,0,0,drop,66,66,0,1,0,1,0
65068,50411,445,0,0,drop,66,66,0,1,0,1,0
65069,0,0,0,0,allow,320,320,0,5,0,5,0
65070,3630,26467,0,0,deny,66,66,0,1,0,1,0
65071,25739,64147,0,0,deny,62,62,0,1,0,1,0
65072,6916,52700,0,0,deny,100,100,0,1,0,1,0
65073,3407,57866,0,0,deny,66,66,0,1,0,1,0
65074,64191,44847,0,0,deny,66,66,0,1,0,1,0
65075,10921,19847,0,0,deny,62,62,0,1,0,1,0
65076,63503,42707,0,0,deny,66,66,0,1,0,1,0
65077,12668,42707,0,0,deny,62,62,0,1,0,1,0
65078,59586,56205,0,0,deny,62,62,0,1,0,1,0
65079,49927,445,0,0,drop,70,70,0,1,0,1,0
65080,16059,22114,0,0,deny,146,146,0,1,0,1,0
65081,41812,8080,0,0,deny,60,60,0,1,0,1,0
65082,41813,8080,0,0,deny,60,60,0,1,0,1,0
65083,55012,445,0,0,drop,70,70,0,1,0,1,0
65084,55010,445,0,0,drop,70,70,0,1,0,1,0
65085,55003,445,0,0,drop,70,70,0,1,0,1,0
65086,29022,23,0,0,deny,60,60,0,1,0,1,0
65087,49818,37965,0,0,deny,66,66,0,1,0,1,0
65088,49920,445,0,0,drop,70,70,0,1,0,1,0
65089,50397,445,0,0,drop,66,66,0,1,0,1,0
65090,50398,445,0,0,drop,66,66,0,1,0,1,0
65091,50395,445,0,0,drop,66,66,0,1,0,1,0
65092,49917,445,0,0,drop,70,70,0,1,0,1,0
65093,26497,64147,0,0,deny,66,66,0,1,0,1,0
65094,54955,7302,0,0,deny,62,62,0,1,0,1,0
65095,55001,445,0,0,drop,70,70,0,1,0,1,0
65096,54999,445,0,0,drop,70,70,0,1,0,1,0
65097,49913,445,0,0,drop,70,70,0,1,0,1,0
65098,54997,445,0,0,drop,70,70,0,1,0,1,0
65099,54993,445,0,0,drop,70,70,0,1,0,1,0
65100,54991,445,0,0,drop,70,70,0,1,0,1,0
65101,49912,445,0,0,drop,70,70,0,1,0,1,0
65102,55878,7302,0,0,deny,66,66,0,1,0,1,0
65103,30559,64147,0,0,deny,62,62,0,1,0,1,0
65104,36727,443,3578,443,allow,27009,7414,19595,46,122,21,25
65105,63708,29685,60492,29685,allow,66,66,0,1,5,1,0
65106,50304,443,23238,443,allow,3565,1947,1618,19,15,9,10
65107,5588,5588,0,0,allow,3562,1936,1626,48,195,24,24
65108,59735,443,59735,443,allow,4730,1823,2907,19,28,11,8
65109,49181,443,9716,443,allow,50097,3666,46431,79,256,36,43
65110,56980,53,42285,53,allow,267,87,180,4,38,2,2
65111,51719,13715,5835,13715,allow,70,70,0,2,8,2,0
65112,61474,443,20361,443,allow,114674,4457,110217,127,48,46,81
65113,61483,443,51261,443,allow,107901,5004,102897,127,46,53,74
65114,5588,5588,0,0,allow,3562,1936,1626,48,192,24,24
65115,51718,55003,38571,55003,allow,70,70,0,2,8,2,0
65116,59646,5223,10066,5223,allow,139,139,0,1,5,1,0
65117,44223,443,7488,443,allow,63895,4604,59291,80,276,34,46
65118,63697,25010,4091,25010,allow,504,382,122,8,16,6,2
65119,56689,53,4538,53,allow,177,91,86,3,38,2,1
65120,53486,443,39031,443,allow,8879,2420,6459,32,255,17,15
65121,14112,443,14112,443,allow,25629,5823,19806,44,179,25,19
65122,50303,443,45984,443,allow,3051,1801,1250,18,15,8,10
65123,44908,443,9126,443,allow,2931,1940,991,19,25,10,9
65124,56748,35148,18439,35148,allow,66,66,0,1,5,1,0
65125,48979,15000,58069,15000,allow,130,70,60,2,5,1,1
65126,51692,25565,11654,25565,allow,66,66,0,1,5,1,0
65127,56747,42333,2469,42333,allow,66,66,0,1,5,1,0
65128,52862,80,51424,80,allow,3150,1478,1672,32,131,17,15
65129,41610,443,48992,443,allow,9488,2196,7292,25,26,14,11
65130,61478,443,38710,443,allow,45313,3360,41953,61,47,26,35
65131,61479,443,17440,443,allow,104543,5227,99316,130,47,57,73
65132,60492,443,48948,443,allow,81016,8373,72643,122,339,57,65
65133,42298,40026,9867,40026,allow,212,90,122,4,30,2,2
65134,58301,53,36478,53,allow,233,102,131,2,30,1,1
65135,61482,443,17696,443,allow,49181,3553,45628,65,46,29,36
65136,63834,27037,60626,27037,allow,1592,1386,206,6,31,4,2
65137,49900,7000,49900,7000,allow,2958,1567,1391,15,15,8,7
65138,51717,63436,12791,63436,allow,70,70,0,2,8,2,0
65139,61477,443,48304,443,allow,30516,3311,27205,49,47,25,24
65140,52694,443,37161,443,allow,10384,4563,5821,34,436,17,17
65141,47362,443,49001,443,allow,8263,2100,6163,34,255,16,18
65142,63683,20299,57737,20299,allow,502,380,122,7,19,5,2
65143,51002,443,58115,443,allow,3536,2198,1338,18,332,9,9
65144,1063,7302,0,0,deny,62,62,0,1,0,1,0
65145,58099,44847,0,0,deny,62,62,0,1,0,1,0
65146,33215,37965,0,0,deny,62,62,0,1,0,1,0
65147,59037,28370,0,0,deny,62,62,0,1,0,1,0
65148,32974,37965,0,0,deny,66,66,0,1,0,1,0
65149,45941,23386,0,0,deny,60,60,0,1,0,1,0
65150,37230,554,0,0,deny,60,60,0,1,0,1,0
65151,49908,445,0,0,drop,70,70,0,1,0,1,0
65152,18889,50584,0,0,deny,146,146,0,1,0,1,0
65153,46090,50584,0,0,deny,66,66,0,1,0,1,0
65154,12549,50265,0,0,deny,146,146,0,1,0,1,0
65155,49907,445,0,0,drop,70,70,0,1,0,1,0
65156,60223,67,0,0,deny,60,60,0,1,0,1,0
65157,1446,35440,0,0,deny,66,66,0,1,0,1,0
65158,54981,445,0,0,drop,70,70,0,1,0,1,0
65159,54979,445,0,0,drop,70,70,0,1,0,1,0
65160,54975,445,0,0,drop,70,70,0,1,0,1,0
65161,62673,34159,0,0,deny,66,66,0,1,0,1,0
65162,49900,4500,1746,4500,allow,78,78,0,1,5,1,0
65163,53098,30840,23341,30840,allow,898,454,444,13,22,8,5
65164,37571,53,19977,53,allow,164,78,86,2,30,1,1
65165,61030,53,15331,53,allow,167,78,89,2,30,1,1
65166,49414,443,63863,443,allow,43326,4905,38421,56,43,16,40
65167,62592,443,27957,443,allow,11741,7040,4701,40,172,22,18
65168,56689,53,17079,53,allow,264,91,173,4,38,2,2
65169,56594,80,5980,80,allow,234,234,0,4,11,4,0
65170,58621,53,5007,53,allow,256,94,162,2,29,1,1
65171,42298,40014,17083,40014,allow,216,94,122,4,29,2,2
65172,42298,40042,61783,40042,allow,273,73,200,4,29,2,2
65173,65164,53,40444,53,allow,265,102,163,2,29,1,1
65174,60561,53,50880,53,allow,343,86,257,2,30,1,1
65175,34517,443,44047,443,allow,5996,1967,4029,17,99,10,7
65176,36836,443,63140,443,allow,7195,1791,5404,18,99,11,7
65177,50958,80,62860,80,allow,5730351,74236,5656115,4865,78,1088,3777
65178,55836,443,16714,443,allow,3538,2015,1523,28,323,14,14
65179,36586,80,45063,80,allow,1114,534,580,12,15,7,5
65180,56980,53,33367,53,allow,267,87,180,4,38,2,2
65181,53513,51354,18257,51354,allow,70,70,0,1,4,1,0
65182,123,123,49669,123,allow,184,94,90,2,29,1,1
65183,50142,443,40604,443,allow,9040,2349,6691,22,64,13,9
65184,50936,80,62610,80,allow,10423067,111935,10311132,8558,119,1601,6957
65185,50960,80,58959,80,allow,5533225,44880,5488345,4345,78,654,3691
65186,42298,40005,47580,40005,allow,211,89,122,4,29,2,2
65187,51716,57137,62764,57137,allow,70,70,0,2,8,2,0
65188,63710,54740,50464,54740,allow,70,70,0,1,4,1,0
65189,60394,53,18080,53,allow,330,94,236,2,30,1,1
65190,56765,443,20044,443,allow,12038195,322404,11715791,12026,153,3435,8591
65191,55470,53,6327,53,allow,197,102,95,2,30,1,1
65192,65461,53,1880,53,allow,268,110,158,2,30,1,1
65193,51811,443,57601,443,allow,18108,1782,16326,31,215,15,16
65194,57340,2258,57340,2258,allow,156,156,0,3,8,3,0
65195,51693,56308,27101,56308,allow,70,70,0,1,5,1,0
65196,41152,443,5083,443,allow,1848,1139,709,14,579,8,6
65197,51497,443,45992,443,allow,4945,1060,3885,21,15,12,9
65198,36256,443,43168,443,allow,3871,2466,1405,22,95,12,10
65199,49164,53,4974,53,allow,212,94,118,2,30,1,1
65200,49997,53,42386,53,allow,264,102,162,2,30,1,1
65201,64354,53,25529,53,allow,240,78,162,2,30,1,1
65202,57664,53,41830,53,allow,168,78,90,2,30,1,1
65203,52558,443,32057,443,allow,3530,1002,2528,12,120,6,6
65204,63691,53,63691,53,allow,198,90,108,2,30,1,1
65205,46069,80,2181,80,allow,2684,2550,134,7,17,5,2
65206,51720,51388,49576,51388,allow,70,70,0,2,8,2,0
65207,38901,53,60941,53,allow,168,78,90,2,30,1,1
65208,56980,53,28670,53,allow,267,87,180,4,38,2,2
65209,50572,80,21152,80,allow,132,132,0,2,8,2,0
65210,52481,443,2836,443,allow,70,70,0,1,5,1,0
65211,43591,443,60892,443,allow,1848,1141,707,14,566,8,6
65212,56917,443,25330,443,allow,14033,1591,12442,26,132,10,16
65213,61665,443,16320,443,allow,6279,1859,4420,25,16,14,11
65214,49520,53,55540,53,allow,229,102,127,2,30,1,1
65215,49899,7000,49899,7000,allow,758568,17631,740937,772,17,269,503
65216,54341,443,8795,443,allow,10046,3300,6746,23,61,14,9
65217,36289,53,0,0,allow,86,86,0,1,30,1,0
65218,56937,8200,52360,8200,allow,78,78,0,1,30,1,0
65219,48857,53,48857,53,allow,213,82,131,2,30,1,1
65220,35112,443,57886,443,allow,3242,1248,1994,26,362,7,19
65221,55024,443,1691,443,allow,552073,14113,537960,536,31,176,360
65222,49394,443,39992,443,allow,6211,1869,4342,18,181,8,10
65223,64495,443,32988,443,allow,1786,172,1614,7,120,3,4
65224,41128,443,53510,443,allow,3474,2349,1125,29,3438,17,12
65225,64626,53,31838,53,allow,326,102,224,2,30,1,1
65226,49608,53,46552,53,allow,177,94,83,2,30,1,1
65227,55470,53,12953,53,allow,197,102,95,2,33,1,1
65228,51691,5543,12224,5543,allow,70,70,0,1,5,1,0
65229,36158,443,34202,443,allow,9808,3005,6803,36,255,19,17
65230,52717,53,4391,53,allow,277,94,183,2,30,1,1
65231,49700,53,14464,53,allow,165,78,87,2,30,1,1
65232,33771,53,38746,53,allow,506,316,190,3,30,2,1
65233,6881,41019,41697,41019,allow,150,150,0,1,1200,1,0
65234,51147,443,55855,443,allow,6162,925,5237,18,52,10,8
65235,47831,53,0,0,allow,86,86,0,1,30,1,0
65236,61973,53,11068,53,allow,222,94,128,2,30,1,1
65237,63811,443,59225,443,allow,25707,7559,18148,53,121,24,29
65238,61431,443,56520,443,allow,352310,324883,27427,389,300,270,119
65239,14641,443,14641,443,allow,254281,66535,187746,336,317,183,153
65240,60441,443,36416,443,allow,3211,1964,1247,25,263,13,12
65241,54961,53,55140,53,allow,375,99,276,4,54,2,2
65242,47594,443,65055,443,allow,5447,1074,4373,21,17,10,11
65243,52860,443,7208,443,allow,7683,2076,5607,42,131,21,21
65244,53510,58706,37396,58706,allow,492,306,186,8,16,5,3
65245,34169,443,8049,443,allow,6507,1060,5447,22,255,12,10
65246,63698,59517,14181,59517,allow,504,382,122,8,15,6,2
65247,50871,80,63200,80,allow,94083,6192,87891,121,139,57,64
65248,42298,40013,38063,40013,allow,209,87,122,4,29,2,2
65249,63711,47951,19949,47951,allow,70,70,0,1,4,1,0
65250,63715,29834,21653,29834,allow,70,70,0,1,4,1,0
65251,63714,48477,18811,48477,allow,70,70,0,1,4,1,0
65252,53321,80,20263,80,allow,3483,2072,1411,21,214,17,4
65253,42298,40007,10253,40007,allow,273,73,200,4,29,2,2
65254,59486,53,24146,53,allow,316,86,230,2,29,1,1
65255,54991,53,13574,53,allow,177,94,83,2,29,1,1
65256,55317,53,22104,53,allow,94,94,0,1,30,1,0
65257,55828,443,52104,443,allow,5278,1026,4252,20,15,11,9
65258,64401,53,5392,53,allow,293,94,199,2,30,1,1
65259,123,123,5546,123,allow,184,94,90,2,29,1,1
65260,55664,53,60480,53,allow,177,94,83,2,29,1,1
65261,54991,53,42971,53,allow,253,87,166,4,29,2,2
65262,42298,40007,25770,40007,allow,206,84,122,4,29,2,2
65263,42298,40024,27133,40024,allow,207,85,122,4,29,2,2
65264,42298,40029,56928,40029,allow,208,86,122,4,29,2,2
65265,42298,40036,28327,40036,allow,205,83,122,4,29,2,2
65266,64254,53,25297,53,allow,211,78,133,2,30,1,1
65267,64905,53,16169,53,allow,245,94,151,2,30,1,1
65268,59165,53,3283,53,allow,186,78,108,2,30,1,1
65269,61113,27045,20306,27045,allow,1778,1386,392,8,30,4,4
65270,55179,53,63963,53,allow,194,102,92,2,30,1,1
65271,64209,53,25156,53,allow,277,94,183,2,30,1,1
65272,59610,53,54271,53,allow,191,78,113,2,30,1,1
65273,55801,53,42672,53,allow,222,102,120,2,30,1,1
65274,49529,53,23720,53,allow,211,94,117,2,30,1,1
65275,53169,443,5040,443,allow,6716,922,5794,20,20,10,10
65276,50136,443,32292,443,allow,23193,8487,14706,57,55,28,29
65277,60972,443,43346,443,allow,10208,5093,5115,46,15,27,19
65278,65383,53,42198,53,allow,267,94,173,2,30,1,1
65279,62139,53,5155,53,allow,291,78,213,2,30,1,1
65280,57067,53,11101,53,allow,252,102,150,2,30,1,1
65281,33305,53,29793,53,allow,168,78,90,2,30,1,1
65282,59393,443,45183,443,allow,1664,914,750,15,275,7,8
65283,63692,42635,61565,42635,allow,562,380,182,8,15,5,3
65284,55179,53,20932,53,allow,194,102,92,2,35,1,1
65285,56980,53,33611,53,allow,526,188,338,6,48,3,3
65286,62293,443,13135,443,allow,4755,1142,3613,15,273,8,7
65287,21133,17068,30422,17068,allow,481,150,331,2,1199,1,1
65288,52559,443,18708,443,allow,4479,2526,1953,10,120,6,4
65289,63853,443,40585,443,allow,3182,1568,1614,8,120,4,4
65290,6881,10385,61159,10385,allow,118,118,0,1,1199,1,0
65291,6881,13234,11039,13234,allow,324,150,174,2,1201,1,1
65292,53523,5362,54435,5362,allow,320,140,180,6,6,3,3
65293,53521,443,39860,443,allow,710,350,360,12,33,6,6
65294,47008,443,47008,443,allow,4373,1466,2907,19,27,11,8
65295,23174,80,23174,80,allow,490,264,226,8,31,5,3
65296,62640,443,62640,443,allow,27723,5572,22151,59,47,31,28
65297,50932,80,42211,80,allow,11381441,121813,11259628,9309,119,1741,7568
65298,64650,53,46185,53,allow,257,126,131,2,30,1,1
65299,3497,53,3497,53,allow,222,90,132,2,30,1,1
65300,65186,53,5333,53,allow,285,94,191,2,30,1,1
65301,49942,53,42485,53,allow,177,94,83,2,31,1,1
65302,53171,443,14871,443,allow,3220,2010,1210,20,19,10,10
65303,50946,80,36199,80,allow,5870176,83236,5786940,5053,78,1161,3892
65304,4960,53,26982,53,allow,222,86,136,2,30,1,1
65305,49585,53,59933,53,allow,718,94,624,2,30,1,1
65306,60739,40010,46673,40010,allow,316,136,180,6,6,3,3
65307,52632,443,1395,443,allow,4399,1857,2542,28,136,14,14
65308,49312,53,2239,53,allow,184,86,98,2,30,1,1
65309,49878,53,64175,53,allow,327,102,225,2,30,1,1
65310,65018,53,40867,53,allow,198,94,104,2,30,1,1
65311,20345,57470,0,0,deny,146,146,0,1,0,1,0
65312,30417,51505,0,0,deny,146,146,0,1,0,1,0
65313,49902,445,0,0,deny,70,70,0,1,0,1,0
65314,52668,51221,0,0,deny,66,66,0,1,0,1,0
65315,46495,4607,0,0,deny,60,60,0,1,0,1,0
65316,49418,57470,0,0,deny,66,66,0,1,0,1,0
65317,59037,51505,0,0,deny,66,66,0,1,0,1,0
65318,50602,26467,0,0,deny,66,66,0,1,0,1,0
65319,50374,445,0,0,drop,66,66,0,1,0,1,0
65320,5244,35440,0,0,deny,66,66,0,1,0,1,0
65321,64757,52700,0,0,deny,62,62,0,1,0,1,0
65322,54973,445,0,0,drop,70,70,0,1,0,1,0
65323,54972,445,0,0,drop,70,70,0,1,0,1,0
65324,59169,56205,0,0,deny,62,62,0,1,0,1,0
65325,23807,44847,0,0,deny,66,66,0,1,0,1,0
65326,26879,37965,0,0,deny,145,145,0,1,0,1,0
65327,49889,445,0,0,drop,70,70,0,1,0,1,0
65328,43329,50584,0,0,deny,146,146,0,1,0,1,0
65329,51130,61689,0,0,deny,66,66,0,1,0,1,0
65330,50368,445,0,0,drop,66,66,0,1,0,1,0
65331,62941,57470,0,0,deny,74,74,0,1,0,1,0
65332,50366,445,0,0,drop,66,66,0,1,0,1,0
65333,61670,57470,0,0,deny,74,74,0,1,0,1,0
65334,49886,445,0,0,drop,70,70,0,1,0,1,0
65335,2995,26467,0,0,deny,62,62,0,1,0,1,0
65336,54963,445,0,0,drop,70,70,0,1,0,1,0
65337,64437,56205,0,0,deny,66,66,0,1,0,1,0
65338,54958,445,0,0,drop,70,70,0,1,0,1,0
65339,54955,445,0,0,drop,70,70,0,1,0,1,0
65340,54951,445,0,0,drop,70,70,0,1,0,1,0
65341,49160,63766,0,0,deny,146,146,0,1,0,1,0
65342,5575,8889,0,0,deny,495,495,0,1,0,1,0
65343,16370,56205,0,0,deny,62,62,0,1,0,1,0
65344,50365,445,0,0,drop,66,66,0,1,0,1,0
65345,11136,57587,0,0,deny,62,62,0,1,0,1,0
65346,11136,17500,0,0,deny,62,62,0,1,0,1,0
65347,49964,64147,0,0,deny,66,66,0,1,0,1,0
65348,49882,445,0,0,drop,70,70,0,1,0,1,0
65349,5223,13602,0,0,deny,66,66,0,1,0,1,0
65350,54945,445,0,0,drop,70,70,0,1,0,1,0
65351,49880,445,0,0,drop,70,70,0,1,0,1,0
65352,61495,37965,0,0,deny,66,66,0,1,0,1,0
65353,44411,37965,0,0,deny,62,62,0,1,0,1,0
65354,54944,445,0,0,drop,70,70,0,1,0,1,0
65355,54943,445,0,0,drop,70,70,0,1,0,1,0
65356,54941,445,0,0,drop,70,70,0,1,0,1,0
65357,49878,445,0,0,drop,70,70,0,1,0,1,0
65358,50355,445,0,0,drop,66,66,0,1,0,1,0
65359,6889,60888,0,0,deny,139,139,0,1,0,1,0
65360,9717,22114,0,0,deny,146,146,0,1,0,1,0
65361,45941,23388,0,0,deny,60,60,0,1,0,1,0
65362,64382,44847,0,0,deny,66,66,0,1,0,1,0
65363,50353,445,0,0,drop,66,66,0,1,0,1,0
65364,50352,445,0,0,drop,66,66,0,1,0,1,0
65365,50350,445,0,0,drop,66,66,0,1,0,1,0
65366,50347,445,0,0,drop,66,66,0,1,0,1,0
65367,50346,445,0,0,drop,66,66,0,1,0,1,0
65368,50345,445,0,0,drop,66,66,0,1,0,1,0
65369,50337,37965,0,0,deny,66,66,0,1,0,1,0
65370,59241,62413,0,0,deny,66,66,0,1,0,1,0
65371,7744,32480,0,0,deny,62,62,0,1,0,1,0
65372,4431,32480,0,0,deny,66,66,0,1,0,1,0
65373,6773,57470,0,0,deny,62,62,0,1,0,1,0
65374,53051,44847,0,0,deny,66,66,0,1,0,1,0
65375,44933,26467,0,0,deny,62,62,0,1,0,1,0
65376,56564,9571,0,0,deny,78,78,0,1,0,1,0
65377,64335,35440,0,0,deny,62,62,0,1,0,1,0
65378,9756,26467,0,0,deny,66,66,0,1,0,1,0
65379,54938,445,0,0,drop,70,70,0,1,0,1,0
65380,54935,445,0,0,drop,70,70,0,1,0,1,0
65381,54932,445,0,0,drop,70,70,0,1,0,1,0
65382,49871,445,0,0,drop,70,70,0,1,0,1,0
65383,30794,37965,0,0,deny,62,62,0,1,0,1,0
65384,50343,445,0,0,drop,66,66,0,1,0,1,0
65385,54931,445,0,0,drop,70,70,0,1,0,1,0
65386,49869,445,0,0,drop,70,70,0,1,0,1,0
65387,50339,445,0,0,drop,66,66,0,1,0,1,0
65388,50337,445,0,0,drop,66,66,0,1,0,1,0
65389,50335,445,0,0,drop,66,66,0,1,0,1,0
65390,49868,445,0,0,drop,70,70,0,1,0,1,0
65391,50333,445,0,0,drop,66,66,0,1,0,1,0
65392,5637,37965,0,0,deny,62,62,0,1,0,1,0
65393,42252,33306,0,0,deny,60,60,0,1,0,1,0
65394,49867,445,0,0,drop,70,70,0,1,0,1,0
65395,49866,445,0,0,drop,70,70,0,1,0,1,0
65396,49864,445,0,0,drop,70,70,0,1,0,1,0
65397,49861,445,0,0,drop,70,70,0,1,0,1,0
65398,53828,2323,0,0,deny,60,60,0,1,0,1,0
65399,54930,445,0,0,drop,70,70,0,1,0,1,0
65400,54922,445,0,0,drop,70,70,0,1,0,1,0
65401,54914,445,0,0,drop,70,70,0,1,0,1,0
65402,49848,445,0,0,drop,70,70,0,1,0,1,0
65403,49846,445,0,0,drop,70,70,0,1,0,1,0
65404,49845,445,0,0,drop,70,70,0,1,0,1,0
65405,49837,445,0,0,drop,70,70,0,1,0,1,0
65406,49838,445,0,0,drop,70,70,0,1,0,1,0
65407,30654,51221,0,0,deny,72,72,0,1,0,1,0
65408,6057,51221,0,0,deny,78,78,0,1,0,1,0
65409,53813,11392,0,0,deny,62,62,0,1,0,1,0
65410,50325,445,0,0,drop,66,66,0,1,0,1,0
65411,61023,26467,0,0,deny,62,62,0,1,0,1,0
65412,56827,63710,0,0,deny,62,62,0,1,0,1,0
65413,24504,37965,0,0,deny,62,62,0,1,0,1,0
65414,52934,26467,0,0,deny,66,66,0,1,0,1,0
65415,49487,60043,0,0,deny,62,62,0,1,0,1,0
65416,50315,445,0,0,drop,66,66,0,1,0,1,0
65417,54909,445,0,0,drop,70,70,0,1,0,1,0
65418,49826,445,0,0,drop,70,70,0,1,0,1,0
65419,5661,37965,0,0,deny,66,66,0,1,0,1,0
65420,44147,64147,0,0,deny,62,62,0,1,0,1,0
65421,57107,64147,0,0,deny,66,66,0,1,0,1,0
65422,11136,15503,0,0,deny,145,145,0,1,0,1,0
65423,40489,1433,0,0,deny,60,60,0,1,0,1,0
65424,53912,26467,0,0,deny,66,66,0,1,0,1,0
65425,9381,35440,0,0,deny,62,62,0,1,0,1,0
65426,50313,445,0,0,drop,66,66,0,1,0,1,0
65427,52328,44847,0,0,deny,66,66,0,1,0,1,0
65428,9265,37965,0,0,deny,66,66,0,1,0,1,0
65429,53358,23,0,0,deny,60,60,0,1,0,1,0
65430,62914,11392,0,0,deny,62,62,0,1,0,1,0
65431,50306,445,0,0,drop,66,66,0,1,0,1,0
65432,49821,445,0,0,drop,70,70,0,1,0,1,0
65433,50303,445,0,0,drop,66,66,0,1,0,1,0
65434,13223,1310,0,0,deny,62,62,0,1,0,1,0
65435,24021,6881,0,0,deny,146,146,0,1,0,1,0
65436,52600,22,0,0,deny,60,60,0,1,0,1,0
65437,51320,37965,0,0,deny,62,62,0,1,0,1,0
65438,49812,445,0,0,drop,70,70,0,1,0,1,0
65439,49810,445,0,0,drop,70,70,0,1,0,1,0
65440,1027,23684,0,0,deny,159,159,0,1,0,1,0
65441,49809,445,0,0,drop,70,70,0,1,0,1,0
65442,49808,445,0,0,drop,70,70,0,1,0,1,0
65443,49804,445,0,0,drop,70,70,0,1,0,1,0
65444,64572,37965,0,0,deny,66,66,0,1,0,1,0
65445,54894,445,0,0,drop,70,70,0,1,0,1,0
65446,54891,445,0,0,drop,70,70,0,1,0,1,0
65447,54892,445,0,0,drop,70,70,0,1,0,1,0
65448,50285,445,0,0,drop,66,66,0,1,0,1,0
65449,50289,445,0,0,drop,66,66,0,1,0,1,0
65450,50290,445,0,0,drop,66,66,0,1,0,1,0
65451,50286,445,0,0,drop,66,66,0,1,0,1,0
65452,50284,445,0,0,drop,66,66,0,1,0,1,0
65453,50288,445,0,0,drop,66,66,0,1,0,1,0
65454,50287,445,0,0,drop,66,66,0,1,0,1,0
65455,50282,445,0,0,drop,66,66,0,1,0,1,0
65456,62739,21416,0,0,deny,145,145,0,1,0,1,0
65457,49502,44847,0,0,deny,66,66,0,1,0,1,0
65458,49798,445,0,0,drop,70,70,0,1,0,1,0
65459,2609,35993,0,0,deny,146,146,0,1,0,1,0
65460,14438,51505,0,0,deny,62,62,0,1,0,1,0
65461,54889,445,0,0,drop,70,70,0,1,0,1,0
65462,54880,445,0,0,drop,70,70,0,1,0,1,0
65463,54875,445,0,0,drop,70,70,0,1,0,1,0
65464,49791,445,0,0,drop,70,70,0,1,0,1,0
65465,40078,44847,0,0,deny,62,62,0,1,0,1,0
65466,49788,445,0,0,drop,70,70,0,1,0,1,0
65467,51098,60043,0,0,deny,62,62,0,1,0,1,0
65468,5938,35070,0,0,allow,60,60,0,1,90,1,0
65469,14092,80,14092,80,allow,3182,2082,1100,18,86,10,8
65470,51689,4765,24946,4765,allow,66,66,0,1,5,1,0
65471,22345,80,22345,80,allow,490,264,226,8,30,5,3
65472,64677,53,12416,53,allow,172,88,84,2,31,1,1
65473,50366,80,53987,80,allow,318,192,126,6,28,4,2
65474,50358,80,31825,80,allow,318,192,126,6,28,4,2
65475,50369,80,41191,80,allow,318,192,126,6,28,4,2
65476,53506,50144,41476,50144,allow,492,306,186,8,15,5,3
65477,55216,53,59483,53,allow,711,87,624,2,30,1,1
65478,58956,53,19380,53,allow,213,89,124,2,30,1,1
65479,55850,443,8932,443,allow,2883,642,2241,13,135,6,7
65480,64385,443,4632,443,allow,3677,1168,2509,17,120,8,9
65481,56456,443,10392,443,allow,3528,1162,2366,10,120,5,5
65482,51000,443,31109,443,allow,41713,34380,7333,67,333,38,29
65483,51709,40705,43195,40705,allow,70,70,0,2,8,2,0
65484,5394,23,5394,23,allow,124,60,64,2,5,1,1
65485,50370,80,12726,80,allow,318,192,126,6,28,4,2
65486,50359,80,41698,80,allow,318,192,126,6,28,4,2
65487,41340,80,50400,80,allow,2426,1540,886,14,23,8,6
65488,61308,443,22375,443,allow,44341,5858,38483,102,195,42,60
65489,50367,80,15574,80,allow,318,192,126,6,28,4,2
65490,30023,3389,30023,3389,allow,4145,1976,2169,22,19,13,9
65491,55015,443,8354,443,allow,1786,172,1614,7,120,3,4
65492,55726,27015,16348,27015,allow,1173,924,249,6,30,3,3
65493,56457,443,49133,443,allow,3654,1144,2510,10,120,5,5
65494,59021,443,44226,443,allow,4596,1442,3154,24,154,11,13
65495,53518,29500,52778,29500,allow,320,140,180,6,7,3,3
65496,51688,47961,35098,47961,allow,66,66,0,1,5,1,0
65497,57031,53,9800,53,allow,170,87,83,2,31,1,1
65498,60375,32277,60465,32277,allow,70,70,0,1,5,1,0
65499,57904,443,64826,443,allow,7912,3215,4697,23,20,12,11
65500,50343,80,49722,80,allow,22233,10123,12110,37,28,16,21
65501,50360,80,16489,80,allow,318,192,126,6,28,4,2
65502,50438,3389,50438,3389,allow,3429,1474,1955,16,16,8,8
65503,50361,80,40866,80,allow,318,192,126,6,28,4,2
65504,50368,80,46672,80,allow,318,192,126,6,28,4,2
65505,49681,53,1706,53,allow,170,87,83,2,30,1,1
65506,35608,443,62915,443,allow,5776,1880,3896,19,272,11,8
65507,57137,53,7336,53,allow,711,87,624,2,30,1,1
65508,5938,22455,0,0,allow,60,60,0,1,90,1,0
65509,36226,60038,0,0,allow,66,66,0,1,91,1,0
65510,49559,53,6355,53,allow,164,84,80,2,31,1,1
65511,57292,53,56725,53,allow,170,87,83,2,31,1,1
65512,58574,443,3429,443,allow,3447,788,2659,13,135,6,7
65513,56985,53,45052,53,allow,711,87,624,2,31,1,1
65514,50269,445,0,0,drop,66,66,0,1,0,1,0
65515,50270,445,0,0,drop,66,66,0,1,0,1,0
65516,50268,445,0,0,drop,66,66,0,1,0,1,0
65517,56103,21247,0,0,deny,66,66,0,1,0,1,0
65518,54874,445,0,0,drop,70,70,0,1,0,1,0
65519,54013,37965,0,0,deny,66,66,0,1,0,1,0
65520,49784,445,0,0,drop,70,70,0,1,0,1,0
65521,49783,445,0,0,drop,70,70,0,1,0,1,0
65522,42995,26467,0,0,deny,62,62,0,1,0,1,0
65523,53314,64097,0,0,deny,66,66,0,1,0,1,0
65524,55142,26467,0,0,deny,66,66,0,1,0,1,0
65525,53848,36237,0,0,deny,62,62,0,1,0,1,0
65526,65323,53,33275,53,allow,356,118,238,2,30,1,1
65527,51710,43069,65147,43069,allow,70,70,0,2,8,2,0
65528,63691,80,13237,80,allow,314,192,122,6,15,4,2
65529,50964,80,13485,80,allow,4680740,67312,4613428,4675,77,985,3690
65530,54871,445,0,0,drop,70,70,0,1,0,1,0
65531,54870,445,0,0,drop,70,70,0,1,0,1,0
65532,54867,445,0,0,drop,70,70,0,1,0,1,0
