t_id,SourcePort,Destination Port,NATSourcePort,NATDestinationPort,Action,Bytes,BytesSent,BytesReceived,Packets,ElapsedTime,pkts_sent,pkts_received
59999,49285,53,48057,53,allow,168,78,90,2,30,1,1
60000,60419,53,60419,53,allow,217,87,130,2,30,1,1
60001,55890,53,46214,53,allow,711,87,624,2,30,1,1
60002,57568,53,57568,53,allow,235,98,137,2,30,1,1
60003,57371,53,40591,53,allow,728,96,632,2,30,1,1
60004,59204,443,10417,443,allow,9335,3052,6283,25,125,11,14
60005,40631,53,40631,53,allow,262,107,155,2,30,1,1
60006,41426,443,52242,443,allow,3396,1964,1432,16,361,8,8
60007,54397,443,59448,443,allow,1786,172,1614,7,120,3,4
60008,50265,27034,40304,27034,allow,480,149,331,2,1200,1,1
60009,42119,36237,0,0,deny,66,66,0,1,0,1,0
60010,51439,445,0,0,drop,70,70,0,1,0,1,0
60011,51837,37965,0,0,deny,66,66,0,1,0,1,0
60012,51878,445,0,0,drop,66,66,0,1,0,1,0
60013,49386,64147,0,0,deny,62,62,0,1,0,1,0
60014,10262,11392,0,0,deny,62,62,0,1,0,1,0
60015,64767,51221,0,0,deny,62,62,0,1,0,1,0
60016,51464,23,0,0,deny,60,60,0,1,0,1,0
60017,51436,445,0,0,drop,70,70,0,1,0,1,0
60018,8999,15503,0,0,deny,146,146,0,1,0,1,0
60019,1128,44847,0,0,deny,62,62,0,1,0,1,0
60020,50102,17546,0,0,deny,66,66,0,1,0,1,0
60021,45394,443,62065,443,allow,1314,653,661,13,185,7,6
60022,49772,80,25587,80,allow,1155,781,374,10,15,6,4
60023,49526,53,60849,53,allow,402,118,284,2,30,1,1
60024,64998,27037,61288,27037,allow,3287,2072,1215,12,30,6,6
60025,57009,53,8536,53,allow,177,94,83,2,30,1,1
60026,49988,443,49988,443,allow,1466,696,770,20,120,10,10
60027,50896,80,56677,80,allow,11459959,142694,11317265,9719,135,1994,7725
60028,50917,80,57551,80,allow,11626518,135099,11491419,9627,134,1907,7720
60029,50509,443,29330,443,allow,9535,1246,8289,29,77,15,14
60030,53561,35885,64999,35885,allow,70,70,0,2,7,2,0
60031,45540,8100,64668,8100,allow,78,78,0,1,4,1,0
60032,51736,34343,51970,34343,allow,70,70,0,1,5,1,0
60033,65366,443,3510,443,allow,4319,2473,1846,24,85,10,14
60034,53505,8102,48744,8102,allow,1495,843,652,10,30,5,5
60035,21909,53,21909,53,allow,197,90,107,2,30,1,1
60036,50941,443,22406,443,allow,12831,2277,10554,37,145,17,20
60037,57224,53,20310,53,allow,532,198,334,6,50,3,3
60038,55067,443,14245,443,allow,1146,360,786,20,75,7,13
60039,50899,80,62536,80,allow,13974043,173337,13800706,11715,134,2429,9286
60040,50508,443,43933,443,allow,5938,1012,4926,20,77,11,9
60041,43837,443,27944,443,allow,70,70,0,1,4,1,0
60042,50507,443,55208,443,allow,7171,1729,5442,24,78,13,11
60043,60746,40010,7294,40010,allow,316,136,180,6,6,3,3
60044,53543,51819,47777,51819,allow,70,70,0,1,4,1,0
60045,33730,443,53132,443,allow,5947,1579,4368,22,315,12,10
60046,35343,80,43757,80,allow,953,538,415,11,318,6,5
60047,57223,443,27688,443,allow,24283,14945,9338,46,318,26,20
60048,50679,443,24042,443,allow,14172,2714,11458,32,637,13,19
60049,55946,443,34803,443,allow,9274,5282,3992,42,186,22,20
60050,65273,53,14991,53,allow,338,110,228,2,29,1,1
60051,64338,53,55215,53,allow,292,102,190,2,29,1,1
60052,44883,53,44883,53,allow,216,90,126,2,29,1,1
60053,65348,53,17423,53,allow,177,94,83,2,29,1,1
60054,56776,18318,59158,18318,allow,70,70,0,1,5,1,0
60055,43483,443,14734,443,allow,144138,17538,126600,275,300,115,160
60056,58659,53,58909,53,allow,167,78,89,2,30,1,1
60057,54322,27015,10656,27015,allow,924,924,0,3,30,3,0
60058,55154,443,28417,443,allow,1610,771,839,22,120,11,11
60059,56176,53,8371,53,allow,194,102,92,2,30,1,1
60060,65263,80,27562,80,allow,7440,4032,3408,48,629,25,23
60061,56775,20617,28248,20617,allow,70,70,0,2,8,2,0
60062,51748,15177,40687,15177,allow,70,70,0,2,9,2,0
60063,56601,80,22349,80,allow,234,234,0,4,12,4,0
60064,43488,443,22133,443,allow,6817,1221,5596,26,285,14,12
60065,44847,46972,13667,46972,allow,150,150,0,1,1200,1,0
60066,36961,443,20198,443,allow,7326,1399,5927,29,280,15,14
60067,57396,53,39255,53,allow,358,102,256,2,30,1,1
60068,55114,53,53852,53,allow,392,100,292,4,33,2,2
60069,51576,443,13071,443,allow,9753,2821,6932,39,201,22,17
60070,8986,443,12105,443,allow,8062,2804,5258,43,161,20,23
60071,46442,80,6730,80,allow,1373,669,704,10,16,5,5
60072,49774,53,5014,53,allow,236,94,142,2,30,1,1
60073,41418,443,15753,443,allow,6670,1576,5094,23,200,13,10
60074,64706,27065,37449,27065,allow,924,924,0,3,30,3,0
60075,55229,53,55587,53,allow,199,94,105,2,30,1,1
60076,59175,53,63239,53,allow,168,78,90,2,30,1,1
60077,57009,53,48433,53,allow,177,94,83,2,30,1,1
60078,50714,443,52657,443,allow,9477,1950,7527,31,181,14,17
60079,44252,443,6888,443,allow,14455,6007,8448,45,120,26,19
60080,51735,50794,12843,50794,allow,70,70,0,1,5,1,0
60081,56395,443,48597,443,allow,77506,2940,74566,100,80,38,62
60082,39527,443,33957,443,allow,8447,3506,4941,28,333,15,13
60083,54321,27015,6955,27015,allow,924,924,0,3,30,3,0
60084,54320,27016,28839,27016,allow,924,924,0,3,30,3,0
60085,35587,123,5043,123,allow,184,94,90,2,30,1,1
60086,6882,8999,49067,8999,allow,238,118,120,2,1200,1,1
60087,65262,80,27207,80,allow,8814,4800,4014,52,629,27,25
60088,61384,80,43597,80,allow,2526,843,1683,12,255,7,5
60089,63264,53,63264,53,allow,197,90,107,2,30,1,1
60090,49796,53,34008,53,allow,238,102,136,2,30,1,1
60091,61256,443,47931,443,allow,2680,255,2425,9,120,4,5
60092,65427,443,32092,443,allow,14205,1527,12678,13,147,2,11
60093,50901,80,6668,80,allow,14661588,141996,14519592,11768,134,2012,9756
60094,55597,7485,9099,7485,allow,70,70,0,2,8,2,0
60095,50903,80,42549,80,allow,13644327,154437,13489890,11257,134,2201,9056
60096,51752,31677,2687,31677,allow,70,70,0,2,8,2,0
60097,7595,80,7595,80,allow,34707,1796,32911,45,45,20,25
60098,57353,443,32586,443,allow,150,150,0,1,5,1,0
60099,56777,42486,21252,42486,allow,70,70,0,1,5,1,0
60100,56964,53,13707,53,allow,267,87,180,4,57,2,2
60101,28989,53,28989,53,allow,197,90,107,2,29,1,1
60102,61492,80,29860,80,allow,901,398,503,10,15,5,5
60103,62109,443,64847,443,allow,21219,1329,19890,32,122,13,19
60104,65287,53,32403,53,allow,222,86,136,2,30,1,1
60105,56126,53,59441,53,allow,336,110,226,2,29,1,1
60106,55567,53,55567,53,allow,216,90,126,2,30,1,1
60107,49553,53,5635,53,allow,614,239,375,6,53,3,3
60108,58664,53,10827,53,allow,167,78,89,2,29,1,1
60109,49419,53,3552,53,allow,343,100,243,4,52,2,2
60110,43484,443,55073,443,allow,130,70,60,2,15,1,1
60111,49610,53,9285,53,allow,168,78,90,2,30,1,1
60112,57588,443,16925,443,allow,9109,2044,7065,25,22,14,11
60113,50645,53,27805,53,allow,177,94,83,2,30,1,1
60114,50500,443,60385,443,allow,12556,1134,11422,28,78,13,15
60115,50502,443,59383,443,allow,11323,3376,7947,29,77,16,13
60116,50504,443,47105,443,allow,5476,1073,4403,22,78,12,10
60117,52629,53,0,0,allow,418,154,264,4,33,2,2
60118,46641,8100,2386,8100,allow,78,78,0,1,4,1,0
60119,64657,53,35491,53,allow,370,96,274,4,39,2,2
60120,4184,53,4184,53,allow,216,90,126,2,29,1,1
60121,59179,53,29104,53,allow,260,86,174,2,30,1,1
60122,50209,53,40978,53,allow,86,86,0,1,30,1,0
60123,56174,443,33268,443,allow,1310,649,661,13,185,7,6
60124,45392,443,53669,443,allow,1312,651,661,13,185,7,6
60125,65251,80,48445,80,allow,6352,4052,2300,44,630,23,21
60126,65466,443,13984,443,allow,478996,13760,465236,490,16,171,319
60127,61712,80,5502,80,allow,1864,1024,840,10,16,6,4
60128,51667,25826,43364,25826,allow,9372,9372,0,11,30,11,0
60129,56291,53,51569,53,allow,260,102,158,2,30,1,1
60130,58658,53,27150,53,allow,260,86,174,2,30,1,1
60131,46297,80,56497,80,allow,1155,781,374,10,15,6,4
60132,43482,443,29764,443,allow,2316,1280,1036,20,278,11,9
60133,35509,3389,35509,3389,allow,4224,2055,2169,22,21,13,9
60134,50645,53,59508,53,allow,177,94,83,2,30,1,1
60135,54807,53,14408,53,allow,206,86,120,2,30,1,1
60136,50825,443,30672,443,allow,252960,10277,242683,301,209,119,182
60137,52321,443,49472,443,allow,10320,5152,5168,45,15,25,20
60138,43487,443,8725,443,allow,6886,1291,5595,27,285,15,12
60139,41296,80,53379,80,allow,1056,682,374,10,15,6,4
60140,65379,443,56474,443,allow,4514,2844,1670,29,84,14,15
60141,65264,80,41866,80,allow,7440,4032,3408,48,629,25,23
60142,17532,53,17532,53,allow,233,90,143,2,31,1,1
60143,52322,53,58058,53,allow,86,86,0,1,30,1,0
60144,60163,443,11476,443,allow,3041,1745,1296,28,3600,15,13
60145,56176,443,9976,443,allow,1312,651,661,13,185,7,6
60146,55928,443,33892,443,allow,5433,3275,2158,16,135,8,8
60147,53541,59939,18832,59939,allow,70,70,0,1,5,1,0
60148,65465,443,59471,443,allow,92040,4799,87241,107,16,43,64
60149,61835,443,61835,443,allow,21703,2433,19270,44,76,18,26
60150,51797,80,9284,80,allow,1929,796,1133,21,135,11,10
60151,61834,443,61834,443,allow,220115,6038,214077,231,76,78,153
60152,50229,443,13758,443,allow,6846,2479,4367,41,256,19,22
60153,50915,80,27954,80,allow,10548172,142265,10405907,9105,134,1982,7123
60154,63968,53,61368,53,allow,310,142,168,2,30,1,1
60155,58562,3389,58562,3389,allow,5387,1909,3478,22,21,10,12
60156,50911,80,6093,80,allow,13780884,170419,13610465,11542,134,2387,9155
60157,44187,443,10571,443,allow,12382,2688,9694,37,361,19,18
60158,56462,445,0,0,drop,70,70,0,1,0,1,0
60159,56454,445,0,0,drop,70,70,0,1,0,1,0
60160,56450,445,0,0,drop,70,70,0,1,0,1,0
60161,26531,37965,0,0,deny,62,62,0,1,0,1,0
60162,51431,445,0,0,drop,70,70,0,1,0,1,0
60163,50784,52952,0,0,deny,66,66,0,1,0,1,0
60164,37568,443,2020,443,allow,499,425,74,4,0,3,1
60165,37564,443,36169,443,allow,499,425,74,4,0,3,1
60166,37567,443,17651,443,allow,499,425,74,4,0,3,1
60167,37566,443,23464,443,allow,499,425,74,4,0,3,1
60168,37563,443,52126,443,allow,499,425,74,4,0,3,1
60169,37565,443,6723,443,allow,499,425,74,4,0,3,1
60170,55865,64147,0,0,deny,66,66,0,1,0,1,0
60171,61315,48817,0,0,deny,62,62,0,1,0,1,0
60172,51870,445,0,0,drop,66,66,0,1,0,1,0
60173,51430,445,0,0,drop,70,70,0,1,0,1,0
60174,50788,48817,0,0,deny,66,66,0,1,0,1,0
60175,51428,445,0,0,drop,70,70,0,1,0,1,0
60176,34382,26314,0,0,deny,143,143,0,1,0,1,0
60177,51244,16474,0,0,deny,100,100,0,1,0,1,0
60178,59584,36237,0,0,deny,66,66,0,1,0,1,0
60179,51244,21162,0,0,deny,100,100,0,1,0,1,0
60180,58597,35440,0,0,deny,62,62,0,1,0,1,0
60181,51244,29517,0,0,deny,100,100,0,1,0,1,0
60182,51244,52290,0,0,deny,100,100,0,1,0,1,0
60183,36656,64147,0,0,deny,62,62,0,1,0,1,0
60184,51244,14984,0,0,deny,100,100,0,1,0,1,0
60185,30114,65151,0,0,deny,60,60,0,1,0,1,0
60186,51859,445,0,0,drop,66,66,0,1,0,1,0
60187,51244,59353,0,0,deny,100,100,0,1,0,1,0
60188,51244,57099,0,0,deny,100,100,0,1,0,1,0
60189,56439,445,0,0,drop,70,70,0,1,0,1,0
60190,36339,50584,0,0,deny,62,62,0,1,0,1,0
60191,19570,50584,0,0,deny,66,66,0,1,0,1,0
60192,1025,40108,0,0,deny,146,146,0,1,0,1,0
60193,52802,56205,0,0,deny,66,66,0,1,0,1,0
60194,60292,7129,0,0,deny,62,62,0,1,0,1,0
60195,9659,81,0,0,deny,60,60,0,1,0,1,0
60196,51856,445,0,0,drop,66,66,0,1,0,1,0
60197,51421,445,0,0,drop,70,70,0,1,0,1,0
60198,27328,21247,0,0,deny,62,62,0,1,0,1,0
60199,51419,445,0,0,drop,70,70,0,1,0,1,0
60200,54071,50265,0,0,deny,62,62,0,1,0,1,0
60201,51848,445,0,0,drop,66,66,0,1,0,1,0
60202,42128,54532,0,0,deny,60,60,0,1,0,1,0
60203,51418,445,0,0,drop,70,70,0,1,0,1,0
60204,51840,445,0,0,drop,66,66,0,1,0,1,0
60205,51417,445,0,0,drop,70,70,0,1,0,1,0
60206,51416,445,0,0,drop,70,70,0,1,0,1,0
60207,51411,445,0,0,drop,70,70,0,1,0,1,0
60208,54631,44847,0,0,deny,74,74,0,1,0,1,0
60209,62780,35440,0,0,deny,66,66,0,1,0,1,0
60210,11458,2767,0,0,deny,66,66,0,1,0,1,0
60211,51398,445,0,0,drop,70,70,0,1,0,1,0
60212,51397,445,0,0,drop,70,70,0,1,0,1,0
60213,51391,445,0,0,drop,70,70,0,1,0,1,0
60214,27442,44847,0,0,deny,62,62,0,1,0,1,0
60215,26802,50584,0,0,deny,146,146,0,1,0,1,0
60216,47173,35440,0,0,deny,62,62,0,1,0,1,0
60217,51388,445,0,0,drop,70,70,0,1,0,1,0
60218,51387,445,0,0,drop,70,70,0,1,0,1,0
60219,26406,37965,0,0,deny,66,66,0,1,0,1,0
60220,56430,445,0,0,drop,70,70,0,1,0,1,0
60221,56428,445,0,0,drop,70,70,0,1,0,1,0
60222,56427,445,0,0,drop,70,70,0,1,0,1,0
60223,51832,445,0,0,drop,66,66,0,1,0,1,0
60224,51833,445,0,0,drop,66,66,0,1,0,1,0
60225,51834,445,0,0,drop,66,66,0,1,0,1,0
60226,51831,445,0,0,drop,66,66,0,1,0,1,0
60227,51827,445,0,0,drop,66,66,0,1,0,1,0
60228,51829,445,0,0,drop,66,66,0,1,0,1,0
60229,51828,445,0,0,drop,66,66,0,1,0,1,0
60230,51826,445,0,0,drop,66,66,0,1,0,1,0
60231,53475,3389,0,0,deny,66,66,0,1,0,1,0
60232,22683,39210,0,0,deny,60,60,0,1,0,1,0
60233,30443,44847,0,0,deny,62,62,0,1,0,1,0
60234,14615,57866,0,0,deny,66,66,0,1,0,1,0
60235,443,12105,0,0,deny,66,66,0,1,0,1,0
60236,65501,57470,0,0,deny,72,72,0,1,0,1,0
60237,62787,51221,0,0,deny,66,66,0,1,0,1,0
60238,53211,22114,0,0,deny,66,66,0,1,0,1,0
60239,6676,63836,0,0,deny,145,145,0,1,0,1,0
60240,58977,37965,0,0,deny,66,66,0,1,0,1,0
60241,51376,445,0,0,drop,70,70,0,1,0,1,0
60242,53745,443,56954,443,allow,499,425,74,4,0,3,1
60243,53744,443,46972,443,allow,499,425,74,4,0,3,1
60244,7444,57470,0,0,deny,66,66,0,1,0,1,0
60245,7222,57470,0,0,deny,62,62,0,1,0,1,0
60246,6895,57354,0,0,deny,148,148,0,1,0,1,0
60247,56422,445,0,0,drop,70,70,0,1,0,1,0
60248,56417,445,0,0,drop,70,70,0,1,0,1,0
60249,56412,445,0,0,drop,70,70,0,1,0,1,0
60250,58748,80,58748,80,allow,6516,564,5952,16,25,7,9
60251,14082,50584,0,0,deny,66,66,0,1,0,1,0
60252,44258,25,0,0,deny,74,74,0,1,0,1,0
60253,51814,445,0,0,drop,66,66,0,1,0,1,0
60254,51813,445,0,0,drop,66,66,0,1,0,1,0
60255,51812,445,0,0,drop,66,66,0,1,0,1,0
60256,19858,64147,0,0,deny,62,62,0,1,0,1,0
60257,56410,445,0,0,drop,70,70,0,1,0,1,0
60258,33822,57470,0,0,deny,66,66,0,1,0,1,0
60259,7301,14914,0,0,deny,157,157,0,1,0,1,0
60260,51372,445,0,0,drop,70,70,0,1,0,1,0
60261,56407,445,0,0,drop,70,70,0,1,0,1,0
60262,56406,445,0,0,drop,70,70,0,1,0,1,0
60263,56403,445,0,0,drop,70,70,0,1,0,1,0
60264,56395,445,0,0,drop,70,70,0,1,0,1,0
60265,33289,50584,0,0,deny,62,62,0,1,0,1,0
60266,48676,53395,0,0,deny,60,60,0,1,0,1,0
60267,51361,445,0,0,drop,70,70,0,1,0,1,0
60268,51363,445,0,0,drop,70,70,0,1,0,1,0
60269,56778,35440,0,0,deny,66,66,0,1,0,1,0
60270,51359,445,0,0,drop,70,70,0,1,0,1,0
60271,51358,445,0,0,drop,70,70,0,1,0,1,0
60272,8999,57470,0,0,deny,146,146,0,1,0,1,0
60273,51355,445,0,0,drop,70,70,0,1,0,1,0
60274,20961,35440,0,0,deny,62,62,0,1,0,1,0
60275,51074,80,51074,80,allow,168467,7348,161119,184,8,67,117
60276,61241,22114,0,0,deny,66,66,0,1,0,1,0
60277,54684,37965,0,0,deny,62,62,0,1,0,1,0
60278,56453,37965,0,0,deny,66,66,0,1,0,1,0
60279,6889,24748,0,0,deny,143,143,0,1,0,1,0
60280,59156,50584,0,0,deny,66,66,0,1,0,1,0
60281,60894,50584,0,0,deny,62,62,0,1,0,1,0
60282,56390,445,0,0,drop,70,70,0,1,0,1,0
60283,56385,445,0,0,drop,70,70,0,1,0,1,0
60284,56383,445,0,0,drop,70,70,0,1,0,1,0
60285,51350,445,0,0,drop,70,70,0,1,0,1,0
60286,18291,37807,0,0,deny,146,146,0,1,0,1,0
60287,46349,51505,0,0,deny,74,74,0,1,0,1,0
60288,0,0,0,0,allow,480,244,236,4,0,2,2
60289,3225,64147,0,0,deny,66,66,0,1,0,1,0
60290,16221,50584,0,0,deny,62,62,0,1,0,1,0
60291,51342,445,0,0,drop,70,70,0,1,0,1,0
60292,51340,445,0,0,drop,70,70,0,1,0,1,0
60293,51788,445,0,0,drop,66,66,0,1,0,1,0
60294,56380,445,0,0,drop,70,70,0,1,0,1,0
60295,16387,26193,0,0,deny,60,60,0,1,0,1,0
60296,1027,44847,0,0,deny,62,62,0,1,0,1,0
60297,50355,43890,0,0,deny,66,66,0,1,0,1,0
60298,16387,35308,0,0,deny,60,60,0,1,0,1,0
60299,16387,56995,0,0,deny,60,60,0,1,0,1,0
60300,6712,123,0,0,deny,90,90,0,1,0,1,0
60301,16524,22114,0,0,deny,62,62,0,1,0,1,0
60302,61524,23,0,0,deny,60,60,0,1,0,1,0
60303,51335,445,0,0,drop,70,70,0,1,0,1,0
60304,51334,445,0,0,drop,70,70,0,1,0,1,0
60305,5379,37965,0,0,deny,66,66,0,1,0,1,0
60306,38926,37965,0,0,deny,62,62,0,1,0,1,0
60307,1811,35440,0,0,deny,62,62,0,1,0,1,0
60308,1024,64147,0,0,deny,109,109,0,1,0,1,0
60309,51783,445,0,0,drop,66,66,0,1,0,1,0
60310,1284,50584,0,0,deny,66,66,0,1,0,1,0
60311,35269,61903,0,0,deny,145,145,0,1,0,1,0
60312,28584,37965,0,0,deny,62,62,0,1,0,1,0
60313,20844,64147,0,0,deny,66,66,0,1,0,1,0
60314,64788,43890,0,0,deny,66,66,0,1,0,1,0
60315,51782,445,0,0,drop,66,66,0,1,0,1,0
60316,51330,445,0,0,drop,70,70,0,1,0,1,0
60317,56368,445,0,0,drop,70,70,0,1,0,1,0
60318,13188,35440,0,0,deny,62,62,0,1,0,1,0
60319,56364,445,0,0,drop,70,70,0,1,0,1,0
60320,56361,445,0,0,drop,70,70,0,1,0,1,0
60321,56360,445,0,0,drop,70,70,0,1,0,1,0
60322,51329,445,0,0,drop,70,70,0,1,0,1,0
60323,51781,445,0,0,drop,66,66,0,1,0,1,0
60324,45941,23388,0,0,deny,60,60,0,1,0,1,0
60325,45941,23388,0,0,deny,60,60,0,1,0,1,0
60326,59523,37965,0,0,deny,62,62,0,1,0,1,0
60327,49516,35894,0,0,deny,62,62,0,1,0,1,0
60328,63433,57866,0,0,deny,62,62,0,1,0,1,0
60329,55618,56205,0,0,deny,62,62,0,1,0,1,0
60330,56354,445,0,0,drop,70,70,0,1,0,1,0
60331,56352,445,0,0,drop,70,70,0,1,0,1,0
60332,56351,445,0,0,drop,70,70,0,1,0,1,0
60333,56348,445,0,0,drop,70,70,0,1,0,1,0
60334,51324,445,0,0,drop,70,70,0,1,0,1,0
60335,57750,37965,0,0,deny,146,146,0,1,0,1,0
60336,39475,443,29487,443,allow,3310,2291,1019,17,16,10,7
60337,33968,443,15691,443,allow,10073,4379,5694,33,42,17,16
60338,50306,443,54494,443,allow,9889,2800,7089,28,82,17,11
60339,63750,63343,38388,63343,allow,66,66,0,2,8,2,0
60340,51731,39392,29228,39392,allow,66,66,0,1,5,1,0
60341,59738,443,4655,443,allow,510,164,346,2,31,1,1
60342,57849,443,35072,443,allow,11893,6064,5829,29,92,15,14
60343,39473,443,25041,443,allow,11226,3340,7886,28,16,16,12
60344,43071,80,63845,80,allow,808,480,328,13,158,9,4
60345,50696,80,3909,80,allow,55872,28838,27034,234,175,117,117
60346,47932,443,21603,443,allow,9467,2741,6726,24,20,15,9
60347,61622,80,61622,80,allow,48702,2799,45903,74,110,38,36
60348,38283,443,38283,443,allow,6981,948,6033,17,54,10,7
60349,50574,80,53098,80,allow,2734,1250,1484,16,15,10,6
60350,60391,47212,53433,47212,allow,258,70,188,4,8,2,2
60351,38085,443,1147,443,allow,78,78,0,1,5,1,0
60352,56964,53,45347,53,allow,267,87,180,4,54,2,2
60353,49465,443,57765,443,allow,11184,6821,4363,27,53,14,13
60354,123,123,62754,123,allow,184,94,90,2,30,1,1
60355,50692,80,35406,80,allow,57678,29714,27964,241,175,120,121
60356,52452,80,35444,80,allow,5582,591,4991,14,75,7,7
60357,50693,80,37544,80,allow,56849,29352,27497,239,175,120,119
60358,39477,443,24151,443,allow,3655,2308,1347,18,15,10,8
60359,60392,1134,52281,1134,allow,70,70,0,2,8,2,0
60360,61836,443,61836,443,allow,132180,4407,127773,146,75,51,95
60361,64530,53,55254,53,allow,261,87,174,4,45,2,2
60362,49523,53,10736,53,allow,728,96,632,2,30,1,1
60363,50695,80,60576,80,allow,58726,30286,28440,246,175,123,123
60364,56559,443,41687,443,allow,2723,1564,1159,15,17,9,6
60365,23317,443,22656,443,allow,2227,1018,1209,17,15,8,9
60366,57470,44224,31554,44224,allow,480,149,331,2,1200,1,1
60367,52454,80,19961,80,allow,2425,529,1896,11,75,6,5
60368,52065,80,16889,80,allow,81670,2359,79311,89,621,30,59
60369,50685,80,30111,80,allow,60374,30984,29390,250,175,123,127
60370,53112,29258,11040,29258,allow,70,70,0,2,8,2,0
60371,49171,443,1136,443,allow,15437,8368,7069,40,361,19,21
60372,51946,443,31314,443,allow,2666,1542,1124,17,17,9,8
60373,62111,443,62044,443,allow,3262,256,3006,9,121,4,5
60374,51749,1408,51950,1408,allow,70,70,0,1,5,1,0
60375,59737,53,18837,53,allow,382,164,218,2,31,1,1
60376,61340,443,7462,443,allow,31549,6352,25197,64,206,26,38
60377,56923,53,49262,53,allow,711,87,624,2,30,1,1
60378,56772,61424,18304,61424,allow,70,70,0,2,8,2,0
60379,39871,53,52816,53,allow,198,93,105,2,31,1,1
60380,30960,45683,56128,45683,allow,330,330,0,6,3609,6,0
60381,30960,45670,41313,45670,allow,462,462,0,8,3632,8,0
60382,61030,443,16792,443,allow,109010,37307,71703,152,895,62,90
60383,21365,23718,0,0,deny,62,62,0,1,0,1,0
60384,51773,445,0,0,drop,66,66,0,1,0,1,0
60385,51769,445,0,0,drop,66,66,0,1,0,1,0
60386,51768,445,0,0,drop,66,66,0,1,0,1,0
60387,51764,445,0,0,drop,66,66,0,1,0,1,0
60388,52514,23,0,0,deny,60,60,0,1,0,1,0
60389,28914,26296,0,0,deny,159,159,0,1,0,1,0
60390,51763,445,0,0,drop,66,66,0,1,0,1,0
60391,51762,445,0,0,drop,66,66,0,1,0,1,0
60392,51761,445,0,0,drop,66,66,0,1,0,1,0
60393,46495,4607,0,0,deny,60,60,0,1,0,1,0
60394,1182,23,0,0,deny,60,60,0,1,0,1,0
60395,61693,443,50704,443,allow,12203,3519,8684,65,18,35,30
60396,50689,80,10754,80,allow,54757,28216,26541,229,175,114,115
60397,50697,80,44763,80,allow,54775,28230,26545,230,175,115,115
60398,50582,80,62835,80,allow,53959,2683,51276,69,16,30,39
60399,31871,53,40960,53,allow,209,86,123,2,29,1,1
60400,64375,53,1918,53,allow,228,110,118,2,29,1,1
60401,57305,53,63466,53,allow,177,94,83,2,30,1,1
60402,55054,443,7526,443,allow,6903,1481,5422,33,612,12,21
60403,43214,443,49896,443,allow,1563663,41030,1522633,1538,40,479,1059
60404,56734,45086,42195,45086,allow,1640,460,1180,8,30,4,4
60405,50909,80,20271,80,allow,12826704,145724,12680980,10558,133,2024,8534
60406,50902,80,26223,80,allow,12578792,132594,12446198,10198,133,1845,8353
60407,52453,443,8871,443,allow,6650,950,5700,18,75,9,9
60408,51733,30688,11073,30688,allow,70,70,0,1,4,1,0
60409,53539,6881,61115,6881,allow,492,306,186,8,14,5,3
60410,42922,80,60551,80,allow,78,78,0,1,4,1,0
60411,52210,443,33908,443,allow,6294,1716,4578,27,23,16,11
60412,51604,443,37096,443,allow,7086,2173,4913,20,16,10,10
60413,57747,80,27520,80,allow,2754,1602,1152,17,22,9,8
60414,34760,443,55387,443,allow,70,70,0,1,4,1,0
60415,39948,5223,55367,5223,allow,5551,1338,4213,28,1323,11,17
60416,64882,53,49587,53,allow,279,126,153,2,30,1,1
60417,57470,8100,10100,8100,allow,3281,894,2387,14,1200,7,7
60418,49848,53,60109,53,allow,260,102,158,2,30,1,1
60419,60380,55125,31447,55125,allow,70,70,0,1,5,1,0
60420,60382,62582,16978,62582,allow,70,70,0,1,5,1,0
60421,51266,16103,3760,16103,allow,70,70,0,2,8,2,0
60422,60062,53,61702,53,allow,168,78,90,2,30,1,1
60423,38321,80,40490,80,allow,543,469,74,6,16,5,1
60424,64530,53,18888,53,allow,261,87,174,4,45,2,2
60425,64573,53,58393,53,allow,558,104,454,4,49,2,2
60426,60385,59696,6029,59696,allow,70,70,0,1,5,1,0
60427,43215,443,55751,443,allow,3245691,49693,3195998,2856,38,666,2190
60428,59016,443,23931,443,allow,12676,4222,8454,36,87,20,16
60429,50501,123,36469,123,allow,184,94,90,2,30,1,1
60430,49621,443,55607,443,allow,46983,4167,42816,66,44,28,38
60431,57305,53,33562,53,allow,177,94,83,2,30,1,1
60432,60895,443,6009,443,allow,9387,2961,6426,38,18,23,15
60433,9129,53,56648,53,allow,205,86,119,2,30,1,1
60434,59739,443,20531,443,allow,304,86,218,2,30,1,1
60435,12433,53,7842,53,allow,208,86,122,2,30,1,1
60436,55339,443,4853,443,allow,2552065,30474,2521591,2074,129,236,1838
60437,23560,53,25867,53,allow,219,86,133,2,30,1,1
60438,60381,26312,40513,26312,allow,70,70,0,1,5,1,0
60439,51734,59825,48074,59825,allow,70,70,0,1,5,1,0
60440,51582,443,29660,443,allow,9080,2186,6894,27,108,14,13
60441,62947,53,18275,53,allow,213,86,127,2,30,1,1
60442,55596,53,49236,53,allow,177,94,83,2,30,1,1
60443,51233,443,5696,443,allow,9925,2939,6986,30,46,17,13
60444,39640,53,64225,53,allow,168,78,90,2,30,1,1
60445,15503,42638,40530,42638,allow,1367,664,703,16,1200,9,7
60446,50908,80,37284,80,allow,14077960,171956,13906004,11755,133,2437,9318
60447,50694,80,5032,80,allow,54760,27837,26923,229,175,114,115
60448,52455,443,34682,443,allow,7356,1014,6342,20,75,10,10
60449,59419,80,51819,80,allow,3442,1672,1770,19,22,10,9
60450,36065,443,10379,443,allow,3171,1490,1681,22,21,12,10
60451,34856,443,47870,443,allow,7524,1903,5621,31,22,18,13
60452,51750,54567,18193,54567,allow,70,70,0,2,7,2,0
60453,46167,80,23731,80,allow,234,234,0,4,11,4,0
60454,57416,66,12942,66,allow,70,70,0,1,4,1,0
60455,7322,80,9945,80,allow,950,485,465,9,16,5,4
60456,50824,443,63186,443,allow,337727,11283,326444,367,208,126,241
60457,56964,53,17076,53,allow,267,87,180,4,53,2,2
60458,61837,443,61837,443,allow,18398,2360,16038,39,75,17,22
60459,47110,80,30489,80,allow,436,222,214,7,19,4,3
60460,50602,443,33341,443,allow,572966,109738,463228,1277,624,639,638
60461,33649,123,62077,123,allow,184,94,90,2,30,1,1
60462,65248,53,8659,53,allow,197,94,103,2,30,1,1
60463,64218,53,41220,53,allow,212,94,118,2,30,1,1
60464,49915,53,47403,53,allow,225,102,123,2,30,1,1
60465,34285,53,45642,53,allow,168,78,90,2,30,1,1
60466,51798,80,50477,80,allow,1825,824,1001,21,134,11,10
60467,56661,53,1967,53,allow,900,110,790,2,30,1,1
60468,48362,443,23544,443,allow,8075,1766,6309,22,78,13,9
60469,57165,53,9169,53,allow,216,102,114,2,30,1,1
60470,41882,53,0,0,allow,86,86,0,1,29,1,0
60471,28481,53,51837,53,allow,205,86,119,2,30,1,1
60472,59740,53,42403,53,allow,304,86,218,2,30,1,1
60473,52495,443,27354,443,allow,787462,10645,776817,653,131,87,566
60474,59727,443,28777,443,allow,304,86,218,2,31,1,1
60475,59725,443,21996,443,allow,304,86,218,2,31,1,1
60476,37965,40840,26004,40840,allow,150,150,0,1,1199,1,0
60477,49501,443,35522,443,allow,13077,4380,8697,34,1881,17,17
60478,59731,443,4869,443,allow,384,166,218,2,31,1,1
60479,51732,54299,38142,54299,allow,70,70,0,1,5,1,0
60480,52907,80,17763,80,allow,1659,653,1006,10,16,6,4
60481,44929,443,44929,443,allow,5469,2222,3247,22,38,13,9
60482,41811,443,11732,443,allow,28899,3134,25765,66,271,32,34
60483,59742,53,55013,53,allow,448,166,282,2,30,1,1
60484,56207,53,30514,53,allow,260,102,158,2,30,1,1
60485,39039,443,46475,443,allow,3159,1237,1922,14,19,8,6
60486,56773,28093,5962,28093,allow,70,70,0,2,8,2,0
60487,53220,80,25607,80,allow,17976,840,17136,21,16,6,15
60488,56964,53,61136,53,allow,267,87,180,4,59,2,2
60489,59741,443,12538,443,allow,384,166,218,2,30,1,1
60490,54743,443,47896,443,allow,166136,7244,158892,202,149,76,126
60491,52784,443,47288,443,allow,2802,1626,1176,18,72,9,9
60492,64720,53,3807,53,allow,216,102,114,2,30,1,1
60493,60044,443,17036,443,allow,15769,1619,14150,17,141,4,13
60494,53069,443,18651,443,allow,13074,8472,4602,31,135,16,15
60495,36936,443,13188,443,allow,490,210,280,8,131,4,4
60496,36934,443,62872,443,allow,490,210,280,8,131,4,4
60497,63171,5228,60967,5228,allow,3535,1973,1562,36,3961,18,18
60498,62110,443,43597,443,allow,10390,3051,7339,16,121,6,10
60499,53562,8999,49942,8999,allow,320,140,180,6,6,3,3
60500,53540,34134,25153,34134,allow,70,70,0,1,5,1,0
60501,50609,80,26280,80,allow,4163,2891,1272,17,17,9,8
60502,50691,80,17442,80,allow,55050,28089,26961,228,175,112,116
60503,42451,443,55087,443,allow,4886,895,3991,16,31,9,7
60504,57264,53,9791,53,allow,214,102,112,2,30,1,1
60505,50112,123,33230,123,allow,184,94,90,2,30,1,1
60506,52493,443,57807,443,allow,32907,8900,24007,38,16,16,22
60507,64530,53,39688,53,allow,261,87,174,4,46,2,2
60508,63733,47013,29294,47013,allow,70,70,0,1,5,1,0
60509,39486,80,4046,80,allow,1184,524,660,7,78,4,3
60510,63530,3389,63530,3389,allow,3489,1534,1955,17,19,9,8
60511,50482,443,21793,443,allow,2520,1267,1253,17,83,9,8
60512,50481,443,21430,443,allow,1258,716,542,13,83,7,6
60513,50684,80,24128,80,allow,57576,29602,27974,239,175,118,121
60514,53214,80,58168,80,allow,19877,856,19021,22,16,6,16
60515,123,123,8140,123,allow,184,94,90,2,30,1,1
60516,56378,53,11573,53,allow,214,102,112,2,30,1,1
60517,123,123,42021,123,allow,184,94,90,2,30,1,1
60518,55704,53,11582,53,allow,260,102,158,2,30,1,1
60519,59733,53,57614,53,allow,384,166,218,2,30,1,1
60520,49777,443,42531,443,allow,35152,27056,8096,56,104,31,25
60521,53556,1024,53867,1024,allow,70,70,0,2,8,2,0
60522,63732,40642,2876,40642,allow,70,70,0,1,5,1,0
60523,50703,80,3596,80,allow,54304,27807,26497,227,175,113,114
60524,50978,80,46474,80,allow,1442,700,742,12,35,6,6
60525,2980,53,2980,53,allow,216,90,126,2,30,1,1
60526,62113,443,7270,443,allow,3262,256,3006,9,121,4,5
60527,33109,443,18483,443,allow,6749,1593,5156,23,123,12,11
60528,62865,443,23097,443,allow,21313,7245,14068,48,128,22,26
60529,56345,445,0,0,drop,70,70,0,1,0,1,0
60530,56343,445,0,0,drop,70,70,0,1,0,1,0
60531,56342,445,0,0,drop,70,70,0,1,0,1,0
60532,51948,37965,0,0,deny,62,62,0,1,0,1,0
60533,51759,445,0,0,drop,66,66,0,1,0,1,0
60534,52401,623,0,0,deny,60,60,0,1,0,1,0
60535,56339,445,0,0,drop,70,70,0,1,0,1,0
60536,51755,445,0,0,drop,66,66,0,1,0,1,0
60537,51311,445,0,0,drop,70,70,0,1,0,1,0
60538,57165,34101,0,0,deny,66,66,0,1,0,1,0
60539,51753,445,0,0,drop,66,66,0,1,0,1,0
60540,51752,445,0,0,drop,66,66,0,1,0,1,0
60541,5180,57866,0,0,deny,62,62,0,1,0,1,0
60542,53298,26467,0,0,deny,66,66,0,1,0,1,0
60543,49501,11392,0,0,deny,62,62,0,1,0,1,0
60544,51749,445,0,0,drop,66,66,0,1,0,1,0
60545,51308,445,0,0,drop,70,70,0,1,0,1,0
60546,59315,35440,0,0,deny,66,66,0,1,0,1,0
60547,5223,5025,0,0,deny,220,220,0,1,0,1,0
60548,6916,9822,0,0,deny,100,100,0,1,0,1,0
60549,56335,445,0,0,drop,70,70,0,1,0,1,0
60550,52650,36237,0,0,deny,62,62,0,1,0,1,0
60551,56330,445,0,0,drop,70,70,0,1,0,1,0
60552,56324,445,0,0,drop,70,70,0,1,0,1,0
60553,55286,37965,0,0,deny,66,66,0,1,0,1,0
60554,17177,64147,0,0,deny,62,62,0,1,0,1,0
60555,29682,44847,0,0,deny,62,62,0,1,0,1,0
60556,62148,37965,0,0,deny,62,62,0,1,0,1,0
60557,51304,445,0,0,drop,70,70,0,1,0,1,0
60558,51829,36134,0,0,deny,66,66,0,1,0,1,0
60559,51302,445,0,0,drop,70,70,0,1,0,1,0
60560,21998,51221,0,0,deny,62,62,0,1,0,1,0
60561,51737,445,0,0,drop,66,66,0,1,0,1,0
60562,51300,445,0,0,drop,70,70,0,1,0,1,0
60563,4910,2149,0,0,deny,66,66,0,1,0,1,0
60564,8999,50432,0,0,deny,62,62,0,1,0,1,0
60565,42128,54532,0,0,deny,60,60,0,1,0,1,0
60566,36538,64147,0,0,deny,62,62,0,1,0,1,0
60567,4594,35993,0,0,deny,66,66,0,1,0,1,0
60568,45941,23386,0,0,deny,60,60,0,1,0,1,0
60569,62392,15503,0,0,deny,146,146,0,1,0,1,0
60570,12471,31573,0,0,deny,62,62,0,1,0,1,0
60571,51730,445,0,0,drop,66,66,0,1,0,1,0
60572,28832,36237,0,0,deny,62,62,0,1,0,1,0
60573,56311,445,0,0,drop,70,70,0,1,0,1,0
60574,64776,50584,0,0,deny,66,66,0,1,0,1,0
60575,1025,64147,0,0,deny,62,62,0,1,0,1,0
60576,51293,445,0,0,drop,70,70,0,1,0,1,0
60577,51727,445,0,0,drop,66,66,0,1,0,1,0
60578,51291,445,0,0,drop,70,70,0,1,0,1,0
60579,25565,54864,0,0,deny,60,60,0,1,0,1,0
60580,52676,53733,0,0,deny,66,66,0,1,0,1,0
60581,57837,64147,0,0,deny,62,62,0,1,0,1,0
60582,51290,445,0,0,drop,70,70,0,1,0,1,0
60583,51289,445,0,0,drop,70,70,0,1,0,1,0
60584,51720,445,0,0,drop,66,66,0,1,0,1,0
60585,51288,445,0,0,drop,70,70,0,1,0,1,0
60586,63379,36237,0,0,deny,66,66,0,1,0,1,0
60587,20650,26467,0,0,deny,66,66,0,1,0,1,0
60588,51286,445,0,0,drop,70,70,0,1,0,1,0
60589,51283,445,0,0,drop,70,70,0,1,0,1,0
60590,58849,64147,0,0,deny,62,62,0,1,0,1,0
60591,51713,445,0,0,drop,66,66,0,1,0,1,0
60592,58486,57470,0,0,deny,66,66,0,1,0,1,0
60593,9067,44847,0,0,deny,62,62,0,1,0,1,0
60594,41908,1433,0,0,deny,60,60,0,1,0,1,0
60595,53743,443,64755,443,allow,495,421,74,4,1,3,1
60596,51270,445,0,0,drop,70,70,0,1,0,1,0
60597,51268,445,0,0,drop,70,70,0,1,0,1,0
60598,52439,35894,0,0,deny,74,74,0,1,0,1,0
60599,51264,445,0,0,drop,70,70,0,1,0,1,0
60600,51260,445,0,0,drop,70,70,0,1,0,1,0
60601,51259,445,0,0,drop,70,70,0,1,0,1,0
60602,52135,2790,0,0,deny,66,66,0,1,0,1,0
60603,56303,445,0,0,drop,70,70,0,1,0,1,0
60604,56301,445,0,0,drop,70,70,0,1,0,1,0
60605,56299,445,0,0,drop,70,70,0,1,0,1,0
60606,4041,50584,0,0,deny,62,62,0,1,0,1,0
60607,51702,445,0,0,drop,66,66,0,1,0,1,0
60608,51704,445,0,0,drop,66,66,0,1,0,1,0
60609,51701,445,0,0,drop,66,66,0,1,0,1,0
60610,51699,445,0,0,drop,66,66,0,1,0,1,0
60611,51697,445,0,0,drop,66,66,0,1,0,1,0
60612,51705,445,0,0,drop,66,66,0,1,0,1,0
60613,51700,445,0,0,drop,66,66,0,1,0,1,0
60614,51698,445,0,0,drop,66,66,0,1,0,1,0
60615,51085,56205,0,0,deny,66,66,0,1,0,1,0
60616,27084,50584,0,0,deny,66,66,0,1,0,1,0
60617,60184,37965,0,0,deny,66,66,0,1,0,1,0
60618,3352,50584,0,0,deny,62,62,0,1,0,1,0
60619,51248,445,0,0,drop,70,70,0,1,0,1,0
60620,64024,57470,0,0,deny,66,66,0,1,0,1,0
60621,64341,57470,0,0,deny,62,62,0,1,0,1,0
60622,54305,35440,0,0,deny,62,62,0,1,0,1,0
60623,7889,48817,0,0,deny,146,146,0,1,0,1,0
60624,52208,43890,0,0,deny,66,66,0,1,0,1,0
60625,56298,445,0,0,drop,70,70,0,1,0,1,0
60626,56292,445,0,0,drop,70,70,0,1,0,1,0
60627,56285,445,0,0,drop,70,70,0,1,0,1,0
60628,14397,37965,0,0,deny,62,62,0,1,0,1,0
60629,51685,445,0,0,drop,66,66,0,1,0,1,0
60630,51684,445,0,0,drop,66,66,0,1,0,1,0
60631,51682,445,0,0,drop,66,66,0,1,0,1,0
60632,3802,55777,0,0,deny,66,66,0,1,0,1,0
60633,31845,55777,0,0,deny,62,62,0,1,0,1,0
60634,50292,62413,0,0,deny,146,146,0,1,0,1,0
60635,51244,445,0,0,drop,70,70,0,1,0,1,0
60636,56282,445,0,0,drop,70,70,0,1,0,1,0
60637,45941,23388,0,0,deny,60,60,0,1,0,1,0
60638,56279,445,0,0,drop,70,70,0,1,0,1,0
60639,51235,445,0,0,drop,70,70,0,1,0,1,0
60640,51233,445,0,0,drop,70,70,0,1,0,1,0
60641,56278,445,0,0,drop,70,70,0,1,0,1,0
60642,56269,445,0,0,drop,70,70,0,1,0,1,0
60643,56267,445,0,0,drop,70,70,0,1,0,1,0
60644,51229,445,0,0,drop,70,70,0,1,0,1,0
60645,51231,445,0,0,drop,70,70,0,1,0,1,0
60646,1114,37965,0,0,deny,62,62,0,1,0,1,0
60647,51227,445,0,0,drop,70,70,0,1,0,1,0
60648,1024,44847,0,0,deny,146,146,0,1,0,1,0
60649,55749,37965,0,0,deny,66,66,0,1,0,1,0
60650,59411,37965,0,0,deny,66,66,0,1,0,1,0
60651,53300,37807,0,0,deny,66,66,0,1,0,1,0
60652,51745,30188,0,0,deny,66,66,0,1,0,1,0
60653,22541,64147,0,0,deny,66,66,0,1,0,1,0
60654,10003,64147,0,0,deny,62,62,0,1,0,1,0
60655,8999,49001,0,0,deny,146,146,0,1,0,1,0
60656,57360,18375,0,0,deny,66,66,0,1,0,1,0
60657,51222,445,0,0,drop,70,70,0,1,0,1,0
60658,32710,22114,0,0,deny,62,62,0,1,0,1,0
60659,56262,445,0,0,drop,70,70,0,1,0,1,0
60660,56259,445,0,0,drop,70,70,0,1,0,1,0
60661,56255,445,0,0,drop,70,70,0,1,0,1,0
60662,62970,44847,0,0,deny,62,62,0,1,0,1,0
60663,53542,9192,0,0,deny,148,148,0,1,0,1,0
60664,25091,64147,0,0,deny,66,66,0,1,0,1,0
60665,52519,44847,0,0,deny,66,66,0,1,0,1,0
60666,25602,64147,0,0,deny,62,62,0,1,0,1,0
60667,1749,64147,0,0,deny,66,66,0,1,0,1,0
60668,51214,445,0,0,drop,70,70,0,1,0,1,0
60669,51212,445,0,0,drop,70,70,0,1,0,1,0
60670,53960,30041,0,0,deny,62,62,0,1,0,1,0
60671,25772,7302,0,0,deny,66,66,0,1,0,1,0
60672,54894,9571,0,0,deny,66,66,0,1,0,1,0
60673,11967,57470,0,0,deny,62,62,0,1,0,1,0
60674,55413,37965,0,0,deny,66,66,0,1,0,1,0
60675,10586,37965,0,0,deny,62,62,0,1,0,1,0
60676,51661,445,0,0,drop,66,66,0,1,0,1,0
60677,56279,23,0,0,deny,60,60,0,1,0,1,0
60678,56251,445,0,0,drop,70,70,0,1,0,1,0
60679,56246,445,0,0,drop,70,70,0,1,0,1,0
60680,51207,445,0,0,drop,70,70,0,1,0,1,0
60681,61185,54532,0,0,deny,62,62,0,1,0,1,0
60682,51206,445,0,0,drop,70,70,0,1,0,1,0
60683,61185,54532,0,0,deny,145,145,0,1,0,1,0
60684,2522,64147,0,0,deny,62,62,0,1,0,1,0
60685,51151,64147,0,0,deny,66,66,0,1,0,1,0
60686,51202,445,0,0,drop,70,70,0,1,0,1,0
60687,49744,80,36258,80,allow,2455,475,1980,9,81,5,4
60688,50478,443,64929,443,allow,36345,2308,34037,52,83,23,29
60689,52494,443,23008,443,allow,5782,1008,4774,17,15,8,9
60690,64663,53,18610,53,allow,578,286,292,9,15,5,4
60691,51139,80,1947,80,allow,124,64,60,2,15,1,1
60692,49841,80,51896,80,allow,3126,469,2657,9,75,5,4
60693,39474,443,60202,443,allow,9766,2050,7716,23,15,12,11
60694,30960,45679,3682,45679,allow,396,396,0,7,3615,7,0
60695,48817,6881,48817,6881,allow,490,149,341,2,1200,1,1
60696,61696,443,54803,443,allow,9097,2123,6974,25,16,15,10
60697,44910,443,16825,443,allow,2841,1916,925,18,26,10,8
60698,50700,80,20685,80,allow,55825,28792,27033,234,174,117,117
60699,54033,443,51149,443,allow,43491,8521,34970,69,50,34,35
60700,50698,80,42687,80,allow,54871,28320,26551,231,174,116,115
60701,50690,80,44292,80,allow,56951,28706,28245,236,174,116,120
60702,24208,53,24208,53,allow,231,88,143,2,32,1,1
60703,56769,11155,9985,11155,allow,70,70,0,2,8,2,0
60704,50702,80,54989,80,allow,55224,28254,26970,230,174,114,116
60705,22680,443,22680,443,allow,18490,7811,10679,47,81,27,20
60706,55596,53,61686,53,allow,170,87,83,2,30,1,1
60707,53533,22642,24303,22642,allow,612,306,306,10,16,5,5
60708,60521,443,45323,443,allow,45001,3799,41202,74,331,35,39
60709,39472,443,61496,443,allow,9767,2138,7629,22,16,12,10
60710,43014,53,60826,53,allow,198,93,105,2,30,1,1
60711,59729,53,2967,53,allow,303,85,218,2,30,1,1
60712,56321,443,18769,443,allow,4704,2423,2281,16,135,8,8
60713,53557,39731,46000,39731,allow,70,70,0,2,8,2,0
60714,51378,3027,51378,3027,allow,156,156,0,3,8,3,0
60715,50477,443,35054,443,allow,2604,1413,1191,15,83,9,6
60716,51357,80,45603,80,allow,124,64,60,2,16,1,1
60717,59730,443,46246,443,allow,303,85,218,2,30,1,1
60718,44654,80,35775,80,allow,2121,1558,563,13,16,7,6
60719,56704,53,33003,53,allow,711,87,624,2,30,1,1
60720,51655,445,0,0,drop,66,66,0,1,0,1,0
60721,21492,51505,0,0,deny,62,62,0,1,0,1,0
60722,51653,445,0,0,drop,66,66,0,1,0,1,0
60723,993,4281,0,0,deny,66,66,0,1,0,1,0
60724,56239,445,0,0,drop,70,70,0,1,0,1,0
60725,51200,445,0,0,drop,70,70,0,1,0,1,0
60726,61013,41705,0,0,deny,66,66,0,1,0,1,0
60727,49711,14984,0,0,deny,66,66,0,1,0,1,0
60728,56237,445,0,0,drop,70,70,0,1,0,1,0
60729,56234,445,0,0,drop,70,70,0,1,0,1,0
60730,56232,445,0,0,drop,70,70,0,1,0,1,0
60731,7842,23,0,0,deny,60,60,0,1,0,1,0
60732,51651,445,0,0,drop,66,66,0,1,0,1,0
60733,6666,3389,0,0,deny,60,60,0,1,0,1,0
60734,38484,48637,0,0,deny,60,60,0,1,0,1,0
60735,51105,50584,0,0,deny,66,66,0,1,0,1,0
60736,53233,51221,0,0,deny,66,66,0,1,0,1,0
60737,62331,61689,0,0,deny,62,62,0,1,0,1,0
60738,35957,51185,0,0,deny,60,60,0,1,0,1,0
60739,50994,35974,0,0,deny,60,60,0,1,0,1,0
60740,51196,445,0,0,drop,70,70,0,1,0,1,0
60741,56225,445,0,0,drop,70,70,0,1,0,1,0
60742,42745,50011,0,0,deny,62,62,0,1,0,1,0
60743,56224,445,0,0,drop,70,70,0,1,0,1,0
60744,56222,445,0,0,drop,70,70,0,1,0,1,0
60745,56220,445,0,0,drop,70,70,0,1,0,1,0
60746,62338,50011,0,0,deny,66,66,0,1,0,1,0
60747,51643,445,0,0,drop,66,66,0,1,0,1,0
60748,30598,46824,0,0,deny,62,62,0,1,0,1,0
60749,51641,445,0,0,drop,66,66,0,1,0,1,0
60750,51640,445,0,0,drop,66,66,0,1,0,1,0
60751,51639,445,0,0,drop,66,66,0,1,0,1,0
60752,20371,35440,0,0,deny,62,62,0,1,0,1,0
60753,51634,445,0,0,drop,66,66,0,1,0,1,0
60754,51632,445,0,0,drop,66,66,0,1,0,1,0
60755,51633,445,0,0,drop,66,66,0,1,0,1,0
60756,52910,51221,0,0,deny,78,78,0,1,0,1,0
60757,52975,23718,0,0,deny,66,66,0,1,0,1,0
60758,50422,50584,0,0,deny,66,66,0,1,0,1,0
60759,50734,37965,0,0,deny,62,62,0,1,0,1,0
60760,56703,50584,0,0,deny,66,66,0,1,0,1,0
60761,56218,445,0,0,drop,70,70,0,1,0,1,0
60762,11582,41599,40027,41599,allow,70,70,0,1,5,1,0
60763,51643,80,38570,80,allow,499,192,307,6,38,4,2
60764,49836,53,62893,53,allow,168,78,90,2,30,1,1
60765,6881,19215,41309,19215,allow,509,150,359,2,1199,1,1
60766,50699,80,28391,80,allow,54318,27824,26494,227,174,113,114
60767,34692,443,49759,443,allow,3386,1833,1553,17,255,9,8
60768,63734,28221,28610,28221,allow,70,70,0,1,4,1,0
60769,53536,34200,55165,34200,allow,70,70,0,1,4,1,0
60770,50662,443,7273,443,allow,4606,3263,1343,19,304,10,9
60771,65426,443,27740,443,allow,14205,1527,12678,13,145,2,11
60772,59379,443,58325,443,allow,4518,1784,2734,30,23,15,15
60773,53213,80,60340,80,allow,18040,904,17136,22,15,7,15
60774,51657,80,10496,80,allow,318,192,126,6,37,4,2
60775,49565,443,37074,443,allow,378,192,186,7,14,4,3
60776,53563,17355,37621,17355,allow,320,140,180,6,5,3,3
60777,14422,443,38791,443,allow,1857,1218,639,18,95,11,7
60778,51658,80,29469,80,allow,318,192,126,6,37,4,2
60779,56770,52920,52041,52920,allow,70,70,0,2,8,2,0
60780,53559,58968,7595,58968,allow,70,70,0,2,7,2,0
60781,51645,80,57006,80,allow,318,192,126,6,38,4,2
60782,51632,80,60453,80,allow,502,256,246,9,39,5,4
60783,55878,53,24199,53,allow,260,102,158,2,29,1,1
60784,59736,53,9602,53,allow,571,166,405,2,29,1,1
60785,59735,443,11235,443,allow,512,166,346,2,29,1,1
60786,55596,53,19558,53,allow,177,94,83,2,30,1,1
60787,56046,53,22169,53,allow,289,160,129,3,29,2,1
60788,62112,443,63604,443,allow,4655,1649,3006,10,120,5,5
60789,56732,10271,46976,10271,allow,3090,1706,1384,16,30,10,6
60790,51650,80,16811,80,allow,312,192,120,6,37,4,2
60791,51635,80,49291,80,allow,318,192,126,6,39,4,2
60792,56665,53,16180,53,allow,216,102,114,2,30,1,1
60793,56546,53,5266,53,allow,177,94,83,2,30,1,1
60794,56060,53,26992,53,allow,224,102,122,2,30,1,1
60795,64945,53,32076,53,allow,733,94,639,2,30,1,1
60796,51654,80,46130,80,allow,318,192,126,6,37,4,2
60797,48297,443,9986,443,allow,7320,1817,5503,41,106,16,25
60798,53715,443,59918,443,allow,70,70,0,1,5,1,0
60799,53111,50809,36816,50809,allow,70,70,0,2,8,2,0
60800,56600,80,32176,80,allow,234,234,0,4,12,4,0
60801,46415,443,41654,443,allow,9307,2265,7042,31,325,13,18
60802,36676,443,44727,443,allow,7636,3367,4269,24,319,13,11
60803,51634,80,59507,80,allow,378,192,186,7,39,4,3
60804,59166,123,2980,123,allow,184,94,90,2,30,1,1
60805,56912,53,43272,53,allow,216,94,122,2,30,1,1
60806,35688,53,49808,53,allow,199,94,105,2,30,1,1
60807,47302,53,19968,53,allow,168,78,90,2,30,1,1
60808,33196,53,25269,53,allow,181,86,95,2,30,1,1
60809,53864,53,19118,53,allow,168,78,90,2,30,1,1
60810,56546,53,1301,53,allow,177,94,83,2,30,1,1
60811,36932,443,8229,443,allow,280,140,140,5,130,3,2
60812,39458,443,56911,443,allow,1053,566,487,10,31,6,4
60813,51647,80,60876,80,allow,378,192,186,7,38,4,3
60814,51444,443,44166,443,allow,7658,1309,6349,24,75,13,11
60815,49723,80,53474,80,allow,2367,557,1810,10,82,6,4
60816,39310,53,33057,53,allow,199,94,105,2,30,1,1
60817,63628,53,35423,53,allow,289,86,203,2,30,1,1
60818,53772,53,7783,53,allow,70,70,0,1,30,1,0
60819,56920,53,48525,53,allow,184,78,106,2,30,1,1
60820,51646,80,56559,80,allow,378,192,186,7,38,4,3
60821,50483,443,29109,443,allow,10050,1192,8858,28,81,14,14
60822,65371,443,38245,443,allow,34653,2523,32130,65,83,26,39
60823,51653,80,24193,80,allow,454,262,192,8,37,5,3
60824,29176,7000,29176,7000,allow,4731,2270,2461,18,15,10,8
60825,54418,443,37950,443,allow,3350,1804,1546,19,255,10,9
60826,48000,443,53560,443,allow,7193,1890,5303,22,37,15,7
60827,40360,443,31288,443,allow,3146,766,2380,10,120,5,5
60828,52965,443,12004,443,allow,8602,1050,7552,16,120,7,9
60829,10976,22,10976,22,allow,9240,3413,5827,59,37,26,33
60830,51637,80,27014,80,allow,378,192,186,7,39,4,3
60831,39532,443,10682,443,allow,345779,9537,336242,359,26,123,236
60832,35710,443,47207,443,allow,1053,566,487,10,31,6,4
60833,30188,59035,2297,59035,allow,1794,750,1044,12,4220,6,6
60834,53462,443,47212,443,allow,6384,1091,5293,18,30,10,8
60835,35897,443,1439,443,allow,6692,1642,5050,24,275,11,13
60836,51659,80,25484,80,allow,318,192,126,6,37,4,2
60837,51102,443,49198,443,allow,3402,1258,2144,13,135,6,7
60838,50014,80,33183,80,allow,810,670,140,6,34,4,2
60839,51652,80,59640,80,allow,454,262,192,8,37,5,3
60840,51644,80,3834,80,allow,499,192,307,6,38,4,2
60841,50064,443,33198,443,allow,6376,2499,3877,20,16,10,10
60842,60195,80,26973,80,allow,3059,1869,1190,17,105,13,4
60843,51655,80,54219,80,allow,318,192,126,6,37,4,2
60844,64530,53,20478,53,allow,261,87,174,4,44,2,2
60845,35422,443,35422,443,allow,5172,1925,3247,22,39,13,9
60846,39983,80,39983,80,allow,6416,997,5419,17,30,8,9
60847,51636,80,6805,80,allow,318,192,126,6,39,4,2
60848,52735,443,43904,443,allow,41870,3567,38303,68,15,34,34
60849,53553,2297,8843,2297,allow,70,70,0,2,7,2,0
60850,53215,443,56280,443,allow,6983,1629,5354,17,15,9,8
60851,52064,80,62647,80,allow,65658,3155,62503,76,621,26,50
60852,60393,46347,14352,46347,allow,320,140,180,6,7,3,3
60853,51638,80,60451,80,allow,318,192,126,6,39,4,2
60854,55596,53,2008,53,allow,177,94,83,2,29,1,1
60855,48006,443,61488,443,allow,1429,1295,134,10,30,8,2
60856,51497,443,32306,443,allow,4710,699,4011,12,15,8,4
60857,53566,80,56289,80,allow,2270749,47314,2223435,2132,99,651,1481
60858,58711,53,20725,53,allow,277,78,199,2,30,1,1
60859,65235,53,39902,53,allow,216,94,122,2,30,1,1
60860,59734,443,60915,443,allow,512,166,346,2,29,1,1
60861,59178,53,27947,53,allow,260,86,174,2,30,1,1
60862,59732,53,64408,53,allow,384,166,218,2,30,1,1
60863,57629,443,51109,443,allow,14555,5048,9507,82,134,33,49
60864,55877,47528,12404,47528,allow,491,150,341,2,1200,1,1
60865,59728,53,43809,53,allow,304,86,218,2,30,1,1
60866,59726,53,53950,53,allow,304,86,218,2,30,1,1
60867,44979,443,39259,443,allow,10311,2186,8125,26,186,14,12
60868,41039,443,10141,443,allow,1053,566,487,10,31,6,4
60869,58046,443,22923,443,allow,1536,1089,447,11,56,7,4
60870,56421,53,8309,53,allow,177,94,83,2,30,1,1
60871,49160,51413,10192,51413,allow,800,150,650,4,1200,2,2
60872,44404,443,27524,443,allow,9060,3523,5537,27,319,15,12
60873,51633,80,4651,80,allow,502,256,246,9,39,5,4
60874,46236,53,38054,53,allow,199,94,105,2,30,1,1
60875,56261,53,65402,53,allow,199,94,105,2,30,1,1
60876,11295,40033,17184,40033,allow,156,94,62,2,30,1,1
60877,49872,53,15358,53,allow,216,94,122,2,30,1,1
60878,51640,80,25604,80,allow,2895,1428,1467,12,38,7,5
60879,52657,80,31996,80,allow,26073,2868,23205,41,110,17,24
60880,51656,80,3808,80,allow,318,192,126,6,37,4,2
60881,56771,43648,30018,43648,allow,70,70,0,2,8,2,0
60882,50479,443,28335,443,allow,1654,1011,643,16,82,9,7
60883,59724,53,63001,53,allow,304,86,218,2,30,1,1
60884,59723,443,40207,443,allow,304,86,218,2,30,1,1
60885,57173,53,39121,53,allow,168,78,90,2,30,1,1
60886,55008,53,19602,53,allow,215,102,113,2,30,1,1
60887,46970,443,52704,443,allow,8394,3155,5239,28,271,16,12
60888,51221,65264,24402,65264,allow,870,330,540,12,1573,6,6
60889,63744,47106,38855,47106,allow,66,66,0,2,8,2,0
60890,60740,80,7735,80,allow,254,128,126,5,16,3,2
60891,65109,53,42813,53,allow,229,102,127,2,30,1,1
60892,56759,53,36247,53,allow,733,94,639,2,31,1,1
60893,50353,443,35772,443,allow,7397,1784,5613,27,306,13,14
60894,63741,36776,34457,36776,allow,66,66,0,2,8,2,0
60895,57076,5222,34364,5222,allow,15600,7789,7811,155,169,82,73
60896,51198,443,22207,443,allow,8075,2723,5352,42,117,24,18
60897,57880,80,31507,80,allow,13028,3246,9782,29,30,16,13
60898,7068,53,7068,53,allow,197,90,107,2,30,1,1
60899,35132,53,35132,53,allow,469,165,304,4,31,2,2
60900,51514,443,43958,443,allow,2188,1329,859,23,19,13,10
60901,58701,27030,9286,27030,allow,70,70,0,1,5,1,0
60902,65388,80,37790,80,allow,1498,392,1106,10,16,5,5
60903,51466,443,4846,443,allow,1878,1050,828,9,16,5,4
60904,49923,53,8519,53,allow,702,194,508,6,67,3,3
60905,53785,53,12230,53,allow,167,78,89,2,31,1,1
60906,56215,445,0,0,drop,70,70,0,1,0,1,0
60907,56212,445,0,0,drop,70,70,0,1,0,1,0
60908,45964,7778,0,0,deny,60,60,0,1,0,1,0
60909,51183,445,0,0,drop,70,70,0,1,0,1,0
60910,63583,37965,0,0,deny,66,66,0,1,0,1,0
60911,51191,26467,0,0,deny,66,66,0,1,0,1,0
60912,51628,445,0,0,drop,66,66,0,1,0,1,0
60913,30599,46824,0,0,deny,66,66,0,1,0,1,0
60914,56211,445,0,0,drop,70,70,0,1,0,1,0
60915,53030,56205,0,0,deny,66,66,0,1,0,1,0
60916,51625,445,0,0,drop,66,66,0,1,0,1,0
60917,60960,49049,0,0,deny,66,66,0,1,0,1,0
60918,62930,21247,0,0,deny,66,66,0,1,0,1,0
60919,51623,445,0,0,drop,66,66,0,1,0,1,0
60920,51622,445,0,0,drop,66,66,0,1,0,1,0
60921,51180,445,0,0,drop,70,70,0,1,0,1,0
60922,2904,44847,0,0,deny,78,78,0,1,0,1,0
60923,46116,51505,0,0,deny,62,62,0,1,0,1,0
60924,51619,445,0,0,drop,66,66,0,1,0,1,0
60925,21294,57470,0,0,deny,62,62,0,1,0,1,0
60926,46849,36237,0,0,deny,66,66,0,1,0,1,0
60927,64219,51050,0,0,deny,66,66,0,1,0,1,0
60928,48815,22114,0,0,deny,146,146,0,1,0,1,0
60929,14084,43890,0,0,deny,62,62,0,1,0,1,0
60930,37234,44847,0,0,deny,62,62,0,1,0,1,0
60931,56206,445,0,0,drop,70,70,0,1,0,1,0
60932,51176,445,0,0,drop,70,70,0,1,0,1,0
60933,39823,36237,0,0,deny,66,66,0,1,0,1,0
60934,51174,445,0,0,drop,70,70,0,1,0,1,0
60935,56200,445,0,0,drop,70,70,0,1,0,1,0
60936,56192,445,0,0,drop,70,70,0,1,0,1,0
60937,1987,26467,0,0,deny,62,62,0,1,0,1,0
60938,11716,37965,0,0,deny,62,62,0,1,0,1,0
60939,10736,6112,0,0,deny,60,60,0,1,0,1,0
60940,51172,445,0,0,drop,70,70,0,1,0,1,0
60941,6666,8530,0,0,deny,60,60,0,1,0,1,0
60942,51608,445,0,0,drop,66,66,0,1,0,1,0
60943,34916,51185,0,0,deny,62,62,0,1,0,1,0
60944,51601,445,0,0,drop,66,66,0,1,0,1,0
60945,60923,49903,0,0,deny,66,66,0,1,0,1,0
60946,51165,445,0,0,drop,70,70,0,1,0,1,0
60947,56183,445,0,0,drop,70,70,0,1,0,1,0
60948,35657,48637,0,0,deny,62,62,0,1,0,1,0
60949,25523,35974,0,0,deny,62,62,0,1,0,1,0
60950,48478,49903,0,0,deny,62,62,0,1,0,1,0
60951,51163,445,0,0,drop,70,70,0,1,0,1,0
60952,33405,37965,0,0,deny,62,62,0,1,0,1,0
60953,51599,445,0,0,drop,66,66,0,1,0,1,0
60954,58715,57470,0,0,deny,62,62,0,1,0,1,0
60955,51162,445,0,0,drop,70,70,0,1,0,1,0
60956,51161,445,0,0,drop,70,70,0,1,0,1,0
60957,51160,445,0,0,drop,70,70,0,1,0,1,0
60958,51157,445,0,0,drop,70,70,0,1,0,1,0
60959,51156,445,0,0,drop,70,70,0,1,0,1,0
60960,1036,64147,0,0,deny,62,62,0,1,0,1,0
60961,51590,445,0,0,drop,66,66,0,1,0,1,0
60962,62452,21247,0,0,deny,66,66,0,1,0,1,0
60963,51586,445,0,0,drop,66,66,0,1,0,1,0
60964,13279,10387,0,0,deny,159,159,0,1,0,1,0
60965,6057,51221,0,0,deny,62,62,0,1,0,1,0
60966,53737,443,15661,443,allow,499,425,74,4,0,3,1
60967,53738,443,58635,443,allow,499,425,74,4,0,3,1
60968,53739,443,35645,443,allow,499,425,74,4,0,3,1
60969,53735,443,34476,443,allow,499,425,74,4,0,3,1
60970,53736,443,20137,443,allow,499,425,74,4,0,3,1
60971,53733,443,35168,443,allow,499,425,74,4,0,3,1
60972,53734,443,22403,443,allow,499,425,74,4,0,3,1
60973,53732,443,58255,443,allow,499,425,74,4,0,3,1
60974,53730,443,15340,443,allow,499,425,74,4,0,3,1
60975,53729,443,15910,443,allow,499,425,74,4,0,3,1
60976,53731,443,61889,443,allow,499,425,74,4,0,3,1
60977,53727,443,53687,443,allow,499,425,74,4,0,3,1
60978,35092,22,0,0,deny,60,60,0,1,0,1,0
60979,51142,445,0,0,drop,70,70,0,1,0,1,0
60980,51140,445,0,0,drop,70,70,0,1,0,1,0
60981,51136,445,0,0,drop,70,70,0,1,0,1,0
60982,51132,445,0,0,drop,70,70,0,1,0,1,0
60983,51131,445,0,0,drop,70,70,0,1,0,1,0
60984,53728,443,11260,443,allow,499,425,74,4,0,3,1
60985,53725,443,12003,443,allow,499,425,74,4,0,3,1
60986,53726,443,39961,443,allow,499,425,74,4,0,3,1
60987,53721,443,9349,443,allow,499,425,74,4,0,3,1
60988,53724,443,54768,443,allow,499,425,74,4,0,3,1
60989,53723,443,16354,443,allow,499,425,74,4,0,3,1
60990,53722,443,25032,443,allow,499,425,74,4,0,3,1
60991,53720,443,24279,443,allow,499,425,74,4,0,3,1
60992,53716,443,47571,443,allow,499,425,74,4,0,3,1
60993,53717,443,51020,443,allow,499,425,74,4,0,3,1
60994,53718,443,3459,443,allow,499,425,74,4,0,3,1
60995,53719,443,17807,443,allow,499,425,74,4,0,3,1
60996,56967,35440,0,0,deny,66,66,0,1,0,1,0
60997,61600,56205,0,0,deny,62,62,0,1,0,1,0
60998,56174,445,0,0,drop,70,70,0,1,0,1,0
60999,56173,445,0,0,drop,70,70,0,1,0,1,0
61000,56171,445,0,0,drop,70,70,0,1,0,1,0
61001,51576,445,0,0,drop,66,66,0,1,0,1,0
61002,51568,445,0,0,drop,66,66,0,1,0,1,0
61003,51575,445,0,0,drop,66,66,0,1,0,1,0
61004,51574,445,0,0,drop,66,66,0,1,0,1,0
61005,51573,445,0,0,drop,66,66,0,1,0,1,0
61006,51570,445,0,0,drop,66,66,0,1,0,1,0
61007,51571,445,0,0,drop,66,66,0,1,0,1,0
61008,51569,445,0,0,drop,66,66,0,1,0,1,0
61009,50668,58833,0,0,deny,66,66,0,1,0,1,0
61010,30920,64147,0,0,deny,62,62,0,1,0,1,0
61011,51120,445,0,0,drop,70,70,0,1,0,1,0
61012,6666,21,0,0,deny,60,60,0,1,0,1,0
61013,2791,7302,0,0,deny,62,62,0,1,0,1,0
61014,46557,57866,0,0,deny,66,66,0,1,0,1,0
61015,56327,44512,0,0,deny,66,66,0,1,0,1,0
61016,56168,445,0,0,drop,70,70,0,1,0,1,0
61017,56165,445,0,0,drop,70,70,0,1,0,1,0
61018,56156,445,0,0,drop,70,70,0,1,0,1,0
61019,53771,37965,0,0,deny,66,66,0,1,0,1,0
61020,56703,22,0,0,deny,60,60,0,1,0,1,0
61021,51115,445,0,0,drop,70,70,0,1,0,1,0
61022,25570,35440,0,0,deny,62,62,0,1,0,1,0
61023,51553,445,0,0,drop,66,66,0,1,0,1,0
61024,51555,445,0,0,drop,66,66,0,1,0,1,0
61025,51554,445,0,0,drop,66,66,0,1,0,1,0
61026,45941,23386,0,0,deny,60,60,0,1,0,1,0
61027,54346,44847,0,0,deny,62,62,0,1,0,1,0
61028,14309,56205,0,0,deny,62,62,0,1,0,1,0
61029,56153,445,0,0,drop,70,70,0,1,0,1,0
61030,51103,445,0,0,drop,70,70,0,1,0,1,0
61031,51104,445,0,0,drop,70,70,0,1,0,1,0
61032,51101,445,0,0,drop,70,70,0,1,0,1,0
61033,51100,445,0,0,drop,70,70,0,1,0,1,0
61034,43129,20220,0,0,deny,62,62,0,1,0,1,0
61035,56151,445,0,0,drop,70,70,0,1,0,1,0
61036,51097,445,0,0,drop,70,70,0,1,0,1,0
61037,5637,23,0,0,deny,60,60,0,1,0,1,0
61038,31061,23,0,0,deny,60,60,0,1,0,1,0
61039,56148,445,0,0,drop,70,70,0,1,0,1,0
61040,56145,445,0,0,drop,70,70,0,1,0,1,0
61041,56144,445,0,0,drop,70,70,0,1,0,1,0
61042,57226,51505,0,0,deny,66,66,0,1,0,1,0
61043,57723,45129,0,0,deny,148,148,0,1,0,1,0
61044,40480,30317,0,0,deny,146,146,0,1,0,1,0
61045,63786,35440,0,0,deny,62,62,0,1,0,1,0
61046,62569,44847,0,0,deny,66,66,0,1,0,1,0
61047,51090,445,0,0,drop,70,70,0,1,0,1,0
61048,56753,44847,0,0,deny,62,62,0,1,0,1,0
61049,49831,30188,0,0,deny,66,66,0,1,0,1,0
61050,15274,19473,0,0,deny,62,62,0,1,0,1,0
61051,1114,37965,0,0,deny,62,62,0,1,0,1,0
61052,56131,445,0,0,drop,70,70,0,1,0,1,0
61053,56129,445,0,0,drop,70,70,0,1,0,1,0
61054,56128,445,0,0,drop,70,70,0,1,0,1,0
61055,60192,35440,0,0,deny,66,66,0,1,0,1,0
61056,57729,19750,0,0,deny,66,66,0,1,0,1,0
61057,51083,445,0,0,drop,70,70,0,1,0,1,0
61058,51080,445,0,0,drop,70,70,0,1,0,1,0
61059,59914,65473,0,0,deny,145,145,0,1,0,1,0
61060,51076,445,0,0,drop,70,70,0,1,0,1,0
61061,53395,50321,40284,50321,allow,7546,4168,3378,37,53,24,13
61062,61460,80,11498,80,allow,1507,1184,323,11,79,7,4
61063,58429,53,0,0,allow,1254,160,1094,4,49,2,2
61064,57470,31381,16195,31381,allow,792,792,0,13,1200,13,0
61065,57356,53,56372,53,allow,815,95,720,2,30,1,1
61066,45434,443,37816,443,allow,74123,16210,57913,106,57,52,54
61067,51730,33399,18349,33399,allow,66,66,0,1,5,1,0
61068,61458,443,40730,443,allow,3505,2042,1463,27,82,15,12
61069,42090,443,46273,443,allow,5041,817,4224,20,373,8,12
61070,43098,443,63074,443,allow,3133,1883,1250,19,16,9,10
61071,51745,2572,13644,2572,allow,70,70,0,2,8,2,0
61072,49308,53,0,0,allow,180,80,100,2,30,1,1
61073,51724,25807,42911,25807,allow,66,66,0,1,5,1,0
61074,43735,53,43735,53,allow,216,88,128,2,30,1,1
61075,49650,53,63255,53,allow,322,110,212,4,30,2,2
61076,56421,53,23965,53,allow,170,87,83,2,30,1,1
61077,51870,53,51870,53,allow,825,99,726,2,30,1,1
61078,57061,53,26951,53,allow,711,87,624,2,30,1,1
61079,53227,443,53227,443,allow,4107,2486,1621,20,24,10,10
61080,53228,443,53228,443,allow,4456,2436,2020,19,24,10,9
61081,38363,15000,1161,15000,allow,130,70,60,2,6,1,1
61082,63751,17102,12860,17102,allow,312,132,180,6,6,3,3
61083,49045,80,27391,80,allow,1105,624,481,13,316,7,6
61084,54817,443,47884,443,allow,12861,6761,6100,34,164,20,14
61085,54818,443,9214,443,allow,13069,6969,6100,37,164,23,14
61086,51727,1024,54726,1024,allow,66,66,0,1,5,1,0
61087,51744,1678,51884,1678,allow,70,70,0,2,8,2,0
61088,50068,53,50068,53,allow,240,96,144,2,30,1,1
61089,49650,53,21786,53,allow,216,110,106,2,30,1,1
61090,56980,53,43925,53,allow,701,88,613,2,30,1,1
61091,60913,443,14058,443,allow,18805,1162,17643,28,135,11,17
61092,54032,53,0,0,allow,195,79,116,2,31,1,1
61093,64933,53,1484,53,allow,738,86,652,2,31,1,1
61094,19229,53,19229,53,allow,213,87,126,2,31,1,1
61095,57281,53,58597,53,allow,711,87,624,2,31,1,1
61096,56760,53,60380,53,allow,760,96,664,2,31,1,1
61097,61716,443,60379,443,allow,3168,1038,2130,16,136,8,8
61098,30960,45682,63379,45682,allow,330,330,0,6,3609,6,0
61099,15503,27645,52952,27645,allow,480,149,331,2,1200,1,1
61100,6881,6881,14545,6881,allow,492,150,342,2,1200,1,1
61101,51075,445,0,0,drop,70,70,0,1,0,1,0
61102,51530,445,0,0,drop,66,66,0,1,0,1,0
61103,38484,48637,0,0,deny,60,60,0,1,0,1,0
61104,56124,445,0,0,drop,70,70,0,1,0,1,0
61105,56118,445,0,0,drop,70,70,0,1,0,1,0
61106,42119,36237,0,0,deny,66,66,0,1,0,1,0
61107,41156,53,41156,53,allow,216,82,134,2,31,1,1
61108,49162,53,61794,53,allow,371,94,277,2,29,1,1
61109,49650,53,24810,53,allow,216,110,106,2,29,1,1
61110,123,123,13833,123,allow,184,94,90,2,30,1,1
61111,57470,43155,32052,43155,allow,594,594,0,10,1199,10,0
61112,58429,53,0,0,allow,360,160,200,4,49,2,2
61113,64114,443,8780,443,allow,1411,852,559,13,24,7,6
61114,51751,80,4770,80,allow,1854,1360,494,12,15,7,5
61115,54350,443,6406,443,allow,2402,1444,958,18,167,10,8
61116,60078,80,2527,80,allow,1114,534,580,12,15,7,5
61117,54535,80,13360,80,allow,4162,3455,707,14,15,8,6
61118,64574,53,64558,53,allow,388,95,293,4,32,2,2
61119,60377,65054,58961,65054,allow,624,318,306,10,15,5,5
61120,63743,46081,59158,46081,allow,66,66,0,2,7,2,0
61121,55787,53,59622,53,allow,229,102,127,2,29,1,1
61122,55488,53,31385,53,allow,210,94,116,2,29,1,1
61123,49650,53,11402,53,allow,216,110,106,2,30,1,1
61124,64742,53,25271,53,allow,165,86,79,2,29,1,1
61125,52996,443,47538,443,allow,22513,15188,7325,69,517,31,38
61126,61448,443,1765,443,allow,6109,1902,4207,33,141,19,14
61127,34499,443,29656,443,allow,19518,11774,7744,46,168,26,20
61128,50413,80,12074,80,allow,8388,2010,6378,17,23,8,9
61129,50338,80,9655,80,allow,2668,870,1798,13,47,7,6
61130,43206,443,34471,443,allow,4550611,95139,4455472,4046,217,935,3111
61131,61953,443,64547,443,allow,15246,5574,9672,60,391,27,33
61132,56143,53,42893,53,allow,195,94,101,2,30,1,1
61133,52466,443,10561,443,allow,5082,896,4186,16,70,8,8
61134,56356,2710,17176,2710,allow,1222,747,475,10,23,5,5
61135,50409,443,27908,443,allow,5386,4374,1012,18,34,11,7
61136,52944,53,19420,53,allow,168,78,90,2,30,1,1
61137,53287,80,8055,80,allow,2881,1001,1880,12,52,7,5
61138,56939,53,33751,53,allow,351,94,257,2,30,1,1
61139,36390,443,36390,443,allow,4563,1656,2907,19,28,11,8
61140,56998,53,2449,53,allow,199,94,105,2,30,1,1
61141,64746,53,10441,53,allow,260,86,174,2,30,1,1
61142,65313,53,33070,53,allow,193,102,91,2,30,1,1
61143,59613,443,9064,443,allow,10366,4530,5836,21,135,10,11
61144,53111,80,26592,80,allow,45904,3904,42000,65,16,33,32
61145,49501,80,23659,80,allow,183116,16652,166464,279,486,59,220
61146,8430,53,21349,53,allow,80361,77433,2928,946,89,930,16
61147,64676,53,19072,53,allow,276,94,182,2,30,1,1
61148,58853,443,38782,443,allow,59754,9493,50261,131,367,68,63
61149,54954,443,24434,443,allow,469752,21060,448692,589,64,265,324
61150,40890,53,0,0,allow,86,86,0,1,30,1,0
61151,64123,53,16597,53,allow,325,102,223,2,30,1,1
61152,60376,58302,44068,58302,allow,624,318,306,10,15,5,5
61153,33588,443,49965,443,allow,6382,2331,4051,24,109,13,11
61154,49268,443,60948,443,allow,77368,9874,67494,139,100,65,74
61155,52711,443,64979,443,allow,107997,3957,104040,135,80,51,84
61156,63742,26305,43986,26305,allow,66,66,0,2,7,2,0
61157,49735,443,35310,443,allow,6292,1682,4610,21,15,9,12
61158,51401,443,9077,443,allow,130,70,60,2,4,1,1
61159,51729,63553,6792,63553,allow,70,70,0,1,5,1,0
61160,52127,443,33029,443,allow,18360,1198,17162,27,25,9,18
61161,56799,443,34365,443,allow,5057,880,4177,16,70,8,8
61162,59636,80,29464,80,allow,1352,848,504,13,169,8,5
61163,60807,443,39155,443,allow,9127,2506,6621,38,146,20,18
61164,60874,443,2065,443,allow,777438,37182,740256,940,64,407,533
61165,64742,53,28467,53,allow,173,94,79,2,29,1,1
61166,60517,53,55123,53,allow,215,94,121,2,29,1,1
61167,50408,443,29487,443,allow,5638,4258,1380,19,34,11,8
61168,56421,53,33128,53,allow,177,94,83,2,29,1,1
61169,64021,53,10744,53,allow,339,118,221,2,29,1,1
61170,49308,53,0,0,allow,627,80,547,2,29,1,1
61171,55367,443,46972,443,allow,101466,17775,83691,225,74,112,113
61172,65313,53,6135,53,allow,193,102,91,2,30,1,1
61173,64747,53,25665,53,allow,167,78,89,2,30,1,1
61174,49397,53,28669,53,allow,365,94,271,2,30,1,1
61175,1100,27540,17868,27540,allow,132,70,62,2,30,1,1
61176,39312,443,51370,443,allow,10148,2203,7945,37,120,19,18
61177,57238,53,58179,53,allow,165,86,79,2,30,1,1
61178,49603,53,2204,53,allow,238,110,128,2,30,1,1
61179,49965,53,21038,53,allow,285,110,175,2,30,1,1
61180,50415,443,63011,443,allow,2542,1504,1038,16,20,9,7
61181,51465,80,10875,80,allow,913,410,503,10,15,5,5
61182,46799,443,46799,443,allow,22215,2460,19755,39,198,15,24
61183,60390,56494,64175,56494,allow,70,70,0,2,8,2,0
61184,51725,32787,46505,32787,allow,70,70,0,1,5,1,0
61185,40648,443,10699,443,allow,130,70,60,3,5,2,1
61186,55588,49737,20798,49737,allow,504,318,186,8,15,5,3
61187,49503,80,52162,80,allow,121857,7431,114426,166,486,38,128
61188,49500,80,17093,80,allow,309313,41646,267667,433,486,113,320
61189,65527,53,57886,53,allow,194,94,100,2,30,1,1
61190,41858,53,0,0,allow,86,86,0,1,30,1,0
61191,35132,53,35132,53,allow,86,86,0,1,30,1,0
61192,50265,55637,31401,55637,allow,528,528,0,9,1200,9,0
61193,50417,80,26233,80,allow,1658,1247,411,8,15,5,3
61194,60742,20010,30698,20010,allow,70,70,0,1,5,1,0
61195,49493,80,3964,80,allow,143422,12598,130824,226,487,52,174
61196,35287,443,46797,443,allow,47587,20536,27051,345,581,173,172
61197,33444,53,33346,53,allow,168,78,90,2,30,1,1
61198,55800,53,32257,53,allow,177,94,83,2,30,1,1
61199,55800,53,5218,53,allow,177,94,83,2,30,1,1
61200,6881,6881,60771,6881,allow,150,150,0,1,1200,1,0
61201,51689,80,35961,80,allow,16205,2525,13680,31,139,15,16
61202,55450,53,40253,53,allow,213,102,111,2,30,1,1
61203,57238,53,29243,53,allow,165,86,79,2,30,1,1
61204,56421,53,57015,53,allow,177,94,83,2,30,1,1
61205,57240,53,54621,53,allow,180,94,86,2,30,1,1
61206,33823,443,20715,443,allow,8237,1724,6513,31,270,16,15
61207,39545,443,12909,443,allow,5596,3797,1799,27,96,14,13
61208,65382,53,20411,53,allow,274,94,180,2,30,1,1
61209,63847,443,57992,443,allow,8012,4410,3602,20,135,10,10
61210,64655,53,25772,53,allow,225,102,123,2,30,1,1
61211,55545,53,22001,53,allow,177,94,83,2,30,1,1
61212,58932,53,21682,53,allow,168,78,90,2,31,1,1
61213,44725,443,58969,443,allow,7998,1347,6651,49,1647,10,39
61214,6881,6881,40959,6881,allow,238,118,120,2,1200,1,1
61215,57470,64919,63117,64919,allow,594,594,0,10,1199,10,0
61216,57470,56432,6012,56432,allow,132,132,0,3,1199,3,0
61217,64966,53,51667,53,allow,458,188,270,6,31,3,3
61218,53554,8999,6458,8999,allow,130,70,60,3,6,2,1
61219,60745,40010,27877,40010,allow,316,136,180,6,6,3,3
61220,48975,443,52782,443,allow,130,70,60,3,5,2,1
61221,49767,80,33888,80,allow,70,70,0,2,8,2,0
61222,63422,443,21466,443,allow,10617247,317598,10299649,11317,243,4141,7176
61223,49435,443,3627,443,allow,10377,3140,7237,23,52,11,12
61224,64631,53,54731,53,allow,351,93,258,4,50,2,2
61225,64399,53,19303,53,allow,373,90,283,4,53,2,2
61226,52731,443,19807,443,allow,10819,5326,5493,45,16,27,18
61227,52277,80,52277,80,allow,259496,6676,252820,249,28,74,175
61228,53548,23310,1766,23310,allow,70,70,0,2,8,2,0
61229,55545,53,60601,53,allow,177,94,83,2,30,1,1
61230,65276,53,46929,53,allow,212,102,110,2,30,1,1
61231,49853,53,48467,53,allow,811,94,717,2,30,1,1
61232,35957,51185,0,0,deny,60,60,0,1,0,1,0
61233,1431,30041,0,0,deny,62,62,0,1,0,1,0
61234,50994,35974,0,0,deny,60,60,0,1,0,1,0
61235,6881,55108,0,0,deny,148,148,0,1,0,1,0
61236,59584,36237,0,0,deny,66,66,0,1,0,1,0
61237,55056,56205,0,0,deny,66,66,0,1,0,1,0
61238,51071,445,0,0,drop,70,70,0,1,0,1,0
61239,13567,23684,0,0,deny,168,168,0,1,0,1,0
61240,40500,48817,0,0,deny,143,143,0,1,0,1,0
61241,51070,445,0,0,drop,70,70,0,1,0,1,0
61242,51528,445,0,0,drop,66,66,0,1,0,1,0
61243,50877,30041,0,0,deny,66,66,0,1,0,1,0
61244,50784,52952,0,0,deny,66,66,0,1,0,1,0
61245,1128,44847,0,0,deny,62,62,0,1,0,1,0
61246,1128,44847,0,0,deny,146,146,0,1,0,1,0
61247,51524,445,0,0,drop,66,66,0,1,0,1,0
61248,56115,445,0,0,drop,70,70,0,1,0,1,0
61249,56109,445,0,0,drop,70,70,0,1,0,1,0
61250,56105,445,0,0,drop,70,70,0,1,0,1,0
61251,56104,445,0,0,drop,70,70,0,1,0,1,0
61252,11842,35440,0,0,deny,62,62,0,1,0,1,0
61253,51522,445,0,0,drop,66,66,0,1,0,1,0
61254,58912,11392,0,0,deny,62,62,0,1,0,1,0
61255,51065,445,0,0,drop,70,70,0,1,0,1,0
61256,36339,50584,0,0,deny,62,62,0,1,0,1,0
61257,17702,6881,0,0,deny,62,62,0,1,0,1,0
61258,56098,445,0,0,drop,70,70,0,1,0,1,0
61259,56096,445,0,0,drop,70,70,0,1,0,1,0
61260,56095,445,0,0,drop,70,70,0,1,0,1,0
61261,56092,445,0,0,drop,70,70,0,1,0,1,0
61262,51514,445,0,0,drop,66,66,0,1,0,1,0
61263,57351,62413,0,0,deny,66,66,0,1,0,1,0
61264,51511,445,0,0,drop,66,66,0,1,0,1,0
61265,51510,445,0,0,drop,66,66,0,1,0,1,0
61266,51505,445,0,0,drop,66,66,0,1,0,1,0
61267,18461,19473,0,0,deny,66,66,0,1,0,1,0
61268,51503,445,0,0,drop,66,66,0,1,0,1,0
61269,51504,445,0,0,drop,66,66,0,1,0,1,0
61270,51502,445,0,0,drop,66,66,0,1,0,1,0
61271,64106,64147,0,0,deny,62,62,0,1,0,1,0
61272,45964,7776,0,0,deny,60,60,0,1,0,1,0
61273,17916,48817,0,0,deny,148,148,0,1,0,1,0
61274,51052,445,0,0,drop,70,70,0,1,0,1,0
61275,56090,445,0,0,drop,70,70,0,1,0,1,0
61276,56089,445,0,0,drop,70,70,0,1,0,1,0
61277,56086,445,0,0,drop,70,70,0,1,0,1,0
61278,51499,445,0,0,drop,66,66,0,1,0,1,0
61279,56083,445,0,0,drop,70,70,0,1,0,1,0
61280,51049,445,0,0,drop,70,70,0,1,0,1,0
61281,62780,35440,0,0,deny,66,66,0,1,0,1,0
61282,51495,445,0,0,drop,66,66,0,1,0,1,0
61283,53406,44847,0,0,deny,66,66,0,1,0,1,0
61284,26531,37965,0,0,deny,62,62,0,1,0,1,0
61285,11458,2767,0,0,deny,66,66,0,1,0,1,0
61286,61865,35440,0,0,deny,66,66,0,1,0,1,0
61287,51494,445,0,0,drop,66,66,0,1,0,1,0
61288,51491,445,0,0,drop,66,66,0,1,0,1,0
61289,26406,37965,0,0,deny,66,66,0,1,0,1,0
61290,59477,36829,0,0,deny,62,62,0,1,0,1,0
61291,51490,445,0,0,drop,66,66,0,1,0,1,0
61292,14615,57866,0,0,deny,66,66,0,1,0,1,0
61293,30443,44847,0,0,deny,62,62,0,1,0,1,0
61294,55196,10387,0,0,deny,159,159,0,1,0,1,0
61295,53475,3389,0,0,deny,66,66,0,1,0,1,0
61296,51535,64147,0,0,deny,62,62,0,1,0,1,0
61297,4366,51505,0,0,deny,62,62,0,1,0,1,0
61298,51043,445,0,0,drop,70,70,0,1,0,1,0
61299,51041,445,0,0,drop,70,70,0,1,0,1,0
61300,50113,51505,0,0,deny,62,62,0,1,0,1,0
61301,56077,445,0,0,drop,70,70,0,1,0,1,0
61302,60292,7129,0,0,deny,62,62,0,1,0,1,0
61303,51038,445,0,0,drop,70,70,0,1,0,1,0
61304,53211,22114,0,0,deny,66,66,0,1,0,1,0
61305,56074,445,0,0,drop,70,70,0,1,0,1,0
61306,56069,445,0,0,drop,70,70,0,1,0,1,0
61307,19394,44847,0,0,deny,62,62,0,1,0,1,0
61308,20706,37965,0,0,deny,62,62,0,1,0,1,0
61309,65501,57470,0,0,deny,72,72,0,1,0,1,0
61310,50972,443,8971,443,allow,469,403,66,4,0,3,1
61311,37906,37965,0,0,deny,62,62,0,1,0,1,0
61312,50081,57470,0,0,deny,66,66,0,1,0,1,0
61313,6890,34729,0,0,deny,146,146,0,1,0,1,0
61314,51480,445,0,0,drop,66,66,0,1,0,1,0
61315,2467,2767,0,0,deny,66,66,0,1,0,1,0
61316,45941,23386,0,0,deny,60,60,0,1,0,1,0
61317,20133,2767,0,0,deny,62,62,0,1,0,1,0
61318,58977,37965,0,0,deny,66,66,0,1,0,1,0
61319,12668,42707,0,0,deny,62,62,0,1,0,1,0
61320,51973,44847,0,0,deny,62,62,0,1,0,1,0
61321,10262,11392,0,0,deny,62,62,0,1,0,1,0
61322,1114,37965,0,0,deny,62,62,0,1,0,1,0
61323,51031,445,0,0,drop,70,70,0,1,0,1,0
61324,31136,50584,0,0,deny,62,62,0,1,0,1,0
61325,51471,445,0,0,drop,66,66,0,1,0,1,0
61326,51029,445,0,0,drop,70,70,0,1,0,1,0
61327,56056,445,0,0,drop,70,70,0,1,0,1,0
61328,61566,44847,0,0,deny,66,66,0,1,0,1,0
61329,51028,445,0,0,drop,70,70,0,1,0,1,0
61330,51027,445,0,0,drop,70,70,0,1,0,1,0
61331,51468,445,0,0,drop,66,66,0,1,0,1,0
61332,51026,445,0,0,drop,70,70,0,1,0,1,0
61333,51023,445,0,0,drop,70,70,0,1,0,1,0
61334,51020,445,0,0,drop,70,70,0,1,0,1,0
61335,62696,50584,0,0,deny,66,66,0,1,0,1,0
61336,51461,445,0,0,drop,66,66,0,1,0,1,0
61337,13164,39033,0,0,deny,145,145,0,1,0,1,0
61338,51008,445,0,0,drop,70,70,0,1,0,1,0
61339,51007,445,0,0,drop,70,70,0,1,0,1,0
61340,51453,445,0,0,drop,66,66,0,1,0,1,0
61341,51001,445,0,0,drop,70,70,0,1,0,1,0
61342,20961,35440,0,0,deny,62,62,0,1,0,1,0
61343,50997,445,0,0,drop,70,70,0,1,0,1,0
61344,50998,445,0,0,drop,70,70,0,1,0,1,0
61345,59156,50584,0,0,deny,66,66,0,1,0,1,0
61346,5200,6643,0,0,deny,145,145,0,1,0,1,0
61347,56047,445,0,0,drop,70,70,0,1,0,1,0
61348,56045,445,0,0,drop,70,70,0,1,0,1,0
61349,56043,445,0,0,drop,70,70,0,1,0,1,0
61350,3225,64147,0,0,deny,66,66,0,1,0,1,0
61351,51443,445,0,0,drop,66,66,0,1,0,1,0
61352,51446,445,0,0,drop,66,66,0,1,0,1,0
61353,51444,445,0,0,drop,66,66,0,1,0,1,0
61354,51438,445,0,0,drop,66,66,0,1,0,1,0
61355,51445,445,0,0,drop,66,66,0,1,0,1,0
61356,51439,445,0,0,drop,66,66,0,1,0,1,0
61357,51441,445,0,0,drop,66,66,0,1,0,1,0
61358,51440,445,0,0,drop,66,66,0,1,0,1,0
61359,1873,37965,0,0,deny,62,62,0,1,0,1,0
61360,50986,445,0,0,drop,70,70,0,1,0,1,0
61361,3407,57866,0,0,deny,66,66,0,1,0,1,0
61362,63503,42707,0,0,deny,66,66,0,1,0,1,0
61363,64191,44847,0,0,deny,62,62,0,1,0,1,0
61364,45964,2666,0,0,deny,60,60,0,1,0,1,0
61365,47910,7454,0,0,deny,60,60,0,1,0,1,0
61366,1025,35447,0,0,deny,62,62,0,1,0,1,0
61367,5223,44091,0,0,deny,220,220,0,1,0,1,0
61368,56041,445,0,0,drop,70,70,0,1,0,1,0
61369,56040,445,0,0,drop,70,70,0,1,0,1,0
61370,56028,445,0,0,drop,70,70,0,1,0,1,0
61371,50982,445,0,0,drop,70,70,0,1,0,1,0
61372,1284,50584,0,0,deny,66,66,0,1,0,1,0
61373,51426,445,0,0,drop,66,66,0,1,0,1,0
61374,51425,445,0,0,drop,66,66,0,1,0,1,0
61375,51423,445,0,0,drop,66,66,0,1,0,1,0
61376,45941,23388,0,0,deny,60,60,0,1,0,1,0
61377,64788,43890,0,0,deny,66,66,0,1,0,1,0
61378,50973,445,0,0,drop,70,70,0,1,0,1,0
61379,50971,445,0,0,drop,70,70,0,1,0,1,0
61380,56025,445,0,0,drop,70,70,0,1,0,1,0
61381,50969,445,0,0,drop,70,70,0,1,0,1,0
61382,50970,445,0,0,drop,70,70,0,1,0,1,0
61383,50964,445,0,0,drop,70,70,0,1,0,1,0
61384,56023,445,0,0,drop,70,70,0,1,0,1,0
61385,20844,64147,0,0,deny,66,66,0,1,0,1,0
61386,19858,64147,0,0,deny,62,62,0,1,0,1,0
61387,56013,445,0,0,drop,70,70,0,1,0,1,0
61388,56012,445,0,0,drop,70,70,0,1,0,1,0
61389,56014,445,0,0,drop,70,70,0,1,0,1,0
61390,30654,51221,0,0,deny,72,72,0,1,0,1,0
61391,63925,37965,0,0,deny,66,66,0,1,0,1,0
61392,33215,37965,0,0,deny,62,62,0,1,0,1,0
61393,40885,23,0,0,deny,60,60,0,1,0,1,0
61394,32974,37965,0,0,deny,66,66,0,1,0,1,0
61395,21365,23718,0,0,deny,62,62,0,1,0,1,0
61396,52802,56205,0,0,deny,66,66,0,1,0,1,0
61397,53535,1393,14227,1393,allow,70,70,0,1,5,1,0
61398,50285,80,56429,80,allow,4064,607,3457,12,45,6,6
61399,57240,53,16899,53,allow,176,90,86,2,30,1,1
61400,49708,443,54037,443,allow,456387,11878,444509,427,81,121,306
61401,56759,55201,40009,55201,allow,66,66,0,1,5,1,0
61402,53799,80,41607,80,allow,1056,682,374,10,15,6,4
61403,50283,80,41911,80,allow,5689,1015,4674,16,45,8,8
61404,59401,443,58968,443,allow,3010,1892,1118,16,15,8,8
61405,51689,443,47234,443,allow,8488,2174,6314,23,255,12,11
61406,51946,443,39002,443,allow,8670,1805,6865,28,26,15,13
61407,40662,443,40662,443,allow,4624,1717,2907,19,28,11,8
61408,59404,443,10904,443,allow,2962,1844,1118,16,15,8,8
61409,63846,443,9201,443,allow,3811,1538,2273,20,135,10,10
61410,34885,443,20315,443,allow,80828,20592,60236,124,180,54,70
61411,51464,443,29786,443,allow,575,326,249,10,15,6,4
61412,39338,443,49574,443,allow,7624,1384,6240,23,17,12,11
61413,25150,53,25150,53,allow,217,87,130,2,30,1,1
61414,52273,80,52273,80,allow,156876,7015,149861,158,28,49,109
61415,60534,80,60534,80,allow,84558,3469,81089,94,16,34,60
61416,52275,80,52275,80,allow,210890,8286,202604,208,28,64,144
61417,52276,80,52276,80,allow,222010,7236,214774,216,28,66,150
61418,60531,80,48244,80,allow,2122,1559,563,13,16,7,6
61419,59402,443,55166,443,allow,4821,1882,2939,19,15,9,10
61420,53892,443,40316,443,allow,9312,4088,5224,23,76,13,10
61421,52274,80,52274,80,allow,852970,14195,838775,769,28,207,562
61422,46858,15000,17792,15000,allow,130,70,60,2,5,1,1
61423,2487,53,2487,53,allow,235,90,145,2,33,1,1
61424,44956,443,44956,443,allow,5220,1973,3247,22,38,13,9
61425,47388,443,27845,443,allow,350,210,140,6,15,4,2
61426,41793,53,3227,53,allow,168,78,90,2,30,1,1
61427,55545,53,10302,53,allow,170,87,83,2,30,1,1
61428,55450,443,1835,443,allow,4275,2479,1796,22,316,11,11
61429,60855,443,10736,443,allow,598135,40549,557586,873,251,326,547
61430,15792,3478,30536,3478,allow,428935914,213443641,215492273,635946,2242,308738,327208
61431,59403,443,13461,443,allow,2866,1684,1182,16,15,8,8
61432,53550,1,56985,1,allow,70,70,0,2,8,2,0
61433,59399,443,48462,443,allow,66108,6145,59963,93,16,41,52
61434,49705,443,51038,443,allow,156357,6403,149954,155,81,44,111
61435,50116,22,50116,22,allow,184,120,64,4,11,3,1
61436,37460,443,55415,443,allow,2885,1732,1153,16,256,9,7
61437,43681,443,58156,443,allow,7235,1097,6138,21,27,10,11
61438,59400,443,43611,443,allow,6489,2731,3758,19,16,10,9
61439,65261,53,13380,53,allow,168,86,82,2,30,1,1
61440,55926,53,35022,53,allow,184,94,90,2,30,1,1
61441,55401,53,40210,53,allow,168,86,82,2,31,1,1
61442,60320,443,1355,443,allow,4679,2232,2447,15,136,7,8
61443,63626,443,34704,443,allow,15769,1619,14150,17,138,4,13
61444,53983,443,37079,443,allow,2571,330,2241,12,135,5,7
61445,46663,53,46663,53,allow,209,83,126,2,30,1,1
61446,40603,53,40603,53,allow,240,96,144,2,31,1,1
61447,39166,53,0,0,allow,82,82,0,1,31,1,0
61448,64180,53,16774,53,allow,176,90,86,2,31,1,1
61449,51584,443,13301,443,allow,12641,5741,6900,26,362,12,14
61450,65428,443,7165,443,allow,14203,1525,12678,13,143,2,11
61451,39414,443,32057,443,allow,4179,1480,2699,18,124,9,9
61452,51160,8090,0,0,deny,60,60,0,1,0,1,0
61453,50958,445,0,0,drop,70,70,0,1,0,1,0
61454,51159,8090,0,0,deny,60,60,0,1,0,1,0
61455,21332,23,0,0,deny,60,60,0,1,0,1,0
61456,46090,50584,0,0,deny,62,62,0,1,0,1,0
61457,64382,44847,0,0,deny,62,62,0,1,0,1,0
61458,50486,443,8859,443,allow,5791,3692,2099,21,78,13,8
61459,61681,443,6029,443,allow,5922,1917,4005,24,18,14,10
61460,38484,48637,0,0,deny,60,60,0,1,0,1,0
61461,35957,51185,0,0,deny,60,60,0,1,0,1,0
61462,50994,35974,0,0,deny,60,60,0,1,0,1,0
61463,56006,445,0,0,drop,70,70,0,1,0,1,0
61464,56005,445,0,0,drop,70,70,0,1,0,1,0
61465,56001,445,0,0,drop,70,70,0,1,0,1,0
61466,50951,445,0,0,drop,70,70,0,1,0,1,0
61467,61216,12250,0,0,deny,148,148,0,1,0,1,0
61468,50949,445,0,0,drop,70,70,0,1,0,1,0
61469,33289,50584,0,0,deny,62,62,0,1,0,1,0
61470,59037,51505,0,0,deny,62,62,0,1,0,1,0
61471,57165,34101,0,0,deny,66,66,0,1,0,1,0
61472,29706,50584,0,0,deny,66,66,0,1,0,1,0
61473,50944,445,0,0,drop,70,70,0,1,0,1,0
61474,50943,445,0,0,drop,70,70,0,1,0,1,0
61475,39161,17,0,0,deny,60,60,0,1,0,1,0
61476,46640,3780,0,0,deny,60,60,0,1,0,1,0
61477,7744,32480,0,0,deny,62,62,0,1,0,1,0
61478,51403,445,0,0,drop,66,66,0,1,0,1,0
61479,45908,3383,0,0,deny,60,60,0,1,0,1,0
61480,55997,445,0,0,drop,70,70,0,1,0,1,0
61481,55990,445,0,0,drop,70,70,0,1,0,1,0
61482,44147,64147,0,0,deny,62,62,0,1,0,1,0
61483,29682,44847,0,0,deny,62,62,0,1,0,1,0
61484,50937,445,0,0,drop,70,70,0,1,0,1,0
61485,48600,23718,0,0,deny,66,66,0,1,0,1,0
61486,23807,44847,0,0,deny,62,62,0,1,0,1,0
61487,6881,10104,0,0,deny,107,107,0,1,0,1,0
61488,52650,36237,0,0,deny,62,62,0,1,0,1,0
61489,59523,37965,0,0,deny,62,62,0,1,0,1,0
61490,50902,80,25107,80,allow,5166,1278,3888,14,144,8,6
61491,57936,443,57936,443,allow,18738,1904,16834,33,17,17,16
61492,45987,123,19536,123,allow,184,94,90,2,30,1,1
61493,64169,53,57112,53,allow,212,102,110,2,30,1,1
61494,57344,53,65328,53,allow,177,94,83,2,30,1,1
61495,8430,53,61822,53,allow,239209,233954,5255,2850,88,2822,28
61496,52272,80,52272,80,allow,237488,7574,229914,231,27,71,160
61497,57240,53,32655,53,allow,180,94,86,2,29,1,1
61498,51880,8001,48278,8001,allow,86,86,0,1,29,1,0
61499,50238,53,16273,53,allow,164,78,86,2,29,1,1
61500,49563,53,57038,53,allow,199,94,105,2,29,1,1
61501,56236,443,26673,443,allow,9597,2488,7109,32,287,16,16
61502,42385,443,55838,443,allow,321621,14025,307596,408,41,185,223
61503,56326,80,40390,80,allow,2541,689,1852,13,60,8,5
61504,49513,80,22592,80,allow,476333,9582,466751,453,225,135,318
61505,49567,443,12074,443,allow,6260,3089,3171,27,142,13,14
61506,52128,443,43146,443,allow,16113,2152,13961,35,20,18,17
61507,54971,443,20430,443,allow,13124,8442,4682,40,43,24,16
61508,55926,53,47769,53,allow,184,94,90,2,29,1,1
61509,65074,53,7213,53,allow,227,94,133,2,29,1,1
61510,57046,53,24095,53,allow,234,94,140,2,29,1,1
61511,65330,53,59699,53,allow,766,102,664,2,29,1,1
61512,53110,8830,31632,8830,allow,70,70,0,2,8,2,0
61513,58478,53,13215,53,allow,332,102,230,2,29,1,1
61514,53552,8999,58202,8999,allow,70,70,0,2,7,2,0
61515,51880,8000,41455,8000,allow,172,94,78,2,29,1,1
61516,49722,53,29083,53,allow,215,94,121,2,30,1,1
61517,49477,53,25866,53,allow,183,86,97,2,30,1,1
61518,61680,443,50542,443,allow,12015,3771,8244,41,18,23,18
61519,56950,53,15623,53,allow,363,109,254,4,46,2,2
61520,53529,17130,52813,17130,allow,492,306,186,8,15,5,3
61521,37202,53,37202,53,allow,216,90,126,2,30,1,1
61522,26900,443,4352,443,allow,24703,16382,8321,49,21,28,21
61523,57902,443,28629,443,allow,20509,7660,12849,54,131,28,26
61524,49930,53,51940,53,allow,258,110,148,2,30,1,1
61525,38009,443,41561,443,allow,130,70,60,3,5,2,1
61526,56424,80,11869,80,allow,17135,1507,15628,24,22,9,15
61527,57344,53,21861,53,allow,177,94,83,2,30,1,1
61528,54761,443,53919,443,allow,103367,3730,99637,117,170,42,75
61529,65405,53,15243,53,allow,210,102,108,2,30,1,1
61530,53108,80,57072,80,allow,1797,1070,727,10,15,5,5
61531,52492,443,60482,443,allow,33131,9092,24039,41,15,19,22
61532,46342,53,46342,53,allow,220,90,130,2,30,1,1
61533,50903,80,4352,80,allow,8600,1437,7163,18,144,10,8
61534,50575,443,24477,443,allow,5197,3181,2016,50,261,26,24
61535,45396,53,7036,53,allow,168,78,90,2,30,1,1
61536,49496,53,24067,53,allow,194,102,92,2,30,1,1
61537,64806,53,2007,53,allow,273,94,179,2,30,1,1
61538,57339,53,58719,53,allow,248,94,154,2,30,1,1
61539,10151,6881,61137,6881,allow,469,150,319,2,1200,1,1
61540,55314,53,61384,53,allow,279,110,169,2,30,1,1
61541,57584,443,53316,443,allow,915797,52405,863392,1231,269,604,627
61542,50934,443,50934,443,allow,5661,2414,3247,22,37,13,9
61543,56755,53,8890,53,allow,663,212,451,6,63,3,3
61544,64137,53,55466,53,allow,228,94,134,2,30,1,1
61545,49787,53,45265,53,allow,196,94,102,2,30,1,1
61546,60097,53,60097,53,allow,193,90,103,2,30,1,1
61547,64874,53,41940,53,allow,324,94,230,2,30,1,1
61548,62119,53,18352,53,allow,239,102,137,2,30,1,1
61549,52706,53,0,0,allow,82,82,0,2,40,2,0
61550,46056,80,34041,80,allow,5066,4404,662,11,30,6,5
61551,61417,80,18297,80,allow,214,140,74,4,55,3,1
61552,50320,53,20919,53,allow,168,78,90,2,30,1,1
61553,56785,53,13080,53,allow,213,102,111,2,30,1,1
61554,65466,53,26406,53,allow,248,94,154,2,30,1,1
61555,63016,53,49407,53,allow,243,94,149,2,30,1,1
61556,15503,11731,3627,11731,allow,1188,1188,0,19,2298,19,0
61557,64566,443,6952,443,allow,8573,2039,6534,25,31,14,11
61558,42440,443,11681,443,allow,9412,2994,6418,27,48,16,11
61559,58753,443,28125,443,allow,70,70,0,1,5,1,0
61560,51405,80,23596,80,allow,1510,481,1029,11,20,6,5
61561,50208,1688,32119,1688,allow,70,70,0,2,8,2,0
61562,55586,17332,8583,17332,allow,70,70,0,1,5,1,0
61563,56464,443,4268,443,allow,5058,913,4145,17,25,10,7
61564,53448,5223,10796,5223,allow,134,60,74,3,4,2,1
61565,57183,53,5484,53,allow,199,94,105,2,29,1,1
61566,49496,53,27238,53,allow,194,102,92,2,30,1,1
61567,65016,53,63384,53,allow,215,94,121,2,29,1,1
61568,57340,53,50973,53,allow,258,110,148,2,30,1,1
61569,56782,53,60829,53,allow,227,94,133,2,29,1,1
61570,64277,53,1694,53,allow,337,110,227,2,30,1,1
61571,50000,53,40875,53,allow,263,110,153,2,30,1,1
61572,49602,53,44779,53,allow,247,102,145,2,30,1,1
61573,55926,53,60455,53,allow,184,94,90,2,30,1,1
61574,55545,53,31002,53,allow,177,94,83,2,30,1,1
61575,49430,53,18362,53,allow,279,94,185,2,30,1,1
61576,55401,53,24581,53,allow,168,86,82,2,30,1,1
61577,49973,53,45350,53,allow,309,110,199,2,30,1,1
61578,36061,4500,28501,4500,allow,12526,5944,6582,24,3599,11,13
61579,55635,53,55876,53,allow,177,94,83,2,30,1,1
61580,64180,53,29611,53,allow,180,94,86,2,31,1,1
61581,53109,80,20052,80,allow,8176,1443,6733,20,15,10,10
61582,56599,80,32983,80,allow,234,234,0,4,12,4,0
61583,59669,80,64457,80,allow,2026957,42480,1984477,1975,80,655,1320
61584,50491,443,45806,443,allow,1304,878,426,12,78,7,5
61585,55665,53,45679,53,allow,229,94,135,2,30,1,1
61586,50433,53,61618,53,allow,770,102,668,2,30,1,1
61587,65261,53,34538,53,allow,168,86,82,2,30,1,1
61588,50870,80,58385,80,allow,7313,1684,5629,15,148,8,7
61589,53526,45046,24762,45046,allow,552,306,246,9,15,5,4
61590,63729,6969,28915,6969,allow,70,70,0,1,5,1,0
61591,63725,80,55530,80,allow,374,192,182,7,15,4,3
61592,52488,443,19422,443,allow,7165,1099,6066,16,18,9,7
61593,58392,3389,58392,3389,allow,4624,1524,3100,17,17,9,8
61594,50490,443,43169,443,allow,1353,903,450,12,78,7,5
61595,55585,48063,18600,48063,allow,70,70,0,1,5,1,0
61596,50542,443,10876,443,allow,86426,3497,82929,102,170,38,64
61597,53521,8999,10502,8999,allow,312,186,126,5,15,3,2
61598,40252,443,46211,443,allow,543828,50144,493684,682,172,254,428
61599,44414,123,11306,123,allow,184,94,90,2,30,1,1
61600,56103,53,56052,53,allow,279,94,185,2,30,1,1
61601,57240,53,1415,53,allow,180,94,86,2,30,1,1
61602,57123,53,38680,53,allow,811,94,717,2,30,1,1
61603,55447,53,41152,53,allow,194,102,92,2,30,1,1
61604,51221,57254,65381,57254,allow,491,150,341,2,1200,1,1
61605,57347,443,57555,443,allow,1081375,19607,1061768,921,122,142,779
61606,49722,53,50235,53,allow,168,78,90,2,30,1,1
61607,49444,53,27495,53,allow,199,94,105,2,30,1,1
61608,55317,53,59583,53,allow,244,94,150,2,31,1,1
61609,57071,53,47529,53,allow,274,110,164,2,31,1,1
61610,57366,53,60542,53,allow,458,188,270,6,31,3,3
61611,55184,53,55740,53,allow,443,92,351,4,31,2,2
61612,45726,443,49906,443,allow,3068,1678,1390,17,242,9,8
61613,52292,443,35142,443,allow,21680,2897,18783,35,120,15,20
61614,58143,443,15049,443,allow,17812,8128,9684,55,343,27,28
61615,64611,53,46299,53,allow,189,102,87,2,30,1,1
61616,43542,53,13639,53,allow,168,78,90,2,30,1,1
61617,56631,53,31631,53,allow,199,94,105,2,30,1,1
61618,50691,443,45100,443,allow,152,86,66,2,6,1,1
61619,52491,443,12140,443,allow,22753,7559,15194,31,16,16,15
61620,56970,53,18773,53,allow,230,110,120,2,30,1,1
61621,55151,53,16947,53,allow,285,102,183,2,30,1,1
61622,55956,53,7528,53,allow,200,94,106,2,30,1,1
61623,51408,443,60315,443,allow,8774,3355,5419,19,36,11,8
61624,38495,443,26566,443,allow,7778,1724,6054,29,17,16,13
61625,65170,53,60576,53,allow,771,102,669,2,30,1,1
61626,65414,53,10727,53,allow,197,102,95,2,31,1,1
61627,64825,53,28794,53,allow,184,94,90,2,31,1,1
61628,20389,64147,0,0,deny,66,66,0,1,0,1,0
61629,11404,64147,0,0,deny,62,62,0,1,0,1,0
61630,55286,37965,0,0,deny,66,66,0,1,0,1,0
61631,41271,50584,0,0,deny,146,146,0,1,0,1,0
61632,51130,61689,0,0,deny,62,62,0,1,0,1,0
61633,50936,445,0,0,drop,70,70,0,1,0,1,0
61634,44411,37965,0,0,deny,62,62,0,1,0,1,0
61635,51397,445,0,0,drop,66,66,0,1,0,1,0
61636,4594,35993,0,0,deny,66,66,0,1,0,1,0
61637,51393,445,0,0,drop,66,66,0,1,0,1,0
61638,55984,445,0,0,drop,70,70,0,1,0,1,0
61639,43815,50584,0,0,deny,146,146,0,1,0,1,0
61640,55979,445,0,0,drop,70,70,0,1,0,1,0
61641,55978,445,0,0,drop,70,70,0,1,0,1,0
61642,55976,445,0,0,drop,70,70,0,1,0,1,0
61643,64000,44847,0,0,deny,66,66,0,1,0,1,0
61644,50931,445,0,0,drop,70,70,0,1,0,1,0
61645,51389,445,0,0,drop,66,66,0,1,0,1,0
61646,60246,44612,0,0,deny,66,66,0,1,0,1,0
61647,11136,15503,0,0,deny,62,62,0,1,0,1,0
61648,52676,53733,0,0,deny,66,66,0,1,0,1,0
61649,61495,37965,0,0,deny,66,66,0,1,0,1,0
61650,55972,445,0,0,drop,70,70,0,1,0,1,0
61651,64776,50584,0,0,deny,66,66,0,1,0,1,0
61652,14360,64147,0,0,deny,145,145,0,1,0,1,0
61653,55968,445,0,0,drop,70,70,0,1,0,1,0
61654,55967,445,0,0,drop,70,70,0,1,0,1,0
61655,55964,445,0,0,drop,70,70,0,1,0,1,0
61656,51383,445,0,0,drop,66,66,0,1,0,1,0
61657,59597,37965,0,0,deny,66,66,0,1,0,1,0
61658,4431,32480,0,0,deny,66,66,0,1,0,1,0
61659,51380,445,0,0,drop,66,66,0,1,0,1,0
61660,51378,445,0,0,drop,66,66,0,1,0,1,0
61661,51375,445,0,0,drop,66,66,0,1,0,1,0
61662,47132,1433,0,0,deny,60,60,0,1,0,1,0
61663,59241,62413,0,0,deny,62,62,0,1,0,1,0
61664,53051,44847,0,0,deny,62,62,0,1,0,1,0
61665,51372,445,0,0,drop,66,66,0,1,0,1,0
61666,51373,445,0,0,drop,66,66,0,1,0,1,0
61667,51371,445,0,0,drop,66,66,0,1,0,1,0
61668,50917,445,0,0,drop,70,70,0,1,0,1,0
61669,20650,26467,0,0,deny,66,66,0,1,0,1,0
61670,42995,26467,0,0,deny,62,62,0,1,0,1,0
61671,50914,445,0,0,drop,70,70,0,1,0,1,0
61672,55962,445,0,0,drop,70,70,0,1,0,1,0
61673,55960,445,0,0,drop,70,70,0,1,0,1,0
61674,55956,445,0,0,drop,70,70,0,1,0,1,0
61675,51369,445,0,0,drop,66,66,0,1,0,1,0
61676,54204,443,58891,443,allow,499,425,74,4,0,3,1
61677,54196,443,33780,443,allow,499,425,74,4,0,3,1
61678,54195,443,37622,443,allow,499,425,74,4,0,3,1
61679,54199,443,31908,443,allow,499,425,74,4,0,3,1
61680,54198,443,37713,443,allow,499,425,74,4,0,3,1
61681,52439,35894,0,0,deny,74,74,0,1,0,1,0
61682,36906,50584,0,0,deny,146,146,0,1,0,1,0
61683,55955,445,0,0,drop,70,70,0,1,0,1,0
61684,42252,33303,0,0,deny,60,60,0,1,0,1,0
61685,49516,35894,0,0,deny,62,62,0,1,0,1,0
61686,443,48120,0,0,deny,97,97,0,1,0,1,0
61687,51365,445,0,0,drop,66,66,0,1,0,1,0
61688,49516,35894,0,0,deny,145,145,0,1,0,1,0
61689,38681,15503,0,0,deny,74,74,0,1,0,1,0
61690,51963,22114,0,0,deny,66,66,0,1,0,1,0
61691,51363,445,0,0,drop,66,66,0,1,0,1,0
61692,51362,445,0,0,drop,66,66,0,1,0,1,0
61693,37998,26467,0,0,deny,66,66,0,1,0,1,0
61694,47132,1433,0,0,deny,60,60,0,1,0,1,0
61695,50910,445,0,0,drop,70,70,0,1,0,1,0
61696,50908,445,0,0,drop,70,70,0,1,0,1,0
61697,65016,37965,0,0,deny,66,66,0,1,0,1,0
61698,42075,36237,0,0,deny,62,62,0,1,0,1,0
61699,43099,5900,0,0,deny,60,60,0,1,0,1,0
61700,50906,445,0,0,drop,70,70,0,1,0,1,0
61701,17777,30188,0,0,deny,62,62,0,1,0,1,0
61702,55953,445,0,0,drop,70,70,0,1,0,1,0
61703,55940,445,0,0,drop,70,70,0,1,0,1,0
61704,55938,445,0,0,drop,70,70,0,1,0,1,0
61705,54202,443,43752,443,allow,499,425,74,4,0,3,1
61706,54203,443,21798,443,allow,499,425,74,4,0,3,1
61707,54201,443,55731,443,allow,499,425,74,4,0,3,1
61708,54200,443,47040,443,allow,499,425,74,4,0,3,1
61709,54197,443,1352,443,allow,499,425,74,4,0,3,1
61710,54194,443,16208,443,allow,499,425,74,4,0,3,1
61711,54305,35440,0,0,deny,62,62,0,1,0,1,0
61712,58248,50584,0,0,deny,66,66,0,1,0,1,0
61713,52208,43890,0,0,deny,66,66,0,1,0,1,0
61714,61148,37965,0,0,deny,66,66,0,1,0,1,0
61715,51351,445,0,0,drop,66,66,0,1,0,1,0
61716,42917,52952,0,0,deny,62,62,0,1,0,1,0
61717,33822,57470,0,0,deny,66,66,0,1,0,1,0
61718,54094,5900,0,0,deny,60,60,0,1,0,1,0
61719,50899,445,0,0,drop,70,70,0,1,0,1,0
61720,52788,64147,0,0,deny,66,66,0,1,0,1,0
61721,50897,445,0,0,drop,70,70,0,1,0,1,0
61722,55966,57866,0,0,deny,66,66,0,1,0,1,0
61723,51341,445,0,0,drop,66,66,0,1,0,1,0
61724,55929,445,0,0,drop,70,70,0,1,0,1,0
61725,57107,64147,0,0,deny,62,62,0,1,0,1,0
61726,50896,445,0,0,drop,70,70,0,1,0,1,0
61727,50895,445,0,0,drop,70,70,0,1,0,1,0
61728,50894,445,0,0,drop,70,70,0,1,0,1,0
61729,43398,25604,0,0,deny,146,146,0,1,0,1,0
61730,50888,445,0,0,drop,70,70,0,1,0,1,0
61731,50889,445,0,0,drop,70,70,0,1,0,1,0
61732,51339,50584,0,0,deny,66,66,0,1,0,1,0
61733,51338,445,0,0,drop,66,66,0,1,0,1,0
61734,59411,37965,0,0,deny,66,66,0,1,0,1,0
61735,0,0,0,0,deny,156,156,0,2,0,2,0
61736,0,0,0,0,deny,156,156,0,2,0,2,0
61737,0,0,0,0,deny,156,156,0,2,0,2,0
61738,0,0,0,0,deny,156,156,0,2,0,2,0
61739,53300,37807,0,0,deny,66,66,0,1,0,1,0
61740,55749,37965,0,0,deny,66,66,0,1,0,1,0
61741,14397,37965,0,0,deny,62,62,0,1,0,1,0
61742,50876,445,0,0,drop,70,70,0,1,0,1,0
61743,50875,445,0,0,drop,70,70,0,1,0,1,0
61744,50872,445,0,0,drop,70,70,0,1,0,1,0
61745,51330,445,0,0,drop,66,66,0,1,0,1,0
61746,50866,445,0,0,drop,70,70,0,1,0,1,0
61747,50865,445,0,0,drop,70,70,0,1,0,1,0
61748,52690,7302,0,0,deny,66,66,0,1,0,1,0
61749,51325,445,0,0,drop,66,66,0,1,0,1,0
61750,62970,44847,0,0,deny,62,62,0,1,0,1,0
61751,52451,56205,0,0,deny,66,66,0,1,0,1,0
61752,56006,23,0,0,deny,60,60,0,1,0,1,0
61753,46389,27098,0,0,deny,66,66,0,1,0,1,0
61754,41852,35440,0,0,deny,62,62,0,1,0,1,0
61755,25091,64147,0,0,deny,66,66,0,1,0,1,0
61756,25602,64147,0,0,deny,62,62,0,1,0,1,0
61757,16387,56995,0,0,deny,60,60,0,1,0,1,0
61758,55918,445,0,0,drop,70,70,0,1,0,1,0
61759,55915,445,0,0,drop,70,70,0,1,0,1,0
61760,55916,445,0,0,drop,70,70,0,1,0,1,0
61761,14484,39004,0,0,deny,145,145,0,1,0,1,0
61762,50854,445,0,0,drop,70,70,0,1,0,1,0
61763,14255,2767,0,0,deny,62,62,0,1,0,1,0
61764,51310,445,0,0,drop,66,66,0,1,0,1,0
61765,51311,445,0,0,drop,66,66,0,1,0,1,0
61766,51313,445,0,0,drop,66,66,0,1,0,1,0
61767,51312,445,0,0,drop,66,66,0,1,0,1,0
61768,51315,445,0,0,drop,66,66,0,1,0,1,0
61769,51314,445,0,0,drop,66,66,0,1,0,1,0
61770,51308,445,0,0,drop,66,66,0,1,0,1,0
61771,51309,445,0,0,drop,66,66,0,1,0,1,0
61772,45964,14444,0,0,deny,60,60,0,1,0,1,0
61773,35347,20238,0,0,deny,66,66,0,1,0,1,0
61774,50849,445,0,0,drop,70,70,0,1,0,1,0
61775,49555,443,34197,443,allow,740109,22948,717161,800,54,311,489
61776,49963,53,30474,53,allow,279,96,183,4,58,2,2
61777,59774,443,17301,443,allow,846,420,426,15,29,8,7
61778,59791,443,43640,443,allow,6603,1085,5518,23,28,11,12
61779,59398,443,65413,443,allow,3730,1956,1774,16,15,8,8
61780,42821,53,25927,53,allow,168,78,90,2,30,1,1
61781,59759,443,40820,443,allow,13342,1221,12121,33,41,15,18
61782,59747,443,56102,443,allow,1991,1190,801,21,32,11,10
61783,49475,80,53528,80,allow,1548,847,701,10,16,5,5
61784,52791,80,25328,80,allow,82430,3774,78656,108,67,49,59
61785,53831,80,61237,80,allow,5774,1483,4291,14,162,8,6
61786,51945,443,60723,443,allow,8830,1950,6880,27,25,14,13
61787,46654,80,33249,80,allow,1518,954,564,14,320,8,6
61788,59798,443,49371,443,allow,1887,1152,735,18,28,9,9
61789,55920,53,58162,53,allow,770,102,668,2,30,1,1
61790,59397,443,43163,443,allow,3218,1700,1518,16,15,8,8
61791,35112,8635,35112,8635,allow,138,78,60,2,5,1,1
61792,63728,11785,51708,11785,allow,66,66,0,1,5,1,0
61793,51667,80,5248,80,allow,20457,4742,15715,37,139,20,17
61794,54649,443,1081,443,allow,355822,186974,168848,1039,1626,433,606
61795,59757,443,13672,443,allow,11663,1141,10522,30,41,14,16
61796,52309,80,52309,80,allow,450,246,204,8,29,5,3
61797,59775,443,41953,443,allow,4951,711,4240,15,29,8,7
61798,52308,80,52308,80,allow,14704,1558,13146,25,29,11,14
61799,49476,80,51976,80,allow,5000,4058,942,15,15,8,7
61800,59770,443,53384,443,allow,9630,1304,8326,28,30,14,14
61801,59646,5223,55530,5223,allow,70,70,0,1,5,1,0
61802,56689,53,22159,53,allow,738,86,652,2,30,1,1
61803,59624,443,22456,443,allow,18261,2059,16202,40,31,20,20
61804,42566,53,42566,53,allow,216,98,118,2,30,1,1
61805,52311,80,52311,80,allow,450,246,204,8,29,5,3
61806,49498,443,36900,443,allow,267319,11446,255873,336,192,117,219
61807,56520,53,14015,53,allow,757,98,659,2,30,1,1
61808,56223,53,26065,53,allow,768,99,669,2,30,1,1
61809,52175,443,52175,443,allow,506908,20303,486605,548,25,204,344
61810,64825,53,38972,53,allow,184,94,90,2,30,1,1
61811,41974,443,41974,443,allow,214163,29159,185004,242,20,108,134
61812,53208,443,19606,443,allow,11664,7921,3743,23,16,14,9
61813,58077,36653,2343,36653,allow,204,64,140,4,10,2,2
61814,59787,443,40007,443,allow,1457,816,641,15,28,7,8
61815,9278,23,9278,23,allow,146,60,86,2,10,1,1
61816,59805,443,46522,443,allow,2334,1113,1221,19,27,9,10
61817,59777,443,29457,443,allow,966,480,486,17,29,9,8
61818,59771,443,63690,443,allow,7672,1164,6508,24,30,12,12
61819,59799,443,7688,443,allow,10642,1102,9540,25,27,11,14
61820,55635,53,27124,53,allow,170,87,83,2,30,1,1
61821,55048,53,59185,53,allow,780,104,676,2,30,1,1
61822,56176,53,4646,53,allow,188,96,92,2,30,1,1
61823,6882,59689,61028,59689,allow,221,111,110,2,1200,1,1
61824,43096,443,6075,443,allow,3063,1813,1250,18,16,8,10
61825,50851,80,30396,80,allow,1123758,19319,1104439,1037,133,278,759
61826,64706,443,64706,443,allow,274,132,142,5,76,3,2
61827,56727,53,56099,53,allow,168,86,82,3,50,2,1
61828,52095,443,20736,443,allow,325846,10609,315237,326,38,106,220
61829,53398,443,48527,443,allow,5196,2308,2888,34,137,16,18
61830,50802,80,54812,80,allow,3874,684,3190,11,141,6,5
61831,52100,443,47301,443,allow,298527,11814,286713,310,37,107,203
61832,60745,123,31928,123,allow,184,94,90,2,30,1,1
61833,49846,443,59260,443,allow,278883,9002,269881,313,72,115,198
61834,55732,53,62249,53,allow,188,96,92,2,31,1,1
61835,63965,53,30693,53,allow,192,90,102,2,31,1,1
61836,58770,53,51678,53,allow,168,78,90,2,31,1,1
61837,57334,53,29836,53,allow,204,104,100,2,31,1,1
61838,64989,53,14791,53,allow,756,95,661,2,31,1,1
61839,49892,443,11967,443,allow,5930,910,5020,18,36,9,9
61840,49848,443,21903,443,allow,5997,976,5021,19,72,10,9
61841,49850,443,7446,443,allow,147320,5771,141549,184,72,73,111
61842,57372,53,34702,53,allow,756,95,661,2,31,1,1
61843,50265,61668,33376,61668,allow,132,132,0,3,1201,3,0
61844,54753,443,7702,443,allow,84945,5052,79893,120,360,61,59
61845,65349,53,30593,53,allow,772,103,669,2,31,1,1
61846,56050,53,45848,53,allow,172,88,84,2,30,1,1
61847,64359,53,39260,53,allow,192,98,94,2,31,1,1
61848,49847,443,53706,443,allow,6117,976,5141,21,72,10,11
61849,49849,443,49569,443,allow,6117,976,5141,21,72,10,11
61850,49866,443,16607,443,allow,6058,1038,5020,20,56,11,9
61851,49865,443,25068,443,allow,6177,1038,5139,22,56,11,11
61852,57173,53,42104,53,allow,216,110,106,2,31,1,1
61853,55896,53,50702,53,allow,184,94,90,2,31,1,1
61854,53006,443,46019,443,allow,17711,5894,11817,47,96,24,23
61855,52968,80,9235,80,allow,4004,1347,2657,29,114,15,14
61856,52868,80,24153,80,allow,54968,1915,53053,71,125,24,47
61857,52902,443,33545,443,allow,13263,7381,5882,51,118,26,25
61858,49824,53,9699,53,allow,172,88,84,2,31,1,1
61859,65049,53,32515,53,allow,204,104,100,2,31,1,1
61860,57173,53,12903,53,allow,216,110,106,2,31,1,1
61861,49864,443,13446,443,allow,5930,910,5020,18,56,9,9
61862,49859,443,23944,443,allow,6065,1045,5020,20,60,11,9
61863,55605,53,47383,53,allow,772,103,669,2,31,1,1
61864,49862,443,63314,443,allow,819841,23462,796379,897,56,298,599
61865,49863,443,31339,443,allow,6057,1038,5019,20,56,11,9
61866,49861,443,11860,443,allow,5995,974,5021,19,56,10,9
61867,49844,443,42026,443,allow,6117,976,5141,21,72,10,11
61868,49845,443,44493,443,allow,5996,976,5020,19,72,10,9
61869,56478,53,58747,53,allow,200,102,98,2,31,1,1
61870,55921,53,12219,53,allow,747,92,655,2,31,1,1
61871,50111,443,14390,443,allow,60978,3794,57184,73,137,26,47
61872,55907,445,0,0,drop,70,70,0,1,0,1,0
61873,55906,445,0,0,drop,70,70,0,1,0,1,0
61874,55900,445,0,0,drop,70,70,0,1,0,1,0
61875,50839,445,0,0,drop,70,70,0,1,0,1,0
61876,50840,445,0,0,drop,70,70,0,1,0,1,0
61877,56103,21247,0,0,deny,66,66,0,1,0,1,0
61878,51296,445,0,0,drop,66,66,0,1,0,1,0
61879,51295,445,0,0,drop,66,66,0,1,0,1,0
61880,51293,445,0,0,drop,66,66,0,1,0,1,0
61881,50838,445,0,0,drop,70,70,0,1,0,1,0
61882,50837,445,0,0,drop,70,70,0,1,0,1,0
61883,10965,22114,0,0,deny,62,62,0,1,0,1,0
61884,58012,5555,0,0,deny,60,60,0,1,0,1,0
61885,29623,37807,0,0,deny,146,146,0,1,0,1,0
61886,50833,445,0,0,drop,70,70,0,1,0,1,0
61887,5222,21212,0,0,deny,66,66,0,1,0,1,0
61888,61013,41705,0,0,deny,66,66,0,1,0,1,0
61889,55897,445,0,0,drop,70,70,0,1,0,1,0
61890,32520,50265,0,0,deny,145,145,0,1,0,1,0
61891,6889,41615,0,0,deny,143,143,0,1,0,1,0
61892,38484,48637,0,0,deny,60,60,0,1,0,1,0
61893,53314,64097,0,0,deny,62,62,0,1,0,1,0
61894,35957,51185,0,0,deny,60,60,0,1,0,1,0
61895,55895,445,0,0,drop,70,70,0,1,0,1,0
61896,53330,443,1024,443,allow,5454,1157,4297,15,22,9,6
61897,56176,53,62297,53,allow,102,102,0,1,30,1,0
61898,55926,53,56818,53,allow,184,94,90,2,29,1,1
61899,49567,53,58916,53,allow,244,94,150,2,29,1,1
61900,64858,53,57701,53,allow,196,102,94,2,30,1,1
61901,50994,35974,0,0,deny,60,60,0,1,0,1,0
61902,29145,8168,0,0,deny,62,62,0,1,0,1,0
61903,60617,64147,0,0,deny,62,62,0,1,0,1,0
61904,45908,3383,0,0,deny,60,60,0,1,0,1,0
61905,57959,21247,0,0,deny,66,66,0,1,0,1,0
61906,55892,445,0,0,drop,70,70,0,1,0,1,0
61907,55888,445,0,0,drop,70,70,0,1,0,1,0
61908,55883,445,0,0,drop,70,70,0,1,0,1,0
61909,52611,9571,0,0,deny,62,62,0,1,0,1,0
61910,50827,445,0,0,drop,70,70,0,1,0,1,0
61911,20371,35440,0,0,deny,62,62,0,1,0,1,0
61912,8889,60297,0,0,deny,60,60,0,1,0,1,0
61913,47013,37965,0,0,deny,62,62,0,1,0,1,0
61914,39244,36829,0,0,deny,146,146,0,1,0,1,0
61915,52975,23718,0,0,deny,66,66,0,1,0,1,0
61916,50820,445,0,0,drop,70,70,0,1,0,1,0
61917,50818,445,0,0,drop,70,70,0,1,0,1,0
61918,50422,50584,0,0,deny,66,66,0,1,0,1,0
61919,55875,445,0,0,drop,70,70,0,1,0,1,0
61920,55874,445,0,0,drop,70,70,0,1,0,1,0
61921,55873,445,0,0,drop,70,70,0,1,0,1,0
61922,64177,44847,0,0,deny,62,62,0,1,0,1,0
61923,56798,9571,0,0,deny,62,62,0,1,0,1,0
61924,33469,61903,0,0,deny,145,145,0,1,0,1,0
61925,443,10010,0,0,deny,60,60,0,1,0,1,0
61926,43271,50584,0,0,deny,146,146,0,1,0,1,0
61927,3964,51505,0,0,deny,62,62,0,1,0,1,0
61928,61357,64147,0,0,deny,62,62,0,1,0,1,0
61929,50813,445,0,0,drop,70,70,0,1,0,1,0
61930,2404,35440,0,0,deny,146,146,0,1,0,1,0
61931,46849,36237,0,0,deny,66,66,0,1,0,1,0
61932,50812,445,0,0,drop,70,70,0,1,0,1,0
61933,60960,49049,0,0,deny,66,66,0,1,0,1,0
61934,62930,21247,0,0,deny,66,66,0,1,0,1,0
61935,53353,26467,0,0,deny,62,62,0,1,0,1,0
61936,64166,35440,0,0,deny,66,66,0,1,0,1,0
61937,46116,51505,0,0,deny,62,62,0,1,0,1,0
61938,51953,37965,0,0,deny,66,66,0,1,0,1,0
61939,51273,445,0,0,drop,66,66,0,1,0,1,0
61940,50808,445,0,0,drop,70,70,0,1,0,1,0
61941,55868,445,0,0,drop,70,70,0,1,0,1,0
61942,55862,445,0,0,drop,70,70,0,1,0,1,0
61943,51570,443,51570,443,allow,11204,3773,7431,29,132,12,17
61944,49275,53,23304,53,allow,212,102,110,2,30,1,1
61945,52490,443,51639,443,allow,23518,8884,14634,32,15,15,17
61946,57863,443,52780,443,allow,1981,1155,826,19,86,10,9
61947,53209,80,42720,80,allow,1452,484,968,8,15,5,3
61948,57413,443,19121,443,allow,16749,7614,9135,74,17,34,40
61949,55635,53,55478,53,allow,177,94,83,2,29,1,1
61950,55776,53,11095,53,allow,272,110,162,2,29,1,1
61951,64611,53,9832,53,allow,181,94,87,2,29,1,1
61952,58771,80,64938,80,allow,2062,904,1158,10,258,6,4
61953,64762,53,23924,53,allow,200,94,106,2,30,1,1
61954,57486,80,57486,80,allow,1248,535,713,10,20,5,5
61955,55732,53,1656,53,allow,194,102,92,2,30,1,1
61956,33057,80,61093,80,allow,1151,711,440,10,15,5,5
61957,56481,443,31113,443,allow,1853,1214,639,18,134,11,7
61958,51715,29358,11619,29358,allow,414,136,278,6,16,3,3
61959,52313,80,52313,80,allow,450,246,204,8,29,5,3
61960,51771,80,34714,80,allow,76066,3663,72403,92,24,40,52
61961,56624,53,50985,53,allow,196,102,94,2,30,1,1
61962,56730,53,45534,53,allow,210,110,100,2,30,1,1
61963,65464,443,36070,443,allow,395647,11870,383777,409,16,144,265
61964,59781,443,23445,443,allow,546,180,366,10,28,4,6
61965,43055,80,43055,80,allow,1246,533,713,10,20,5,5
61966,59752,443,31611,443,allow,12150,1262,10888,29,41,13,16
61967,53196,443,1285,443,allow,4371,1115,3256,19,19,9,10
61968,49939,53,36312,53,allow,384,103,281,4,50,2,2
61969,51739,62163,31026,62163,allow,70,70,0,2,8,2,0
61970,51118,80,26346,80,allow,1952,1118,834,21,365,11,10
61971,55635,53,13643,53,allow,177,94,83,2,30,1,1
61972,49963,53,54838,53,allow,279,96,183,4,59,2,2
61973,64946,53,45329,53,allow,210,102,108,2,30,1,1
61974,49614,53,48437,53,allow,258,110,148,2,30,1,1
61975,55217,53,21902,53,allow,189,102,87,2,30,1,1
61976,37984,443,32167,443,allow,3149,1829,1320,22,315,12,10
61977,52730,443,26039,443,allow,8040,2587,5453,39,16,23,16
61978,60368,443,14990,443,allow,10483,4072,6411,20,26,9,11
61979,39036,443,62520,443,allow,1768,541,1227,11,20,7,4
61980,64858,53,5118,53,allow,819,102,717,2,30,1,1
61981,65298,53,31126,53,allow,277,110,167,2,30,1,1
61982,56602,53,21237,53,allow,197,102,95,2,30,1,1
61983,35338,443,9775,443,allow,7504,2762,4742,35,61,17,18
61984,51773,80,63744,80,allow,40993,2984,38009,57,24,28,29
61985,56768,10880,3397,10880,allow,70,70,0,1,5,1,0
61986,55879,53,32478,53,allow,200,94,106,2,30,1,1
61987,53049,443,20030,443,allow,7393,2050,5343,34,92,16,18
61988,52997,443,41046,443,allow,10754,4129,6625,42,112,20,22
61989,51768,80,6690,80,allow,211684,9903,201781,247,27,109,138
61990,38891,80,9037,80,allow,5491,2690,2801,13,15,7,6
61991,51770,80,6696,80,allow,135293,6214,129079,161,24,71,90
61992,50970,80,27517,80,allow,1123476,15099,1108377,963,39,223,740
61993,56482,443,53337,443,allow,10788,6521,4267,61,134,31,30
61994,57414,443,40284,443,allow,103144,2997,100147,114,16,36,78
61995,38305,443,38305,443,allow,5510,2263,3247,22,40,13,9
61996,51738,47483,28405,47483,allow,70,70,0,2,8,2,0
61997,51723,10622,28735,10622,allow,70,70,0,1,5,1,0
61998,34157,443,57470,443,allow,154,94,60,2,5,1,1
61999,59789,443,31655,443,allow,5520,1212,4308,18,28,9,9
62000,46734,53,46734,53,allow,314,98,216,2,29,1,1
62001,33022,443,32074,443,allow,162,102,60,2,5,1,1
62002,55447,53,22356,53,allow,194,102,92,2,29,1,1
62003,55769,53,28226,53,allow,373,103,270,4,43,2,2
62004,56925,53,26704,53,allow,275,110,165,2,29,1,1
62005,52310,80,52310,80,allow,450,246,204,8,29,5,3
62006,59779,443,65358,443,allow,18360,1734,16626,32,28,13,19
62007,64489,53,3033,53,allow,320,97,223,4,50,2,2
62008,36452,53,36452,53,allow,226,106,120,2,29,1,1
62009,51675,53,24941,53,allow,168,78,90,2,29,1,1
62010,64742,53,25545,53,allow,761,102,659,2,29,1,1
62011,49446,80,49446,80,allow,5724,3966,1758,25,38,14,11
62012,60306,53,57588,53,allow,168,78,90,2,29,1,1
62013,64890,53,55634,53,allow,210,110,100,2,29,1,1
62014,52312,80,52312,80,allow,450,246,204,8,29,5,3
62015,49557,53,50413,53,allow,272,110,162,2,29,1,1
62016,59780,443,27949,443,allow,19224,2358,16866,38,28,15,23
62017,65025,53,29192,53,allow,786,110,676,2,29,1,1
62018,64890,53,13860,53,allow,210,110,100,2,30,1,1
62019,55896,53,65305,53,allow,184,94,90,2,30,1,1
62020,56154,53,34116,53,allow,291,94,197,2,29,1,1
62021,56730,53,53565,53,allow,210,110,100,2,30,1,1
62022,55217,53,28752,53,allow,189,102,87,2,30,1,1
62023,41923,53,17859,53,allow,168,78,90,2,30,1,1
62024,55498,53,3379,53,allow,340,134,206,2,30,1,1
62025,56793,53,24911,53,allow,196,102,94,2,30,1,1
62026,49864,53,65077,53,allow,212,102,110,2,30,1,1
62027,64359,53,44275,53,allow,196,102,94,2,30,1,1
62028,50921,443,40184,443,allow,9516,1896,7620,21,127,11,10
62029,49959,443,21643,443,allow,102240,4349,97891,128,136,46,82
62030,56050,53,45376,53,allow,178,94,84,2,30,1,1
62031,49896,443,43604,443,allow,5996,976,5020,19,35,10,9
62032,19473,44929,9531,44929,allow,481,150,331,2,1200,1,1
62033,50683,443,25335,443,allow,6414,1372,5042,19,171,9,10
62034,50893,443,25118,443,allow,9452,1832,7620,20,130,10,10
62035,59494,443,29596,443,allow,338,278,60,2,5,1,1
62036,53107,44060,27368,44060,allow,70,70,0,1,5,1,0
62037,40375,443,13030,443,allow,130,70,60,3,5,2,1
62038,37450,443,11367,443,allow,617919,23432,594487,706,39,297,409
62039,64188,53,11006,53,allow,299,98,201,4,57,2,2
62040,56624,53,20436,53,allow,819,102,717,2,30,1,1
62041,64487,53,6176,53,allow,225,110,115,2,30,1,1
62042,49213,53,21489,53,allow,272,94,178,2,30,1,1
62043,57235,53,3428,53,allow,212,102,110,2,30,1,1
62044,33806,443,17179,443,allow,37541,4945,32596,69,127,31,38
62045,52993,443,38783,443,allow,10754,4129,6625,42,112,20,22
62046,57879,80,31290,80,allow,318,192,126,6,27,4,2
62047,51772,80,5918,80,allow,93693,4469,89224,115,24,53,62
62048,51294,443,42258,443,allow,162,102,60,2,5,1,1
62049,49612,80,42484,80,allow,1388,562,826,11,315,6,5
62050,59776,443,24367,443,allow,966,480,486,17,29,9,8
62051,57334,53,43556,53,allow,210,110,100,2,30,1,1
62052,55403,53,28747,53,allow,211,102,109,2,30,1,1
62053,56176,53,42328,53,allow,194,102,92,2,30,1,1
62054,46865,80,11797,80,allow,662,600,62,12,495,11,1
62055,50841,443,31504,443,allow,10475,1518,8957,24,139,11,13
62056,59778,443,33771,443,allow,6723,1014,5709,19,29,10,9
62057,46186,443,59452,443,allow,10103,3482,6621,59,16,29,30
62058,40576,443,40576,443,allow,4433,1526,2907,19,27,11,8
62059,49522,53,16817,53,allow,688,185,503,6,45,3,3
62060,49128,443,6577,443,allow,3062,1747,1315,17,16,9,8
62061,52797,443,22094,443,allow,8355,1923,6432,32,16,18,14
62062,43634,80,30485,80,allow,1151,711,440,10,15,5,5
62063,65414,53,34166,53,allow,197,102,95,2,30,1,1
62064,56268,53,23212,53,allow,210,102,108,2,30,1,1
62065,57334,53,14690,53,allow,210,110,100,2,30,1,1
62066,56793,53,12485,53,allow,196,102,94,2,30,1,1
62067,64153,53,64829,53,allow,340,134,206,2,30,1,1
62068,56478,53,62940,53,allow,200,102,98,2,30,1,1
62069,44847,6881,59803,6881,allow,484,150,334,2,1200,1,1
62070,55649,443,18027,443,allow,7045,2145,4900,18,136,8,10
62071,50939,443,38504,443,allow,8058,1136,6922,19,126,9,10
62072,50680,443,16561,443,allow,7066,1129,5937,19,172,9,10
62073,60880,443,53335,443,allow,12278,1931,10347,32,56,18,14
62074,60873,443,47153,443,allow,60954,33730,27224,101,63,50,51
62075,50894,80,58930,80,allow,5900,751,5149,15,130,7,8
62076,56050,53,26569,53,allow,178,94,84,2,30,1,1
62077,56522,53,58867,53,allow,322,134,188,2,30,1,1
62078,55384,53,33566,53,allow,212,102,110,2,30,1,1
62079,65246,53,1802,53,allow,209,102,107,2,30,1,1
62080,49854,443,54861,443,allow,5089,1037,4052,20,61,11,9
62081,65049,53,22516,53,allow,210,110,100,2,30,1,1
62082,64513,53,7726,53,allow,396,102,294,2,31,1,1
62083,57173,53,30572,53,allow,322,110,212,4,31,2,2
62084,57294,443,32624,443,allow,122959,4611,118348,142,150,51,91
62085,49473,53,57880,53,allow,290,118,172,2,30,1,1
62086,64865,53,41424,53,allow,423,102,321,2,30,1,1
62087,39569,443,64666,443,allow,125906,21096,104810,172,130,68,104
62088,55313,443,62411,443,allow,4005,1162,2843,17,142,8,9
62089,60849,443,12589,443,allow,3364,1737,1627,15,360,8,7
62090,65496,123,10878,123,allow,184,94,90,2,30,1,1
62091,55896,53,44537,53,allow,184,94,90,2,30,1,1
62092,56997,123,16433,123,allow,184,94,90,2,30,1,1
62093,49679,53,54923,53,allow,166,86,80,2,30,1,1
62094,65418,53,64332,53,allow,211,102,109,2,30,1,1
62095,56050,53,44342,53,allow,178,94,84,2,30,1,1
62096,59278,53,0,0,allow,86,86,0,1,30,1,0
62097,54369,53,50744,53,allow,168,78,90,2,31,1,1
62098,55732,53,61011,53,allow,194,102,92,2,30,1,1
62099,56602,53,29182,53,allow,197,102,95,2,30,1,1
62100,57334,53,19722,53,allow,210,110,100,2,30,1,1
62101,64825,53,52627,53,allow,184,94,90,2,30,1,1
62102,64056,53,57608,53,allow,383,94,289,2,30,1,1
62103,45614,123,42191,123,allow,184,94,90,2,30,1,1
62104,49540,53,39432,53,allow,198,110,88,2,31,1,1
62105,63965,53,54423,53,allow,180,94,86,2,31,1,1
62106,57470,20014,49843,20014,allow,528,528,0,9,1200,9,0
62107,65423,443,16318,443,allow,5854,1796,4058,21,142,10,11
62108,48344,443,10226,443,allow,68467,4750,63717,100,276,48,52
62109,42934,443,36835,443,allow,4514,1928,2586,17,241,8,9
62110,49540,53,53210,53,allow,198,110,88,2,30,1,1
62111,49890,443,45754,443,allow,6068,1047,5021,20,50,11,9
62112,49885,443,59973,443,allow,37539,4310,33229,63,51,27,36
62113,49858,443,16431,443,allow,2027955,75406,1952549,2104,60,564,1540
62114,55951,53,13243,53,allow,197,102,95,2,31,1,1
62115,57173,53,19613,53,allow,216,110,106,2,31,1,1
62116,49889,443,5001,443,allow,214782,13389,201393,277,50,98,179
62117,49177,53,40047,53,allow,184,94,90,2,31,1,1
62118,64643,443,21220,443,allow,3433,1192,2241,13,136,6,7
62119,49873,443,58284,443,allow,14476,2843,11633,45,55,22,23
62120,49876,443,4745,443,allow,5993,974,5019,19,54,10,9
62121,47534,443,60052,443,allow,291717,11752,279965,319,137,123,196
62122,51221,53239,19108,53239,allow,1487,594,893,19,1571,10,9
62123,55292,53,33154,53,allow,211,102,109,2,31,1,1
62124,46866,80,59082,80,allow,662,600,62,12,495,11,1
62125,53330,443,46161,443,allow,3701,1232,2469,13,136,6,7
62126,56727,53,55377,53,allow,250,86,164,4,52,2,2
62127,49963,53,15871,53,allow,279,96,183,4,58,2,2
62128,49963,53,58470,53,allow,564,191,373,6,62,3,3
62129,55922,53,46699,53,allow,423,102,321,2,30,1,1
62130,56983,53,28765,53,allow,424,108,316,4,55,2,2
62131,64180,53,4267,53,allow,180,94,86,2,30,1,1
62132,64825,53,49543,53,allow,184,94,90,2,31,1,1
62133,50031,53,36003,53,allow,386,134,252,2,30,1,1
62134,49679,53,7089,53,allow,166,86,80,2,31,1,1
62135,64297,53,33648,53,allow,199,94,105,2,30,1,1
62136,56478,53,14582,53,allow,200,102,98,2,30,1,1
62137,49839,443,14297,443,allow,5026,973,4053,19,72,10,9
62138,56341,443,32673,443,allow,49417,5511,43906,108,439,54,54
62139,55732,53,40584,53,allow,194,102,92,2,31,1,1
62140,56366,443,56718,443,allow,7234,4345,2889,27,235,15,12
62141,65049,53,4020,53,allow,210,110,100,2,31,1,1
62142,49842,443,41562,443,allow,5309,1043,4266,22,72,11,11
62143,55033,53,37383,53,allow,182,94,88,2,31,1,1
62144,36902,443,18209,443,allow,10252,2152,8100,38,126,18,20
62145,37264,443,36936,443,allow,3068,1678,1390,17,241,9,8
62146,50692,443,11802,443,allow,152,86,66,2,5,1,1
62147,53527,45626,13998,45626,allow,70,70,0,1,5,1,0
62148,61705,80,47319,80,allow,134,60,74,3,11,2,1
62149,50865,443,45042,443,allow,6883,1378,5505,19,131,9,10
62150,49511,80,32515,80,allow,1693924,34466,1659458,1627,230,522,1105
62151,50804,443,11310,443,allow,6337,1378,4959,19,140,9,10
62152,50840,443,34565,443,allow,8057,1135,6922,19,139,9,10
62153,53530,8999,1234,8999,allow,70,70,0,1,5,1,0
62154,56736,53,58809,53,allow,283,94,189,4,41,2,2
62155,56793,53,43867,53,allow,196,102,94,2,30,1,1
62156,49824,53,46232,53,allow,178,94,84,2,30,1,1
62157,64256,53,5483,53,allow,334,94,240,2,31,1,1
62158,55896,53,45886,53,allow,184,94,90,2,31,1,1
62159,49824,53,29358,53,allow,178,94,84,2,31,1,1
62160,49883,443,3067,443,allow,4960,1114,3846,21,51,12,9
62161,49894,443,1865,443,allow,8633,2099,6534,29,35,15,14
62162,49875,443,6451,443,allow,31715,20427,11288,103,54,54,49
62163,49827,443,61208,443,allow,5523,3016,2507,36,75,20,16
62164,56524,53,60434,53,allow,182,102,80,2,31,1,1
62165,13826,53,57057,53,allow,200,94,106,2,31,1,1
62166,50265,64304,32485,64304,allow,970,598,372,14,1201,8,6
62167,56430,443,5643,443,allow,2274816,85295,2189521,2305,127,825,1480
62168,55049,5228,10544,5228,allow,9193,2770,6423,51,5193,28,23
62169,55548,443,42567,443,allow,12205,2036,10169,33,138,18,15
62170,53528,20485,28809,20485,allow,70,70,0,1,5,1,0
62171,50864,443,18823,443,allow,6663,1556,5107,21,132,10,11
62172,50919,443,47767,443,allow,6412,1370,5042,19,129,9,10
62173,50828,443,49506,443,allow,6337,1378,4959,19,140,9,10
62174,50867,443,26907,443,allow,6351,1370,4981,18,131,9,9
62175,50914,443,19872,443,allow,8058,1136,6922,19,129,9,10
62176,50800,443,31236,443,allow,7067,1129,5938,19,141,9,10
62177,14084,43890,0,0,deny,62,62,0,1,0,1,0
62178,56100,57470,0,0,deny,62,62,0,1,0,1,0
62179,61845,11392,0,0,deny,66,66,0,1,0,1,0
62180,50806,445,0,0,drop,70,70,0,1,0,1,0
62181,12694,12446,0,0,deny,62,62,0,1,0,1,0
62182,26573,44847,0,0,deny,62,62,0,1,0,1,0
62183,6889,55108,0,0,deny,143,143,0,1,0,1,0
62184,51413,54351,0,0,deny,136,136,0,1,0,1,0
62185,49298,18593,0,0,deny,145,145,0,1,0,1,0
62186,1987,26467,0,0,deny,62,62,0,1,0,1,0
62187,51413,1,0,0,deny,72,72,0,1,0,1,0
62188,49386,64147,0,0,deny,62,62,0,1,0,1,0
62189,30951,50584,0,0,deny,62,62,0,1,0,1,0
62190,51266,445,0,0,drop,66,66,0,1,0,1,0
62191,14993,50584,0,0,deny,62,62,0,1,0,1,0
62192,51263,445,0,0,drop,66,66,0,1,0,1,0
62193,55855,445,0,0,drop,70,70,0,1,0,1,0
62194,9775,30188,0,0,deny,62,62,0,1,0,1,0
62195,50802,445,0,0,drop,70,70,0,1,0,1,0
62196,8999,42873,0,0,deny,146,146,0,1,0,1,0
62197,55851,445,0,0,drop,70,70,0,1,0,1,0
62198,55850,445,0,0,drop,70,70,0,1,0,1,0
62199,55847,445,0,0,drop,70,70,0,1,0,1,0
62200,51262,445,0,0,drop,66,66,0,1,0,1,0
62201,6069,45680,0,0,deny,159,159,0,1,0,1,0
62202,48478,49903,0,0,deny,62,62,0,1,0,1,0
62203,60923,49903,0,0,deny,66,66,0,1,0,1,0
62204,58486,57470,0,0,deny,66,66,0,1,0,1,0
62205,16275,23117,0,0,deny,146,146,0,1,0,1,0
62206,55842,445,0,0,drop,70,70,0,1,0,1,0
62207,14613,12446,0,0,deny,66,66,0,1,0,1,0
62208,55840,445,0,0,drop,70,70,0,1,0,1,0
62209,55838,445,0,0,drop,70,70,0,1,0,1,0
62210,55836,445,0,0,drop,70,70,0,1,0,1,0
62211,52666,40108,0,0,deny,148,148,0,1,0,1,0
62212,51254,445,0,0,drop,66,66,0,1,0,1,0
62213,18085,26467,0,0,deny,66,66,0,1,0,1,0
62214,51247,445,0,0,drop,66,66,0,1,0,1,0
62215,51248,445,0,0,drop,66,66,0,1,0,1,0
62216,51245,445,0,0,drop,66,66,0,1,0,1,0
62217,50789,445,0,0,drop,70,70,0,1,0,1,0
62218,51233,43890,0,0,deny,66,66,0,1,0,1,0
62219,23379,57866,0,0,deny,146,146,0,1,0,1,0
62220,51243,445,0,0,drop,66,66,0,1,0,1,0
62221,51244,445,0,0,drop,66,66,0,1,0,1,0
62222,51241,445,0,0,drop,66,66,0,1,0,1,0
62223,59586,57470,0,0,deny,66,66,0,1,0,1,0
62224,62452,21247,0,0,deny,66,66,0,1,0,1,0
62225,50786,445,0,0,drop,70,70,0,1,0,1,0
62226,19838,23,0,0,deny,60,60,0,1,0,1,0
62227,55835,445,0,0,drop,70,70,0,1,0,1,0
62228,55833,445,0,0,drop,70,70,0,1,0,1,0
62229,55828,445,0,0,drop,70,70,0,1,0,1,0
62230,51240,445,0,0,drop,66,66,0,1,0,1,0
62231,55827,445,0,0,drop,70,70,0,1,0,1,0
62232,56967,35440,0,0,deny,66,66,0,1,0,1,0
62233,51236,445,0,0,drop,66,66,0,1,0,1,0
62234,51234,445,0,0,drop,66,66,0,1,0,1,0
62235,51233,445,0,0,drop,66,66,0,1,0,1,0
62236,55262,44847,0,0,deny,62,62,0,1,0,1,0
62237,50781,445,0,0,drop,70,70,0,1,0,1,0
62238,26888,23,0,0,deny,60,60,0,1,0,1,0
62239,50780,445,0,0,drop,70,70,0,1,0,1,0
62240,51230,445,0,0,drop,66,66,0,1,0,1,0
62241,50668,58833,0,0,deny,66,66,0,1,0,1,0
62242,50778,445,0,0,drop,70,70,0,1,0,1,0
62243,25151,58833,0,0,deny,146,146,0,1,0,1,0
62244,25342,8168,0,0,deny,62,62,0,1,0,1,0
62245,54826,56205,0,0,deny,66,66,0,1,0,1,0
62246,55821,445,0,0,drop,70,70,0,1,0,1,0
62247,24351,57470,0,0,deny,62,62,0,1,0,1,0
62248,55818,445,0,0,drop,70,70,0,1,0,1,0
62249,55815,445,0,0,drop,70,70,0,1,0,1,0
62250,46557,57866,0,0,deny,66,66,0,1,0,1,0
62251,50853,50584,0,0,deny,66,66,0,1,0,1,0
62252,50771,445,0,0,drop,70,70,0,1,0,1,0
62253,51221,445,0,0,drop,66,66,0,1,0,1,0
62254,25570,35440,0,0,deny,62,62,0,1,0,1,0
62255,0,0,0,0,allow,156,156,0,2,0,2,0
62256,0,0,0,0,allow,244,244,0,2,0,2,0
62257,50769,445,0,0,drop,70,70,0,1,0,1,0
62258,49359,64147,0,0,deny,66,66,0,1,0,1,0
62259,6889,30170,0,0,deny,143,143,0,1,0,1,0
62260,40990,10387,0,0,deny,148,148,0,1,0,1,0
62261,50768,445,0,0,drop,70,70,0,1,0,1,0
62262,50767,445,0,0,drop,70,70,0,1,0,1,0
62263,50,64147,0,0,deny,62,62,0,1,0,1,0
62264,51212,445,0,0,drop,66,66,0,1,0,1,0
62265,50766,445,0,0,drop,70,70,0,1,0,1,0
62266,58876,57470,0,0,deny,66,66,0,1,0,1,0
62267,55800,445,0,0,drop,70,70,0,1,0,1,0
62268,50761,445,0,0,drop,70,70,0,1,0,1,0
62269,50760,445,0,0,drop,70,70,0,1,0,1,0
62270,37213,36237,0,0,deny,66,66,0,1,0,1,0
62271,6890,11204,0,0,deny,146,146,0,1,0,1,0
62272,56411,50584,0,0,deny,62,62,0,1,0,1,0
62273,51209,445,0,0,drop,66,66,0,1,0,1,0
62274,50748,445,0,0,drop,70,70,0,1,0,1,0
62275,50747,445,0,0,drop,70,70,0,1,0,1,0
62276,53957,35440,0,0,deny,146,146,0,1,0,1,0
62277,50745,445,0,0,drop,70,70,0,1,0,1,0
62278,60132,50584,0,0,deny,62,62,0,1,0,1,0
62279,25973,26467,0,0,deny,66,66,0,1,0,1,0
62280,50738,445,0,0,drop,70,70,0,1,0,1,0
62281,50737,445,0,0,drop,70,70,0,1,0,1,0
62282,56327,44512,0,0,deny,66,66,0,1,0,1,0
62283,23650,37807,0,0,deny,62,62,0,1,0,1,0
62284,51201,445,0,0,drop,66,66,0,1,0,1,0
62285,35657,48637,0,0,deny,62,62,0,1,0,1,0
62286,34916,51185,0,0,deny,62,62,0,1,0,1,0
62287,25523,35974,0,0,deny,62,62,0,1,0,1,0
62288,51194,445,0,0,drop,66,66,0,1,0,1,0
62289,25523,35974,0,0,deny,145,145,0,1,0,1,0
62290,50200,44847,0,0,deny,74,74,0,1,0,1,0
62291,60192,35440,0,0,deny,66,66,0,1,0,1,0
62292,10753,22114,0,0,deny,146,146,0,1,0,1,0
62293,50726,445,0,0,drop,70,70,0,1,0,1,0
62294,25470,24748,0,0,deny,143,143,0,1,0,1,0
62295,6890,27520,0,0,deny,146,146,0,1,0,1,0
62296,52941,443,58388,443,allow,14630,5941,8689,52,115,26,26
62297,60189,443,11334,443,allow,10816,1112,9704,22,125,10,12
62298,50332,80,19945,80,allow,2862,1465,1397,11,47,6,5
62299,60309,443,17740,443,allow,130,70,60,3,5,2,1
62300,49860,443,20445,443,allow,10754,2778,7976,38,59,19,19
62301,49893,443,34865,443,allow,7115,1670,5445,24,35,13,11
62302,53138,443,56360,443,allow,7141,2507,4634,28,42,13,15
62303,52912,443,9289,443,allow,41094,14929,26165,126,116,69,57
62304,52942,443,55996,443,allow,14696,5947,8749,53,115,26,27
62305,52921,443,44773,443,allow,36892,20283,16609,191,116,77,114
62306,52879,443,43280,443,allow,286404,12478,273926,379,118,130,249
62307,52887,80,9477,80,allow,5694,2514,3180,36,118,19,17
62308,52918,443,11338,443,allow,326078,45627,280451,737,116,252,485
62309,47744,443,50454,443,allow,7761,2376,5385,24,256,12,12
62310,52928,443,12845,443,allow,56910,3384,53526,85,115,33,52
62311,52940,443,39271,443,allow,14640,5951,8689,52,115,26,26
62312,52938,443,4484,443,allow,14896,6021,8875,56,115,27,29
62313,60187,443,13141,443,allow,9875,1112,8763,21,125,10,11
62314,37066,443,58040,443,allow,9705,4332,5373,32,321,17,15
62315,61714,443,30943,443,allow,134,60,74,3,10,2,1
62316,53194,443,63620,443,allow,1462,965,497,13,18,7,6
62317,53127,443,49935,443,allow,68982,15774,53208,113,45,42,71
62318,53128,443,36411,443,allow,72734,14614,58120,112,44,39,73
62319,52880,443,45002,443,allow,1695880,25777,1670103,1423,118,264,1159
62320,53018,443,30354,443,allow,48877,5205,43672,95,93,32,63
62321,52931,443,32527,443,allow,23112,6278,16834,140,115,55,85
62322,60190,443,8550,443,allow,10178,1101,9077,22,125,10,12
62323,53525,34759,11727,34759,allow,70,70,0,1,5,1,0
62324,53195,443,48069,443,allow,1462,965,497,13,18,7,6
62325,53179,80,43162,80,allow,1628,828,800,10,25,6,4
62326,52943,443,54392,443,allow,14640,5951,8689,52,115,26,26
62327,52930,443,54761,443,allow,21194,5779,15415,118,115,47,71
62328,53115,443,63976,443,allow,9616,6956,2660,39,47,21,18
62329,52898,80,57619,80,allow,3020,1414,1606,30,118,16,14
62330,51411,443,64614,443,allow,7842,1155,6687,19,105,10,9
62331,51265,63960,52529,63960,allow,70,70,0,2,8,2,0
62332,45426,80,3986,80,allow,416,210,206,7,28,4,3
62333,49175,2710,30746,2710,allow,70,70,0,2,8,2,0
62334,44481,443,29524,443,allow,6336,1633,4703,22,256,12,10
62335,49662,443,55920,443,allow,9534,4029,5505,22,59,12,10
62336,48360,3389,48360,3389,allow,4085,1916,2169,21,19,12,9
62337,45428,80,14591,80,allow,350,210,140,6,28,4,2
62338,49649,443,64805,443,allow,5964,674,5290,16,60,7,9
62339,55951,53,16889,53,allow,194,99,95,2,31,1,1
62340,46980,443,8668,443,allow,7633,5620,2013,31,60,19,12
62341,45427,80,37690,80,allow,350,210,140,6,28,4,2
62342,50571,80,64124,80,allow,300,174,126,5,15,3,2
62343,38306,443,65032,443,allow,4580,1210,3370,17,28,10,7
62344,50848,80,48215,80,allow,1213557,27203,1186354,1120,133,327,793
62345,50863,80,47507,80,allow,5874,744,5130,14,131,7,7
62346,53524,45395,27489,45395,allow,70,70,0,1,5,1,0
62347,49674,443,62205,443,allow,8656,2060,6596,20,57,10,10
62348,56420,443,51933,443,allow,5220,922,4298,17,135,10,7
62349,49722,443,17749,443,allow,5943,850,5093,16,50,7,9
62350,60188,443,15594,443,allow,9811,1112,8699,21,125,10,11
62351,52896,80,13613,80,allow,3020,1414,1606,30,118,16,14
62352,45119,443,36541,443,allow,5082,969,4113,18,30,10,8
62353,52904,443,65264,443,allow,17521,6560,10961,55,117,28,27
62354,52903,443,57569,443,allow,253281,6271,247010,276,117,66,210
62355,52939,443,34090,443,allow,16053,6801,9252,51,115,26,25
62356,52876,443,35265,443,allow,501046,7967,493079,419,118,69,350
62357,49894,443,19598,443,allow,7418,2721,4697,23,20,12,11
62358,38808,443,46954,443,allow,25120,1874,23246,39,171,17,22
62359,57595,443,62180,443,allow,291,171,120,4,16,2,2
62360,50795,443,7705,443,allow,18444,12288,6156,36,149,20,16
62361,64915,443,15491,443,allow,4659604,120303,4539301,4651,74,1586,3065
62362,49177,53,33754,53,allow,184,94,90,2,31,1,1
62363,49851,443,11118,443,allow,6058,1038,5020,20,71,11,9
62364,59950,53,51206,53,allow,395,115,280,2,30,1,1
62365,5938,47968,0,0,allow,60,60,0,1,91,1,0
62366,57737,443,13855,443,allow,15625,4662,10963,25,123,11,14
62367,52865,443,62658,443,allow,120290,2988,117302,123,132,32,91
62368,52901,443,37617,443,allow,87558,4155,83403,115,117,41,74
62369,52895,443,23981,443,allow,18795,10297,8498,56,118,29,27
62370,53137,443,3588,443,allow,7648,3641,4007,29,42,13,16
62371,53131,443,52675,443,allow,33229,7810,25419,63,44,24,39
62372,50214,53,34671,53,allow,789,110,679,2,31,1,1
62373,49364,53,62830,53,allow,180,92,88,2,31,1,1
62374,54952,5228,14099,5228,allow,12140,3028,9112,54,4653,28,26
62375,53005,443,10690,443,allow,13028,4115,8913,45,95,23,22
62376,52897,80,31689,80,allow,4292,1932,2360,32,118,17,15
62377,53002,443,30088,443,allow,16537,4585,11952,46,96,24,22
62378,53129,443,62080,443,allow,51742,10734,41008,85,44,33,52
62379,43568,80,8531,80,allow,2277,1521,756,16,16,10,6
62380,56215,53,26623,53,allow,216,110,106,2,31,1,1
62381,64914,443,15488,443,allow,6120028,157580,5962448,6108,75,2083,4025
62382,39381,53,0,0,allow,82,82,0,1,31,1,0
62383,47504,53,47504,53,allow,174,77,97,2,30,1,1
62384,63945,53,52680,53,allow,216,110,106,2,31,1,1
62385,65127,53,26912,53,allow,188,96,92,2,31,1,1
62386,56322,53,7412,53,allow,202,103,99,2,31,1,1
62387,57470,46772,63151,46772,allow,528,528,0,9,1201,9,0
62388,57356,443,4225,443,allow,7802,4189,3613,22,136,11,11
62389,55478,443,16411,443,allow,23029908,732047,22297861,24550,183,8143,16407
62390,52925,5555,0,0,deny,60,60,0,1,0,1,0
62391,55791,445,0,0,drop,70,70,0,1,0,1,0
62392,30920,64147,0,0,deny,62,62,0,1,0,1,0
62393,55788,445,0,0,drop,70,70,0,1,0,1,0
62394,55787,445,0,0,drop,70,70,0,1,0,1,0
62395,51187,445,0,0,drop,66,66,0,1,0,1,0
62396,51185,445,0,0,drop,66,66,0,1,0,1,0
62397,51186,445,0,0,drop,66,66,0,1,0,1,0
62398,51184,445,0,0,drop,66,66,0,1,0,1,0
62399,51182,445,0,0,drop,66,66,0,1,0,1,0
62400,51183,445,0,0,drop,66,66,0,1,0,1,0
62401,51181,445,0,0,drop,66,66,0,1,0,1,0
62402,51179,445,0,0,drop,66,66,0,1,0,1,0
62403,18655,50584,0,0,deny,146,146,0,1,0,1,0
62404,64767,51221,0,0,deny,62,62,0,1,0,1,0
62405,50722,445,0,0,drop,70,70,0,1,0,1,0
62406,50102,17546,0,0,deny,66,66,0,1,0,1,0
62407,13743,33720,0,0,deny,159,159,0,1,0,1,0
62408,52917,443,43916,443,allow,7148,2358,4790,40,116,18,22
62409,52952,443,15638,443,allow,9381,3074,6307,47,114,24,23
62410,52924,443,50522,443,allow,21789,7672,14117,78,115,39,39
62411,50404,80,8357,80,allow,4242,3615,627,15,32,8,7
62412,50403,80,8423,80,allow,4332,3596,736,14,32,8,6
62413,46346,35440,0,0,deny,66,66,0,1,0,1,0
62414,56405,62413,0,0,deny,66,66,0,1,0,1,0
62415,27517,23,0,0,deny,60,60,0,1,0,1,0
62416,50712,445,0,0,drop,70,70,0,1,0,1,0
62417,50711,445,0,0,drop,70,70,0,1,0,1,0
62418,60192,35440,0,0,deny,62,62,0,1,0,1,0
62419,55056,56205,0,0,deny,66,66,0,1,0,1,0
62420,55779,445,0,0,drop,70,70,0,1,0,1,0
62421,55776,445,0,0,drop,70,70,0,1,0,1,0
62422,55772,445,0,0,drop,70,70,0,1,0,1,0
62423,50707,445,0,0,drop,70,70,0,1,0,1,0
62424,50708,445,0,0,drop,70,70,0,1,0,1,0
62425,1431,30041,0,0,deny,62,62,0,1,0,1,0
62426,50877,30041,0,0,deny,66,66,0,1,0,1,0
62427,61329,51505,0,0,deny,62,62,0,1,0,1,0
62428,50705,445,0,0,drop,70,70,0,1,0,1,0
62429,51167,445,0,0,drop,66,66,0,1,0,1,0
62430,51164,445,0,0,drop,66,66,0,1,0,1,0
62431,51166,445,0,0,drop,66,66,0,1,0,1,0
62432,55770,445,0,0,drop,70,70,0,1,0,1,0
62433,58597,35440,0,0,deny,66,66,0,1,0,1,0
62434,55767,445,0,0,drop,70,70,0,1,0,1,0
62435,55762,445,0,0,drop,70,70,0,1,0,1,0
62436,55761,445,0,0,drop,70,70,0,1,0,1,0
62437,50875,53,15135,53,allow,234,234,0,4,47,4,0
62438,49870,443,21099,443,allow,6062,1042,5020,20,55,11,9
62439,49882,443,51154,443,allow,79524,18512,61012,205,50,101,104
62440,56847,53,25632,53,allow,225,86,139,2,30,1,1
62441,55190,53,57289,53,allow,311,94,217,2,30,1,1
62442,55951,53,4112,53,allow,197,102,95,2,30,1,1
62443,42853,443,43627,443,allow,3508,2120,1388,20,241,10,10
62444,50265,33734,14802,33734,allow,132,132,0,3,1200,3,0
62445,52975,443,20822,443,allow,291803,6522,285281,284,113,58,226
62446,50771,80,8237,80,allow,6420,677,5743,13,151,6,7
62447,50852,80,1179,80,allow,1118864,18787,1100077,1036,132,280,756
62448,50859,443,27316,443,allow,6886,1380,5506,19,132,9,10
62449,50895,443,56217,443,allow,6354,1373,4981,18,129,9,9
62450,50866,443,31244,443,allow,9517,1897,7620,21,130,11,10
62451,55947,53,33524,53,allow,311,108,203,4,42,2,2
62452,48017,443,12876,443,allow,198,78,120,4,6,2,2
62453,53543,51819,43192,51819,allow,70,70,0,2,7,2,0
62454,50689,443,50217,443,allow,152,86,66,2,4,1,1
62455,64991,443,64991,443,allow,9107,1499,7608,20,75,11,9
62456,52965,443,44159,443,allow,86041,4656,81385,102,113,34,68
62457,50849,80,37869,80,allow,1218354,26709,1191645,1128,133,332,796
62458,50739,443,62875,443,allow,6335,1376,4959,19,165,9,10
62459,56727,53,4531,53,allow,250,86,164,4,46,2,2
62460,50770,443,41782,443,allow,6350,1369,4981,18,151,9,9
62461,50682,80,52857,80,allow,5237,680,4557,12,170,6,6
62462,49897,443,23230,443,allow,33013,21249,11764,151,492,79,72
62463,50972,80,5146,80,allow,1095399,7129,1088270,832,37,106,726
62464,50686,443,29049,443,allow,6340,1381,4959,19,170,9,10
62465,50746,443,7838,443,allow,6354,1372,4982,18,161,9,9
62466,60871,443,15673,443,allow,95311,21869,73442,140,62,61,79
62467,50720,443,25123,443,allow,6336,1377,4959,19,169,9,10
62468,50064,443,49945,443,allow,4118,2209,1909,36,239,21,15
62469,50744,443,22315,443,allow,6854,1380,5474,18,161,9,9
62470,50769,443,26960,443,allow,6882,1377,5505,19,151,9,10
62471,50965,443,11513,443,allow,8949,1200,7749,21,85,10,11
62472,50843,443,54645,443,allow,6337,1378,4959,19,135,9,10
62473,57348,443,22476,443,allow,6250,1312,4938,23,315,12,11
62474,61828,443,31671,443,allow,7490,2688,4802,23,383,10,13
62475,50920,443,55566,443,allow,6273,1375,4898,18,127,9,9
62476,56135,53,22804,53,allow,542,112,430,4,34,2,2
62477,53544,22051,5953,22051,allow,70,70,0,2,7,2,0
62478,49727,443,58320,443,allow,4116,972,3144,15,50,8,7
62479,53522,24116,50290,24116,allow,70,70,0,1,4,1,0
62480,49673,443,32250,443,allow,6404,829,5575,18,57,9,9
62481,53203,443,27595,443,allow,3656,2345,1311,18,17,9,9
62482,52846,80,43511,80,allow,3626,1778,1848,36,143,19,17
62483,52990,443,9852,443,allow,7093,2235,4858,39,111,20,19
62484,53081,443,13924,443,allow,16157,6478,9679,46,83,23,23
62485,52951,443,13326,443,allow,628801,19603,609198,708,114,227,481
62486,53163,443,16194,443,allow,7432,1694,5738,23,27,12,11
62487,53027,443,45299,443,allow,26309,3035,23274,69,92,27,42
62488,49499,443,13640,443,allow,87970,5355,82615,141,483,55,86
62489,49775,53,55039,53,allow,399,93,306,4,41,2,2
62490,49689,443,55526,443,allow,1179,655,524,13,56,7,6
62491,49881,443,45580,443,allow,5997,978,5019,19,53,10,9
62492,49900,443,21992,443,allow,6896,2139,4757,31,33,15,16
62493,63927,53,30501,53,allow,196,94,102,2,30,1,1
62494,65412,53,14297,53,allow,305,118,187,2,30,1,1
62495,55281,53,43570,53,allow,210,102,108,2,30,1,1
62496,43444,53,43444,53,allow,314,98,216,2,30,1,1
62497,64694,53,57973,53,allow,209,102,107,2,30,1,1
62498,64018,53,10598,53,allow,229,94,135,2,30,1,1
62499,61060,53,61060,53,allow,257,106,151,2,30,1,1
62500,53052,443,60187,443,allow,8476,2030,6446,38,91,19,19
62501,56363,443,4827,443,allow,4864,3011,1853,20,234,12,8
62502,53063,80,2438,80,allow,2725,1228,1497,24,90,13,11
62503,53023,443,2353,443,allow,9625,3512,6113,41,92,21,20
62504,53022,443,29069,443,allow,15099,7828,7271,45,92,24,21
62505,53204,443,30061,443,allow,3655,2344,1311,18,17,9,9
62506,53093,443,27460,443,allow,6774,3651,3123,35,80,18,17
62507,53004,443,34423,443,allow,18064,5135,12929,108,95,44,64
62508,52949,443,60761,443,allow,9564,2054,7510,42,114,20,22
62509,53010,443,23300,443,allow,31660,3248,28412,58,93,23,35
62510,53037,80,8932,80,allow,2906,1233,1673,24,92,13,11
62511,52948,443,49245,443,allow,9629,2119,7510,42,114,20,22
62512,51736,34343,5872,34343,allow,70,70,0,2,8,2,0
62513,52955,443,58633,443,allow,23572,2063,21509,46,114,20,26
62514,53201,443,51458,443,allow,3655,2344,1311,18,17,9,9
62515,41059,443,46382,443,allow,1248874,30382,1218492,1261,111,425,836
62516,53165,443,14639,443,allow,7434,1695,5739,23,27,12,11
62517,49901,443,3004,443,allow,4949,1047,3902,22,33,11,11
62518,53207,443,15704,443,allow,3655,2344,1311,18,17,9,9
62519,49884,443,63837,443,allow,5998,978,5020,19,50,10,9
62520,53156,443,62340,443,allow,3814,2664,1150,22,28,12,10
62521,53199,443,19271,443,allow,1582,965,617,15,18,7,8
62522,49869,443,47117,443,allow,7910,1967,5943,30,55,15,15
62523,53187,443,36781,443,allow,5244,1925,3319,33,21,17,16
62524,49857,443,36785,443,allow,4221,1038,3183,19,59,11,8
62525,19236,53,19236,53,allow,235,90,145,2,33,1,1
62526,53193,443,17954,443,allow,1462,965,497,13,18,7,6
62527,49895,443,39538,443,allow,6060,1040,5020,20,34,11,9
62528,58677,28678,3047,28678,allow,1806,1806,0,22,225,22,0
62529,49826,443,4711,443,allow,1738,1159,579,16,74,10,6
62530,53055,443,19489,443,allow,17225,7769,9456,71,91,34,37
62531,35900,443,35900,443,allow,5661,2414,3247,22,39,13,9
62532,49650,53,42506,53,allow,248,110,138,2,30,1,1
62533,52944,443,11890,443,allow,58499,47163,11336,106,115,59,47
62534,34989,80,37174,80,allow,350,210,140,6,28,4,2
62535,54309,80,4585,80,allow,552,280,272,9,30,5,4
62536,52886,80,7195,80,allow,5688,2508,3180,36,118,19,17
62537,64371,53,21841,53,allow,181,86,95,2,30,1,1
62538,49721,443,52287,443,allow,4588,843,3745,14,52,7,7
62539,64701,53,54317,53,allow,195,94,101,2,30,1,1
62540,50244,80,52530,80,allow,136475,59298,77177,166,53,78,88
62541,55033,53,44325,53,allow,182,94,88,2,30,1,1
62542,49724,443,6596,443,allow,7226,844,6382,19,50,9,10
62543,51667,21391,14607,21391,allow,1345,679,666,9,30,5,4
62544,51666,45702,58433,45702,allow,1201,577,624,8,30,4,4
62545,52985,80,52009,80,allow,3111,1364,1747,28,112,15,13
62546,53206,443,65067,443,allow,3656,2345,1311,18,17,9,9
62547,52957,443,8095,443,allow,38149,4388,33761,68,113,26,42
62548,53064,443,10926,443,allow,8095,2586,5509,38,90,19,19
62549,53154,443,28335,443,allow,3947,2796,1151,22,28,12,10
62550,53160,443,52369,443,allow,2738,1904,834,18,28,10,8
62551,60881,443,31300,443,allow,31109,2922,28187,54,52,26,28
62552,41657,443,13161,443,allow,122547,6414,116133,160,81,61,99
62553,36262,443,11222,443,allow,678861,22499,656362,749,19,290,459
62554,53241,443,45177,443,allow,1950,1176,774,18,103,11,7
62555,50405,80,63982,80,allow,4530,3395,1135,15,32,8,7
62556,49872,443,32419,443,allow,4595,1038,3557,19,54,11,8
62557,49877,443,32997,443,allow,37364,16799,20565,189,53,87,102
62558,49828,443,7626,443,allow,1737,1158,579,16,74,10,6
62559,56362,443,29740,443,allow,12746,7725,5021,39,234,24,15
62560,57424,53,8409,53,allow,210,102,108,2,30,1,1
62561,56215,53,24448,53,allow,216,110,106,2,30,1,1
62562,64749,53,21766,53,allow,227,110,117,2,30,1,1
62563,63965,53,11899,53,allow,180,94,86,2,30,1,1
62564,64029,443,14573,443,allow,252,70,182,3,120,1,2
62565,35459,443,42175,443,allow,2350,1392,958,17,275,9,8
62566,63127,55860,37307,55860,allow,316,190,126,5,15,3,2
62567,49718,443,25229,443,allow,4524,779,3745,13,52,6,7
62568,49723,443,63349,443,allow,6780,710,6070,16,50,7,9
62569,49668,443,23437,443,allow,7978,2204,5774,20,58,10,10
62570,49715,443,43667,443,allow,4418,789,3629,13,54,6,7
62571,53035,443,38723,443,allow,20048,9134,10914,96,92,39,57
62572,53161,443,30923,443,allow,2731,1895,836,18,28,10,8
62573,52973,443,33521,443,allow,9294,2728,6566,43,113,22,21
62574,52852,80,35656,80,allow,7572,3232,4340,42,140,23,19
62575,53197,443,58160,443,allow,1462,965,497,13,18,7,6
62576,53012,443,44779,443,allow,13938,3220,10718,44,93,21,23
62577,49824,53,4911,53,allow,392,88,304,4,53,2,2
62578,34988,80,55946,80,allow,416,210,206,7,28,4,3
62579,35106,443,63708,443,allow,309321,13076,296245,368,189,150,218
62580,49853,443,20017,443,allow,11534,2076,9458,43,60,21,22
62581,54310,80,7871,80,allow,552,280,272,9,30,5,4
62582,9707,3389,9707,3389,allow,3441,1552,1889,17,21,10,7
62583,57917,443,1119,443,allow,6520,1550,4970,19,54,11,8
62584,60878,443,38028,443,allow,764899,31427,733472,883,60,368,515
62585,50868,80,40174,80,allow,12388,742,11646,18,130,7,11
62586,50803,443,31091,443,allow,6417,1376,5041,19,140,9,10
62587,50918,80,48461,80,allow,9643,812,8831,18,128,8,10
62588,50681,443,36673,443,allow,6888,1380,5508,19,171,9,10
62589,50801,443,41271,443,allow,6893,1384,5509,19,140,9,10
62590,60840,443,45920,443,allow,54975,32043,22932,71,319,40,31
62591,50745,80,27446,80,allow,2977,680,2297,11,161,6,5
62592,60872,443,25312,443,allow,27204,15677,11527,59,62,30,29
62593,50873,443,21465,443,allow,6889,1381,5508,19,129,9,10
62594,50892,443,40533,443,allow,8057,1135,6922,19,129,9,10
62595,50878,80,60118,80,allow,325925,18062,307863,377,146,161,216
62596,50898,443,1887,443,allow,6883,1378,5505,19,128,9,10
62597,51721,35426,54780,35426,allow,70,70,0,1,5,1,0
62598,50944,443,36385,443,allow,9517,1898,7619,21,85,11,10
62599,50850,443,34368,443,allow,6341,1382,4959,19,132,9,10
62600,62705,443,21442,443,allow,357841,77119,280722,646,142,316,330
62601,51735,50794,43847,50794,allow,70,70,0,2,8,2,0
62602,36261,443,56856,443,allow,1269784,41489,1228295,1339,37,478,861
62603,65463,443,25060,443,allow,92752,4519,88233,105,15,39,66
62604,50690,443,9122,443,allow,152,86,66,2,4,1,1
62605,53520,37553,29607,37553,allow,70,70,0,1,4,1,0
62606,53531,48908,42269,48908,allow,70,70,0,1,4,1,0
62607,40521,28678,47764,28678,allow,1806,1806,0,22,225,22,0
62608,52640,443,13563,443,allow,70,70,0,1,5,1,0
62609,49720,443,54089,443,allow,4936,855,4081,17,52,7,10
62610,42925,443,37247,443,allow,5617,1559,4058,22,138,13,9
62611,60191,443,1843,443,allow,7292,950,6342,19,125,9,10
62612,49726,443,2292,443,allow,3941,902,3039,13,50,7,6
62613,53155,443,52565,443,allow,3866,2774,1092,21,28,12,9
62614,36256,443,38729,443,allow,3936219,107920,3828299,3880,132,1208,2672
62615,53152,443,44569,443,allow,16706,6162,10544,39,29,19,20
62616,52913,443,33752,443,allow,50739,5508,45231,100,116,36,64
62617,49719,443,28042,443,allow,4717,849,3868,15,52,7,8
62618,53079,443,11081,443,allow,8233,5537,2696,40,84,21,19
62619,53192,443,46060,443,allow,35788,2073,33715,54,21,20,34
62620,52857,443,23236,443,allow,10234,2550,7684,47,139,23,24
62621,53164,443,1379,443,allow,7434,1695,5739,23,27,12,11
62622,53140,443,40797,443,allow,8349,1987,6362,23,30,12,11
62623,52853,80,51325,80,allow,7502,3168,4334,41,140,22,19
62624,52959,443,64973,443,allow,9257,2079,7178,39,113,19,20
62625,52891,443,27899,443,allow,320255,9207,311048,343,117,107,236
62626,52866,80,44619,80,allow,6022,2590,3432,37,131,20,17
62627,53198,443,2334,443,allow,1462,965,497,13,18,7,6
62628,53186,443,23298,443,allow,10332,2735,7597,36,21,17,19
62629,52961,443,6824,443,allow,925322,25097,900225,971,113,287,684
62630,52956,443,14626,443,allow,15659,3294,12365,60,114,25,35
62631,52970,443,47039,443,allow,19221,5366,13855,88,113,36,52
62632,53159,443,33030,443,allow,9711,3950,5761,38,28,22,16
62633,53094,443,6776,443,allow,6726,3603,3123,34,80,17,17
62634,50968,443,54503,443,allow,13683,6075,7608,58,5113,23,35
62635,50974,80,21113,80,allow,1095989,7833,1088156,841,37,117,724
62636,49880,443,51797,443,allow,1087632,32231,1055401,1112,53,334,778
62637,49868,443,19461,443,allow,11578,2375,9203,47,55,22,25
62638,49856,443,10855,443,allow,5512,978,4534,20,60,10,10
62639,49879,443,31980,443,allow,6121,1042,5079,21,53,11,10
62640,64359,53,14911,53,allow,196,102,94,2,30,1,1
62641,56524,53,26224,53,allow,182,102,80,2,30,1,1
62642,55853,53,62979,53,allow,228,110,118,2,30,1,1
62643,65361,53,62352,53,allow,211,102,109,2,30,1,1
62644,64614,53,60972,53,allow,168,86,82,2,31,1,1
62645,49855,443,64909,443,allow,28887,9850,19037,96,60,41,55
62646,49871,443,47130,443,allow,615040,25597,589443,704,54,245,459
62647,49829,443,43793,443,allow,3026,1775,1251,23,74,14,9
62648,56364,443,28728,443,allow,10427,6311,4116,33,234,20,13
62649,65432,53,33110,53,allow,448,184,264,6,30,3,3
62650,56215,53,5017,53,allow,216,110,106,2,30,1,1
62651,37297,443,18068,443,allow,4514,1928,2586,17,240,8,9
62652,21133,59392,22505,59392,allow,481,150,331,2,1199,1,1
62653,49961,53,9720,53,allow,327,126,201,2,30,1,1
62654,50977,80,25806,80,allow,1111949,11633,1100316,906,37,173,733
62655,52473,443,5513,443,allow,1625,1038,587,14,28,8,6
62656,48252,443,55839,443,allow,60300,47341,12959,192,39,108,84
62657,49671,443,7194,443,allow,1485,940,545,13,57,7,6
62658,51685,80,11134,80,allow,1516,481,1035,11,15,6,5
62659,54307,443,65534,443,allow,5661,1444,4217,19,135,11,8
62660,56598,80,2431,80,allow,234,234,0,4,12,4,0
62661,38171,443,40043,443,allow,1649,980,669,14,28,7,7
62662,49725,443,45081,443,allow,7162,780,6382,18,50,8,10
62663,53043,443,3283,443,allow,11020,3760,7260,56,92,25,31
62664,52397,443,10007,443,allow,9680,2399,7281,47,136,27,20
62665,52919,443,28761,443,allow,7573,1986,5587,40,115,19,21
62666,53080,443,53725,443,allow,108155,4527,103628,115,83,30,85
62667,52888,443,11223,443,allow,12876,2739,10137,44,118,21,23
62668,52932,443,63575,443,allow,13165,3626,9539,56,115,30,26
62669,52967,443,11017,443,allow,9893,2231,7662,42,113,21,21
62670,53200,443,25558,443,allow,1462,965,497,13,18,7,6
62671,52875,443,25381,443,allow,89335,4699,84636,107,118,32,75
62672,52894,443,46843,443,allow,5424,1445,3979,29,117,14,15
62673,52937,443,42865,443,allow,22218,12408,9810,66,115,33,33
62674,53202,443,64942,443,allow,3655,2344,1311,18,17,9,9
62675,29029,53,43871,53,allow,323,77,246,4,30,2,2
62676,55081,53,46160,53,allow,209,102,107,2,30,1,1
62677,57341,3389,57341,3389,allow,3428,1714,1714,16,33,8,8
62678,49691,443,33512,443,allow,1183,659,524,13,56,7,6
62679,49684,443,64157,443,allow,9083,2300,6783,19,56,10,9
62680,50402,80,18324,80,allow,5981,3589,2392,15,32,8,7
62681,53114,443,33125,443,allow,15277,10027,5250,36,46,21,15
62682,52861,443,16498,443,allow,3633587,34615,3598972,2964,137,514,2450
62683,52874,443,59388,443,allow,392514,41757,350757,626,118,209,417
62684,52966,80,53251,80,allow,2974,1352,1622,28,113,15,13
62685,53184,443,16399,443,allow,13515,3057,10458,40,21,20,20
62686,52872,443,5601,443,allow,110507,3940,106567,129,118,37,92
62687,53205,443,46818,443,allow,3658,2347,1311,18,17,9,9
62688,53026,443,50319,443,allow,14051,6332,7719,43,92,21,22
62689,65079,53,34794,53,allow,272,94,178,2,30,1,1
62690,65049,53,16377,53,allow,210,110,100,2,30,1,1
62691,49878,443,52783,443,allow,5997,978,5019,19,53,10,9
62692,49841,443,32376,443,allow,7084,1611,5473,29,71,15,14
62693,49840,443,9507,443,allow,58656,12994,45662,148,71,64,84
62694,50403,53,9932,53,allow,749,94,655,2,30,1,1
62695,56478,53,64286,53,allow,200,102,98,2,30,1,1
62696,65218,53,47163,53,allow,276,126,150,2,30,1,1
62697,49874,443,3516,443,allow,6058,1037,5021,20,54,11,9
62698,49886,443,23328,443,allow,7488,1598,5890,25,50,13,12
62699,45402,443,57057,443,allow,7710,3375,4335,32,131,18,14
62700,56758,40000,5881,40000,allow,70,70,0,1,5,1,0
62701,34990,80,31222,80,allow,350,210,140,6,28,4,2
62702,49716,443,56032,443,allow,4653,785,3868,14,52,6,8
62703,49717,443,52321,443,allow,4876,855,4021,16,52,7,9
62704,53019,443,6559,443,allow,30012,3461,26551,72,93,28,44
62705,53121,443,1605,443,allow,10893,7149,3744,31,45,18,13
62706,53031,443,7092,443,allow,16055,5856,10199,97,92,42,55
62707,52885,80,48034,80,allow,5688,2508,3180,36,118,19,17
62708,53047,443,44730,443,allow,13229,3527,9702,56,91,28,28
62709,53077,443,28917,443,allow,6715,1415,5300,27,84,14,13
62710,36563,6851,45259,6851,allow,7584,4075,3509,51,169,27,24
62711,52870,443,27625,443,allow,113894,15573,98321,182,119,67,115
62712,52920,443,54361,443,allow,31161,4934,26227,73,115,32,41
62713,49756,53,22675,53,allow,243,118,125,2,30,1,1
62714,56881,53,21712,53,allow,181,86,95,2,30,1,1
62715,49413,53,52444,53,allow,231,110,121,2,30,1,1
62716,52989,443,57788,443,allow,182945,23135,159810,191,111,63,128
62717,59988,443,59988,443,allow,8589,2809,5780,30,16,15,15
62718,52428,80,60172,80,allow,2516,1929,587,15,16,9,6
62719,56365,443,42336,443,allow,4850,2997,1853,20,234,12,8
62720,56215,53,1097,53,allow,216,110,106,2,30,1,1
62721,65127,53,45861,53,allow,194,102,92,2,30,1,1
62722,56322,53,2088,53,allow,209,110,99,2,30,1,1
62723,57074,53,27906,53,allow,259,78,181,2,30,1,1
62724,49177,53,24852,53,allow,184,94,90,2,30,1,1
62725,49627,53,57352,53,allow,288,110,178,2,31,1,1
62726,64835,53,56147,53,allow,200,102,98,2,31,1,1
62727,32299,40015,23096,40015,allow,188,70,118,2,31,1,1
62728,5588,5588,0,0,allow,3562,1936,1626,48,196,24,24
62729,64077,53,54964,53,allow,199,94,105,2,30,1,1
62730,58981,443,5501,443,allow,3155,836,2319,13,135,6,7
62731,57470,6881,59936,6881,allow,132,132,0,3,1199,3,0
62732,6881,1564,62594,1564,allow,324,150,174,2,1200,1,1
62733,57470,25089,59334,25089,allow,132,132,0,3,1199,3,0
62734,52994,443,57845,443,allow,10694,4129,6565,41,111,20,21
62735,52910,443,4102,443,allow,179433,12614,166819,217,116,78,139
62736,52998,443,44367,443,allow,22480,2705,19775,49,109,22,27
62737,56727,53,51350,53,allow,250,86,164,4,54,2,2
62738,53029,443,57596,443,allow,9246,1808,7438,35,92,17,18
62739,65056,53,43061,53,allow,211,102,109,2,30,1,1
62740,41095,443,28178,443,allow,108842,88940,19902,313,255,159,154
62741,52329,53,12571,53,allow,294,86,208,2,30,1,1
62742,40682,443,13381,443,allow,10010,4051,5959,32,346,17,15
62743,49897,443,33898,443,allow,8586,1352,7234,27,34,13,14
62744,64814,53,5615,53,allow,243,94,149,2,30,1,1
62745,56367,443,5869,443,allow,4863,3011,1852,20,234,12,8
62746,64359,53,62943,53,allow,196,102,94,2,30,1,1
62747,56617,53,16257,53,allow,286,94,192,2,30,1,1
62748,55972,53,36064,53,allow,193,102,91,2,30,1,1
62749,55559,53,59475,53,allow,182,94,88,2,30,1,1
62750,65020,53,52884,53,allow,289,102,187,2,30,1,1
62751,55951,53,63735,53,allow,197,102,95,2,31,1,1
62752,59946,443,42319,443,allow,11836,3531,8305,37,121,19,18
62753,60046,443,51072,443,allow,8241,2346,5895,18,136,8,10
62754,47274,5223,2647,5223,allow,4269,1451,2818,22,3002,13,9
62755,65277,53,17756,53,allow,819,102,717,2,31,1,1
62756,55972,53,18787,53,allow,193,102,91,2,31,1,1
62757,63945,53,11861,53,allow,216,110,106,2,31,1,1
62758,60303,443,45517,443,allow,7914400,166459,7747941,6839,775,1138,5701
62759,39615,443,10074,443,allow,6133,1343,4790,22,275,12,10
62760,64742,53,40488,53,allow,194,94,100,2,31,1,1
62761,57470,1,27948,1,allow,132,132,0,3,1199,3,0
62762,57470,51413,17602,51413,allow,330,330,0,6,1199,6,0
62763,57470,46501,13184,46501,allow,132,132,0,3,1199,3,0
62764,50265,24387,12796,24387,allow,132,132,0,3,1200,3,0
62765,50265,42698,16471,42698,allow,726,726,0,12,1200,12,0
62766,58612,443,21355,443,allow,154,94,60,2,5,1,1
62767,55759,445,0,0,drop,70,70,0,1,0,1,0
62768,50699,445,0,0,drop,70,70,0,1,0,1,0
62769,30114,65151,0,0,deny,60,60,0,1,0,1,0
62770,43840,50265,0,0,deny,72,72,0,1,0,1,0
62771,27328,21247,0,0,deny,66,66,0,1,0,1,0
62772,44258,25,0,0,deny,74,74,0,1,0,1,0
62773,54071,50265,0,0,deny,66,66,0,1,0,1,0
62774,50692,445,0,0,drop,70,70,0,1,0,1,0
62775,26792,37965,0,0,deny,62,62,0,1,0,1,0
62776,42285,57470,0,0,deny,62,62,0,1,0,1,0
62777,50689,445,0,0,drop,70,70,0,1,0,1,0
62778,55746,445,0,0,drop,70,70,0,1,0,1,0
62779,55745,445,0,0,drop,70,70,0,1,0,1,0
62780,55743,445,0,0,drop,70,70,0,1,0,1,0
62781,11136,15503,0,0,deny,62,62,0,1,0,1,0
62782,50685,445,0,0,drop,70,70,0,1,0,1,0
62783,50684,445,0,0,drop,70,70,0,1,0,1,0
62784,4366,51505,0,0,deny,62,62,0,1,0,1,0
62785,61865,35440,0,0,deny,66,66,0,1,0,1,0
62786,53406,44847,0,0,deny,66,66,0,1,0,1,0
62787,50680,445,0,0,drop,70,70,0,1,0,1,0
62788,1042,64147,0,0,deny,145,145,0,1,0,1,0
62789,51144,445,0,0,drop,66,66,0,1,0,1,0
62790,55741,445,0,0,drop,70,70,0,1,0,1,0
62791,55734,445,0,0,drop,70,70,0,1,0,1,0
62792,50678,445,0,0,drop,70,70,0,1,0,1,0
62793,50386,22114,0,0,deny,62,62,0,1,0,1,0
62794,1027,65473,0,0,deny,159,159,0,1,0,1,0
62795,36945,23,0,0,deny,60,60,0,1,0,1,0
62796,22683,39210,0,0,deny,60,60,0,1,0,1,0
62797,50081,57470,0,0,deny,66,66,0,1,0,1,0
62798,2467,2767,0,0,deny,66,66,0,1,0,1,0
62799,25412,23,0,0,deny,60,60,0,1,0,1,0
62800,51137,445,0,0,drop,66,66,0,1,0,1,0
62801,50674,445,0,0,drop,70,70,0,1,0,1,0
62802,37042,48983,0,0,deny,159,159,0,1,0,1,0
62803,2919,57866,0,0,deny,62,62,0,1,0,1,0
62804,51134,445,0,0,drop,66,66,0,1,0,1,0
62805,25739,64147,0,0,deny,62,62,0,1,0,1,0
62806,55731,445,0,0,drop,70,70,0,1,0,1,0
62807,62787,51221,0,0,deny,66,66,0,1,0,1,0
62808,62632,35440,0,0,deny,66,66,0,1,0,1,0
62809,55726,445,0,0,drop,70,70,0,1,0,1,0
62810,55724,445,0,0,drop,70,70,0,1,0,1,0
62811,55721,445,0,0,drop,70,70,0,1,0,1,0
62812,51132,445,0,0,drop,66,66,0,1,0,1,0
62813,17070,48817,0,0,deny,140,140,0,1,0,1,0
62814,31136,50584,0,0,deny,62,62,0,1,0,1,0
62815,39480,8055,0,0,deny,148,148,0,1,0,1,0
62816,6057,51221,0,0,deny,78,78,0,1,0,1,0
62817,61566,44847,0,0,deny,66,66,0,1,0,1,0
62818,55714,445,0,0,drop,70,70,0,1,0,1,0
62819,15793,64147,0,0,deny,66,66,0,1,0,1,0
62820,55712,445,0,0,drop,70,70,0,1,0,1,0
62821,55710,445,0,0,drop,70,70,0,1,0,1,0
62822,55708,445,0,0,drop,70,70,0,1,0,1,0
62823,50661,445,0,0,drop,70,70,0,1,0,1,0
62824,51125,445,0,0,drop,66,66,0,1,0,1,0
62825,60894,50584,0,0,deny,66,66,0,1,0,1,0
62826,63331,51221,0,0,deny,62,62,0,1,0,1,0
62827,2182,57354,0,0,deny,145,145,0,1,0,1,0
62828,51121,445,0,0,drop,66,66,0,1,0,1,0
62829,51117,445,0,0,drop,66,66,0,1,0,1,0
62830,51120,445,0,0,drop,66,66,0,1,0,1,0
62831,51114,445,0,0,drop,66,66,0,1,0,1,0
62832,51113,445,0,0,drop,66,66,0,1,0,1,0
62833,51112,445,0,0,drop,66,66,0,1,0,1,0
62834,50658,445,0,0,drop,70,70,0,1,0,1,0
62835,62696,50584,0,0,deny,66,66,0,1,0,1,0
62836,58318,15503,0,0,deny,66,66,0,1,0,1,0
62837,17760,50584,0,0,deny,62,62,0,1,0,1,0
62838,33822,57470,0,0,deny,66,66,0,1,0,1,0
62839,55707,445,0,0,drop,70,70,0,1,0,1,0
62840,55705,445,0,0,drop,70,70,0,1,0,1,0
62841,55703,445,0,0,drop,70,70,0,1,0,1,0
62842,58326,50584,0,0,deny,146,146,0,1,0,1,0
62843,51110,445,0,0,drop,66,66,0,1,0,1,0
62844,55699,445,0,0,drop,70,70,0,1,0,1,0
62845,50653,445,0,0,drop,70,70,0,1,0,1,0
62846,51106,445,0,0,drop,66,66,0,1,0,1,0
62847,50652,445,0,0,drop,70,70,0,1,0,1,0
62848,51105,445,0,0,drop,66,66,0,1,0,1,0
62849,51104,445,0,0,drop,66,66,0,1,0,1,0
62850,50650,445,0,0,drop,70,70,0,1,0,1,0
62851,0,0,0,0,allow,320,320,0,5,0,5,0
62852,51101,445,0,0,drop,66,66,0,1,0,1,0
62853,50116,22,0,0,deny,60,60,0,1,0,1,0
62854,43129,20220,0,0,deny,62,62,0,1,0,1,0
62855,55694,445,0,0,drop,70,70,0,1,0,1,0
62856,45908,3383,0,0,deny,60,60,0,1,0,1,0
62857,52459,33890,0,0,deny,60,60,0,1,0,1,0
62858,6881,9074,0,0,deny,143,143,0,1,0,1,0
62859,55685,445,0,0,drop,70,70,0,1,0,1,0
62860,55684,445,0,0,drop,70,70,0,1,0,1,0
62861,50643,445,0,0,drop,70,70,0,1,0,1,0
62862,45941,23386,0,0,deny,60,60,0,1,0,1,0
62863,50641,445,0,0,drop,70,70,0,1,0,1,0
62864,51092,445,0,0,drop,66,66,0,1,0,1,0
62865,49818,37965,0,0,deny,62,62,0,1,0,1,0
62866,26198,64147,0,0,deny,62,62,0,1,0,1,0
62867,13188,35440,0,0,deny,66,66,0,1,0,1,0
62868,50640,445,0,0,drop,70,70,0,1,0,1,0
62869,50639,445,0,0,drop,70,70,0,1,0,1,0
62870,50638,445,0,0,drop,70,70,0,1,0,1,0
62871,50635,445,0,0,drop,70,70,0,1,0,1,0
62872,50632,445,0,0,drop,70,70,0,1,0,1,0
62873,51083,445,0,0,drop,66,66,0,1,0,1,0
62874,16948,990,0,0,deny,60,60,0,1,0,1,0
62875,55672,445,0,0,drop,70,70,0,1,0,1,0
62876,33457,27015,0,0,deny,67,67,0,1,0,1,0
62877,55878,7302,0,0,deny,62,62,0,1,0,1,0
62878,1446,35440,0,0,deny,62,62,0,1,0,1,0
62879,50620,445,0,0,drop,70,70,0,1,0,1,0
62880,50619,445,0,0,drop,70,70,0,1,0,1,0
62881,50613,445,0,0,drop,70,70,0,1,0,1,0
62882,63864,23,0,0,deny,60,60,0,1,0,1,0
62883,63925,37965,0,0,deny,66,66,0,1,0,1,0
62884,1873,37965,0,0,deny,62,62,0,1,0,1,0
62885,63433,57866,0,0,deny,66,66,0,1,0,1,0
62886,51080,445,0,0,drop,66,66,0,1,0,1,0
62887,50610,445,0,0,drop,70,70,0,1,0,1,0
62888,50609,445,0,0,drop,70,70,0,1,0,1,0
62889,51073,445,0,0,drop,66,66,0,1,0,1,0
62890,2995,26467,0,0,deny,62,62,0,1,0,1,0
62891,123,123,15561,123,allow,184,94,90,2,30,1,1
62892,64614,53,55255,53,allow,168,86,82,2,30,1,1
62893,56117,53,10364,53,allow,757,98,659,2,30,1,1
62894,55479,53,3977,53,allow,789,110,679,2,30,1,1
62895,43095,443,16830,443,allow,3067,1817,1250,18,16,8,10
62896,52089,443,15915,443,allow,6032,3616,2416,39,187,20,19
62897,61399,80,3299,80,allow,5518,527,4991,13,75,6,7
62898,56755,31774,8678,31774,allow,378,192,186,7,15,4,3
62899,45377,443,49244,443,allow,5291,3987,1304,19,255,11,8
62900,51719,13715,9141,13715,allow,66,66,0,1,5,1,0
62901,64756,53,24462,53,allow,757,98,659,2,30,1,1
62902,52933,80,52933,80,allow,98765,5293,93472,131,199,48,83
62903,63720,55027,38364,55027,allow,1233,902,331,12,17,8,4
62904,54853,443,64447,443,allow,7689,3574,4115,65,308,32,33
62905,61397,80,22347,80,allow,2500,531,1969,11,75,6,5
62906,38807,443,45968,443,allow,99092,3694,95398,115,170,43,72
62907,50537,5223,31982,5223,allow,12710,4688,8022,44,2961,19,25
62908,57108,53,22880,53,allow,186,95,91,2,30,1,1
62909,55972,53,10428,53,allow,186,95,91,2,30,1,1
62910,45937,443,35765,443,allow,4592,697,3895,14,25,8,6
62911,53546,17203,56777,17203,allow,320,140,180,6,7,3,3
62912,51717,63436,58721,63436,allow,66,66,0,1,5,1,0
62913,50807,443,17833,443,allow,9328,1709,7619,18,139,8,10
62914,57594,443,61887,443,allow,291,171,120,4,15,2,2
62915,44036,443,28418,443,allow,6599,3950,2649,36,186,20,16
62916,56617,3389,56617,3389,allow,3425,1470,1955,16,17,8,8
62917,51718,55003,59957,55003,allow,66,66,0,1,5,1,0
62918,61398,80,45091,80,allow,2425,529,1896,11,75,6,5
62919,23228,443,23228,443,allow,20540,5514,15026,52,76,29,23
62920,5588,5588,0,0,allow,3498,1872,1626,48,200,24,24
62921,50061,443,9312,443,allow,7199,2528,4671,18,76,10,8
62922,48965,443,50088,443,allow,9519,4377,5142,33,354,17,16
62923,22452,443,22452,443,allow,5785,2575,3210,24,76,14,10
62924,53545,27700,24861,27700,allow,320,140,180,6,7,3,3
62925,63808,53,2452,53,allow,578,286,292,9,15,5,4
62926,38809,443,49064,443,allow,79659,3269,76390,96,170,37,59
62927,37570,443,53443,443,allow,986,499,487,9,17,5,4
62928,64835,53,1399,53,allow,200,102,98,2,30,1,1
62929,56243,53,64458,53,allow,762,101,661,2,30,1,1
62930,55559,53,26431,53,allow,180,92,88,2,30,1,1
62931,50870,5228,4125,5228,allow,7069,1804,5265,20,3602,11,9
62932,16387,29288,0,0,allow,60,60,0,1,61,1,0
62933,16387,64374,0,0,allow,60,60,0,1,61,1,0
62934,16387,25523,0,0,allow,60,60,0,1,61,1,0
62935,65460,53,42143,53,allow,194,99,95,2,31,1,1
62936,51066,445,0,0,drop,66,66,0,1,0,1,0
62937,1025,64147,0,0,deny,62,62,0,1,0,1,0
62938,443,43775,0,0,deny,97,97,0,1,0,1,0
62939,49418,57470,0,0,deny,62,62,0,1,0,1,0
62940,62673,34159,0,0,deny,66,66,0,1,0,1,0
62941,46495,4607,0,0,deny,60,60,0,1,0,1,0
62942,56296,53,43298,53,allow,216,110,106,2,30,1,1
62943,50582,53,45109,53,allow,216,110,106,2,30,1,1
62944,65277,53,20067,53,allow,196,102,94,2,30,1,1
62945,65127,53,38412,53,allow,194,102,92,2,30,1,1
62946,50119,443,16718,443,allow,15168,5689,9479,51,34,27,24
62947,49160,28890,3522,28890,allow,830,150,680,4,1200,2,2
62948,57122,53,32018,53,allow,216,110,106,2,30,1,1
62949,50120,443,54666,443,allow,29503,9695,19808,55,34,30,25
62950,49364,53,61563,53,allow,182,94,88,2,30,1,1
62951,49769,443,1740,443,allow,13455,1982,11473,29,31,16,13
62952,56897,7003,14885,7003,allow,1098,672,426,14,734,8,6
62953,64950,53,11191,53,allow,326,88,238,4,52,2,2
62954,65460,53,26483,53,allow,197,102,95,2,30,1,1
62955,51716,57137,20087,57137,allow,70,70,0,1,5,1,0
62956,51720,51388,35731,51388,allow,70,70,0,1,5,1,0
62957,49364,53,40148,53,allow,182,94,88,2,30,1,1
62958,57108,53,35898,53,allow,193,102,91,2,30,1,1
62959,55824,53,60939,53,allow,819,102,717,2,30,1,1
62960,64614,53,52648,53,allow,168,86,82,2,31,1,1
62961,36448,80,28179,80,allow,1325,336,989,10,15,5,5
62962,51734,59825,40402,59825,allow,70,70,0,2,8,2,0
62963,60385,59696,28455,59696,allow,70,70,0,2,8,2,0
62964,34155,443,36605,443,allow,154,94,60,2,5,1,1
62965,23270,443,23270,443,allow,5802,2592,3210,24,76,14,10
62966,60382,62582,18649,62582,allow,70,70,0,2,8,2,0
62967,56435,53,21877,53,allow,193,102,91,2,30,1,1
62968,40804,8434,40804,8434,allow,156,156,0,3,8,3,0
62969,64580,53,23762,53,allow,199,102,97,2,30,1,1
62970,35666,443,50206,443,allow,3389452,85022,3304430,3290,159,997,2293
62971,55824,53,12441,53,allow,196,102,94,2,30,1,1
62972,57108,53,37838,53,allow,193,102,91,2,30,1,1
62973,19840,7000,19840,7000,allow,3610,2043,1567,16,17,9,7
62974,56234,443,33837,443,allow,8971,2446,6525,50,347,23,27
62975,65134,53,31124,53,allow,229,110,119,2,30,1,1
62976,36924,53,36924,53,allow,257,106,151,2,30,1,1
62977,57122,53,3566,53,allow,216,110,106,2,30,1,1
62978,65403,53,24512,53,allow,249,102,147,2,30,1,1
62979,50561,53,34475,53,allow,763,102,661,2,30,1,1
62980,63582,443,11318,443,allow,6178,1669,4509,19,15,11,8
62981,50969,80,54293,80,allow,921711,12229,909482,780,37,172,608
62982,52489,443,60427,443,allow,32975,9028,23947,39,15,18,21
62983,60744,40010,53059,40010,allow,316,136,180,6,5,3,3
62984,60381,26312,6064,26312,allow,70,70,0,2,8,2,0
62985,48016,443,47269,443,allow,138,78,60,2,5,1,1
62986,60306,443,28741,443,allow,9188,3421,5767,43,83,19,24
62987,50973,80,49428,80,allow,1095221,7065,1088156,829,36,105,724
62988,60380,55125,53805,55125,allow,70,70,0,2,8,2,0
62989,53156,51689,64576,51689,allow,546,306,240,9,142,5,4
62990,53541,59939,24806,59939,allow,70,70,0,2,7,2,0
62991,37523,443,28556,443,allow,154,94,60,2,4,1,1
62992,22352,443,22352,443,allow,6899,3403,3496,27,76,16,11
62993,51733,30688,48958,30688,allow,70,70,0,2,8,2,0
62994,57416,66,17429,66,allow,70,70,0,2,7,2,0
62995,56712,53,4721,53,allow,448,184,264,6,29,3,3
62996,50572,80,46272,80,allow,62,62,0,1,5,1,0
62997,64968,53,11604,53,allow,448,98,350,4,41,2,2
62998,52849,443,32844,443,allow,7735,1260,6475,16,133,7,9
62999,65123,53,24943,53,allow,307,110,197,2,29,1,1
63000,23276,443,23276,443,allow,4668,1745,2923,21,76,12,9
63001,55559,53,16251,53,allow,182,94,88,2,30,1,1
63002,49177,53,27104,53,allow,184,94,90,2,30,1,1
63003,55559,53,6941,53,allow,182,94,88,2,29,1,1
63004,55017,53,20456,53,allow,288,110,178,2,29,1,1
63005,64580,53,13673,53,allow,199,102,97,2,30,1,1
63006,57108,53,1595,53,allow,193,102,91,2,30,1,1
63007,56322,53,24189,53,allow,209,110,99,2,30,1,1
63008,64835,53,60535,53,allow,200,102,98,2,31,1,1
63009,60047,443,20320,443,allow,229060,38515,190545,283,135,113,170
63010,52155,80,42520,80,allow,1056,682,374,10,15,6,4
63011,56862,53,7245,53,allow,198,94,104,2,30,1,1
63012,49364,53,15202,53,allow,182,94,88,2,30,1,1
63013,56829,53,48980,53,allow,199,102,97,2,30,1,1
63014,33048,443,57285,443,allow,90054,6681,83373,104,133,33,71
63015,49168,443,13690,443,allow,519325,13798,505527,535,18,193,342
63016,55342,443,55342,443,allow,5593,2346,3247,22,39,13,9
63017,49648,7275,24792,7275,allow,8962,1625,7337,28,16,15,13
63018,48632,443,58774,443,allow,12433,4515,7918,32,136,17,15
63019,48631,443,20403,443,allow,42910,5005,37905,72,136,36,36
63020,50582,53,14787,53,allow,216,110,106,2,30,1,1
63021,57330,53,31519,53,allow,228,94,134,2,30,1,1
63022,65049,443,55584,443,allow,12674,1396,11278,12,139,2,10
63023,17750,30022,45838,30022,allow,481,150,331,2,1200,1,1
63024,51732,54299,27558,54299,allow,70,70,0,2,8,2,0
63025,64586,80,64586,80,allow,123115,6863,116252,160,29,76,84
63026,56435,53,33982,53,allow,193,102,91,2,30,1,1
63027,64615,53,40640,53,allow,198,94,104,2,30,1,1
63028,56829,53,59229,53,allow,199,102,97,2,30,1,1
63029,55535,53,57254,53,allow,199,102,97,2,30,1,1
63030,58082,443,14473,443,allow,45314943,1391230,43923713,47149,303,15196,31953
63031,49249,443,43033,443,allow,35406,17785,17621,79,141,40,39
63032,55535,53,2360,53,allow,199,102,97,2,31,1,1
63033,50265,6881,13047,6881,allow,491,150,341,2,1200,1,1
63034,50008,53,47667,53,allow,193,102,91,2,31,1,1
63035,63733,47013,45780,47013,allow,66,66,0,2,8,2,0
63036,48408,443,3268,443,allow,115036,11567,103469,189,103,92,97
63037,64357,53,38839,53,allow,469,103,366,4,43,2,2
63038,43078,80,13694,80,allow,1052,612,440,10,15,5,5
63039,50971,80,41640,80,allow,1094437,6233,1088204,817,36,92,725
63040,63945,53,38413,53,allow,216,110,106,2,30,1,1
63041,27999,443,45047,443,allow,5577,1390,4187,19,15,9,10
63042,61676,443,64478,443,allow,6353,1520,4833,20,17,12,8
63043,60900,443,23820,443,allow,134,60,74,3,6,2,1
63044,45540,8100,25472,8100,allow,234,234,0,4,12,4,0
63045,64659,53,14647,53,allow,464,99,365,4,39,2,2
63046,45227,80,43141,80,allow,1114,534,580,12,16,7,5
63047,43175,53,11498,53,allow,194,86,108,2,30,1,1
63048,50598,445,0,0,drop,70,70,0,1,0,1,0
63049,25565,55690,0,0,deny,60,60,0,1,0,1,0
63050,52668,51221,0,0,deny,66,66,0,1,0,1,0
63051,55664,445,0,0,drop,70,70,0,1,0,1,0
63052,55660,445,0,0,drop,70,70,0,1,0,1,0
63053,55659,445,0,0,drop,70,70,0,1,0,1,0
63054,51948,37965,0,0,deny,62,62,0,1,0,1,0
63055,51052,445,0,0,drop,66,66,0,1,0,1,0
63056,51054,445,0,0,drop,66,66,0,1,0,1,0
63057,51057,445,0,0,drop,66,66,0,1,0,1,0
63058,51051,445,0,0,drop,66,66,0,1,0,1,0
63059,51058,445,0,0,drop,66,66,0,1,0,1,0
63060,51055,445,0,0,drop,66,66,0,1,0,1,0
63061,51056,445,0,0,drop,66,66,0,1,0,1,0
63062,51050,445,0,0,drop,66,66,0,1,0,1,0
63063,5180,57866,0,0,deny,66,66,0,1,0,1,0
63064,48544,44847,0,0,deny,146,146,0,1,0,1,0
63065,49501,11392,0,0,deny,66,66,0,1,0,1,0
63066,57896,1,0,0,deny,100,100,0,1,0,1,0
63067,55618,56205,0,0,deny,66,66,0,1,0,1,0
63068,29706,50584,0,0,deny,66,66,0,1,0,1,0
63069,5121,35440,0,0,deny,62,62,0,1,0,1,0
63070,25151,58833,0,0,deny,62,62,0,1,0,1,0
63071,50594,445,0,0,drop,70,70,0,1,0,1,0
63072,56564,9571,0,0,deny,78,78,0,1,0,1,0
63073,44933,26467,0,0,deny,62,62,0,1,0,1,0
63074,28584,37965,0,0,deny,62,62,0,1,0,1,0
63075,41836,23,0,0,deny,60,60,0,1,0,1,0
63076,47910,7454,0,0,deny,60,60,0,1,0,1,0
63077,9471,23,0,0,deny,60,60,0,1,0,1,0
63078,50583,445,0,0,drop,70,70,0,1,0,1,0
63079,50585,445,0,0,drop,70,70,0,1,0,1,0
63080,6889,47807,0,0,deny,143,143,0,1,0,1,0
63081,50581,445,0,0,drop,70,70,0,1,0,1,0
63082,50579,445,0,0,drop,70,70,0,1,0,1,0
63083,62148,37965,0,0,deny,62,62,0,1,0,1,0
63084,50578,445,0,0,drop,70,70,0,1,0,1,0
63085,1025,35447,0,0,deny,62,62,0,1,0,1,0
63086,55654,445,0,0,drop,70,70,0,1,0,1,0
63087,55649,445,0,0,drop,70,70,0,1,0,1,0
63088,55644,445,0,0,drop,70,70,0,1,0,1,0
63089,44318,51180,0,0,deny,74,74,0,1,0,1,0
63090,51038,445,0,0,drop,66,66,0,1,0,1,0
63091,51037,445,0,0,drop,66,66,0,1,0,1,0
63092,51035,445,0,0,drop,66,66,0,1,0,1,0
63093,26379,23,0,0,deny,60,60,0,1,0,1,0
63094,6980,48543,0,0,deny,139,139,0,1,0,1,0
63095,20389,64147,0,0,deny,66,66,0,1,0,1,0
63096,55641,445,0,0,drop,70,70,0,1,0,1,0
63097,11404,64147,0,0,deny,62,62,0,1,0,1,0
63098,64000,44847,0,0,deny,66,66,0,1,0,1,0
63099,60246,44612,0,0,deny,66,66,0,1,0,1,0
63100,11136,15503,0,0,deny,145,145,0,1,0,1,0
63101,11136,17500,0,0,deny,62,62,0,1,0,1,0
63102,11136,57587,0,0,deny,62,62,0,1,0,1,0
63103,55639,445,0,0,drop,70,70,0,1,0,1,0
63104,50572,445,0,0,drop,70,70,0,1,0,1,0
63105,28832,36237,0,0,deny,66,66,0,1,0,1,0
63106,55635,445,0,0,drop,70,70,0,1,0,1,0
63107,55634,445,0,0,drop,70,70,0,1,0,1,0
63108,55632,445,0,0,drop,70,70,0,1,0,1,0
63109,30923,12883,0,0,deny,157,157,0,1,0,1,0
63110,57837,64147,0,0,deny,66,66,0,1,0,1,0
63111,50564,445,0,0,drop,70,70,0,1,0,1,0
63112,50563,445,0,0,drop,70,70,0,1,0,1,0
63113,59597,37965,0,0,deny,66,66,0,1,0,1,0
63114,5223,44091,0,0,deny,220,220,0,1,0,1,0
63115,50558,445,0,0,drop,70,70,0,1,0,1,0
63116,6975,29028,0,0,deny,139,139,0,1,0,1,0
63117,55621,445,0,0,drop,70,70,0,1,0,1,0
63118,55619,445,0,0,drop,70,70,0,1,0,1,0
63119,55615,445,0,0,deny,70,70,0,1,0,1,0
63120,6975,26543,0,0,deny,139,139,0,1,0,1,0
63121,50556,445,0,0,drop,70,70,0,1,0,1,0
63122,5637,37965,0,0,deny,62,62,0,1,0,1,0
63123,58486,57470,0,0,deny,66,66,0,1,0,1,0
63124,38681,15503,0,0,deny,74,74,0,1,0,1,0
63125,9756,26467,0,0,deny,62,62,0,1,0,1,0
63126,50052,65008,0,0,deny,60,60,0,1,0,1,0
63127,50552,445,0,0,drop,70,70,0,1,0,1,0
63128,51963,22114,0,0,deny,66,66,0,1,0,1,0
63129,4041,50584,0,0,deny,62,62,0,1,0,1,0
63130,58849,64147,0,0,deny,66,66,0,1,0,1,0
63131,51085,56205,0,0,deny,66,66,0,1,0,1,0
63132,42075,36237,0,0,deny,62,62,0,1,0,1,0
63133,50551,445,0,0,drop,70,70,0,1,0,1,0
63134,65016,37965,0,0,deny,66,66,0,1,0,1,0
63135,51014,445,0,0,drop,66,66,0,1,0,1,0
63136,42252,33303,0,0,deny,60,60,0,1,0,1,0
63137,24504,37965,0,0,deny,62,62,0,1,0,1,0
63138,55613,445,0,0,drop,70,70,0,1,0,1,0
63139,55606,445,0,0,drop,70,70,0,1,0,1,0
63140,60184,37965,0,0,deny,66,66,0,1,0,1,0
63141,3352,50584,0,0,deny,66,66,0,1,0,1,0
63142,50546,445,0,0,drop,70,70,0,1,0,1,0
63143,3052,20421,0,0,deny,104,104,0,1,0,1,0
63144,21998,51221,0,0,deny,62,62,0,1,0,1,0
63145,51009,445,0,0,drop,66,66,0,1,0,1,0
63146,61148,37965,0,0,deny,66,66,0,1,0,1,0
63147,42917,52952,0,0,deny,62,62,0,1,0,1,0
63148,51006,445,0,0,drop,66,66,0,1,0,1,0
63149,55601,445,0,0,drop,70,70,0,1,0,1,0
63150,55595,445,0,0,drop,70,70,0,1,0,1,0
63151,55591,445,0,0,drop,70,70,0,1,0,1,0
63152,55592,445,0,0,drop,70,70,0,1,0,1,0
63153,52788,64147,0,0,deny,66,66,0,1,0,1,0
63154,51004,445,0,0,drop,66,66,0,1,0,1,0
63155,55966,57866,0,0,deny,66,66,0,1,0,1,0
63156,36538,64147,0,0,deny,62,62,0,1,0,1,0
63157,53927,64147,0,0,deny,66,66,0,1,0,1,0
63158,11136,15503,0,0,deny,62,62,0,1,0,1,0
63159,5661,37965,0,0,deny,62,62,0,1,0,1,0
63160,52934,26467,0,0,deny,66,66,0,1,0,1,0
63161,9532,56205,0,0,deny,146,146,0,1,0,1,0
63162,56793,53,56695,53,allow,192,98,94,2,0,1,1
63163,50533,445,0,0,drop,70,70,0,1,0,1,0
63164,55586,445,0,0,drop,70,70,0,1,0,1,0
63165,49711,14984,0,0,deny,66,66,0,1,0,1,0
63166,5200,6643,0,0,deny,145,145,0,1,0,1,0
63167,52328,44847,0,0,deny,62,62,0,1,0,1,0
63168,51339,50584,0,0,deny,66,66,0,1,0,1,0
63169,55584,445,0,0,drop,70,70,0,1,0,1,0
63170,55582,445,0,0,drop,70,70,0,1,0,1,0
63171,55580,445,0,0,drop,70,70,0,1,0,1,0
63172,50995,445,0,0,deny,66,66,0,1,0,1,0
63173,9265,37965,0,0,deny,62,62,0,1,0,1,0
63174,50530,445,0,0,drop,70,70,0,1,0,1,0
63175,50994,445,0,0,drop,66,66,0,1,0,1,0
63176,50993,445,0,0,drop,66,66,0,1,0,1,0
63177,50989,445,0,0,drop,66,66,0,1,0,1,0
63178,33822,57470,0,0,deny,66,66,0,1,0,1,0
63179,50987,445,0,0,drop,66,66,0,1,0,1,0
63180,50985,445,0,0,drop,66,66,0,1,0,1,0
63181,50984,445,0,0,drop,66,66,0,1,0,1,0
63182,52690,7302,0,0,deny,66,66,0,1,0,1,0
63183,57954,48817,0,0,deny,78,78,0,1,0,1,0
63184,51353,46314,0,0,deny,145,145,0,1,0,1,0
63185,15056,2222,0,0,deny,60,60,0,1,0,1,0
63186,57360,18375,0,0,deny,66,66,0,1,0,1,0
63187,443,10010,0,0,deny,60,60,0,1,0,1,0
63188,50525,445,0,0,drop,70,70,0,1,0,1,0
63189,19367,35440,0,0,deny,146,146,0,1,0,1,0
63190,55578,445,0,0,drop,70,70,0,1,0,1,0
63191,55572,445,0,0,drop,70,70,0,1,0,1,0
63192,55573,445,0,0,drop,70,70,0,1,0,1,0
63193,50524,445,0,0,drop,70,70,0,1,0,1,0
63194,50982,445,0,0,drop,66,66,0,1,0,1,0
63195,55571,445,0,0,drop,70,70,0,1,0,1,0
63196,40898,5555,0,0,deny,60,60,0,1,0,1,0
63197,50979,445,0,0,drop,66,66,0,1,0,1,0
63198,1028,64147,0,0,deny,62,62,0,1,0,1,0
63199,50522,445,0,0,drop,70,70,0,1,0,1,0
63200,11552,44847,0,0,deny,62,62,0,1,0,1,0
63201,50977,445,0,0,drop,66,66,0,1,0,1,0
63202,50975,445,0,0,drop,66,66,0,1,0,1,0
63203,53957,35440,0,0,deny,62,62,0,1,0,1,0
63204,14255,2767,0,0,deny,62,62,0,1,0,1,0
63205,50973,445,0,0,drop,66,66,0,1,0,1,0
63206,53960,30041,0,0,deny,66,66,0,1,0,1,0
63207,49502,44847,0,0,deny,66,66,0,1,0,1,0
63208,7307,23,0,0,deny,60,60,0,1,0,1,0
63209,55566,445,0,0,drop,70,70,0,1,0,1,0
63210,32051,37965,0,0,deny,62,62,0,1,0,1,0
63211,50515,445,0,0,drop,70,70,0,1,0,1,0
63212,46389,27098,0,0,deny,66,66,0,1,0,1,0
63213,45964,55559,0,0,deny,60,60,0,1,0,1,0
63214,55559,445,0,0,drop,70,70,0,1,0,1,0
63215,55554,445,0,0,drop,70,70,0,1,0,1,0
63216,35347,20238,0,0,deny,66,66,0,1,0,1,0
63217,50513,445,0,0,drop,70,70,0,1,0,1,0
63218,7377,57470,0,0,deny,62,62,0,1,0,1,0
63219,54165,443,54165,443,allow,147750,13521,134229,182,92,84,98
63220,23406,443,23406,443,allow,5368,1609,3759,21,75,12,9
63221,58520,443,24680,443,allow,9429,3621,5808,60,80,26,34
63222,53912,3478,60537,3478,allow,3532,1792,1740,58,88,29,29
63223,65114,53,35237,53,allow,192,98,94,2,30,1,1
63224,60272,443,24375,443,allow,1853,1214,639,18,87,11,7
63225,54887,443,54887,443,allow,5573,2326,3247,22,40,13,9
63226,65154,443,37170,443,allow,5753,3034,2719,52,281,25,27
63227,50967,443,62336,443,allow,5841,1986,3855,19,17,11,8
63228,62306,443,62306,443,allow,5442,2195,3247,22,39,13,9
63229,60387,32087,24462,32087,allow,320,140,180,6,7,3,3
63230,63166,443,63166,443,allow,5407,2160,3247,22,38,13,9
63231,53436,443,59367,443,allow,7941,2678,5263,25,122,12,13
63232,64289,53,24247,53,allow,198,101,97,2,30,1,1
63233,50387,443,41513,443,allow,8507,1945,6562,21,33,10,11
63234,58884,15000,25949,15000,allow,138,78,60,2,5,1,1
63235,59395,443,39581,443,allow,5817,1995,3822,19,16,10,9
63236,53109,41661,38343,41661,allow,320,140,180,6,8,3,3
63237,37965,24475,30249,24475,allow,480,149,331,2,1200,1,1
63238,52173,443,52173,443,allow,201007,10015,190992,239,22,100,139
63239,64600,80,64600,80,allow,98859,6426,92433,136,27,68,68
63240,49430,443,47050,443,allow,18859,5795,13064,62,3666,28,34
63241,49660,53,64845,53,allow,186,95,91,2,30,1,1
63242,50172,443,51694,443,allow,3756,1914,1842,19,361,9,10
63243,57547,80,39933,80,allow,32368,2187,30181,45,337,23,22
63244,46477,443,29699,443,allow,4900,904,3996,16,97,9,7
63245,46478,443,23649,443,allow,493,280,213,8,97,5,3
63246,65176,53,13076,53,allow,299,103,196,4,51,2,2
63247,41624,15000,41127,15000,allow,130,70,60,2,5,1,1
63248,50008,53,29808,53,allow,186,95,91,2,30,1,1
63249,49154,80,61897,80,allow,2438,565,1873,10,75,6,4
63250,63403,443,54530,443,allow,4470,1597,2873,16,138,8,8
63251,49866,443,40314,443,allow,2937,717,2220,14,136,6,8
63252,30960,45676,24387,45676,allow,396,396,0,7,3616,7,0
63253,53151,29500,62396,29500,allow,514,274,240,8,143,4,4
63254,64926,53,43197,53,allow,192,98,94,2,40,1,1
63255,50012,7000,50012,7000,allow,3132,815,2317,14,16,7,7
63256,51731,39392,6820,39392,allow,70,70,0,2,8,2,0
63257,51709,40705,29645,40705,allow,66,66,0,1,5,1,0
63258,59396,443,16679,443,allow,5801,1995,3806,19,16,10,9
63259,55535,53,31917,53,allow,198,101,97,2,30,1,1
63260,52174,443,52174,443,allow,55503,7279,48224,79,22,32,47
63261,60271,443,5474,443,allow,10324,8406,1918,44,87,26,18
63262,65201,53,7188,53,allow,216,110,106,2,30,1,1
63263,55090,53,47013,53,allow,192,98,94,2,30,1,1
63264,54387,5228,7370,5228,allow,7019,1592,5427,25,3600,14,11
63265,56296,53,27962,53,allow,216,110,106,2,30,1,1
63266,59649,443,47146,443,allow,11784,7785,3999,55,120,28,27
63267,38603,5228,52662,5228,allow,3534,1679,1855,30,3640,11,19
63268,50965,445,0,0,drop,66,66,0,1,0,1,0
63269,50512,445,0,0,drop,70,70,0,1,0,1,0
63270,39100,2767,0,0,deny,62,62,0,1,0,1,0
63271,50511,445,0,0,drop,70,70,0,1,0,1,0
63272,50510,445,0,0,drop,70,70,0,1,0,1,0
63273,50507,445,0,0,drop,70,70,0,1,0,1,0
63274,50506,445,0,0,drop,70,70,0,1,0,1,0
63275,55142,26467,0,0,deny,62,62,0,1,0,1,0
63276,17777,30188,0,0,deny,62,62,0,1,0,1,0
63277,10965,22114,0,0,deny,62,62,0,1,0,1,0
63278,10965,22114,0,0,deny,146,146,0,1,0,1,0
63279,50955,445,0,0,drop,66,66,0,1,0,1,0
63280,65201,53,5294,53,allow,216,110,106,2,30,1,1
63281,62331,61689,0,0,deny,66,66,0,1,0,1,0
63282,55543,445,0,0,drop,70,70,0,1,0,1,0
63283,53233,51221,0,0,deny,66,66,0,1,0,1,0
63284,50492,445,0,0,drop,70,70,0,1,0,1,0
63285,50490,445,0,0,drop,70,70,0,1,0,1,0
63286,50485,445,0,0,drop,70,70,0,1,0,1,0
63287,50482,445,0,0,drop,70,70,0,1,0,1,0
63288,50481,445,0,0,drop,70,70,0,1,0,1,0
63289,38363,5900,0,0,deny,60,60,0,1,0,1,0
63290,50953,445,0,0,drop,66,66,0,1,0,1,0
63291,45912,44847,0,0,deny,62,62,0,1,0,1,0
63292,50945,445,0,0,drop,66,66,0,1,0,1,0
63293,56973,443,44291,443,allow,7481,2264,5217,22,135,10,12
63294,64869,443,59977,443,allow,6454,1227,5227,18,122,9,9
63295,52916,443,43880,443,allow,5455,1388,4067,17,15,9,8
63296,44633,443,21223,443,allow,5715,1536,4179,24,16,13,11
63297,50869,80,23647,80,allow,28291,3346,24945,46,144,25,21
63298,53540,34134,43313,34134,allow,70,70,0,2,7,2,0
63299,37987,49152,22842,49152,allow,156,156,0,3,7,3,0
63300,41995,80,63213,80,allow,1105,634,471,11,15,6,5
63301,52171,443,52171,443,allow,154883,8710,146173,182,23,69,113
63302,55535,53,24278,53,allow,199,102,97,2,29,1,1
63303,56322,53,19228,53,allow,209,110,99,2,29,1,1
63304,50008,53,33522,53,allow,193,102,91,2,29,1,1
63305,56615,443,6112,443,allow,22938,14436,8502,43,41,23,20
63306,47856,443,54908,443,allow,7816,2371,5445,34,255,18,16
63307,63734,28221,59198,28221,allow,66,66,0,2,7,2,0
63308,63732,40642,31051,40642,allow,66,66,0,2,7,2,0
63309,53536,34200,55904,34200,allow,70,70,0,2,7,2,0
63310,46641,8100,62793,8100,allow,234,234,0,4,11,4,0
63311,39953,80,18059,80,allow,1035,564,471,10,15,5,5
63312,48015,443,20608,443,allow,138,78,60,2,4,1,1
63313,55972,53,35969,53,allow,193,102,91,2,29,1,1
63314,55090,53,34414,53,allow,196,102,94,2,29,1,1
63315,55090,53,59676,53,allow,196,102,94,2,29,1,1
63316,56296,53,37666,53,allow,216,110,106,2,30,1,1
63317,53041,443,62358,443,allow,2881,346,2535,12,120,5,7
63318,17735,53,27345,53,allow,223,86,137,2,29,1,1
63319,64835,53,33008,53,allow,200,102,98,2,29,1,1
63320,56296,53,12716,53,allow,216,110,106,2,29,1,1
63321,57455,123,24910,123,allow,184,94,90,2,29,1,1
63322,55090,53,17815,53,allow,196,102,94,2,30,1,1
63323,56597,80,61984,80,allow,234,234,0,4,12,4,0
63324,51712,53203,62336,53203,allow,70,70,0,1,5,1,0
63325,51710,43069,28929,43069,allow,70,70,0,1,5,1,0
63326,53106,59478,22060,59478,allow,70,70,0,1,5,1,0
63327,49413,443,7382,443,allow,44505,6962,37543,64,48,21,43
63328,65114,53,28927,53,allow,196,102,94,2,30,1,1
63329,49173,27402,64212,27402,allow,70,70,0,1,5,1,0
63330,56764,45797,41990,45797,allow,164,70,94,2,5,1,1
63331,47975,443,46443,443,allow,8301,2172,6129,25,255,12,13
63332,60942,443,40230,443,allow,5081,896,4185,16,70,8,8
63333,65208,53,46888,53,allow,637,178,459,6,70,3,3
63334,56847,443,59529,443,allow,35160,6404,28756,82,196,31,51
63335,46550,443,33261,443,allow,7330,4420,2910,31,316,16,15
63336,34994,443,34994,443,allow,5046,2069,2977,20,15,11,9
63337,37234,53,61804,53,allow,168,78,90,2,30,1,1
63338,52176,443,52176,443,allow,126525,6370,120155,147,22,56,91
63339,50008,53,59037,53,allow,359,95,264,4,46,2,2
63340,63964,53,52901,53,allow,196,94,102,2,30,1,1
63341,57780,53,53500,53,allow,70,70,0,1,30,1,0
63342,6881,6881,26370,6881,allow,502,150,352,2,1200,1,1
63343,49542,443,62121,443,allow,40423,35897,4526,52,16,33,19
63344,65460,53,30831,53,allow,197,102,95,2,30,1,1
63345,53542,50321,25266,50321,allow,320,140,180,6,6,3,3
63346,56765,1841,2876,1841,allow,70,70,0,1,5,1,0
63347,45214,443,34615,443,allow,6641,4617,2024,34,80,18,16
63348,57470,34617,39417,34617,allow,481,150,331,2,1199,1,1
63349,39348,443,17067,443,allow,28301,21778,6523,88,125,49,39
63350,59683,443,22150,443,allow,13310,4422,8888,47,136,27,20
63351,57582,80,30299,80,allow,370,222,148,6,48,4,2
63352,60156,443,49389,443,allow,178,118,60,2,15,1,1
63353,50900,80,42676,80,allow,26867,2743,24124,45,140,23,22
63354,52088,443,13388,443,allow,16165,3877,12288,53,186,25,28
63355,50975,80,56708,80,allow,1095845,7641,1088204,839,35,114,725
63356,50976,80,46012,80,allow,1094127,5977,1088150,812,35,88,724
63357,37988,49152,27635,49152,allow,156,156,0,3,7,3,0
63358,27998,443,50249,443,allow,5515,1388,4127,18,15,9,9
63359,52917,443,10403,443,allow,5583,1390,4193,19,14,9,10
63360,56925,80,48459,80,allow,214,140,74,4,25,3,1
63361,50385,443,20761,443,allow,11098,2853,8245,25,33,12,13
63362,53715,443,45128,443,allow,70,70,0,2,8,2,0
63363,56680,8100,25887,8100,allow,234,234,0,4,11,4,0
63364,62729,51558,61898,51558,allow,70,70,0,1,4,1,0
63365,53517,48019,30847,48019,allow,70,70,0,1,4,1,0
63366,54964,443,18537,443,allow,24232,10141,14091,74,76,39,35
63367,50378,443,15906,443,allow,8663,1983,6680,21,33,10,11
63368,65176,53,64803,53,allow,299,103,196,4,51,2,2
63369,49660,53,23772,53,allow,193,102,91,2,30,1,1
63370,63945,53,51432,53,allow,216,110,106,2,29,1,1
63371,49450,53,27588,53,allow,227,94,133,2,29,1,1
63372,65127,53,53558,53,allow,194,102,92,2,29,1,1
63373,64416,53,53808,53,allow,211,94,117,2,30,1,1
63374,64414,53,58315,53,allow,406,142,264,2,30,1,1
63375,11582,41599,27860,41599,allow,70,70,0,2,8,2,0
63376,60715,80,28604,80,allow,198,78,120,4,11,2,2
63377,52485,443,22795,443,allow,22817,7615,15202,30,16,16,14
63378,56315,123,48493,123,allow,184,94,90,2,30,1,1
63379,43374,443,52439,443,allow,10176,2162,8014,25,186,14,11
63380,51713,33724,27696,33724,allow,70,70,0,1,5,1,0
63381,56756,13973,64423,13973,allow,70,70,0,1,5,1,0
63382,64614,53,61495,53,allow,538,179,359,6,63,3,3
63383,64289,53,50043,53,allow,199,102,97,2,30,1,1
63384,58984,443,13660,443,allow,4874459,114404,4760055,4469,188,1112,3357
63385,64289,53,28932,53,allow,199,102,97,2,30,1,1
63386,65201,53,42204,53,allow,216,110,106,2,30,1,1
63387,64289,53,64357,53,allow,199,102,97,2,30,1,1
63388,56536,443,9088,443,allow,8866,2743,6123,23,139,11,12
63389,51711,1027,5156,1027,allow,70,70,0,1,5,1,0
63390,52848,443,15385,443,allow,6218,1239,4979,14,133,7,7
63391,56926,80,46037,80,allow,214,140,74,4,25,3,1
63392,49820,123,49820,123,allow,184,94,90,2,30,1,1
63393,65460,53,40464,53,allow,197,102,95,2,30,1,1
63394,65201,53,38349,53,allow,216,110,106,2,30,1,1
63395,61178,53,58018,53,allow,290,86,204,2,30,1,1
63396,49222,53,61468,53,allow,418,150,268,2,30,1,1
63397,48555,53,5829,53,allow,215,86,129,2,30,1,1
63398,65114,53,27541,53,allow,196,102,94,2,31,1,1
63399,57947,443,51760,443,allow,3282,781,2501,17,136,8,9
63400,54631,443,52521,443,allow,2352,1394,958,17,275,9,8
63401,51077,80,9544,80,allow,9133,1055,8078,17,151,8,9
63402,6881,7560,34838,7560,allow,509,150,359,2,1199,1,1
63403,51610,443,19441,443,allow,6952,3608,3344,27,21,14,13
63404,60379,34301,5453,34301,allow,320,140,180,6,7,3,3
63405,58701,27030,51697,27030,allow,70,70,0,2,9,2,0
63406,42157,443,25655,443,allow,4819,2903,1916,29,81,15,14
63407,49660,53,56463,53,allow,193,102,91,2,31,1,1
63408,65515,53,22832,53,allow,338,107,231,4,39,2,2
63409,60318,80,34962,80,allow,2714,2154,560,12,26,7,5
63410,61382,443,28176,443,allow,32082,12801,19281,62,150,25,37
63411,42922,80,41285,80,allow,234,234,0,4,12,4,0
63412,49701,443,31912,443,allow,13022,1500,11522,30,23,15,15
63413,3964,51505,0,0,deny,62,62,0,1,0,1,0
63414,50939,445,0,0,drop,66,66,0,1,0,1,0
63415,50470,445,0,0,drop,70,70,0,1,0,1,0
63416,59196,34962,0,0,deny,148,148,0,1,0,1,0
63417,443,39878,0,0,deny,74,74,0,1,0,1,0
63418,49680,26467,0,0,deny,146,146,0,1,0,1,0
63419,443,32698,0,0,deny,89,89,0,1,0,1,0
63420,11020,62413,0,0,deny,62,62,0,1,0,1,0
63421,11967,57470,0,0,deny,62,62,0,1,0,1,0
63422,53030,56205,0,0,deny,66,66,0,1,0,1,0
63423,13947,37965,0,0,deny,145,145,0,1,0,1,0
63424,55536,445,0,0,drop,70,70,0,1,0,1,0
63425,55532,445,0,0,drop,70,70,0,1,0,1,0
63426,55531,445,0,0,drop,70,70,0,1,0,1,0
63427,50926,445,0,0,drop,66,66,0,1,0,1,0
63428,50928,445,0,0,drop,66,66,0,1,0,1,0
63429,50929,445,0,0,drop,66,66,0,1,0,1,0
63430,50925,445,0,0,drop,66,66,0,1,0,1,0
63431,4607,6004,0,0,deny,70,70,0,1,0,1,0
63432,50927,445,0,0,drop,66,66,0,1,0,1,0
63433,50930,445,0,0,drop,66,66,0,1,0,1,0
63434,50924,445,0,0,drop,66,66,0,1,0,1,0
63435,50923,445,0,0,drop,66,66,0,1,0,1,0
63436,50466,445,0,0,drop,70,70,0,1,0,1,0
63437,64166,35440,0,0,deny,66,66,0,1,0,1,0
63438,47013,37965,0,0,deny,62,62,0,1,0,1,0
63439,51953,37965,0,0,deny,66,66,0,1,0,1,0
63440,50457,445,0,0,drop,70,70,0,1,0,1,0
63441,50455,445,0,0,drop,70,70,0,1,0,1,0
63442,50453,445,0,0,drop,70,70,0,1,0,1,0
63443,50454,445,0,0,drop,70,70,0,1,0,1,0
63444,61845,11392,0,0,deny,66,66,0,1,0,1,0
63445,50449,445,0,0,drop,70,70,0,1,0,1,0
63446,37234,44847,0,0,deny,66,66,0,1,0,1,0
63447,38041,10104,0,0,deny,146,146,0,1,0,1,0
63448,21294,57470,0,0,deny,62,62,0,1,0,1,0
63449,38664,37965,0,0,deny,145,145,0,1,0,1,0
63450,55523,445,0,0,drop,70,70,0,1,0,1,0
63451,55520,445,0,0,drop,70,70,0,1,0,1,0
63452,55516,445,0,0,drop,70,70,0,1,0,1,0
63453,41852,35440,0,0,deny,62,62,0,1,0,1,0
63454,49717,666,0,0,deny,60,60,0,1,0,1,0
63455,51413,1,0,0,deny,72,72,0,1,0,1,0
63456,30303,30303,0,0,deny,171,171,0,1,0,1,0
63457,14993,50584,0,0,deny,62,62,0,1,0,1,0
63458,50910,445,0,0,drop,66,66,0,1,0,1,0
63459,50908,445,0,0,drop,66,66,0,1,0,1,0
63460,50907,445,0,0,drop,66,66,0,1,0,1,0
63461,2904,44847,0,0,deny,78,78,0,1,0,1,0
63462,53869,56205,0,0,deny,62,62,0,1,0,1,0
63463,55514,445,0,0,drop,70,70,0,1,0,1,0
63464,30399,44847,0,0,deny,146,146,0,1,0,1,0
63465,50444,445,0,0,drop,70,70,0,1,0,1,0
63466,58715,57470,0,0,deny,66,66,0,1,0,1,0
63467,55511,445,0,0,drop,70,70,0,1,0,1,0
63468,55504,445,0,0,drop,70,70,0,1,0,1,0
63469,55502,445,0,0,drop,70,70,0,1,0,1,0
63470,55500,445,0,0,drop,70,70,0,1,0,1,0
63471,58486,57470,0,0,deny,66,66,0,1,0,1,0
63472,50436,445,0,0,drop,70,70,0,1,0,1,0
63473,50971,443,37029,443,allow,469,403,66,4,0,3,1
63474,50970,443,47824,443,allow,469,403,66,4,0,3,1
63475,14613,12446,0,0,deny,66,66,0,1,0,1,0
63476,12694,12446,0,0,deny,62,62,0,1,0,1,0
63477,50433,445,0,0,drop,70,70,0,1,0,1,0
63478,6881,6881,0,0,deny,146,146,0,1,0,1,0
63479,6057,51221,0,0,deny,78,78,0,1,0,1,0
63480,18085,26467,0,0,deny,66,66,0,1,0,1,0
63481,8239,37965,0,0,deny,146,146,0,1,0,1,0
63482,33405,37965,0,0,deny,62,62,0,1,0,1,0
63483,50140,44847,0,0,deny,62,62,0,1,0,1,0
63484,53796,17546,0,0,deny,62,62,0,1,0,1,0
63485,50429,445,0,0,drop,70,70,0,1,0,1,0
63486,37316,22114,0,0,deny,62,62,0,1,0,1,0
63487,50428,445,0,0,drop,70,70,0,1,0,1,0
63488,55491,445,0,0,drop,70,70,0,1,0,1,0
63489,55489,445,0,0,drop,70,70,0,1,0,1,0
63490,55487,445,0,0,drop,70,70,0,1,0,1,0
63491,45908,3383,0,0,deny,60,60,0,1,0,1,0
63492,60617,64147,0,0,deny,62,62,0,1,0,1,0
63493,50424,445,0,0,drop,70,70,0,1,0,1,0
63494,61600,56205,0,0,deny,66,66,0,1,0,1,0
63495,50052,65008,0,0,deny,60,60,0,1,0,1,0
63496,50423,445,0,0,drop,70,70,0,1,0,1,0
63497,50886,445,0,0,drop,66,66,0,1,0,1,0
63498,56103,21247,0,0,deny,66,66,0,1,0,1,0
63499,57434,50584,0,0,deny,62,62,0,1,0,1,0
63500,55485,445,0,0,drop,70,70,0,1,0,1,0
63501,55483,445,0,0,drop,70,70,0,1,0,1,0
63502,54826,56205,0,0,deny,66,66,0,1,0,1,0
63503,40611,9571,0,0,deny,72,72,0,1,0,1,0
63504,51514,50584,0,0,deny,62,62,0,1,0,1,0
63505,50418,445,0,0,drop,70,70,0,1,0,1,0
63506,32124,30188,0,0,deny,62,62,0,1,0,1,0
63507,50853,50584,0,0,deny,66,66,0,1,0,1,0
63508,2791,7302,0,0,deny,62,62,0,1,0,1,0
63509,50881,445,0,0,drop,66,66,0,1,0,1,0
63510,1027,9822,0,0,deny,146,146,0,1,0,1,0
63511,50878,445,0,0,drop,66,66,0,1,0,1,0
63512,53771,37965,0,0,deny,66,66,0,1,0,1,0
63513,55471,445,0,0,drop,70,70,0,1,0,1,0
63514,55466,445,0,0,drop,70,70,0,1,0,1,0
63515,55467,445,0,0,drop,70,70,0,1,0,1,0
63516,55463,445,0,0,drop,70,70,0,1,0,1,0
63517,54346,44847,0,0,deny,66,66,0,1,0,1,0
63518,50875,445,0,0,drop,66,66,0,1,0,1,0
63519,45766,2323,0,0,deny,60,60,0,1,0,1,0
63520,58876,57470,0,0,deny,66,66,0,1,0,1,0
63521,24351,57470,0,0,deny,62,62,0,1,0,1,0
63522,18592,44612,0,0,deny,62,62,0,1,0,1,0
63523,6909,57470,0,0,deny,62,62,0,1,0,1,0
63524,50405,445,0,0,drop,70,70,0,1,0,1,0
63525,55458,445,0,0,drop,70,70,0,1,0,1,0
63526,2704,37,0,0,deny,60,60,0,1,0,1,0
63527,57226,51505,0,0,deny,66,66,0,1,0,1,0
63528,63287,44847,0,0,deny,62,62,0,1,0,1,0
63529,50402,445,0,0,drop,70,70,0,1,0,1,0
63530,56411,50584,0,0,deny,62,62,0,1,0,1,0
63531,55456,445,0,0,drop,70,70,0,1,0,1,0
63532,55454,445,0,0,drop,70,70,0,1,0,1,0
63533,55453,445,0,0,drop,70,70,0,1,0,1,0
63534,1036,64147,0,0,deny,62,62,0,1,0,1,0
63535,50868,445,0,0,drop,66,66,0,1,0,1,0
63536,25973,26467,0,0,deny,66,66,0,1,0,1,0
63537,50865,445,0,0,drop,66,66,0,1,0,1,0
63538,50863,445,0,0,drop,66,66,0,1,0,1,0
63539,50861,445,0,0,drop,66,66,0,1,0,1,0
63540,50856,445,0,0,drop,66,66,0,1,0,1,0
63541,50859,445,0,0,drop,66,66,0,1,0,1,0
63542,50858,445,0,0,drop,66,66,0,1,0,1,0
63543,63786,35440,0,0,deny,66,66,0,1,0,1,0
63544,62569,44847,0,0,deny,66,66,0,1,0,1,0
63545,58238,23,0,0,deny,60,60,0,1,0,1,0
63546,50397,445,0,0,drop,70,70,0,1,0,1,0
63547,35657,48637,0,0,deny,145,145,0,1,0,1,0
63548,50396,445,0,0,drop,70,70,0,1,0,1,0
63549,50200,44847,0,0,deny,74,74,0,1,0,1,0
63550,55450,445,0,0,drop,70,70,0,1,0,1,0
63551,55448,445,0,0,drop,70,70,0,1,0,1,0
63552,55446,445,0,0,drop,70,70,0,1,0,1,0
63553,50394,445,0,0,drop,70,70,0,1,0,1,0
63554,50854,445,0,0,drop,66,66,0,1,0,1,0
63555,52034,26467,0,0,deny,62,62,0,1,0,1,0
63556,55443,445,0,0,drop,70,70,0,1,0,1,0
63557,56783,43890,0,0,deny,66,66,0,1,0,1,0
63558,15274,19473,0,0,deny,62,62,0,1,0,1,0
63559,54540,22,0,0,deny,60,60,0,1,0,1,0
63560,50850,445,0,0,drop,66,66,0,1,0,1,0
63561,50971,44847,0,0,deny,62,62,0,1,0,1,0
63562,58916,21247,0,0,deny,146,146,0,1,0,1,0
63563,50849,445,0,0,drop,66,66,0,1,0,1,0
63564,50848,445,0,0,drop,66,66,0,1,0,1,0
63565,50584,51748,57588,51748,allow,1356,300,1056,6,1200,3,3
63566,56526,80,57143,80,allow,1056,682,374,10,15,6,4
63567,57149,443,55393,443,allow,1647,1375,272,9,37,5,4
63568,60069,443,60069,443,allow,5610,2363,3247,22,40,13,9
63569,60323,443,19514,443,allow,1743,1164,579,16,25,10,6
63570,60324,443,7520,443,allow,1743,1164,579,16,25,10,6
63571,62238,443,62238,443,allow,58141,3051,55090,78,78,29,49
63572,51648,80,61615,80,allow,3227,2425,802,9,31,5,4
63573,63383,53,63383,53,allow,235,90,145,2,33,1,1
63574,2267,53,19148,53,allow,826,826,0,8,44,8,0
63575,38085,443,21750,443,allow,234,234,0,4,12,4,0
63576,49573,80,24541,80,allow,180917,5183,175734,175,65,49,126
63577,51730,33399,62466,33399,allow,70,70,0,2,8,2,0
63578,64565,443,57848,443,allow,24984,2042,22942,41,33,19,22
63579,49579,80,10648,80,allow,277736,7810,269926,277,65,91,186
63580,49577,80,46203,80,allow,147113,4021,143092,144,65,41,103
63581,60321,443,49674,443,allow,1743,1164,579,16,25,10,6
63582,50047,443,50047,443,allow,4534,1627,2907,19,27,11,8
63583,56014,443,56014,443,allow,4334,1427,2907,19,30,11,8
63584,60320,443,16711,443,allow,1743,1164,579,16,25,10,6
63585,51704,9266,12391,9266,allow,66,66,0,1,5,1,0
63586,61692,443,18049,443,allow,126,60,66,3,10,2,1
63587,51727,1024,33037,1024,allow,70,70,0,2,8,2,0
63588,51705,59244,12307,59244,allow,66,66,0,1,5,1,0
63589,62235,443,62235,443,allow,16675,2296,14379,37,78,17,20
63590,63102,443,30669,443,allow,8848,3081,5767,56,335,26,30
63591,60832,5222,60932,5222,allow,3848,1039,2809,37,662,11,26
63592,56465,443,52483,443,allow,6081,844,5237,17,15,9,8
63593,63976,53,34685,53,allow,200,102,98,2,30,1,1
63594,5588,5588,0,0,allow,3562,1936,1626,48,194,24,24
63595,57256,443,52300,443,allow,47762,39522,8240,77,332,43,34
63596,50121,443,24047,443,allow,307104860,2750998,304353862,234597,6122,15017,219580
63597,56177,443,61837,443,allow,6826,5299,1527,22,330,12,10
63598,50060,80,8335,80,allow,2425,529,1896,11,75,6,5
63599,60322,443,12700,443,allow,1743,1164,579,16,25,10,6
63600,22419,1433,22419,1433,allow,146,60,86,2,9,1,1
63601,49576,80,6202,80,allow,174140,4942,169198,166,65,47,119
63602,30960,45656,54549,45656,allow,66,66,0,1,3600,1,0
63603,48817,6889,48817,6889,allow,480,149,331,2,1200,1,1
63604,50584,6881,63450,6881,allow,1320,300,1020,6,1200,3,3
63605,50584,62833,22282,62833,allow,1275,300,975,6,1200,3,3
63606,56597,53,9477,53,allow,197,197,0,3,60,3,0
63607,62102,443,60782,443,allow,3182,1568,1614,8,121,4,4
63608,50584,54321,2526,54321,allow,1275,300,975,6,1200,3,3
63609,50584,30773,22058,30773,allow,1356,300,1056,6,1200,3,3
63610,50584,45270,4666,45270,allow,1377,300,1077,6,1200,3,3
63611,30960,45665,23931,45665,allow,462,462,0,8,3632,8,0
63612,50845,445,0,0,drop,66,66,0,1,0,1,0
63613,51062,1433,0,0,deny,60,60,0,1,0,1,0
63614,57750,37965,0,0,deny,62,62,0,1,0,1,0
63615,50387,445,0,0,drop,70,70,0,1,0,1,0
63616,55440,445,0,0,drop,70,70,0,1,0,1,0
63617,50385,445,0,0,drop,70,70,0,1,0,1,0
63618,50102,17546,0,0,deny,66,66,0,1,0,1,0
63619,55432,445,0,0,drop,70,70,0,1,0,1,0
63620,55428,445,0,0,drop,70,70,0,1,0,1,0
63621,50384,445,0,0,drop,70,70,0,1,0,1,0
63622,443,25740,0,0,deny,131,131,0,1,0,1,0
63623,50383,445,0,0,drop,70,70,0,1,0,1,0
63624,27889,32480,0,0,deny,100,100,0,1,0,1,0
63625,50382,445,0,0,drop,70,70,0,1,0,1,0
63626,60192,35440,0,0,deny,62,62,0,1,0,1,0
63627,50378,445,0,0,drop,70,70,0,1,0,1,0
63628,50377,445,0,0,drop,70,70,0,1,0,1,0
63629,50837,445,0,0,drop,66,66,0,1,0,1,0
63630,443,10010,0,0,deny,60,60,0,1,0,1,0
63631,44258,25,0,0,deny,74,74,0,1,0,1,0
63632,45941,23386,0,0,deny,60,60,0,1,0,1,0
63633,6881,26296,0,0,deny,157,157,0,1,0,1,0
63634,59371,22114,0,0,deny,62,62,0,1,0,1,0
63635,11842,35440,0,0,deny,66,66,0,1,0,1,0
63636,50362,445,0,0,drop,70,70,0,1,0,1,0
63637,50361,445,0,0,drop,70,70,0,1,0,1,0
63638,50359,445,0,0,drop,70,70,0,1,0,1,0
63639,50827,445,0,0,drop,66,66,0,1,0,1,0
63640,58912,11392,0,0,deny,66,66,0,1,0,1,0
63641,55415,445,0,0,drop,70,70,0,1,0,1,0
63642,50351,445,0,0,drop,70,70,0,1,0,1,0
63643,50210,26467,0,0,deny,62,62,0,1,0,1,0
63644,5223,44091,0,0,deny,66,66,0,1,0,1,0
63645,58597,35440,0,0,deny,66,66,0,1,0,1,0
63646,61173,2323,0,0,deny,60,60,0,1,0,1,0
63647,50824,445,0,0,drop,66,66,0,1,0,1,0
63648,47398,7302,0,0,deny,62,62,0,1,0,1,0
63649,39839,67,0,0,deny,60,60,0,1,0,1,0
63650,43271,50584,0,0,deny,62,62,0,1,0,1,0
63651,17702,6881,0,0,deny,66,66,0,1,0,1,0
63652,27328,21247,0,0,deny,66,66,0,1,0,1,0
63653,60292,7129,0,0,deny,62,62,0,1,0,1,0
63654,43840,50265,0,0,deny,72,72,0,1,0,1,0
63655,62092,35440,0,0,deny,66,66,0,1,0,1,0
63656,54071,50265,0,0,deny,66,66,0,1,0,1,0
63657,64106,64147,0,0,deny,66,66,0,1,0,1,0
63658,50818,445,0,0,drop,66,66,0,1,0,1,0
63659,50340,445,0,0,drop,70,70,0,1,0,1,0
63660,50807,445,0,0,drop,66,66,0,1,0,1,0
63661,50336,445,0,0,drop,70,70,0,1,0,1,0
63662,55407,445,0,0,drop,70,70,0,1,0,1,0
63663,55403,445,0,0,drop,70,70,0,1,0,1,0
63664,55404,445,0,0,drop,70,70,0,1,0,1,0
63665,53472,17,0,0,deny,60,60,0,1,0,1,0
63666,59969,443,49407,443,allow,6655,1166,5489,21,360,11,10
63667,45001,443,55898,443,allow,570,318,252,10,20,6,4
63668,50584,6889,64241,6889,allow,1326,300,1026,6,1200,3,3
63669,50584,28020,62483,28020,allow,1302,300,1002,6,1200,3,3
63670,50584,54993,58004,54993,allow,652,300,352,4,1200,3,1
63671,58248,53,0,0,allow,633,83,550,2,30,1,1
63672,50880,80,36202,80,allow,395978,13168,382810,411,143,151,260
63673,59779,443,2318,443,allow,5834,1810,4024,24,17,13,11
63674,50535,22,50535,22,allow,6292,2375,3917,35,20,19,16
63675,57594,443,55656,443,allow,614577,24675,589902,673,149,228,445
63676,51737,54691,48488,54691,allow,316,136,180,6,5,3,3
63677,65476,53,44080,53,allow,226,110,116,2,29,1,1
63678,65304,53,52702,53,allow,194,86,108,2,29,1,1
63679,50056,27018,43222,27018,allow,468,390,78,5,29,4,1
63680,62678,53,62678,53,allow,216,90,126,2,30,1,1
63681,50584,51413,45972,51413,allow,1275,300,975,6,1200,3,3
63682,59162,80,16258,80,allow,1031,314,717,13,175,3,10
63683,65176,53,35354,53,allow,511,195,316,6,56,3,3
63684,42500,443,20918,443,allow,8932,2039,6893,23,24,12,11
63685,49885,443,30250,443,allow,4626083,113708,4512375,4382,213,1198,3184
63686,43210,443,51289,443,allow,5960402,99613,5860789,5017,133,952,4065
63687,52314,443,46456,443,allow,3448,1612,1836,31,36,17,14
63688,35498,80,39354,80,allow,1270,387,883,16,392,4,12
63689,49608,80,59432,80,allow,145752,3240,142512,128,61,23,105
63690,62237,443,62237,443,allow,169315,5255,164060,190,77,66,124
63691,60742,20010,63644,20010,allow,70,70,0,2,8,2,0
63692,51729,63553,13105,63553,allow,70,70,0,2,8,2,0
63693,63106,443,7897,443,allow,8712,3748,4964,51,255,23,28
63694,49577,53,54563,53,allow,384,94,290,2,30,1,1
63695,49703,80,27292,80,allow,71256,962,70294,63,52,11,52
63696,49700,80,44971,80,allow,71320,1026,70294,64,52,12,52
63697,49702,80,5138,80,allow,71256,962,70294,63,52,11,52
63698,60961,443,5669,443,allow,75122,4244,70878,101,45,48,53
63699,60239,53,53135,53,allow,219,102,117,2,30,1,1
63700,55610,53,9648,53,allow,265,91,174,4,36,2,2
63701,57170,53,13134,53,allow,298,102,196,4,36,2,2
63702,60777,443,22998,443,allow,10417,2617,7800,32,15,17,15
63703,50618,443,50618,443,allow,4351,1444,2907,19,28,11,8
63704,54810,80,61461,80,allow,6098,1916,4182,31,357,16,15
63705,60959,443,46440,443,allow,17149,2543,14606,40,46,22,18
63706,49634,443,7107,443,allow,1575,988,587,13,35,7,6
63707,50318,80,21534,80,allow,3855,828,3027,11,15,5,6
63708,60960,443,48167,443,allow,7488,1552,5936,23,46,13,10
63709,49359,53,57768,53,allow,102,102,0,1,60,1,0
63710,58248,53,0,0,allow,186,83,103,2,30,1,1
63711,60989,443,62484,443,allow,3182,1568,1614,8,120,4,4
63712,57798,443,21508,443,allow,12877,5188,7689,27,130,12,15
63713,65005,53,2818,53,allow,239,94,145,2,30,1,1
63714,50584,54741,14563,54741,allow,868,150,718,4,1200,2,2
63715,50584,15926,55734,15926,allow,1377,300,1077,6,1200,3,3
63716,49711,80,42345,80,allow,2269,821,1448,15,51,8,7
63717,49701,80,63516,80,allow,70321,956,69365,62,52,11,51
63718,62236,443,62236,443,allow,28126,3114,25012,50,77,22,28
63719,51708,21278,38128,21278,allow,70,70,0,1,5,1,0
63720,55581,64301,29198,64301,allow,316,190,126,5,15,3,2
63721,65008,53,8162,53,allow,312,94,218,2,30,1,1
63722,57266,53,22077,53,allow,209,102,107,2,30,1,1
63723,2267,53,3037,53,allow,826,826,0,8,44,8,0
63724,49891,443,20308,443,allow,1820,1101,719,18,73,10,8
63725,51571,443,51571,443,allow,1724,916,808,17,128,7,10
63726,52315,443,14653,443,allow,24304,2974,21330,57,34,31,26
63727,49609,80,24955,80,allow,11534,719,10815,18,61,7,11
63728,51572,443,51572,443,allow,1724,916,808,17,128,7,10
63729,53188,443,8819,443,allow,7878,3197,4681,22,18,11,11
63730,56009,53,4440,53,allow,232,94,138,2,30,1,1
63731,50584,25935,2865,25935,allow,1377,300,1077,6,1200,3,3
63732,50584,55624,58737,55624,allow,1326,300,1026,6,1200,3,3
63733,44847,6881,3655,6881,allow,324,150,174,2,1201,1,1
63734,50584,51413,47261,51413,allow,1275,300,975,6,1200,3,3
63735,55104,443,37071,443,allow,10470,3626,6844,20,131,9,11
63736,55385,443,7012,443,allow,11771,2624,9147,50,20,25,25
63737,44586,443,61467,443,allow,122708,5797,116911,169,132,75,94
63738,55036,443,41925,443,allow,10001,2547,7454,27,35,14,13
63739,50929,80,17624,80,allow,9630744,98097,9532647,7804,123,1387,6417
63740,60319,80,61391,80,allow,194,128,66,4,25,3,1
63741,52177,443,52177,443,allow,38013,6855,31158,58,21,25,33
63742,62233,443,62233,443,allow,41941,3388,38553,67,77,26,41
63743,63976,53,54161,53,allow,200,102,98,2,33,1,1
63744,51703,3010,58034,3010,allow,70,70,0,1,5,1,0
63745,56463,443,48725,443,allow,6364,1147,5217,19,24,11,8
63746,49892,443,65121,443,allow,1820,1101,719,18,73,10,8
63747,64584,80,64584,80,allow,142674,8057,134617,192,27,94,98
63748,65176,53,60246,53,allow,299,103,196,4,53,2,2
63749,49698,80,3522,80,allow,140258,1720,138538,117,52,18,99
63750,24009,53,46041,53,allow,223,86,137,2,29,1,1
63751,61669,443,27122,443,allow,12453,3460,8993,43,18,24,19
63752,49660,53,59057,53,allow,193,102,91,2,29,1,1
63753,53392,53,53392,53,allow,832,106,726,2,30,1,1
63754,65073,53,55415,53,allow,325,102,223,2,29,1,1
63755,65114,53,15041,53,allow,196,102,94,2,29,1,1
63756,7060,53,45870,53,allow,197,94,103,2,30,1,1
63757,58409,53,57147,53,allow,307,86,221,2,30,1,1
63758,56459,53,55165,53,allow,392,86,306,2,30,1,1
63759,49412,443,56019,443,allow,46271,6834,39437,63,47,19,44
63760,27393,53,7301,53,allow,168,78,90,2,30,1,1
63761,55330,53,4334,53,allow,216,102,114,2,30,1,1
63762,50584,56112,8598,56112,allow,1377,300,1077,6,1200,3,3
63763,50584,61467,32483,61467,allow,1377,300,1077,6,1200,3,3
63764,50584,11888,51615,11888,allow,1356,300,1056,6,1200,3,3
63765,59970,443,18481,443,allow,6720,1166,5554,22,360,11,11
63766,50584,40420,46560,40420,allow,868,150,718,4,1200,2,2
63767,50584,8999,18180,8999,allow,1356,300,1056,6,1200,3,3
63768,50584,49376,27285,49376,allow,1320,300,1020,6,1200,3,3
63769,50584,54157,4800,54157,allow,1377,300,1077,6,1200,3,3
63770,50584,6889,7914,6889,allow,1326,300,1026,6,1200,3,3
63771,13971,53,13971,53,allow,220,90,130,2,30,1,1
63772,63976,53,50670,53,allow,200,102,98,2,30,1,1
63773,49538,53,56684,53,allow,258,102,156,2,30,1,1
63774,50584,21094,39450,21094,allow,1356,300,1056,6,1200,3,3
63775,63542,3389,63542,3389,allow,3504,1790,1714,17,32,9,8
63776,54525,80,24122,80,allow,50436663,1205750,49230913,49415,198,16827,32588
63777,51725,32787,39792,32787,allow,70,70,0,2,8,2,0
63778,51706,30673,17118,30673,allow,70,70,0,1,5,1,0
63779,49630,443,54596,443,allow,7776,2266,5510,17,35,9,8
63780,65278,53,45335,53,allow,264,110,154,2,30,1,1
63781,58828,53,32002,53,allow,215,102,113,2,30,1,1
63782,50584,38578,41911,38578,allow,1377,300,1077,6,1200,3,3
63783,50584,16455,26852,16455,allow,1356,300,1056,6,1200,3,3
63784,55584,34914,32488,34914,allow,504,318,186,8,15,5,3
63785,43817,53,0,0,allow,82,82,0,2,40,2,0
63786,49688,443,44354,443,allow,318,192,126,6,53,4,2
63787,63718,80,18056,80,allow,314,192,122,6,15,4,2
63788,64038,53,4227,53,allow,321,102,219,2,30,1,1
63789,58562,53,31864,53,allow,215,102,113,2,30,1,1
63790,41267,443,45130,443,allow,8248,876,7372,25,186,9,16
63791,50584,51413,31560,51413,allow,800,150,650,4,1200,2,2
63792,50584,49001,36650,49001,allow,1290,300,990,6,1200,3,3
63793,50584,47174,17468,47174,allow,300,300,0,3,1200,3,0
63794,55877,62071,53667,62071,allow,481,150,331,2,1200,1,1
63795,53936,443,5510,443,allow,886,70,816,14,166,2,12
63796,49782,80,13908,80,allow,1661,1147,514,9,210,5,4
63797,50584,8569,42866,8569,allow,1356,300,1056,6,1200,3,3
63798,50584,6889,50435,6889,allow,1326,300,1026,6,1200,3,3
63799,6881,666,16595,666,allow,268,150,118,2,1199,1,1
63800,19987,53,54747,53,allow,208,86,122,2,30,1,1
63801,64745,53,11106,53,allow,196,94,102,2,31,1,1
63802,38770,5228,21583,5228,allow,6033,1874,4159,33,4073,11,22
63803,46999,993,56009,993,allow,45153,20621,24532,323,43,165,158
63804,50939,80,16478,80,allow,1375,1038,337,7,137,4,3
63805,54366,443,39148,443,allow,17629,5828,11801,39,41,20,19
63806,50933,80,44380,80,allow,9932735,85391,9847344,7875,123,1237,6638
63807,64602,80,64602,80,allow,18594,5204,13390,42,26,25,17
63808,52482,443,8869,443,allow,26154,6874,19280,35,17,16,19
63809,36716,53,54815,53,allow,224,78,146,2,31,1,1
63810,50796,445,0,0,drop,66,66,0,1,0,1,0
63811,50802,445,0,0,drop,66,66,0,1,0,1,0
63812,50800,445,0,0,drop,66,66,0,1,0,1,0
63813,50795,445,0,0,drop,66,66,0,1,0,1,0
63814,50798,445,0,0,drop,66,66,0,1,0,1,0
63815,50799,445,0,0,drop,66,66,0,1,0,1,0
63816,50797,445,0,0,drop,66,66,0,1,0,1,0
63817,50794,445,0,0,drop,66,66,0,1,0,1,0
63818,27125,51221,0,0,deny,62,62,0,1,0,1,0
63819,51535,64147,0,0,deny,66,66,0,1,0,1,0
63820,59477,36829,0,0,deny,66,66,0,1,0,1,0
63821,50327,445,0,0,drop,70,70,0,1,0,1,0
63822,50325,445,0,0,drop,70,70,0,1,0,1,0
63823,50322,445,0,0,drop,70,70,0,1,0,1,0
63824,50321,445,0,0,drop,70,70,0,1,0,1,0
63825,55704,64097,0,0,deny,66,66,0,1,0,1,0
63826,58338,3369,0,0,deny,60,60,0,1,0,1,0
63827,50319,445,0,0,drop,70,70,0,1,0,1,0
63828,50113,51505,0,0,deny,66,66,0,1,0,1,0
63829,19394,44847,0,0,deny,66,66,0,1,0,1,0
63830,35718,20238,0,0,deny,62,62,0,1,0,1,0
63831,55397,445,0,0,drop,70,70,0,1,0,1,0
63832,55394,445,0,0,drop,70,70,0,1,0,1,0
63833,55387,445,0,0,drop,70,70,0,1,0,1,0
63834,64767,51221,0,0,deny,62,62,0,1,0,1,0
63835,62787,51221,0,0,deny,66,66,0,1,0,1,0
63836,37538,37965,0,0,deny,66,66,0,1,0,1,0
63837,35377,43890,0,0,deny,62,62,0,1,0,1,0
63838,50780,445,0,0,drop,66,66,0,1,0,1,0
63839,50782,445,0,0,drop,66,66,0,1,0,1,0
63840,50779,445,0,0,drop,66,66,0,1,0,1,0
63841,55663,44847,0,0,deny,62,62,0,1,0,1,0
63842,50313,445,0,0,drop,70,70,0,1,0,1,0
63843,20706,37965,0,0,deny,62,62,0,1,0,1,0
63844,50626,43890,0,0,deny,62,62,0,1,0,1,0
63845,42969,8146,0,0,deny,62,62,0,1,0,1,0
63846,19963,2767,0,0,deny,66,66,0,1,0,1,0
63847,55386,445,0,0,drop,70,70,0,1,0,1,0
63848,51973,44847,0,0,deny,66,66,0,1,0,1,0
63849,62663,35253,0,0,deny,66,66,0,1,0,1,0
63850,55383,445,0,0,drop,70,70,0,1,0,1,0
63851,55377,445,0,0,drop,70,70,0,1,0,1,0
63852,55375,445,0,0,drop,70,70,0,1,0,1,0
63853,55373,445,0,0,drop,70,70,0,1,0,1,0
63854,50306,445,0,0,drop,70,70,0,1,0,1,0
63855,50304,445,0,0,drop,70,70,0,1,0,1,0
63856,6057,51221,0,0,deny,78,78,0,1,0,1,0
63857,64059,30188,0,0,deny,62,62,0,1,0,1,0
63858,58014,39004,0,0,deny,62,62,0,1,0,1,0
63859,12668,42707,0,0,deny,62,62,0,1,0,1,0
63860,9520,32480,0,0,deny,62,62,0,1,0,1,0
63861,50299,445,0,0,drop,70,70,0,1,0,1,0
63862,50298,445,0,0,drop,70,70,0,1,0,1,0
63863,59374,51505,0,0,deny,62,62,0,1,0,1,0
63864,55364,445,0,0,drop,70,70,0,1,0,1,0
63865,55360,445,0,0,drop,70,70,0,1,0,1,0
63866,55359,445,0,0,drop,70,70,0,1,0,1,0
63867,50294,445,0,0,drop,70,70,0,1,0,1,0
63868,60894,50584,0,0,deny,66,66,0,1,0,1,0
63869,11136,57587,0,0,deny,145,145,0,1,0,1,0
63870,17760,50584,0,0,deny,62,62,0,1,0,1,0
63871,60092,51505,0,0,deny,62,62,0,1,0,1,0
63872,50293,445,0,0,drop,70,70,0,1,0,1,0
63873,50840,57470,0,0,deny,66,66,0,1,0,1,0
63874,11825,38338,0,0,deny,86,86,0,1,0,1,0
63875,58036,443,0,0,deny,1097,1097,0,1,0,1,0
63876,0,0,0,0,allow,134,64,70,2,0,1,1
63877,64191,44847,0,0,deny,66,66,0,1,0,1,0
63878,443,50755,0,0,deny,102,102,0,1,0,1,0
63879,1256,50584,0,0,deny,146,146,0,1,0,1,0
63880,443,10010,0,0,deny,60,60,0,1,0,1,0
63881,3407,57866,0,0,deny,66,66,0,1,0,1,0
63882,50759,445,0,0,drop,66,66,0,1,0,1,0
63883,5195,64147,0,0,deny,66,66,0,1,0,1,0
63884,63503,42707,0,0,deny,66,66,0,1,0,1,0
63885,55358,445,0,0,drop,70,70,0,1,0,1,0
63886,55357,445,0,0,drop,70,70,0,1,0,1,0
63887,50288,445,0,0,drop,70,70,0,1,0,1,0
63888,56216,50584,0,0,deny,62,62,0,1,0,1,0
63889,50753,445,0,0,drop,66,66,0,1,0,1,0
63890,26795,6881,0,0,deny,146,146,0,1,0,1,0
63891,50750,445,0,0,drop,66,66,0,1,0,1,0
63892,55344,445,0,0,drop,70,70,0,1,0,1,0
63893,13188,35440,0,0,deny,66,66,0,1,0,1,0
63894,11777,37965,0,0,deny,62,62,0,1,0,1,0
63895,55341,445,0,0,drop,70,70,0,1,0,1,0
63896,55339,445,0,0,drop,70,70,0,1,0,1,0
63897,55335,445,0,0,drop,70,70,0,1,0,1,0
63898,50748,445,0,0,drop,66,66,0,1,0,1,0
63899,50274,445,0,0,drop,70,70,0,1,0,1,0
63900,45941,23386,0,0,deny,60,60,0,1,0,1,0
63901,63888,57470,0,0,deny,62,62,0,1,0,1,0
63902,50271,445,0,0,drop,70,70,0,1,0,1,0
63903,60524,64147,0,0,deny,66,66,0,1,0,1,0
63904,11651,64147,0,0,deny,145,145,0,1,0,1,0
63905,55330,445,0,0,drop,70,70,0,1,0,1,0
63906,5223,61002,0,0,deny,161,161,0,1,0,1,0
63907,63433,57866,0,0,deny,66,66,0,1,0,1,0
63908,64616,53,29802,53,allow,184,80,104,2,30,1,1
63909,61046,443,61046,443,allow,5830,2583,3247,22,40,13,9
63910,40710,5228,9746,5228,allow,4065,2585,1480,28,40,14,14
63911,40709,53,32661,53,allow,221,75,146,2,30,1,1
63912,50968,80,19228,80,allow,109660,1992,107668,99,35,20,79
63913,5588,5588,0,0,allow,3498,1872,1626,48,195,24,24
63914,993,54634,0,0,allow,66,66,0,1,90,1,0
63915,52765,443,14674,443,allow,283,163,120,4,16,2,2
63916,47740,443,62722,443,allow,6234,4369,1865,25,316,12,13
63917,50967,80,65454,80,allow,1439,697,742,12,35,6,6
63918,56149,80,45182,80,allow,1286,403,883,16,400,4,12
63919,50312,80,15679,80,allow,17102,1099,16003,19,16,5,14
63920,54368,443,18976,443,allow,10707,2548,8159,27,39,15,12
63921,34338,443,23040,443,allow,8152,3395,4757,27,18,15,12
63922,56896,80,32594,80,allow,2684,2550,134,7,16,5,2
63923,46488,443,7780,443,allow,87129,6924,80205,126,258,49,77
63924,54360,443,12392,443,allow,7723,2282,5441,22,255,11,11
63925,23293,443,23293,443,allow,50236,37417,12819,67,19,41,26
63926,56759,55201,4487,55201,allow,70,70,0,2,8,2,0
63927,24037,443,24037,443,allow,3611,2177,1434,24,17,13,11
63928,53535,1393,2385,1393,allow,70,70,0,2,8,2,0
63929,57595,80,57595,80,allow,254,120,134,5,26,3,2
63930,51724,25807,54569,25807,allow,70,70,0,2,8,2,0
63931,48381,53,16694,53,allow,221,75,146,2,30,1,1
63932,59808,443,49702,443,allow,147637,6160,141477,164,121,56,108
63933,65404,443,46166,443,allow,63040,3063,59977,78,129,30,48
63934,42298,40030,5035,40030,allow,146,84,62,2,31,1,1
63935,50073,443,21032,443,allow,9873,2384,7489,25,242,14,11
63936,55328,445,0,0,drop,70,70,0,1,0,1,0
63937,55326,445,0,0,drop,70,70,0,1,0,1,0
63938,55324,445,0,0,drop,70,70,0,1,0,1,0
63939,50282,37965,0,0,deny,66,66,0,1,0,1,0
63940,50739,445,0,0,drop,66,66,0,1,0,1,0
63941,33215,37965,0,0,deny,62,62,0,1,0,1,0
63942,32974,37965,0,0,deny,66,66,0,1,0,1,0
63943,50962,5900,0,0,deny,60,60,0,1,0,1,0
63944,50736,445,0,0,drop,66,66,0,1,0,1,0
63945,50733,445,0,0,drop,66,66,0,1,0,1,0
63946,50732,445,0,0,drop,66,66,0,1,0,1,0
63947,50731,445,0,0,drop,66,66,0,1,0,1,0
63948,50730,445,0,0,drop,66,66,0,1,0,1,0
63949,50728,445,0,0,drop,66,66,0,1,0,1,0
63950,50266,445,0,0,drop,70,70,0,1,0,1,0
63951,46090,50584,0,0,deny,66,66,0,1,0,1,0
63952,50265,445,0,0,drop,70,70,0,1,0,1,0
63953,443,29326,0,0,deny,82,82,0,1,0,1,0
63954,63729,6969,55353,6969,allow,66,66,0,2,8,2,0
63955,48203,80,21963,80,allow,946,531,415,11,315,6,5
63956,1924,80,29370,80,allow,214,140,74,4,15,3,1
63957,50263,445,0,0,drop,70,70,0,1,0,1,0
63958,57493,443,0,0,deny,60,60,0,1,0,1,0
63959,55323,445,0,0,drop,70,70,0,1,0,1,0
63960,55318,445,0,0,drop,70,70,0,1,0,1,0
63961,55320,445,0,0,drop,70,70,0,1,0,1,0
63962,50725,445,0,0,drop,66,66,0,1,0,1,0
63963,40703,5900,0,0,deny,60,60,0,1,0,1,0
63964,24311,22617,0,0,deny,60,60,0,1,0,1,0
63965,55315,445,0,0,drop,70,70,0,1,0,1,0
63966,34716,23,0,0,deny,60,60,0,1,0,1,0
63967,58338,3362,0,0,deny,60,60,0,1,0,1,0
63968,58338,3362,0,0,deny,60,60,0,1,0,1,0
63969,50723,445,0,0,drop,66,66,0,1,0,1,0
63970,49057,5900,0,0,deny,60,60,0,1,0,1,0
63971,50721,445,0,0,drop,66,66,0,1,0,1,0
63972,50720,445,0,0,drop,66,66,0,1,0,1,0
63973,23061,23,0,0,deny,60,60,0,1,0,1,0
63974,59037,51505,0,0,deny,66,66,0,1,0,1,0
63975,60435,35440,0,0,deny,62,62,0,1,0,1,0
63976,50717,445,0,0,drop,66,66,0,1,0,1,0
63977,5180,57866,0,0,deny,66,66,0,1,0,1,0
63978,49501,11392,0,0,deny,66,66,0,1,0,1,0
63979,50256,445,0,0,drop,70,70,0,1,0,1,0
63980,5223,1210,0,0,deny,103,103,0,1,0,1,0
63981,55618,56205,0,0,deny,66,66,0,1,0,1,0
63982,50254,445,0,0,drop,70,70,0,1,0,1,0
63983,52431,64147,0,0,deny,62,62,0,1,0,1,0
63984,58849,64147,0,0,deny,66,66,0,1,0,1,0
63985,55310,445,0,0,drop,70,70,0,1,0,1,0
63986,51426,52700,0,0,deny,100,100,0,1,0,1,0
63987,50253,445,0,0,drop,70,70,0,1,0,1,0
63988,23807,44847,0,0,deny,66,66,0,1,0,1,0
63989,52910,51221,0,0,deny,78,78,0,1,0,1,0
63990,55302,445,0,0,drop,70,70,0,1,0,1,0
63991,55300,445,0,0,drop,70,70,0,1,0,1,0
63992,50252,445,0,0,drop,70,70,0,1,0,1,0
63993,50251,445,0,0,drop,70,70,0,1,0,1,0
63994,54095,26467,0,0,deny,62,62,0,1,0,1,0
63995,50249,445,0,0,drop,70,70,0,1,0,1,0
63996,50246,445,0,0,drop,70,70,0,1,0,1,0
63997,50438,19426,0,0,deny,62,62,0,1,0,1,0
63998,51130,61689,0,0,deny,66,66,0,1,0,1,0
63999,515,10214,0,0,deny,62,62,0,1,0,1,0
64000,50708,445,0,0,drop,66,66,0,1,0,1,0
64001,7744,32480,0,0,deny,62,62,0,1,0,1,0
64002,443,29326,0,0,deny,82,82,0,1,0,1,0
64003,12232,18593,0,0,deny,139,139,0,1,0,1,0
64004,64277,30188,0,0,deny,62,62,0,1,0,1,0
64005,50233,445,0,0,drop,70,70,0,1,0,1,0
64006,50231,445,0,0,drop,70,70,0,1,0,1,0
64007,50230,445,0,0,drop,70,70,0,1,0,1,0
64008,50222,445,0,0,drop,70,70,0,1,0,1,0
64009,50223,445,0,0,drop,70,70,0,1,0,1,0
64010,65024,51505,0,0,deny,62,62,0,1,0,1,0
64011,5223,44091,0,0,deny,66,66,0,1,0,1,0
64012,5223,44091,0,0,deny,119,119,0,1,0,1,0
64013,5223,44091,0,0,deny,167,167,0,1,0,1,0
64014,6712,161,0,0,deny,82,82,0,1,0,1,0
64015,443,10010,0,0,deny,60,60,0,1,0,1,0
64016,52218,31573,0,0,deny,62,62,0,1,0,1,0
64017,50699,445,0,0,drop,66,66,0,1,0,1,0
64018,443,22238,0,0,deny,112,112,0,1,0,1,0
64019,44147,64147,0,0,deny,62,62,0,1,0,1,0
64020,28832,36237,0,0,deny,66,66,0,1,0,1,0
64021,55288,445,0,0,drop,70,70,0,1,0,1,0
64022,44411,37965,0,0,deny,62,62,0,1,0,1,0
64023,64601,80,64601,80,allow,56887,6820,50067,90,25,49,41
64024,58081,3389,58081,3389,allow,3549,1594,1955,18,16,10,8
64025,60743,40010,9730,40010,allow,316,136,180,6,6,3,3
64026,58438,53,46803,53,allow,246,102,144,2,29,1,1
64027,54373,443,3920,443,allow,16029,6377,9652,46,37,24,22
64028,54363,443,18639,443,allow,23766,10707,13059,80,42,41,39
64029,50316,80,27928,80,allow,1677,862,815,10,15,5,5
64030,54348,443,31489,443,allow,27760,9709,18051,56,45,27,29
64031,53817,443,11999,443,allow,7443,2043,5400,34,255,17,17
64032,53515,39608,40902,39608,allow,70,70,0,1,4,1,0
64033,33637,443,44559,443,allow,24214,18131,6083,81,118,44,37
64034,26758,443,6342,443,allow,20851,15854,4997,36,20,20,16
64035,46985,993,3733,993,allow,9725,3931,5794,46,48,25,21
64036,50028,53,56615,53,allow,323,110,213,2,29,1,1
64037,50013,53,8122,53,allow,662,195,467,6,39,3,3
64038,61670,443,47830,443,allow,5943,1991,3952,23,17,14,9
64039,38413,53,37201,53,allow,199,94,105,2,29,1,1
64040,37752,53,54109,53,allow,220,78,142,2,30,1,1
64041,59437,53,35841,53,allow,215,86,129,2,29,1,1
64042,58602,53,5583,53,allow,197,86,111,2,29,1,1
64043,56763,27734,6083,27734,allow,70,70,0,1,5,1,0
64044,34413,443,27966,443,allow,8107,2200,5907,34,255,16,18
64045,42805,443,52110,443,allow,130,70,60,2,15,1,1
64046,49445,80,19716,80,allow,1586,808,778,13,45,7,6
64047,54374,443,44819,443,allow,9131,3499,5632,39,24,21,18
64048,43221,443,25236,443,allow,72183,3193,68990,89,20,34,55
64049,49166,53,8191,53,allow,468,93,375,4,34,2,2
64050,55580,45817,63033,45817,allow,70,70,0,1,5,1,0
64051,51702,33451,34580,33451,allow,70,70,0,1,5,1,0
64052,55585,48063,46430,48063,allow,70,70,0,2,8,2,0
64053,64593,53,5715,53,allow,602,93,509,4,42,2,2
64054,43532,80,43879,80,allow,1449,364,1085,13,15,6,7
64055,65318,53,16200,53,allow,395,102,293,2,30,1,1
64056,43782,7275,17092,7275,allow,4955,1749,3206,24,16,15,9
64057,57768,7635,57768,7635,allow,138,78,60,2,6,1,1
64058,35105,443,59131,443,allow,639937,14873,625064,627,230,188,439
64059,43402,53,65461,53,allow,241,78,163,2,30,1,1
64060,56762,25080,40998,25080,allow,70,70,0,1,5,1,0
64061,49812,53,37839,53,allow,195,86,109,2,30,1,1
64062,39417,53,53271,53,allow,224,78,146,2,30,1,1
64063,52785,443,33714,443,allow,5806,1059,4747,16,63,8,8
64064,4683,53,49166,53,allow,207,86,121,2,30,1,1
64065,40885,443,32340,443,allow,4014,1592,2422,17,147,9,8
64066,49980,443,59748,443,allow,7227,4437,2790,29,271,16,13
64067,59420,53,63231,53,allow,224,78,146,2,30,1,1
64068,62103,443,43175,443,allow,6345,3495,2850,18,120,9,9
64069,57470,1136,15403,1136,allow,402,132,270,6,1209,3,3
64070,49505,53,46670,53,allow,232,110,122,2,30,1,1
64071,52203,80,56885,80,allow,432,246,186,7,40,4,3
64072,49154,53,7041,53,allow,763,204,559,6,40,3,3
64073,49792,53,58447,53,allow,339,110,229,2,30,1,1
64074,59801,443,35070,443,allow,5678,2820,2858,25,141,11,14
64075,61675,80,46507,80,allow,5108,676,4432,14,15,7,7
64076,60308,443,13749,443,allow,5445,1072,4373,24,80,11,13
64077,55583,14822,28217,14822,allow,70,70,0,1,5,1,0
64078,52402,53,52402,53,allow,212,98,114,2,30,1,1
64079,49230,53,32099,53,allow,195,94,101,2,30,1,1
64080,59943,443,41706,443,allow,2979,914,2065,10,120,5,5
64081,64585,80,64585,80,allow,405673,21057,384616,519,26,252,267
64082,49416,443,60307,443,allow,27484,4857,22627,42,46,15,27
64083,49646,443,41538,443,allow,5647,1832,3815,16,36,9,7
64084,60307,443,42783,443,allow,5574,1200,4374,26,80,13,13
64085,51140,443,48264,443,allow,5759,1904,3855,19,15,11,8
64086,53374,443,16272,443,allow,4317,1134,3183,16,26,9,7
64087,55579,58420,44629,58420,allow,70,70,0,1,5,1,0
64088,53375,443,59892,443,allow,4317,1134,3183,16,26,9,7
64089,65461,443,11386,443,allow,396698,11870,384828,409,16,144,265
64090,33099,443,5841,443,allow,11110,1700,9410,33,750,11,22
64091,56595,80,43530,80,allow,234,234,0,4,12,4,0
64092,39135,443,24335,443,allow,8286,2195,6091,24,256,12,12
64093,44363,443,4525,443,allow,10667,2992,7675,32,560,17,15
64094,33327,53,12719,53,allow,199,94,105,2,29,1,1
64095,51069,80,24367,80,allow,254,128,126,5,15,3,2
64096,47993,443,45711,443,allow,5272,1535,3737,17,35,12,5
64097,53868,53,29458,53,allow,86,86,0,1,30,1,0
64098,53663,80,16666,80,allow,149148,7515,141633,197,20,95,102
64099,55582,26957,64555,26957,allow,70,70,0,1,5,1,0
64100,50377,80,8000,80,allow,1451,796,655,11,31,6,5
64101,63709,21989,3950,21989,allow,696,508,188,10,16,7,3
64102,58866,53,56575,53,allow,355,118,237,2,29,1,1
64103,60425,443,26007,443,allow,1541,1004,537,14,26,8,6
64104,64947,53,12228,53,allow,402,118,284,2,29,1,1
64105,61412,53,24202,53,allow,225,78,147,2,30,1,1
64106,50355,443,60927,443,allow,4137,2232,1905,13,132,8,5
64107,41677,443,61867,443,allow,7292,1489,5803,21,187,11,10
64108,37965,51719,40903,51719,allow,481,150,331,2,1199,1,1
64109,35101,443,31000,443,allow,4988930,161289,4827641,5384,290,1964,3420
64110,51701,24343,49961,24343,allow,70,70,0,1,5,1,0
64111,55578,45682,64868,45682,allow,70,70,0,1,5,1,0
64112,50313,80,63654,80,allow,736,670,66,6,15,5,1
64113,46619,123,26763,123,allow,184,94,90,2,30,1,1
64114,36928,53,43446,53,allow,241,78,163,2,30,1,1
64115,37383,443,62473,443,allow,11389,4837,6552,27,120,13,14
64116,56761,34725,47498,34725,allow,70,70,0,1,5,1,0
64117,53180,443,55711,443,allow,7876,3195,4681,22,20,11,11
64118,5588,5588,0,0,allow,3562,1936,1626,48,192,24,24
64119,60302,443,30801,443,allow,39850,4375,35475,73,80,31,42
64120,57318,53,50520,53,allow,418,88,330,4,41,2,2
64121,55586,17332,63048,17332,allow,70,70,0,2,8,2,0
64122,44674,80,41945,80,allow,1298,624,674,12,16,5,7
64123,60374,17432,21315,17432,allow,564,318,246,9,18,5,4
64124,53283,443,23870,443,allow,9121,2486,6635,22,45,13,9
64125,64772,53,2611,53,allow,633,231,402,6,47,3,3
64126,59793,443,44894,443,allow,41635,3977,37658,63,121,25,38
64127,42025,443,40368,443,allow,2394,1365,1029,18,275,9,9
64128,62101,443,33220,443,allow,1867,250,1617,8,120,4,4
64129,56429,443,9683,443,allow,355939,9284,346655,365,121,125,240
64130,15503,21394,46725,21394,allow,479,150,329,2,1200,1,1
64131,6882,24271,34047,24271,allow,228,118,110,2,1200,1,1
64132,51726,18475,34444,18475,allow,316,136,180,6,7,3,3
64133,40299,443,53474,443,allow,9574,2600,6974,29,136,16,13
64134,64000,53,61132,53,allow,214,102,112,2,30,1,1
64135,51108,53,64155,53,allow,168,78,90,2,30,1,1
64136,57099,53,12968,53,allow,278,102,176,2,31,1,1
64137,52208,80,51352,80,allow,372,246,126,6,28,4,2
64138,56408,443,56408,443,allow,4373,1466,2907,19,28,11,8
64139,10602,3389,10602,3389,allow,3910,1805,2105,20,19,12,8
64140,50961,80,36404,80,allow,5730066,61301,5668765,4686,81,891,3795
64141,50308,80,8289,80,allow,1083,653,430,8,16,5,3
64142,58959,53,45652,53,allow,307,86,221,2,30,1,1
64143,30654,51221,0,0,deny,72,72,0,1,0,1,0
64144,63062,35440,0,0,deny,62,62,0,1,0,1,0
64145,49150,51505,0,0,deny,146,146,0,1,0,1,0
64146,61495,37965,0,0,deny,66,66,0,1,0,1,0
64147,53479,23,0,0,deny,60,60,0,1,0,1,0
64148,50696,445,0,0,drop,66,66,0,1,0,1,0
64149,28584,37965,0,0,deny,62,62,0,1,0,1,0
64150,21173,37965,0,0,deny,145,145,0,1,0,1,0
64151,43704,465,0,0,deny,60,60,0,1,0,1,0
64152,443,29326,0,0,deny,82,82,0,1,0,1,0
64153,64382,44847,0,0,deny,66,66,0,1,0,1,0
64154,50211,445,0,0,drop,70,70,0,1,0,1,0
64155,57837,64147,0,0,deny,66,66,0,1,0,1,0
64156,59241,62413,0,0,deny,66,66,0,1,0,1,0
64157,4431,32480,0,0,deny,66,66,0,1,0,1,0
64158,53051,44847,0,0,deny,66,66,0,1,0,1,0
64159,50681,445,0,0,drop,66,66,0,1,0,1,0
64160,50636,23117,0,0,deny,62,62,0,1,0,1,0
64161,64880,64147,0,0,deny,62,62,0,1,0,1,0
64162,4041,50584,0,0,deny,62,62,0,1,0,1,0
64163,2704,37,0,0,deny,60,60,0,1,0,1,0
64164,64279,23718,0,0,deny,146,146,0,1,0,1,0
64165,50207,445,0,0,drop,70,70,0,1,0,1,0
64166,62148,37965,0,0,deny,62,62,0,1,0,1,0
64167,50968,443,1243,443,allow,469,403,66,4,0,3,1
64168,50969,443,54163,443,allow,469,403,66,4,0,3,1
64169,56942,443,61847,443,allow,494,420,74,4,0,3,1
64170,47063,15503,0,0,deny,62,62,0,1,0,1,0
64171,55278,445,0,0,drop,70,70,0,1,0,1,0
64172,55276,445,0,0,drop,70,70,0,1,0,1,0
64173,55275,445,0,0,drop,70,70,0,1,0,1,0
64174,61706,64147,0,0,deny,62,62,0,1,0,1,0
64175,50674,445,0,0,drop,66,66,0,1,0,1,0
64176,50670,445,0,0,drop,66,66,0,1,0,1,0
64177,50668,445,0,0,drop,66,66,0,1,0,1,0
64178,50673,445,0,0,drop,66,66,0,1,0,1,0
64179,50671,445,0,0,drop,66,66,0,1,0,1,0
64180,50672,445,0,0,drop,66,66,0,1,0,1,0
64181,50666,445,0,0,drop,66,66,0,1,0,1,0
64182,50667,445,0,0,drop,66,66,0,1,0,1,0
64183,50198,445,0,0,drop,70,70,0,1,0,1,0
64184,50196,445,0,0,drop,70,70,0,1,0,1,0
64185,50195,445,0,0,drop,70,70,0,1,0,1,0
64186,50192,445,0,0,drop,70,70,0,1,0,1,0
64187,12694,12446,0,0,deny,145,145,0,1,0,1,0
64188,51085,56205,0,0,deny,66,66,0,1,0,1,0
64189,50191,445,0,0,drop,70,70,0,1,0,1,0
64190,54080,26467,0,0,deny,62,62,0,1,0,1,0
64191,6057,51221,0,0,deny,78,78,0,1,0,1,0
64192,6666,401,0,0,deny,60,60,0,1,0,1,0
64193,60184,37965,0,0,deny,66,66,0,1,0,1,0
64194,51948,37965,0,0,deny,62,62,0,1,0,1,0
64195,443,29326,0,0,deny,82,82,0,1,0,1,0
64196,50561,55777,0,0,deny,62,62,0,1,0,1,0
64197,55273,445,0,0,drop,70,70,0,1,0,1,0
64198,55265,445,0,0,drop,70,70,0,1,0,1,0
64199,55261,445,0,0,drop,70,70,0,1,0,1,0
64200,59059,80,0,0,deny,62,62,0,1,0,1,0
64201,50184,445,0,0,drop,70,70,0,1,0,1,0
64202,50654,445,0,0,drop,66,66,0,1,0,1,0
64203,50652,445,0,0,drop,66,66,0,1,0,1,0
64204,50653,445,0,0,drop,66,66,0,1,0,1,0
64205,3352,50584,0,0,deny,66,66,0,1,0,1,0
64206,55258,445,0,0,drop,70,70,0,1,0,1,0
64207,25151,58833,0,0,deny,62,62,0,1,0,1,0
64208,14903,10387,0,0,deny,159,159,0,1,0,1,0
64209,50177,445,0,0,drop,70,70,0,1,0,1,0
64210,55255,445,0,0,drop,70,70,0,1,0,1,0
64211,50174,445,0,0,drop,70,70,0,1,0,1,0
64212,45941,23386,0,0,deny,60,60,0,1,0,1,0
64213,57107,64147,0,0,deny,66,66,0,1,0,1,0
64214,55252,445,0,0,drop,70,70,0,1,0,1,0
64215,55251,445,0,0,drop,70,70,0,1,0,1,0
64216,55244,445,0,0,drop,70,70,0,1,0,1,0
64217,5223,1210,0,0,deny,103,103,0,1,0,1,0
64218,51716,44847,0,0,deny,62,62,0,1,0,1,0
64219,50065,44847,0,0,deny,62,62,0,1,0,1,0
64220,35849,30188,0,0,deny,146,146,0,1,0,1,0
64221,50170,445,0,0,drop,70,70,0,1,0,1,0
64222,36538,64147,0,0,deny,62,62,0,1,0,1,0
64223,50169,445,0,0,drop,70,70,0,1,0,1,0
64224,0,0,0,0,deny,60,60,0,1,0,1,0
64225,0,0,0,0,allow,480,244,236,4,0,2,2
64226,19416,23,0,0,deny,60,60,0,1,0,1,0
64227,24037,53415,0,0,deny,76,76,0,1,0,1,0
64228,50165,445,0,0,drop,70,70,0,1,0,1,0
64229,57360,18375,0,0,deny,66,66,0,1,0,1,0
64230,55235,445,0,0,drop,70,70,0,1,0,1,0
64231,55236,445,0,0,drop,70,70,0,1,0,1,0
64232,55231,445,0,0,drop,70,70,0,1,0,1,0
64233,60441,5900,0,0,deny,60,60,0,1,0,1,0
64234,50375,50584,0,0,deny,62,62,0,1,0,1,0
64235,50163,445,0,0,drop,70,70,0,1,0,1,0
64236,68,67,0,0,deny,594,594,0,1,0,1,0
64237,53957,35440,0,0,deny,62,62,0,1,0,1,0
64238,42995,26467,0,0,deny,62,62,0,1,0,1,0
64239,11552,44847,0,0,deny,62,62,0,1,0,1,0
64240,53960,30041,0,0,deny,66,66,0,1,0,1,0
64241,50159,445,0,0,drop,70,70,0,1,0,1,0
64242,50632,445,0,0,drop,66,66,0,1,0,1,0
64243,55230,445,0,0,drop,70,70,0,1,0,1,0
64244,55228,445,0,0,drop,70,70,0,1,0,1,0
64245,52451,56205,0,0,deny,66,66,0,1,0,1,0
64246,49386,64147,0,0,deny,62,62,0,1,0,1,0
64247,3777,64097,0,0,deny,146,146,0,1,0,1,0
64248,58446,56205,0,0,deny,62,62,0,1,0,1,0
64249,39100,2767,0,0,deny,62,62,0,1,0,1,0
64250,5223,1210,0,0,deny,66,66,0,1,0,1,0
64251,50626,445,0,0,drop,66,66,0,1,0,1,0
64252,50834,64147,0,0,deny,62,62,0,1,0,1,0
64253,50622,445,0,0,drop,66,66,0,1,0,1,0
64254,57763,52752,0,0,deny,66,66,0,1,0,1,0
64255,42298,40002,11642,40002,allow,724,550,174,4,30,2,2
64256,53471,8118,42759,8118,allow,1745,1091,654,10,31,5,5
64257,57814,443,32836,443,allow,6162,925,5237,18,108,10,8
64258,53004,80,58597,80,allow,9956,2570,7386,21,335,10,11
64259,58700,443,30626,443,allow,8124,1079,7045,16,26,8,8
64260,42298,51408,45869,51408,allow,725,325,400,12,31,6,6
64261,49631,53,0,0,allow,82,82,0,1,30,1,0
64262,52461,443,54450,443,allow,16541,4900,11641,62,131,26,36
64263,57263,443,6071,443,allow,7748,3859,3889,20,148,10,10
64264,52916,80,53748,80,allow,4266,1776,2490,20,367,11,9
64265,60152,80,38610,80,allow,1056,682,374,10,15,6,4
64266,53000,80,5659,80,allow,1991,686,1305,10,335,6,4
64267,52096,443,12292,443,allow,86745,6260,80485,121,32,58,63
64268,42298,40018,26921,40018,allow,148,86,62,2,30,1,1
64269,12299,53,12299,53,allow,229,89,140,2,30,1,1
64270,51167,443,46694,443,allow,13777,1743,12034,26,31,12,14
64271,50301,80,40498,80,allow,7979,802,7177,17,39,8,9
64272,63707,28423,64677,28423,allow,564,382,182,9,16,6,3
64273,38725,80,37134,80,allow,130,70,60,2,15,1,1
64274,49816,80,56471,80,allow,130,70,60,2,15,1,1
64275,43314,443,11137,443,allow,27958,21973,5985,77,403,43,34
64276,37780,443,20085,443,allow,1403708,31893,1371815,1301,162,292,1009
64277,51728,55504,11641,55504,allow,316,136,180,6,6,3,3
64278,39540,80,37629,80,allow,130,70,60,2,15,1,1
64279,63728,11785,52016,11785,allow,66,66,0,2,8,2,0
64280,42298,40031,35344,40031,allow,1346,662,684,8,32,4,4
64281,56753,38028,14806,38028,allow,156,66,90,2,5,1,1
64282,46981,443,34961,443,allow,2809,1884,925,19,25,11,8
64283,51698,63846,26436,63846,allow,66,66,0,1,5,1,0
64284,5588,5588,0,0,allow,3562,1936,1626,48,191,24,24
64285,65045,53,53307,53,allow,194,99,95,2,30,1,1
64286,35905,443,10061,443,allow,8272,2091,6181,25,331,12,13
64287,42298,40001,24361,40001,allow,140,78,62,2,31,1,1
64288,42298,40007,30822,40007,allow,143,81,62,2,31,1,1
64289,50027,80,48247,80,allow,3648,2069,1579,16,85,9,7
64290,53852,80,48149,80,allow,130,70,60,2,15,1,1
64291,52999,80,62826,80,allow,1991,686,1305,10,335,6,4
64292,52930,80,36918,80,allow,76193,2105,74088,75,359,23,52
64293,52928,80,52040,80,allow,1996,691,1305,10,359,6,4
64294,51699,37224,26533,37224,allow,66,66,0,1,5,1,0
64295,57813,443,65376,443,allow,6163,925,5238,18,109,10,8
64296,56754,14715,43516,14715,allow,66,66,0,1,5,1,0
64297,35965,443,35465,443,allow,14940,9434,5506,30,105,17,13
64298,50380,80,4994,80,allow,3190,980,2210,13,30,7,6
64299,39796,443,27327,443,allow,7425,2276,5149,24,16,12,12
64300,56876,443,56876,443,allow,18542,1778,16764,30,17,15,15
64301,42298,40036,17125,40036,allow,141,79,62,2,30,1,1
64302,34717,53,24183,53,allow,168,78,90,2,31,1,1
64303,42298,40006,18530,40006,allow,243,180,63,2,31,1,1
64304,54521,443,4685,443,allow,1574197,46737,1527460,1590,34,557,1033
64305,56524,53,52908,53,allow,711,87,624,2,31,1,1
64306,42298,40002,3434,40002,allow,241,178,63,2,31,1,1
64307,55461,443,39176,443,allow,2341,540,1801,9,121,5,4
64308,33624,443,6639,443,allow,247438,52606,194832,305,237,124,181
64309,63587,443,60950,443,allow,10576,3685,6891,46,92,24,22
64310,35087,443,32747,443,allow,6053,3586,2467,17,135,8,9
64311,42298,40025,58686,40025,allow,140,78,62,2,31,1,1
64312,42298,40019,18664,40019,allow,597,79,518,2,31,1,1
64313,42298,443,10335,443,allow,64,64,0,1,31,1,0
64314,50875,443,41381,443,allow,1786,172,1614,7,121,3,4
64315,123,123,7719,123,allow,184,94,90,2,31,1,1
64316,52797,443,2237,443,allow,6876,3332,3544,22,140,11,11
64317,5938,37145,0,0,allow,60,60,0,1,90,1,0
64318,55216,445,0,0,drop,70,70,0,1,0,1,0
64319,51426,59737,0,0,deny,100,100,0,1,0,1,0
64320,50146,445,0,0,drop,70,70,0,1,0,1,0
64321,55212,445,0,0,drop,70,70,0,1,0,1,0
64322,55211,445,0,0,drop,70,70,0,1,0,1,0
64323,55207,445,0,0,drop,70,70,0,1,0,1,0
64324,50620,445,0,0,drop,66,66,0,1,0,1,0
64325,53314,64097,0,0,deny,66,66,0,1,0,1,0
64326,50143,445,0,0,drop,70,70,0,1,0,1,0
64327,21998,51221,0,0,deny,62,62,0,1,0,1,0
64328,53233,51221,0,0,deny,66,66,0,1,0,1,0
64329,62331,61689,0,0,deny,66,66,0,1,0,1,0
64330,51769,80,52683,80,allow,74039,4367,69672,91,19,40,51
64331,50877,80,27709,80,allow,186520,11545,174975,222,141,96,126
64332,46417,443,30278,443,allow,359878,6703,353175,325,36,88,237
64333,58972,80,64079,80,allow,943,513,430,9,14,6,3
64334,52207,80,29595,80,allow,372,246,126,6,27,4,2
64335,65045,53,16728,53,allow,197,102,95,2,29,1,1
64336,56051,53,2559,53,allow,249,102,147,2,29,1,1
64337,50935,80,3414,80,allow,8167195,108448,8058747,7107,121,1531,5576
64338,34765,5222,48630,5222,allow,10109,3480,6629,72,615,38,34
64339,51567,443,51567,443,allow,1654,916,738,16,126,7,9
64340,49952,53,43225,53,allow,196,94,102,2,30,1,1
64341,35190,80,55473,80,allow,130,70,60,2,14,1,1
64342,50890,80,12548,80,allow,290951,15209,275742,327,141,132,195
64343,52206,80,42642,80,allow,372,246,126,6,27,4,2
64344,29025,53,29025,53,allow,235,90,145,2,31,1,1
64345,61713,80,49521,80,allow,134,60,74,3,5,2,1
64346,61707,80,47062,80,allow,134,60,74,3,4,2,1
64347,53350,80,3605,80,allow,1712,913,799,12,273,7,5
64348,47655,53,46246,53,allow,168,78,90,2,29,1,1
64349,64045,53,1404,53,allow,1011,232,779,6,55,3,3
64350,50876,80,52453,80,allow,121344,7345,113999,144,141,61,83
64351,64735,53,29173,53,allow,350,118,232,2,29,1,1
64352,49811,53,32866,53,allow,308,110,198,2,29,1,1
64353,64382,53,40543,53,allow,278,102,176,2,30,1,1
64354,65450,53,49502,53,allow,336,110,226,2,30,1,1
64355,33954,53,7602,53,allow,168,78,90,2,29,1,1
64356,52182,53,52182,53,allow,832,106,726,2,30,1,1
64357,49232,53,52451,53,allow,242,78,164,2,29,1,1
64358,51723,10622,43836,10622,allow,70,70,0,2,8,2,0
64359,59601,443,24962,443,allow,162,102,60,2,5,1,1
64360,53181,443,19571,443,allow,2309,1443,866,16,17,8,8
64361,52607,80,12616,80,allow,2543,691,1852,13,30,8,5
64362,42298,40022,6562,40022,allow,148,86,62,2,30,1,1
64363,23331,53,23331,53,allow,242,98,144,2,30,1,1
64364,53298,80,1119,80,allow,12660,7492,5168,27,274,14,13
64365,56377,80,8742,80,allow,1633,943,690,15,72,8,7
64366,55887,53,55333,53,allow,212,94,118,2,30,1,1
64367,53002,80,19802,80,allow,1601,761,840,10,334,6,4
64368,50892,80,51133,80,allow,256436,14131,242305,283,141,111,172
64369,56862,443,9641,443,allow,7819,1662,6157,20,76,11,9
64370,46746,443,33868,443,allow,7002,4142,2860,46,1485,29,17
64371,57092,53,3743,53,allow,228,102,126,2,30,1,1
64372,43705,443,47459,443,allow,8060,2001,6059,24,19,14,10
64373,52626,80,56571,80,allow,2820,1466,1354,20,534,11,9
64374,64351,53,15747,53,allow,228,102,126,2,30,1,1
64375,37707,53,28750,53,allow,168,78,90,2,30,1,1
64376,50886,80,22505,80,allow,312952,13869,299083,347,141,138,209
64377,49976,53,5693,53,allow,393,110,283,2,30,1,1
64378,42298,40007,6536,40007,allow,148,86,62,2,30,1,1
64379,54367,3389,54367,3389,allow,4365,2581,1784,20,32,11,9
64380,62768,443,53717,443,allow,30902,6307,24595,86,269,36,50
64381,50883,80,64742,80,allow,204646,11741,192905,240,141,104,136
64382,53006,80,12227,80,allow,1988,742,1246,10,334,6,4
64383,52960,80,43936,80,allow,82011,2937,79074,91,358,34,57
64384,59877,80,9809,80,allow,1306,557,749,10,25,6,4
64385,55179,53,7582,53,allow,194,102,92,2,33,1,1
64386,50873,80,11525,80,allow,173653,9305,164348,189,141,73,116
64387,50414,80,48434,80,allow,1657,1246,411,8,15,5,3
64388,49287,53,21721,53,allow,405,90,315,4,59,2,2
64389,42298,40007,31436,40007,allow,148,86,62,2,30,1,1
64390,65306,53,12072,53,allow,244,94,150,2,30,1,1
64391,45725,443,40804,443,allow,8600,4882,3718,44,225,23,21
64392,55028,443,3475,443,allow,1403116,30089,1373027,1321,32,404,917
64393,43208,443,45939,443,allow,4296557,96359,4200198,3781,143,838,2943
64394,50934,80,52977,80,allow,10213447,100765,10112682,8215,121,1412,6803
64395,42298,40022,48973,40022,allow,730,548,182,4,30,2,2
64396,60193,443,30919,443,allow,677029,102078,574951,1152,455,559,593
64397,63712,21917,18745,21917,allow,504,382,122,8,15,6,2
64398,52481,443,46031,443,allow,6270,1368,4902,22,15,12,10
64399,53206,80,36804,80,allow,2622,1074,1548,14,282,8,6
64400,52209,80,41464,80,allow,372,246,126,6,27,4,2
64401,53107,44060,63943,44060,allow,70,70,0,2,8,2,0
64402,43412,80,13841,80,allow,78,78,0,1,4,1,0
64403,36927,80,32507,80,allow,130,70,60,2,14,1,1
64404,65462,443,5746,443,allow,92384,4519,87865,105,15,39,66
64405,52210,80,30096,80,allow,372,246,126,6,30,4,2
64406,60470,443,16410,443,allow,7289,1899,5390,29,317,16,13
64407,53886,443,35805,443,allow,6074,1579,4495,18,125,11,7
64408,65045,53,56055,53,allow,197,102,95,2,32,1,1
64409,63366,30365,36289,30365,allow,70,70,0,1,4,1,0
64410,63704,28291,53778,28291,allow,504,382,122,8,15,6,2
64411,50889,80,11268,80,allow,397616,15684,381932,419,141,157,262
64412,65233,53,6826,53,allow,448,130,318,4,44,2,2
64413,65169,80,56657,80,allow,1516,481,1035,11,15,6,5
64414,47729,443,6419,443,allow,15600,2166,13434,32,205,16,16
64415,54498,443,44231,443,allow,8060,2001,6059,24,19,14,10
64416,64454,53,61289,53,allow,293,110,183,2,29,1,1
64417,65309,53,47712,53,allow,258,110,148,2,30,1,1
64418,57604,53,48752,53,allow,290,86,204,2,29,1,1
64419,54385,53,14777,53,allow,168,78,90,2,30,1,1
64420,50887,80,30027,80,allow,256649,11414,245235,280,141,111,169
64421,56404,80,13755,80,allow,17376,1687,15689,28,40,12,16
64422,55320,53,12991,53,allow,239,102,137,2,30,1,1
64423,58151,53,58151,53,allow,241,98,143,2,30,1,1
64424,42298,40020,48690,40020,allow,148,86,62,2,30,1,1
64425,41910,443,63630,443,allow,9358,2304,7054,39,120,20,19
64426,60520,53,60520,53,allow,198,90,108,2,30,1,1
64427,55087,53,44618,53,allow,344,110,234,2,30,1,1
64428,50388,53,36843,53,allow,177,94,83,2,30,1,1
64429,42298,40038,63975,40038,allow,148,86,62,2,30,1,1
64430,42298,40031,52392,40031,allow,156,94,62,2,30,1,1
64431,57589,53,7858,53,allow,165,78,87,2,30,1,1
64432,42298,40015,12335,40015,allow,140,78,62,2,31,1,1
64433,42298,40022,41026,40022,allow,717,551,166,4,31,2,2
64434,36567,443,58934,443,allow,2341,1054,1287,20,299,7,13
64435,64575,53,36717,53,allow,268,110,158,2,31,1,1
64436,53028,80,12775,80,allow,3470,1464,2006,21,190,10,11
64437,60735,28080,14759,28080,allow,70,70,0,1,5,1,0
64438,56376,80,29400,80,allow,1635,945,690,15,72,8,7
64439,50884,80,30103,80,allow,238059,13790,224269,276,141,113,163
64440,43465,80,31398,80,allow,1352,848,504,13,255,8,5
64441,5588,5588,0,0,allow,3498,1872,1626,48,195,24,24
64442,42298,40005,19733,40005,allow,148,86,62,2,30,1,1
64443,42298,40017,13967,40017,allow,148,86,62,2,30,1,1
64444,54942,53,0,0,allow,168,74,94,2,30,1,1
64445,52951,80,38288,80,allow,6266,4430,1836,22,358,13,9
64446,51697,60619,59919,60619,allow,70,70,0,1,5,1,0
64447,57802,80,24943,80,allow,2762,2628,134,8,17,6,2
64448,53271,443,53446,443,allow,34908,2650,32258,52,45,23,29
64449,64006,53,16897,53,allow,394,96,298,4,47,2,2
64450,65519,53,27344,53,allow,321,102,219,2,30,1,1
64451,42298,40005,17939,40005,allow,263,182,81,2,30,1,1
64452,42298,40039,50865,40039,allow,602,86,516,2,30,1,1
64453,50882,80,51896,80,allow,207895,10483,197412,229,141,90,139
64454,52946,80,56196,80,allow,4085,2870,1215,23,358,14,9
64455,55004,443,32429,443,allow,1334906,33112,1301794,1315,35,446,869
64456,52959,80,37640,80,allow,122572,3630,118942,128,358,46,82
64457,53534,40960,13903,40960,allow,320,140,180,6,6,3,3
64458,36486,80,36486,80,allow,15249,1015,14234,24,29,9,15
64459,56375,80,51111,80,allow,1609,919,690,15,72,8,7
64460,50874,80,33456,80,allow,331828,15003,316825,363,141,140,223
64461,55350,53,18566,53,allow,315,95,220,4,50,2,2
64462,41776,443,6550,443,allow,32434,15588,16846,164,1128,83,81
64463,42298,40008,62209,40008,allow,148,86,62,2,30,1,1
64464,42298,40042,16142,40042,allow,148,86,62,2,30,1,1
64465,42298,40028,40095,40028,allow,563,86,477,2,30,1,1
64466,10151,51413,40673,51413,allow,460,150,310,2,1200,1,1
64467,42298,40032,22903,40032,allow,720,549,171,4,30,2,2
64468,49899,53,23402,53,allow,718,94,624,2,30,1,1
64469,52824,443,27899,443,allow,4114,2920,1194,19,80,11,8
64470,39508,53,12625,53,allow,78,78,0,1,30,1,0
64471,65454,53,35372,53,allow,218,86,132,2,31,1,1
64472,27269,53,56522,53,allow,199,94,105,2,31,1,1
64473,42298,40010,41895,40010,allow,1082,86,996,2,31,1,1
64474,42298,40030,21853,40030,allow,546,486,60,2,30,1,1
64475,42298,40014,14476,40014,allow,148,86,62,2,31,1,1
64476,52431,443,19671,443,allow,7396,3677,3719,16,120,8,8
64477,64744,53,33076,53,allow,376,118,258,2,30,1,1
64478,42298,40014,10112,40014,allow,140,78,62,2,31,1,1
64479,51221,6881,43660,6881,allow,479,150,329,2,1200,1,1
64480,42298,40010,33875,40010,allow,148,86,62,2,31,1,1
64481,57587,443,4519,443,allow,15613,1408,14205,32,125,15,17
64482,59570,443,54074,443,allow,6713,3052,3661,49,5974,15,34
64483,57588,53,31636,53,allow,165,78,87,2,30,1,1
64484,49428,53,34747,53,allow,267,94,173,2,31,1,1
64485,42298,40020,47579,40020,allow,148,86,62,2,31,1,1
64486,42298,40021,40004,40021,allow,148,86,62,2,31,1,1
64487,39992,443,33603,443,allow,3470,1045,2425,13,121,6,7
64488,53512,23280,49318,23280,allow,1950,957,993,17,17,10,7
64489,50291,80,56837,80,allow,442,250,192,8,45,5,3
64490,59494,443,39878,443,allow,448,78,370,6,25,1,5
64491,50881,80,32099,80,allow,128327,7366,120961,154,141,67,87
64492,51510,443,23309,443,allow,1047,560,487,10,16,6,4
64493,50938,80,32549,80,allow,10272889,104948,10167941,8416,121,1525,6891
64494,49758,443,14307,443,allow,17412,6917,10495,38,63,20,18
64495,44924,53,44924,53,allow,235,90,145,2,32,1,1
64496,53522,24116,32649,24116,allow,70,70,0,2,8,2,0
64497,55640,53,37187,53,allow,797,208,589,6,67,3,3
64498,57959,21247,0,0,deny,66,66,0,1,0,1,0
64499,55203,445,0,0,drop,70,70,0,1,0,1,0
64500,55199,445,0,0,drop,70,70,0,1,0,1,0
64501,55198,445,0,0,drop,70,70,0,1,0,1,0
64502,55196,445,0,0,drop,70,70,0,1,0,1,0
64503,50611,445,0,0,drop,66,66,0,1,0,1,0
64504,50138,445,0,0,drop,70,70,0,1,0,1,0
64505,50604,445,0,0,drop,66,66,0,1,0,1,0
64506,50610,445,0,0,drop,66,66,0,1,0,1,0
64507,50606,445,0,0,drop,66,66,0,1,0,1,0
64508,5223,1210,0,0,deny,66,66,0,1,0,1,0
64509,5223,1210,0,0,deny,103,103,0,1,0,1,0
64510,50137,445,0,0,drop,70,70,0,1,0,1,0
64511,45912,44847,0,0,deny,62,62,0,1,0,1,0
64512,50603,445,0,0,drop,66,66,0,1,0,1,0
64513,50602,445,0,0,drop,66,66,0,1,0,1,0
64514,50601,445,0,0,drop,66,66,0,1,0,1,0
64515,50135,445,0,0,drop,70,70,0,1,0,1,0
64516,1025,64147,0,0,deny,62,62,0,1,0,1,0
64517,31062,50584,0,0,deny,62,62,0,1,0,1,0
64518,64177,44847,0,0,deny,66,66,0,1,0,1,0
64519,55193,445,0,0,drop,70,70,0,1,0,1,0
64520,55191,445,0,0,drop,70,70,0,1,0,1,0
64521,55190,445,0,0,drop,70,70,0,1,0,1,0
64522,52611,9571,0,0,deny,62,62,0,1,0,1,0
64523,59942,22114,0,0,deny,62,62,0,1,0,1,0
64524,50596,445,0,0,drop,66,66,0,1,0,1,0
64525,56798,9571,0,0,deny,66,66,0,1,0,1,0
64526,53030,56205,0,0,deny,66,66,0,1,0,1,0
64527,54827,50432,0,0,deny,109,109,0,1,0,1,0
64528,55187,445,0,0,drop,70,70,0,1,0,1,0
64529,50595,445,0,0,drop,66,66,0,1,0,1,0
64530,10494,23,0,0,deny,60,60,0,1,0,1,0
64531,1773,11392,0,0,deny,62,62,0,1,0,1,0
64532,50593,445,0,0,drop,66,66,0,1,0,1,0
64533,50592,445,0,0,drop,66,66,0,1,0,1,0
64534,55212,53733,0,0,deny,66,66,0,1,0,1,0
64535,50128,445,0,0,drop,70,70,0,1,0,1,0
64536,61670,57470,0,0,deny,74,74,0,1,0,1,0
64537,2704,37,0,0,deny,60,60,0,1,0,1,0
64538,50589,445,0,0,drop,66,66,0,1,0,1,0
64539,4607,6004,0,0,deny,70,70,0,1,0,1,0
64540,50126,445,0,0,drop,70,70,0,1,0,1,0
64541,55919,64147,0,0,deny,62,62,0,1,0,1,0
64542,50125,445,0,0,drop,70,70,0,1,0,1,0
64543,50124,445,0,0,drop,70,70,0,1,0,1,0
64544,55182,445,0,0,drop,70,70,0,1,0,1,0
64545,50123,445,0,0,drop,70,70,0,1,0,1,0
64546,49578,80,61645,80,allow,25846,2486,23360,39,50,16,23
64547,50118,445,0,0,drop,70,70,0,1,0,1,0
64548,50119,445,0,0,drop,70,70,0,1,0,1,0
64549,55172,445,0,0,drop,70,70,0,1,0,1,0
64550,55173,445,0,0,drop,70,70,0,1,0,1,0
64551,26573,44847,0,0,deny,66,66,0,1,0,1,0
64552,42469,30188,0,0,deny,62,62,0,1,0,1,0
64553,29145,8168,0,0,deny,62,62,0,1,0,1,0
64554,9775,30188,0,0,deny,62,62,0,1,0,1,0
64555,50578,445,0,0,drop,66,66,0,1,0,1,0
64556,9544,11392,0,0,deny,62,62,0,1,0,1,0
64557,50105,445,0,0,drop,70,70,0,1,0,1,0
64558,50104,445,0,0,drop,70,70,0,1,0,1,0
64559,50100,445,0,0,drop,70,70,0,1,0,1,0
64560,56564,9571,0,0,deny,78,78,0,1,0,1,0
64561,56100,57470,0,0,deny,62,62,0,1,0,1,0
64562,50095,445,0,0,drop,70,70,0,1,0,1,0
64563,50094,445,0,0,drop,70,70,0,1,0,1,0
64564,20939,60461,0,0,deny,60,60,0,1,0,1,0
64565,61357,64147,0,0,deny,62,62,0,1,0,1,0
64566,37234,44847,0,0,deny,66,66,0,1,0,1,0
64567,20939,60461,0,0,deny,60,60,0,1,0,1,0
64568,2904,44847,0,0,deny,78,78,0,1,0,1,0
64569,50571,445,0,0,drop,66,66,0,1,0,1,0
64570,55160,445,0,0,drop,70,70,0,1,0,1,0
64571,2704,37,0,0,deny,60,60,0,1,0,1,0
64572,45941,23386,0,0,deny,60,60,0,1,0,1,0
64573,50568,445,0,0,drop,66,66,0,1,0,1,0
64574,17916,23,0,0,deny,60,60,0,1,0,1,0
64575,50082,445,0,0,drop,70,70,0,1,0,1,0
64576,21294,57470,0,0,deny,62,62,0,1,0,1,0
64577,58715,57470,0,0,deny,66,66,0,1,0,1,0
64578,58635,51505,0,0,deny,62,62,0,1,0,1,0
64579,53353,26467,0,0,deny,62,62,0,1,0,1,0
64580,25342,8168,0,0,deny,66,66,0,1,0,1,0
64581,7916,23,0,0,deny,60,60,0,1,0,1,0
64582,50562,445,0,0,drop,66,66,0,1,0,1,0
64583,51233,43890,0,0,deny,66,66,0,1,0,1,0
64584,62588,57470,0,0,deny,146,146,0,1,0,1,0
64585,50553,445,0,0,drop,66,66,0,1,0,1,0
64586,50078,445,0,0,drop,70,70,0,1,0,1,0
64587,2791,7302,0,0,deny,62,62,0,1,0,1,0
64588,11967,57470,0,0,deny,62,62,0,1,0,1,0
64589,6057,51221,0,0,deny,78,78,0,1,0,1,0
64590,50067,445,0,0,drop,70,70,0,1,0,1,0
64591,50069,445,0,0,drop,70,70,0,1,0,1,0
64592,13160,7905,0,0,deny,62,62,0,1,0,1,0
64593,50065,445,0,0,drop,70,70,0,1,0,1,0
64594,50064,445,0,0,drop,70,70,0,1,0,1,0
64595,55152,445,0,0,drop,70,70,0,1,0,1,0
64596,55148,445,0,0,drop,70,70,0,1,0,1,0
64597,55147,445,0,0,drop,70,70,0,1,0,1,0
64598,55262,44847,0,0,deny,62,62,0,1,0,1,0
64599,50061,445,0,0,drop,70,70,0,1,0,1,0
64600,50546,445,0,0,drop,66,66,0,1,0,1,0
64601,50544,445,0,0,drop,66,66,0,1,0,1,0
64602,50545,445,0,0,drop,66,66,0,1,0,1,0
64603,50543,445,0,0,drop,66,66,0,1,0,1,0
64604,50542,445,0,0,drop,66,66,0,1,0,1,0
64605,50539,445,0,0,drop,66,66,0,1,0,1,0
64606,50540,445,0,0,drop,66,66,0,1,0,1,0
64607,50538,445,0,0,drop,66,66,0,1,0,1,0
64608,13179,57866,0,0,deny,62,62,0,1,0,1,0
64609,42753,56205,0,0,deny,62,62,0,1,0,1,0
64610,61600,56205,0,0,deny,66,66,0,1,0,1,0
64611,57955,44847,0,0,deny,62,62,0,1,0,1,0
64612,59586,57470,0,0,deny,66,66,0,1,0,1,0
64613,443,63113,0,0,deny,100,100,0,1,0,1,0
64614,11136,17500,0,0,deny,145,145,0,1,0,1,0
64615,50055,445,0,0,drop,70,70,0,1,0,1,0
64616,65528,62413,0,0,deny,62,62,0,1,0,1,0
64617,55145,445,0,0,drop,70,70,0,1,0,1,0
64618,55133,445,0,0,drop,70,70,0,1,0,1,0
64619,55131,445,0,0,drop,70,70,0,1,0,1,0
64620,35940,47808,0,0,deny,60,60,0,1,0,1,0
64621,58023,47808,0,0,deny,60,60,0,1,0,1,0
64622,50526,445,0,0,drop,66,66,0,1,0,1,0
64623,50524,445,0,0,drop,66,66,0,1,0,1,0
64624,50525,445,0,0,drop,66,66,0,1,0,1,0
64625,0,0,0,0,allow,600,306,294,6,0,3,3
64626,0,0,0,0,allow,600,306,294,6,0,3,3
64627,0,0,0,0,allow,600,306,294,6,0,3,3
64628,53771,37965,0,0,deny,66,66,0,1,0,1,0
64629,33405,37965,0,0,deny,62,62,0,1,0,1,0
64630,52321,26467,0,0,deny,62,62,0,1,0,1,0
64631,55129,445,0,0,drop,70,70,0,1,0,1,0
64632,50048,445,0,0,drop,70,70,0,1,0,1,0
64633,65493,51221,0,0,deny,62,62,0,1,0,1,0
64634,1487,35440,0,0,deny,146,146,0,1,0,1,0
64635,54346,44847,0,0,deny,66,66,0,1,0,1,0
64636,50046,445,0,0,drop,70,70,0,1,0,1,0
64637,50,64147,0,0,deny,66,66,0,1,0,1,0
64638,55127,445,0,0,drop,70,70,0,1,0,1,0
64639,18592,44612,0,0,deny,62,62,0,1,0,1,0
64640,55123,445,0,0,drop,70,70,0,1,0,1,0
64641,55120,445,0,0,drop,70,70,0,1,0,1,0
64642,55117,445,0,0,drop,70,70,0,1,0,1,0
64643,46627,36237,0,0,deny,62,62,0,1,0,1,0
64644,45941,23388,0,0,deny,60,60,0,1,0,1,0
64645,37213,36237,0,0,deny,66,66,0,1,0,1,0
64646,50041,445,0,0,drop,70,70,0,1,0,1,0
64647,50040,445,0,0,drop,70,70,0,1,0,1,0
64648,57226,51505,0,0,deny,66,66,0,1,0,1,0
64649,3272,1433,0,0,deny,60,60,0,1,0,1,0
64650,26799,50584,0,0,deny,146,146,0,1,0,1,0
64651,60132,50584,0,0,deny,66,66,0,1,0,1,0
64652,50036,445,0,0,drop,70,70,0,1,0,1,0
64653,23650,37807,0,0,deny,66,66,0,1,0,1,0
64654,49812,26467,0,0,deny,62,62,0,1,0,1,0
64655,63786,35440,0,0,deny,66,66,0,1,0,1,0
64656,62569,44847,0,0,deny,66,66,0,1,0,1,0
64657,62348,51221,0,0,deny,72,72,0,1,0,1,0
64658,50035,445,0,0,drop,70,70,0,1,0,1,0
64659,55109,445,0,0,drop,70,70,0,1,0,1,0
64660,55108,445,0,0,drop,70,70,0,1,0,1,0
64661,55103,445,0,0,drop,70,70,0,1,0,1,0
64662,47832,50584,0,0,deny,62,62,0,1,0,1,0
64663,6666,3389,0,0,deny,60,60,0,1,0,1,0
64664,8999,57470,0,0,deny,146,146,0,1,0,1,0
64665,15313,34068,0,0,deny,146,146,0,1,0,1,0
64666,50030,445,0,0,drop,70,70,0,1,0,1,0
64667,19099,56205,0,0,deny,62,62,0,1,0,1,0
64668,42298,4126,11425,4126,allow,132,64,68,2,30,1,1
64669,50450,80,35672,80,allow,2781,563,2218,11,125,6,5
64670,53189,80,57818,80,allow,1873,713,1160,10,15,5,5
64671,48757,443,52585,443,allow,6353,1075,5278,18,33,10,8
64672,50334,443,44789,443,allow,8863,1567,7296,24,41,12,12
64673,50348,443,42997,443,allow,1385,868,517,12,30,6,6
64674,50017,443,23366,443,allow,56408,47400,9008,88,138,49,39
64675,58196,53,55117,53,allow,578,286,292,9,16,5,4
64676,48758,443,1312,443,allow,6353,1075,5278,18,33,10,8
64677,50388,443,13080,443,allow,6734,4301,2433,21,29,12,9
64678,53525,34759,57554,34759,allow,70,70,0,2,8,2,0
64679,57957,80,26267,80,allow,3524,1945,1579,32,131,17,15
64680,54192,443,18650,443,allow,17821,7006,10815,95,448,48,47
64681,42298,40018,41162,40018,allow,629,83,546,4,31,2,2
64682,57170,53,64269,53,allow,200,102,98,2,31,1,1
64683,50451,80,13158,80,allow,2673,564,2109,11,125,6,5
64684,42298,58000,33594,58000,allow,596,256,340,10,30,5,5
64685,61484,443,59400,443,allow,9479,3507,5972,24,16,12,12
64686,53191,80,63359,80,allow,1871,712,1159,10,15,5,5
64687,42298,40023,18178,40023,allow,1531,729,802,10,31,5,5
64688,42298,40023,34639,40023,allow,1188,567,621,6,31,3,3
64689,59513,53,30834,53,allow,212,92,120,2,30,1,1
64690,57200,53,48391,53,allow,711,87,624,2,30,1,1
64691,35041,80,18613,80,allow,3515,1137,2378,12,30,7,5
64692,42298,40029,57945,40029,allow,652,83,569,4,31,2,2
64693,50391,443,17235,443,allow,5968,985,4983,17,29,8,9
64694,27735,53,27735,53,allow,235,90,145,2,32,1,1
64695,39200,443,57759,443,allow,8918,2361,6557,35,255,18,17
64696,53524,45395,6631,45395,allow,70,70,0,2,8,2,0
64697,49473,80,51676,80,allow,388,262,126,7,29,5,2
64698,48754,443,18594,443,allow,6490,1145,5345,20,33,11,9
64699,50336,443,6025,443,allow,8814,1579,7235,24,41,12,12
64700,50347,443,6764,443,allow,1385,868,517,12,30,6,6
64701,48755,443,25931,443,allow,6423,1145,5278,19,33,11,8
64702,53190,80,50867,80,allow,1873,713,1160,10,15,5,5
64703,49272,7000,49272,7000,allow,3132,815,2317,14,15,7,7
64704,54942,53,0,0,allow,631,74,557,2,30,1,1
64705,50028,443,29629,443,allow,15425,9901,5524,33,84,17,16
64706,57866,53,0,0,allow,216,80,136,2,30,1,1
64707,5588,5588,0,0,allow,3562,1936,1626,48,195,24,24
64708,42298,40009,62202,40009,allow,148,86,62,2,30,1,1
64709,55587,32217,8141,32217,allow,320,140,180,6,6,3,3
64710,50373,443,36496,443,allow,4695,859,3836,17,30,9,8
64711,50374,443,25596,443,allow,4749,859,3890,18,30,9,9
64712,50349,443,62395,443,allow,1385,868,517,12,30,6,6
64713,60424,443,16988,443,allow,1477,940,537,13,26,7,6
64714,50345,443,44342,443,allow,1385,868,517,12,30,6,6
64715,33818,443,39799,443,allow,16265,3132,13133,54,276,26,28
64716,50375,443,20024,443,allow,4707,865,3842,17,30,9,8
64717,50346,443,6974,443,allow,1385,868,517,12,30,6,6
64718,42298,40040,5414,40040,allow,140,78,62,2,30,1,1
64719,48756,443,37837,443,allow,6353,1075,5278,18,33,10,8
64720,42298,40027,29472,40027,allow,144,82,62,2,30,1,1
64721,5588,5588,0,0,allow,3498,1872,1626,48,195,24,24
64722,42298,40008,56571,40008,allow,206,84,122,4,31,2,2
64723,123,123,49338,123,allow,184,94,90,2,30,1,1
64724,59390,53,43106,53,allow,184,86,98,2,31,1,1
64725,49608,53,10158,53,allow,170,87,83,2,31,1,1
64726,55179,53,36377,53,allow,188,96,92,2,31,1,1
64727,49160,9703,22798,9703,allow,842,150,692,4,1200,2,2
64728,61741,443,4502,443,allow,68851,3430,65421,93,121,35,58
64729,57470,5382,65418,5382,allow,2411,1328,1083,19,1200,11,8
64730,53500,443,28730,443,allow,3036,975,2061,14,136,7,7
64731,50503,445,0,0,drop,66,66,0,1,0,1,0
64732,57750,37965,0,0,deny,62,62,0,1,0,1,0
64733,55100,445,0,0,drop,70,70,0,1,0,1,0
64734,55099,445,0,0,drop,70,70,0,1,0,1,0
64735,51197,30188,0,0,deny,66,66,0,1,0,1,0
64736,44746,37965,0,0,deny,62,62,0,1,0,1,0
64737,42298,25161,56288,25161,allow,138,70,68,2,30,1,1
64738,65196,53,4463,53,allow,177,94,83,2,30,1,1
64739,64369,53,59649,53,allow,240,110,130,2,30,1,1
64740,35414,53,44913,53,allow,168,78,90,2,30,1,1
64741,50876,443,55719,443,allow,1786,172,1614,7,120,3,4
64742,55718,27025,19303,27025,allow,1778,1386,392,8,30,4,4
64743,38167,443,36158,443,allow,6150,914,5236,18,16,10,8
64744,48731,443,51910,443,allow,769074,31261,737813,876,165,356,520
64745,51861,53,51861,53,allow,305,160,145,3,33,2,1
64746,63727,61557,39781,61557,allow,312,132,180,6,6,3,3
64747,63976,53,54023,53,allow,200,102,98,2,33,1,1
64748,42298,40028,3543,40028,allow,148,86,62,2,29,1,1
64749,62332,53,0,0,allow,633,75,558,2,29,1,1
64750,65196,53,58386,53,allow,177,94,83,2,30,1,1
64751,49935,53,55130,53,allow,458,111,347,4,59,2,2
64752,50305,80,32825,80,allow,5500,2829,2671,19,34,10,9
64753,53527,45626,48951,45626,allow,70,70,0,2,7,2,0
64754,50875,80,60669,80,allow,141059,7791,133268,168,140,72,96
64755,48726,443,17212,443,allow,6644134,184008,6460126,6659,204,2197,4462
64756,50931,80,59351,80,allow,7978844,97517,7881327,6752,120,1393,5359
64757,60406,443,21053,443,allow,8404,1892,6512,23,30,12,11
64758,33664,80,64127,80,allow,3667,1654,2013,20,189,11,9
64759,53530,8999,38471,8999,allow,70,70,0,2,7,2,0
64760,49838,53,62523,53,allow,866,221,645,6,56,3,3
64761,42298,40005,13329,40005,allow,148,86,62,2,29,1,1
64762,1156,53,45394,53,allow,278,86,192,2,29,1,1
64763,64250,53,22733,53,allow,314,102,212,2,29,1,1
64764,62486,53,33326,53,allow,303,303,0,4,47,4,0
64765,64284,53,35627,53,allow,306,94,212,2,29,1,1
64766,52107,53,0,0,allow,621,77,544,2,29,1,1
64767,65482,53,17558,53,allow,278,126,152,2,30,1,1
64768,42019,443,22698,443,allow,21620,7973,13647,112,488,57,55
64769,55577,80,44269,80,allow,70,70,0,1,5,1,0
64770,56751,32300,2097,32300,allow,70,70,0,1,5,1,0
64771,38258,443,9287,443,allow,5714,1536,4178,24,21,13,11
64772,49901,7000,49901,7000,allow,3310,1535,1775,15,15,8,7
64773,53737,443,33568,443,allow,12192,3674,8518,53,454,26,27
64774,49415,443,33045,443,allow,29561,4857,24704,44,44,15,29
64775,42298,40016,11792,40016,allow,148,86,62,2,30,1,1
64776,42298,40016,13493,40016,allow,148,86,62,2,30,1,1
64777,42298,443,6175,443,allow,70,70,0,1,30,1,0
64778,53182,443,48630,443,allow,6094,1073,5021,19,15,10,9
64779,51499,443,64851,443,allow,43980,3500,40480,65,16,31,34
64780,54991,53,33819,53,allow,177,94,83,2,30,1,1
64781,52021,443,14701,443,allow,7508,2350,5158,37,1323,21,16
64782,42298,40039,27373,40039,allow,148,86,62,2,30,1,1
64783,52394,53,35816,53,allow,168,78,90,2,30,1,1
64784,57353,443,37638,443,allow,150,150,0,1,5,1,0
64785,51498,443,51057,443,allow,29265,2836,26429,47,16,21,26
64786,50893,80,33062,80,allow,149442,8423,141019,177,140,76,101
64787,50390,443,34358,443,allow,1328,876,452,11,29,6,5
64788,50401,443,36442,443,allow,1124,594,530,12,26,6,6
64789,50398,80,47950,80,allow,318,192,126,6,26,4,2
64790,50400,443,29231,443,allow,1124,594,530,12,26,6,6
64791,50379,443,5364,443,allow,6748,1843,4905,21,29,11,10
64792,49472,80,16724,80,allow,318,192,126,6,28,4,2
64793,2582,80,2582,80,allow,8395,700,7695,17,15,8,9
64794,50395,443,41606,443,allow,6205,2761,3444,25,28,14,11
64795,50394,443,25886,443,allow,7584,1848,5736,19,29,10,9
64796,39609,53,46701,53,allow,168,78,90,2,30,1,1
64797,34531,80,18192,80,allow,467664,17895,449769,610,355,265,345
64798,35814,443,26348,443,allow,5205,1251,3954,18,15,10,8
64799,39158,53,23110,53,allow,168,78,90,2,30,1,1
64800,64803,53,24000,53,allow,303,303,0,4,47,4,0
64801,50914,443,65485,443,allow,6813,1729,5084,18,16,10,8
64802,42222,53,45931,53,allow,209,86,123,2,30,1,1
64803,56825,53,3164,53,allow,177,94,83,2,30,1,1
64804,39684,443,56331,443,allow,5150,853,4297,16,34,9,7
64805,57839,53,57631,53,allow,231,231,0,4,47,4,0
64806,42298,40008,65439,40008,allow,140,78,62,2,30,1,1
64807,55776,53,24282,53,allow,168,78,90,2,30,1,1
64808,42298,40001,45646,40001,allow,156,94,62,2,30,1,1
64809,49855,53,54307,53,allow,212,102,110,2,30,1,1
64810,65445,53,5000,53,allow,718,94,624,2,30,1,1
64811,34430,53,54160,53,allow,199,94,105,2,30,1,1
64812,57031,443,21412,443,allow,2963,797,2166,10,120,5,5
64813,42298,40033,43978,40033,allow,245,182,63,2,30,1,1
64814,33107,443,4785,443,allow,3820081,140348,3679733,4457,136,1736,2721
64815,50444,443,13843,443,allow,5593,996,4597,22,127,11,11
64816,49832,443,25686,443,allow,8589,2871,5718,26,46,14,12
64817,50392,443,55310,443,allow,1125,595,530,12,29,6,6
64818,50411,80,65137,80,allow,1657,1246,411,8,15,5,3
64819,61229,53,16392,53,allow,261,261,0,4,47,4,0
64820,59615,53,32493,53,allow,320,94,226,2,30,1,1
64821,56825,53,56167,53,allow,177,94,83,2,30,1,1
64822,42298,40031,8368,40031,allow,157,94,63,2,30,1,1
64823,57170,53,47776,53,allow,200,102,98,2,30,1,1
64824,50393,443,64712,443,allow,1125,595,530,12,29,6,6
64825,50888,80,61019,80,allow,538995,15959,523036,552,140,201,351
64826,50165,80,3536,80,allow,17387,9304,8083,30,56,19,11
64827,41049,443,3441,443,allow,197239,6098,191141,213,170,75,138
64828,50915,443,63177,443,allow,9599,3465,6134,20,16,11,9
64829,40189,80,30791,80,allow,5043,1656,3387,18,205,10,8
64830,50879,80,6049,80,allow,15453,3281,12172,29,140,16,13
64831,56891,53,55899,53,allow,226,110,116,2,30,1,1
64832,64737,53,9334,53,allow,269,110,159,2,30,1,1
64833,42298,40042,19672,40042,allow,148,86,62,2,30,1,1
64834,42298,40016,35583,40016,allow,157,94,63,2,30,1,1
64835,52724,80,24269,80,allow,9532,745,8787,18,113,9,9
64836,42657,443,20758,443,allow,10204,2106,8098,37,255,19,18
64837,51502,443,28500,443,allow,10204,5034,5170,45,16,25,20
64838,56758,40000,32207,40000,allow,70,70,0,2,8,2,0
64839,56568,53,11893,53,allow,306,306,0,4,47,4,0
64840,35497,443,49704,443,allow,162,102,60,2,4,1,1
64841,51695,37590,12016,37590,allow,70,70,0,1,5,1,0
64842,55575,31948,50458,31948,allow,70,70,0,1,5,1,0
64843,47264,80,26226,80,allow,1737,796,941,12,16,7,5
64844,50542,443,16831,443,allow,5347,2537,2810,17,120,8,9
64845,50947,80,65255,80,allow,5427472,61630,5365842,4509,79,894,3615
64846,64842,53,15693,53,allow,340,95,245,4,47,2,2
64847,50945,80,53857,80,allow,6920116,91852,6828264,6765,79,1277,5488
64848,50399,80,19756,80,allow,318,192,126,6,26,4,2
64849,51157,443,53993,443,allow,5378,1423,3955,19,22,11,8
64850,42658,443,41427,443,allow,10170,2072,8098,37,255,19,18
64851,50292,80,5743,80,allow,442,250,192,8,44,5,3
64852,53520,37553,50212,37553,allow,70,70,0,2,7,2,0
64853,53528,20485,38765,20485,allow,70,70,0,2,7,2,0
64854,53531,48908,54109,48908,allow,70,70,0,2,7,2,0
64855,48729,443,23852,443,allow,8504354,221135,8283219,8447,196,2721,5726
64856,51500,443,12798,443,allow,49843,3506,46337,77,16,39,38
64857,65447,53,29961,53,allow,330,105,225,4,37,2,2
64858,51630,80,41968,80,allow,7679,5325,2354,15,29,8,7
64859,62597,53,49610,53,allow,306,306,0,4,47,4,0
64860,49827,443,4607,443,allow,21625,7638,13987,45,48,24,21
64861,50913,443,27670,443,allow,5057,851,4206,15,16,9,6
64862,42298,40009,56378,40009,allow,148,86,62,2,29,1,1
64863,50894,80,18419,80,allow,53024,5569,47455,72,140,35,37
64864,27288,53,2459,53,allow,199,94,105,2,30,1,1
64865,43057,80,9462,80,allow,1195,401,794,9,16,5,4
64866,62332,53,0,0,allow,170,75,95,2,29,1,1
64867,52107,53,0,0,allow,210,77,133,2,29,1,1
64868,57866,53,0,0,allow,627,80,547,2,29,1,1
64869,50388,53,14304,53,allow,177,94,83,2,29,1,1
64870,42298,40012,32444,40012,allow,148,86,62,2,29,1,1
64871,42298,40031,50162,40031,allow,1341,657,684,8,30,4,4
64872,46295,443,11323,443,allow,9938,1398,8540,9,128,1,8
64873,42298,40034,23763,40034,allow,588,86,502,2,30,1,1
64874,42298,40013,37939,40013,allow,205,83,122,4,30,2,2
64875,55875,53,42726,53,allow,228,110,118,2,30,1,1
64876,42298,40023,18406,40023,allow,1487,743,744,10,30,5,5
64877,30188,36914,20864,36914,allow,2668,1950,718,16,7827,14,2
64878,42298,40003,32102,40003,allow,206,84,122,4,30,2,2
64879,51576,443,48626,443,allow,21523,4681,16842,37,149,18,19
64880,44816,80,47339,80,allow,130,70,60,2,15,1,1
64881,56752,43888,19580,43888,allow,70,70,0,1,5,1,0
64882,53185,443,12844,443,allow,8020,1134,6886,23,15,11,12
64883,54951,443,4064,443,allow,30123,21849,8274,65,77,38,27
64884,51496,443,41580,443,allow,1177,624,553,12,16,7,5
64885,53183,443,26366,443,allow,6094,1073,5021,19,15,10,9
64886,50958,53,30226,53,allow,264,264,0,4,47,4,0
64887,53986,53,63410,53,allow,306,306,0,4,47,4,0
64888,42298,40031,17629,40031,allow,148,86,62,2,30,1,1
64889,53789,53,48550,53,allow,168,78,90,2,30,1,1
64890,52074,53,21333,53,allow,199,94,105,2,30,1,1
64891,42298,40022,65114,40022,allow,148,86,62,2,30,1,1
64892,55866,53,14599,53,allow,168,78,90,2,30,1,1
64893,42298,40037,29650,40037,allow,208,86,122,4,30,2,2
64894,50407,80,54250,80,allow,1388,917,471,11,26,6,5
64895,53105,61310,38041,61310,allow,70,70,0,1,5,1,0
64896,51696,14370,13279,14370,allow,70,70,0,1,5,1,0
64897,41050,443,28705,443,allow,137809,4697,133112,153,170,55,98
64898,55593,53,39878,53,allow,288,288,0,4,47,4,0
64899,55610,53,57817,53,allow,181,94,87,2,30,1,1
64900,57171,53,25491,53,allow,214,102,112,2,30,1,1
64901,49197,53,54717,53,allow,214,102,112,2,30,1,1
64902,52838,53,22296,53,allow,168,78,90,2,30,1,1
64903,42140,443,52282,443,allow,12322,3893,8429,28,139,13,15
64904,50891,80,64394,80,allow,136656,9764,126892,162,140,70,92
64905,51721,35426,42015,35426,allow,70,70,0,2,8,2,0
64906,56745,56518,23267,56518,allow,1556,588,968,11,16,6,5
64907,58472,53,35113,53,allow,246,246,0,4,47,4,0
64908,42298,40013,31078,40013,allow,140,78,62,2,30,1,1
64909,42298,40022,27294,40022,allow,156,94,62,2,30,1,1
64910,64237,53,49326,53,allow,227,110,117,2,31,1,1
64911,57470,39608,19893,39608,allow,330,330,0,6,1199,6,0
64912,49608,53,36244,53,allow,177,94,83,2,31,1,1
64913,42632,443,43354,443,allow,4299,1870,2429,17,150,8,9
64914,62197,443,16977,443,allow,3937,1210,2727,18,134,8,10
64915,57470,58210,46855,58210,allow,2118,858,1260,28,1261,14,14
64916,64994,443,32046,443,allow,3547,1351,2196,17,135,8,9
64917,61636,25735,61636,25735,allow,3828,1516,2312,29,5271,18,11
64918,61279,443,45971,443,allow,4076,1378,2698,14,136,7,7
64919,19473,6889,17971,6889,allow,481,150,331,2,1200,1,1
64920,53514,8999,20953,8999,allow,70,70,0,1,5,1,0
64921,49950,80,40840,80,allow,51651,48866,2785,74,20,38,36
64922,56735,53283,31023,53283,allow,4188,1648,2540,17,19,9,8
64923,50922,80,57250,80,allow,9219616,105865,9113751,7687,120,1487,6200
64924,55664,53,23659,53,allow,177,94,83,2,30,1,1
64925,63705,19652,30539,19652,allow,70,70,0,1,5,1,0
64926,45813,5222,28803,5222,allow,5723,3023,2700,58,548,32,26
64927,50872,80,50084,80,allow,54441,4387,50054,75,140,37,38
64928,55708,8060,17338,8060,allow,70,70,0,1,5,1,0
64929,51401,443,22599,443,allow,202,70,132,3,11,1,2
64930,37953,1935,23472,1935,allow,3623810,67493,3556317,3486,35,943,2543
64931,42298,40039,40294,40039,allow,211,89,122,4,30,2,2
64932,42298,40035,3337,40035,allow,207,85,122,4,30,2,2
64933,46346,35440,0,0,deny,66,66,0,1,0,1,0
64934,25363,23,0,0,deny,60,60,0,1,0,1,0
64935,56405,62413,0,0,deny,66,66,0,1,0,1,0
64936,45908,3383,0,0,deny,60,60,0,1,0,1,0
64937,47020,2323,0,0,deny,60,60,0,1,0,1,0
64938,50497,445,0,0,drop,66,66,0,1,0,1,0
64939,50017,445,0,0,drop,70,70,0,1,0,1,0
64940,61329,51505,0,0,deny,66,66,0,1,0,1,0
64941,6881,33720,0,0,deny,157,157,0,1,0,1,0
64942,50494,445,0,0,drop,66,66,0,1,0,1,0
64943,55088,445,0,0,drop,70,70,0,1,0,1,0
64944,6881,6881,0,0,deny,146,146,0,1,0,1,0
64945,55084,445,0,0,drop,70,70,0,1,0,1,0
64946,55083,445,0,0,drop,70,70,0,1,0,1,0
64947,55081,445,0,0,drop,70,70,0,1,0,1,0
64948,50490,445,0,0,drop,66,66,0,1,0,1,0
64949,50014,445,0,0,drop,70,70,0,1,0,1,0
64950,57434,50584,0,0,deny,62,62,0,1,0,1,0
64951,1574,50584,0,0,deny,62,62,0,1,0,1,0
64952,18624,29434,0,0,deny,148,148,0,1,0,1,0
64953,11842,35440,0,0,deny,66,66,0,1,0,1,0
64954,49747,37965,0,0,deny,62,62,0,1,0,1,0
64955,55701,55777,0,0,deny,62,62,0,1,0,1,0
64956,55075,445,0,0,drop,70,70,0,1,0,1,0
64957,34914,25604,0,0,deny,145,145,0,1,0,1,0
64958,59785,14914,0,0,deny,143,143,0,1,0,1,0
64959,50010,445,0,0,drop,70,70,0,1,0,1,0
64960,55072,445,0,0,drop,70,70,0,1,0,1,0
64961,55070,445,0,0,drop,70,70,0,1,0,1,0
64962,55068,445,0,0,drop,70,70,0,1,0,1,0
64963,17702,6881,0,0,deny,66,66,0,1,0,1,0
64964,58912,11392,0,0,deny,66,66,0,1,0,1,0
64965,50008,445,0,0,drop,70,70,0,1,0,1,0
64966,50483,445,0,0,drop,66,66,0,1,0,1,0
64967,43271,50584,0,0,deny,62,62,0,1,0,1,0
64968,6666,21,0,0,deny,60,60,0,1,0,1,0
64969,50482,445,0,0,drop,66,66,0,1,0,1,0
64970,50479,445,0,0,drop,66,66,0,1,0,1,0
64971,50477,445,0,0,drop,66,66,0,1,0,1,0
64972,50006,445,0,0,drop,70,70,0,1,0,1,0
64973,50475,445,0,0,drop,66,66,0,1,0,1,0
64974,50474,445,0,0,drop,66,66,0,1,0,1,0
64975,50472,445,0,0,drop,66,66,0,1,0,1,0
64976,41447,26467,0,0,deny,62,62,0,1,0,1,0
64977,30114,65151,0,0,deny,60,60,0,1,0,1,0
64978,64106,64147,0,0,deny,66,66,0,1,0,1,0
64979,33498,5529,0,0,deny,145,145,0,1,0,1,0
64980,47398,7302,0,0,deny,62,62,0,1,0,1,0
64981,55066,445,0,0,drop,70,70,0,1,0,1,0
64982,55064,445,0,0,drop,70,70,0,1,0,1,0
64983,55060,445,0,0,drop,70,70,0,1,0,1,0
64984,40500,48009,0,0,deny,146,146,0,1,0,1,0
64985,11136,15503,0,0,deny,62,62,0,1,0,1,0
64986,50469,445,0,0,drop,66,66,0,1,0,1,0
64987,55059,445,0,0,drop,70,70,0,1,0,1,0
64988,4817,11392,0,0,deny,146,146,0,1,0,1,0
64989,50467,445,0,0,drop,66,66,0,1,0,1,0
64990,49999,445,0,0,drop,70,70,0,1,0,1,0
64991,50465,445,0,0,drop,66,66,0,1,0,1,0
64992,50464,445,0,0,drop,66,66,0,1,0,1,0
64993,49997,445,0,0,drop,70,70,0,1,0,1,0
64994,443,43775,0,0,deny,97,97,0,1,0,1,0
64995,50461,445,0,0,drop,66,66,0,1,0,1,0
64996,45908,33330,0,0,deny,60,60,0,1,0,1,0
64997,50386,22114,0,0,deny,66,66,0,1,0,1,0
64998,42576,30188,0,0,deny,146,146,0,1,0,1,0
64999,59477,36829,0,0,deny,66,66,0,1,0,1,0
65000,49996,445,0,0,drop,70,70,0,1,0,1,0
65001,9544,7302,0,0,deny,62,62,0,1,0,1,0
65002,49995,445,0,0,drop,70,70,0,1,0,1,0
65003,49994,445,0,0,drop,70,70,0,1,0,1,0
65004,49992,445,0,0,drop,70,70,0,1,0,1,0
65005,49988,445,0,0,drop,70,70,0,1,0,1,0
65006,26792,37965,0,0,deny,62,62,0,1,0,1,0
65007,58725,7302,0,0,deny,66,66,0,1,0,1,0
65008,55055,445,0,0,drop,70,70,0,1,0,1,0
65009,37837,37965,0,0,deny,62,62,0,1,0,1,0
65010,55049,445,0,0,drop,70,70,0,1,0,1,0
65011,55044,445,0,0,drop,70,70,0,1,0,1,0
65012,35718,20238,0,0,deny,62,62,0,1,0,1,0
65013,50113,51505,0,0,deny,66,66,0,1,0,1,0
65014,49976,445,0,0,drop,70,70,0,1,0,1,0
65015,49975,445,0,0,drop,70,70,0,1,0,1,0
65016,19394,44847,0,0,deny,66,66,0,1,0,1,0
65017,53710,443,55386,443,allow,499,425,74,4,0,3,1
65018,53711,443,24841,443,allow,499,425,74,4,0,3,1
65019,53706,443,53579,443,allow,499,425,74,4,0,3,1
65020,53705,443,11151,443,allow,499,425,74,4,0,3,1
65021,49973,445,0,0,drop,70,70,0,1,0,1,0
65022,50453,445,0,0,drop,66,66,0,1,0,1,0
65023,49965,445,0,0,drop,70,70,0,1,0,1,0
65024,49966,445,0,0,drop,70,70,0,1,0,1,0
65025,37538,37965,0,0,deny,66,66,0,1,0,1,0
65026,20706,37965,0,0,deny,62,62,0,1,0,1,0
65027,2919,57866,0,0,deny,66,66,0,1,0,1,0
65028,3428,22,0,0,deny,60,60,0,1,0,1,0
65029,19963,2767,0,0,deny,66,66,0,1,0,1,0
65030,22683,39210,0,0,deny,60,60,0,1,0,1,0
65031,42969,8146,0,0,deny,62,62,0,1,0,1,0
65032,62632,35440,0,0,deny,66,66,0,1,0,1,0
65033,51973,44847,0,0,deny,66,66,0,1,0,1,0
65034,50443,445,0,0,drop,66,66,0,1,0,1,0
65035,42285,57470,0,0,deny,62,62,0,1,0,1,0
65036,55031,445,0,0,drop,70,70,0,1,0,1,0
65037,16762,61689,0,0,deny,62,62,0,1,0,1,0
65038,15793,64147,0,0,deny,66,66,0,1,0,1,0
65039,49954,445,0,0,drop,70,70,0,1,0,1,0
65040,6057,51221,0,0,deny,78,78,0,1,0,1,0
65041,50441,445,0,0,drop,66,66,0,1,0,1,0
65042,52780,37965,0,0,deny,66,66,0,1,0,1,0
65043,50432,445,0,0,drop,66,66,0,1,0,1,0
65044,50424,445,0,0,drop,66,66,0,1,0,1,0
65045,59374,51505,0,0,deny,62,62,0,1,0,1,0
65046,49950,445,0,0,drop,70,70,0,1,0,1,0
65047,56396,5900,0,0,deny,60,60,0,1,0,1,0
65048,58318,15503,0,0,deny,66,66,0,1,0,1,0
65049,63331,51221,0,0,deny,62,62,0,1,0,1,0
65050,49941,445,0,0,drop,70,70,0,1,0,1,0
65051,49939,445,0,0,drop,70,70,0,1,0,1,0
65052,49935,445,0,0,drop,70,70,0,1,0,1,0
65053,49936,445,0,0,drop,70,70,0,1,0,1,0
65054,49570,5900,0,0,deny,60,60,0,1,0,1,0
65055,49934,445,0,0,drop,70,70,0,1,0,1,0
65056,55024,445,0,0,drop,70,70,0,1,0,1,0
65057,55021,445,0,0,drop,70,70,0,1,0,1,0
65058,55019,445,0,0,drop,70,70,0,1,0,1,0
65059,43611,61903,0,0,deny,148,148,0,1,0,1,0
65060,56927,64147,0,0,deny,145,145,0,1,0,1,0
65061,50413,445,0,0,drop,66,66,0,1,0,1,0
65062,50418,445,0,0,drop,66,66,0,1,0,1,0
65063,50416,445,0,0,drop,66,66,0,1,0,1,0
65064,50417,445,0,0,drop,66,66,0,1,0,1,0
65065,50415,445,0,0,drop,66,66,0,1,0,1,0
65066,50414,445,0,0,drop,66,66,0,1,0,1,0
65067,50412,445,0,0,drop,66,66,0,1,0,1,0
65068,50411,445,0,0,drop,66,66,0,1,0,1,0
65069,0,0,0,0,allow,320,320,0,5,0,5,0
65070,3630,26467,0,0,deny,66,66,0,1,0,1,0
65071,25739,64147,0,0,deny,62,62,0,1,0,1,0
65072,6916,52700,0,0,deny,100,100,0,1,0,1,0
65073,3407,57866,0,0,deny,66,66,0,1,0,1,0
65074,64191,44847,0,0,deny,66,66,0,1,0,1,0
65075,10921,19847,0,0,deny,62,62,0,1,0,1,0
65076,63503,42707,0,0,deny,66,66,0,1,0,1,0
65077,12668,42707,0,0,deny,62,62,0,1,0,1,0
65078,59586,56205,0,0,deny,62,62,0,1,0,1,0
65079,49927,445,0,0,drop,70,70,0,1,0,1,0
65080,16059,22114,0,0,deny,146,146,0,1,0,1,0
65081,41812,8080,0,0,deny,60,60,0,1,0,1,0
65082,41813,8080,0,0,deny,60,60,0,1,0,1,0
65083,55012,445,0,0,drop,70,70,0,1,0,1,0
65084,55010,445,0,0,drop,70,70,0,1,0,1,0
65085,55003,445,0,0,drop,70,70,0,1,0,1,0
65086,29022,23,0,0,deny,60,60,0,1,0,1,0
65087,49818,37965,0,0,deny,66,66,0,1,0,1,0
65088,49920,445,0,0,drop,70,70,0,1,0,1,0
65089,50397,445,0,0,drop,66,66,0,1,0,1,0
65090,50398,445,0,0,drop,66,66,0,1,0,1,0
65091,50395,445,0,0,drop,66,66,0,1,0,1,0
65092,49917,445,0,0,drop,70,70,0,1,0,1,0
65093,26497,64147,0,0,deny,66,66,0,1,0,1,0
65094,54955,7302,0,0,deny,62,62,0,1,0,1,0
65095,55001,445,0,0,drop,70,70,0,1,0,1,0
65096,54999,445,0,0,drop,70,70,0,1,0,1,0
65097,49913,445,0,0,drop,70,70,0,1,0,1,0
65098,54997,445,0,0,drop,70,70,0,1,0,1,0
65099,54993,445,0,0,drop,70,70,0,1,0,1,0
65100,54991,445,0,0,drop,70,70,0,1,0,1,0
65101,49912,445,0,0,drop,70,70,0,1,0,1,0
65102,55878,7302,0,0,deny,66,66,0,1,0,1,0
65103,30559,64147,0,0,deny,62,62,0,1,0,1,0
65104,36727,443,3578,443,allow,27009,7414,19595,46,122,21,25
65105,63708,29685,60492,29685,allow,66,66,0,1,5,1,0
65106,50304,443,23238,443,allow,3565,1947,1618,19,15,9,10
65107,5588,5588,0,0,allow,3562,1936,1626,48,195,24,24
65108,59735,443,59735,443,allow,4730,1823,2907,19,28,11,8
65109,49181,443,9716,443,allow,50097,3666,46431,79,256,36,43
65110,56980,53,42285,53,allow,267,87,180,4,38,2,2
65111,51719,13715,5835,13715,allow,70,70,0,2,8,2,0
65112,61474,443,20361,443,allow,114674,4457,110217,127,48,46,81
65113,61483,443,51261,443,allow,107901,5004,102897,127,46,53,74
65114,5588,5588,0,0,allow,3562,1936,1626,48,192,24,24
65115,51718,55003,38571,55003,allow,70,70,0,2,8,2,0
65116,59646,5223,10066,5223,allow,139,139,0,1,5,1,0
65117,44223,443,7488,443,allow,63895,4604,59291,80,276,34,46
65118,63697,25010,4091,25010,allow,504,382,122,8,16,6,2
65119,56689,53,4538,53,allow,177,91,86,3,38,2,1
65120,53486,443,39031,443,allow,8879,2420,6459,32,255,17,15
65121,14112,443,14112,443,allow,25629,5823,19806,44,179,25,19
65122,50303,443,45984,443,allow,3051,1801,1250,18,15,8,10
65123,44908,443,9126,443,allow,2931,1940,991,19,25,10,9
65124,56748,35148,18439,35148,allow,66,66,0,1,5,1,0
65125,48979,15000,58069,15000,allow,130,70,60,2,5,1,1
65126,51692,25565,11654,25565,allow,66,66,0,1,5,1,0
65127,56747,42333,2469,42333,allow,66,66,0,1,5,1,0
65128,52862,80,51424,80,allow,3150,1478,1672,32,131,17,15
65129,41610,443,48992,443,allow,9488,2196,7292,25,26,14,11
65130,61478,443,38710,443,allow,45313,3360,41953,61,47,26,35
65131,61479,443,17440,443,allow,104543,5227,99316,130,47,57,73
65132,60492,443,48948,443,allow,81016,8373,72643,122,339,57,65
65133,42298,40026,9867,40026,allow,212,90,122,4,30,2,2
65134,58301,53,36478,53,allow,233,102,131,2,30,1,1
65135,61482,443,17696,443,allow,49181,3553,45628,65,46,29,36
65136,63834,27037,60626,27037,allow,1592,1386,206,6,31,4,2
65137,49900,7000,49900,7000,allow,2958,1567,1391,15,15,8,7
65138,51717,63436,12791,63436,allow,70,70,0,2,8,2,0
65139,61477,443,48304,443,allow,30516,3311,27205,49,47,25,24
65140,52694,443,37161,443,allow,10384,4563,5821,34,436,17,17
65141,47362,443,49001,443,allow,8263,2100,6163,34,255,16,18
65142,63683,20299,57737,20299,allow,502,380,122,7,19,5,2
65143,51002,443,58115,443,allow,3536,2198,1338,18,332,9,9
65144,1063,7302,0,0,deny,62,62,0,1,0,1,0
65145,58099,44847,0,0,deny,62,62,0,1,0,1,0
65146,33215,37965,0,0,deny,62,62,0,1,0,1,0
65147,59037,28370,0,0,deny,62,62,0,1,0,1,0
65148,32974,37965,0,0,deny,66,66,0,1,0,1,0
65149,45941,23386,0,0,deny,60,60,0,1,0,1,0
65150,37230,554,0,0,deny,60,60,0,1,0,1,0
65151,49908,445,0,0,drop,70,70,0,1,0,1,0
65152,18889,50584,0,0,deny,146,146,0,1,0,1,0
65153,46090,50584,0,0,deny,66,66,0,1,0,1,0
65154,12549,50265,0,0,deny,146,146,0,1,0,1,0
65155,49907,445,0,0,drop,70,70,0,1,0,1,0
65156,60223,67,0,0,deny,60,60,0,1,0,1,0
65157,1446,35440,0,0,deny,66,66,0,1,0,1,0
65158,54981,445,0,0,drop,70,70,0,1,0,1,0
65159,54979,445,0,0,drop,70,70,0,1,0,1,0
65160,54975,445,0,0,drop,70,70,0,1,0,1,0
65161,62673,34159,0,0,deny,66,66,0,1,0,1,0
65162,49900,4500,1746,4500,allow,78,78,0,1,5,1,0
65163,53098,30840,23341,30840,allow,898,454,444,13,22,8,5
65164,37571,53,19977,53,allow,164,78,86,2,30,1,1
65165,61030,53,15331,53,allow,167,78,89,2,30,1,1
65166,49414,443,63863,443,allow,43326,4905,38421,56,43,16,40
65167,62592,443,27957,443,allow,11741,7040,4701,40,172,22,18
65168,56689,53,17079,53,allow,264,91,173,4,38,2,2
65169,56594,80,5980,80,allow,234,234,0,4,11,4,0
65170,58621,53,5007,53,allow,256,94,162,2,29,1,1
65171,42298,40014,17083,40014,allow,216,94,122,4,29,2,2
65172,42298,40042,61783,40042,allow,273,73,200,4,29,2,2
65173,65164,53,40444,53,allow,265,102,163,2,29,1,1
65174,60561,53,50880,53,allow,343,86,257,2,30,1,1
65175,34517,443,44047,443,allow,5996,1967,4029,17,99,10,7
65176,36836,443,63140,443,allow,7195,1791,5404,18,99,11,7
65177,50958,80,62860,80,allow,5730351,74236,5656115,4865,78,1088,3777
65178,55836,443,16714,443,allow,3538,2015,1523,28,323,14,14
65179,36586,80,45063,80,allow,1114,534,580,12,15,7,5
65180,56980,53,33367,53,allow,267,87,180,4,38,2,2
65181,53513,51354,18257,51354,allow,70,70,0,1,4,1,0
65182,123,123,49669,123,allow,184,94,90,2,29,1,1
65183,50142,443,40604,443,allow,9040,2349,6691,22,64,13,9
65184,50936,80,62610,80,allow,10423067,111935,10311132,8558,119,1601,6957
65185,50960,80,58959,80,allow,5533225,44880,5488345,4345,78,654,3691
65186,42298,40005,47580,40005,allow,211,89,122,4,29,2,2
65187,51716,57137,62764,57137,allow,70,70,0,2,8,2,0
65188,63710,54740,50464,54740,allow,70,70,0,1,4,1,0
65189,60394,53,18080,53,allow,330,94,236,2,30,1,1
65190,56765,443,20044,443,allow,12038195,322404,11715791,12026,153,3435,8591
65191,55470,53,6327,53,allow,197,102,95,2,30,1,1
65192,65461,53,1880,53,allow,268,110,158,2,30,1,1
65193,51811,443,57601,443,allow,18108,1782,16326,31,215,15,16
65194,57340,2258,57340,2258,allow,156,156,0,3,8,3,0
65195,51693,56308,27101,56308,allow,70,70,0,1,5,1,0
65196,41152,443,5083,443,allow,1848,1139,709,14,579,8,6
65197,51497,443,45992,443,allow,4945,1060,3885,21,15,12,9
65198,36256,443,43168,443,allow,3871,2466,1405,22,95,12,10
65199,49164,53,4974,53,allow,212,94,118,2,30,1,1
65200,49997,53,42386,53,allow,264,102,162,2,30,1,1
65201,64354,53,25529,53,allow,240,78,162,2,30,1,1
65202,57664,53,41830,53,allow,168,78,90,2,30,1,1
65203,52558,443,32057,443,allow,3530,1002,2528,12,120,6,6
65204,63691,53,63691,53,allow,198,90,108,2,30,1,1
65205,46069,80,2181,80,allow,2684,2550,134,7,17,5,2
65206,51720,51388,49576,51388,allow,70,70,0,2,8,2,0
65207,38901,53,60941,53,allow,168,78,90,2,30,1,1
65208,56980,53,28670,53,allow,267,87,180,4,38,2,2
65209,50572,80,21152,80,allow,132,132,0,2,8,2,0
65210,52481,443,2836,443,allow,70,70,0,1,5,1,0
65211,43591,443,60892,443,allow,1848,1141,707,14,566,8,6
65212,56917,443,25330,443,allow,14033,1591,12442,26,132,10,16
65213,61665,443,16320,443,allow,6279,1859,4420,25,16,14,11
65214,49520,53,55540,53,allow,229,102,127,2,30,1,1
65215,49899,7000,49899,7000,allow,758568,17631,740937,772,17,269,503
65216,54341,443,8795,443,allow,10046,3300,6746,23,61,14,9
65217,36289,53,0,0,allow,86,86,0,1,30,1,0
65218,56937,8200,52360,8200,allow,78,78,0,1,30,1,0
65219,48857,53,48857,53,allow,213,82,131,2,30,1,1
65220,35112,443,57886,443,allow,3242,1248,1994,26,362,7,19
65221,55024,443,1691,443,allow,552073,14113,537960,536,31,176,360
65222,49394,443,39992,443,allow,6211,1869,4342,18,181,8,10
65223,64495,443,32988,443,allow,1786,172,1614,7,120,3,4
65224,41128,443,53510,443,allow,3474,2349,1125,29,3438,17,12
65225,64626,53,31838,53,allow,326,102,224,2,30,1,1
65226,49608,53,46552,53,allow,177,94,83,2,30,1,1
65227,55470,53,12953,53,allow,197,102,95,2,33,1,1
65228,51691,5543,12224,5543,allow,70,70,0,1,5,1,0
65229,36158,443,34202,443,allow,9808,3005,6803,36,255,19,17
65230,52717,53,4391,53,allow,277,94,183,2,30,1,1
65231,49700,53,14464,53,allow,165,78,87,2,30,1,1
65232,33771,53,38746,53,allow,506,316,190,3,30,2,1
65233,6881,41019,41697,41019,allow,150,150,0,1,1200,1,0
65234,51147,443,55855,443,allow,6162,925,5237,18,52,10,8
65235,47831,53,0,0,allow,86,86,0,1,30,1,0
65236,61973,53,11068,53,allow,222,94,128,2,30,1,1
65237,63811,443,59225,443,allow,25707,7559,18148,53,121,24,29
65238,61431,443,56520,443,allow,352310,324883,27427,389,300,270,119
65239,14641,443,14641,443,allow,254281,66535,187746,336,317,183,153
65240,60441,443,36416,443,allow,3211,1964,1247,25,263,13,12
65241,54961,53,55140,53,allow,375,99,276,4,54,2,2
65242,47594,443,65055,443,allow,5447,1074,4373,21,17,10,11
65243,52860,443,7208,443,allow,7683,2076,5607,42,131,21,21
65244,53510,58706,37396,58706,allow,492,306,186,8,16,5,3
65245,34169,443,8049,443,allow,6507,1060,5447,22,255,12,10
65246,63698,59517,14181,59517,allow,504,382,122,8,15,6,2
65247,50871,80,63200,80,allow,94083,6192,87891,121,139,57,64
65248,42298,40013,38063,40013,allow,209,87,122,4,29,2,2
65249,63711,47951,19949,47951,allow,70,70,0,1,4,1,0
65250,63715,29834,21653,29834,allow,70,70,0,1,4,1,0
65251,63714,48477,18811,48477,allow,70,70,0,1,4,1,0
65252,53321,80,20263,80,allow,3483,2072,1411,21,214,17,4
65253,42298,40007,10253,40007,allow,273,73,200,4,29,2,2
65254,59486,53,24146,53,allow,316,86,230,2,29,1,1
65255,54991,53,13574,53,allow,177,94,83,2,29,1,1
65256,55317,53,22104,53,allow,94,94,0,1,30,1,0
65257,55828,443,52104,443,allow,5278,1026,4252,20,15,11,9
65258,64401,53,5392,53,allow,293,94,199,2,30,1,1
65259,123,123,5546,123,allow,184,94,90,2,29,1,1
65260,55664,53,60480,53,allow,177,94,83,2,29,1,1
65261,54991,53,42971,53,allow,253,87,166,4,29,2,2
65262,42298,40007,25770,40007,allow,206,84,122,4,29,2,2
65263,42298,40024,27133,40024,allow,207,85,122,4,29,2,2
65264,42298,40029,56928,40029,allow,208,86,122,4,29,2,2
65265,42298,40036,28327,40036,allow,205,83,122,4,29,2,2
65266,64254,53,25297,53,allow,211,78,133,2,30,1,1
65267,64905,53,16169,53,allow,245,94,151,2,30,1,1
65268,59165,53,3283,53,allow,186,78,108,2,30,1,1
65269,61113,27045,20306,27045,allow,1778,1386,392,8,30,4,4
65270,55179,53,63963,53,allow,194,102,92,2,30,1,1
65271,64209,53,25156,53,allow,277,94,183,2,30,1,1
65272,59610,53,54271,53,allow,191,78,113,2,30,1,1
65273,55801,53,42672,53,allow,222,102,120,2,30,1,1
65274,49529,53,23720,53,allow,211,94,117,2,30,1,1
65275,53169,443,5040,443,allow,6716,922,5794,20,20,10,10
65276,50136,443,32292,443,allow,23193,8487,14706,57,55,28,29
65277,60972,443,43346,443,allow,10208,5093,5115,46,15,27,19
65278,65383,53,42198,53,allow,267,94,173,2,30,1,1
65279,62139,53,5155,53,allow,291,78,213,2,30,1,1
65280,57067,53,11101,53,allow,252,102,150,2,30,1,1
65281,33305,53,29793,53,allow,168,78,90,2,30,1,1
65282,59393,443,45183,443,allow,1664,914,750,15,275,7,8
65283,63692,42635,61565,42635,allow,562,380,182,8,15,5,3
65284,55179,53,20932,53,allow,194,102,92,2,35,1,1
65285,56980,53,33611,53,allow,526,188,338,6,48,3,3
65286,62293,443,13135,443,allow,4755,1142,3613,15,273,8,7
65287,21133,17068,30422,17068,allow,481,150,331,2,1199,1,1
65288,52559,443,18708,443,allow,4479,2526,1953,10,120,6,4
65289,63853,443,40585,443,allow,3182,1568,1614,8,120,4,4
65290,6881,10385,61159,10385,allow,118,118,0,1,1199,1,0
65291,6881,13234,11039,13234,allow,324,150,174,2,1201,1,1
65292,53523,5362,54435,5362,allow,320,140,180,6,6,3,3
65293,53521,443,39860,443,allow,710,350,360,12,33,6,6
65294,47008,443,47008,443,allow,4373,1466,2907,19,27,11,8
65295,23174,80,23174,80,allow,490,264,226,8,31,5,3
65296,62640,443,62640,443,allow,27723,5572,22151,59,47,31,28
65297,50932,80,42211,80,allow,11381441,121813,11259628,9309,119,1741,7568
65298,64650,53,46185,53,allow,257,126,131,2,30,1,1
65299,3497,53,3497,53,allow,222,90,132,2,30,1,1
65300,65186,53,5333,53,allow,285,94,191,2,30,1,1
65301,49942,53,42485,53,allow,177,94,83,2,31,1,1
65302,53171,443,14871,443,allow,3220,2010,1210,20,19,10,10
65303,50946,80,36199,80,allow,5870176,83236,5786940,5053,78,1161,3892
65304,4960,53,26982,53,allow,222,86,136,2,30,1,1
65305,49585,53,59933,53,allow,718,94,624,2,30,1,1
65306,60739,40010,46673,40010,allow,316,136,180,6,6,3,3
65307,52632,443,1395,443,allow,4399,1857,2542,28,136,14,14
65308,49312,53,2239,53,allow,184,86,98,2,30,1,1
65309,49878,53,64175,53,allow,327,102,225,2,30,1,1
65310,65018,53,40867,53,allow,198,94,104,2,30,1,1
65311,20345,57470,0,0,deny,146,146,0,1,0,1,0
65312,30417,51505,0,0,deny,146,146,0,1,0,1,0
65313,49902,445,0,0,deny,70,70,0,1,0,1,0
65314,52668,51221,0,0,deny,66,66,0,1,0,1,0
65315,46495,4607,0,0,deny,60,60,0,1,0,1,0
65316,49418,57470,0,0,deny,66,66,0,1,0,1,0
65317,59037,51505,0,0,deny,66,66,0,1,0,1,0
65318,50602,26467,0,0,deny,66,66,0,1,0,1,0
65319,50374,445,0,0,drop,66,66,0,1,0,1,0
65320,5244,35440,0,0,deny,66,66,0,1,0,1,0
65321,64757,52700,0,0,deny,62,62,0,1,0,1,0
65322,54973,445,0,0,drop,70,70,0,1,0,1,0
65323,54972,445,0,0,drop,70,70,0,1,0,1,0
65324,59169,56205,0,0,deny,62,62,0,1,0,1,0
65325,23807,44847,0,0,deny,66,66,0,1,0,1,0
65326,26879,37965,0,0,deny,145,145,0,1,0,1,0
65327,49889,445,0,0,drop,70,70,0,1,0,1,0
65328,43329,50584,0,0,deny,146,146,0,1,0,1,0
65329,51130,61689,0,0,deny,66,66,0,1,0,1,0
65330,50368,445,0,0,drop,66,66,0,1,0,1,0
65331,62941,57470,0,0,deny,74,74,0,1,0,1,0
65332,50366,445,0,0,drop,66,66,0,1,0,1,0
65333,61670,57470,0,0,deny,74,74,0,1,0,1,0
65334,49886,445,0,0,drop,70,70,0,1,0,1,0
65335,2995,26467,0,0,deny,62,62,0,1,0,1,0
65336,54963,445,0,0,drop,70,70,0,1,0,1,0
65337,64437,56205,0,0,deny,66,66,0,1,0,1,0
65338,54958,445,0,0,drop,70,70,0,1,0,1,0
65339,54955,445,0,0,drop,70,70,0,1,0,1,0
65340,54951,445,0,0,drop,70,70,0,1,0,1,0
65341,49160,63766,0,0,deny,146,146,0,1,0,1,0
65342,5575,8889,0,0,deny,495,495,0,1,0,1,0
65343,16370,56205,0,0,deny,62,62,0,1,0,1,0
65344,50365,445,0,0,drop,66,66,0,1,0,1,0
65345,11136,57587,0,0,deny,62,62,0,1,0,1,0
65346,11136,17500,0,0,deny,62,62,0,1,0,1,0
65347,49964,64147,0,0,deny,66,66,0,1,0,1,0
65348,49882,445,0,0,drop,70,70,0,1,0,1,0
65349,5223,13602,0,0,deny,66,66,0,1,0,1,0
65350,54945,445,0,0,drop,70,70,0,1,0,1,0
65351,49880,445,0,0,drop,70,70,0,1,0,1,0
65352,61495,37965,0,0,deny,66,66,0,1,0,1,0
65353,44411,37965,0,0,deny,62,62,0,1,0,1,0
65354,54944,445,0,0,drop,70,70,0,1,0,1,0
65355,54943,445,0,0,drop,70,70,0,1,0,1,0
65356,54941,445,0,0,drop,70,70,0,1,0,1,0
65357,49878,445,0,0,drop,70,70,0,1,0,1,0
65358,50355,445,0,0,drop,66,66,0,1,0,1,0
65359,6889,60888,0,0,deny,139,139,0,1,0,1,0
65360,9717,22114,0,0,deny,146,146,0,1,0,1,0
65361,45941,23388,0,0,deny,60,60,0,1,0,1,0
65362,64382,44847,0,0,deny,66,66,0,1,0,1,0
65363,50353,445,0,0,drop,66,66,0,1,0,1,0
65364,50352,445,0,0,drop,66,66,0,1,0,1,0
65365,50350,445,0,0,drop,66,66,0,1,0,1,0
65366,50347,445,0,0,drop,66,66,0,1,0,1,0
65367,50346,445,0,0,drop,66,66,0,1,0,1,0
65368,50345,445,0,0,drop,66,66,0,1,0,1,0
65369,50337,37965,0,0,deny,66,66,0,1,0,1,0
65370,59241,62413,0,0,deny,66,66,0,1,0,1,0
65371,7744,32480,0,0,deny,62,62,0,1,0,1,0
65372,4431,32480,0,0,deny,66,66,0,1,0,1,0
65373,6773,57470,0,0,deny,62,62,0,1,0,1,0
65374,53051,44847,0,0,deny,66,66,0,1,0,1,0
65375,44933,26467,0,0,deny,62,62,0,1,0,1,0
65376,56564,9571,0,0,deny,78,78,0,1,0,1,0
65377,64335,35440,0,0,deny,62,62,0,1,0,1,0
65378,9756,26467,0,0,deny,66,66,0,1,0,1,0
65379,54938,445,0,0,drop,70,70,0,1,0,1,0
65380,54935,445,0,0,drop,70,70,0,1,0,1,0
65381,54932,445,0,0,drop,70,70,0,1,0,1,0
65382,49871,445,0,0,drop,70,70,0,1,0,1,0
65383,30794,37965,0,0,deny,62,62,0,1,0,1,0
65384,50343,445,0,0,drop,66,66,0,1,0,1,0
65385,54931,445,0,0,drop,70,70,0,1,0,1,0
65386,49869,445,0,0,drop,70,70,0,1,0,1,0
65387,50339,445,0,0,drop,66,66,0,1,0,1,0
65388,50337,445,0,0,drop,66,66,0,1,0,1,0
65389,50335,445,0,0,drop,66,66,0,1,0,1,0
65390,49868,445,0,0,drop,70,70,0,1,0,1,0
65391,50333,445,0,0,drop,66,66,0,1,0,1,0
65392,5637,37965,0,0,deny,62,62,0,1,0,1,0
65393,42252,33306,0,0,deny,60,60,0,1,0,1,0
65394,49867,445,0,0,drop,70,70,0,1,0,1,0
65395,49866,445,0,0,drop,70,70,0,1,0,1,0
65396,49864,445,0,0,drop,70,70,0,1,0,1,0
65397,49861,445,0,0,drop,70,70,0,1,0,1,0
65398,53828,2323,0,0,deny,60,60,0,1,0,1,0
65399,54930,445,0,0,drop,70,70,0,1,0,1,0
65400,54922,445,0,0,drop,70,70,0,1,0,1,0
65401,54914,445,0,0,drop,70,70,0,1,0,1,0
65402,49848,445,0,0,drop,70,70,0,1,0,1,0
65403,49846,445,0,0,drop,70,70,0,1,0,1,0
65404,49845,445,0,0,drop,70,70,0,1,0,1,0
65405,49837,445,0,0,drop,70,70,0,1,0,1,0
65406,49838,445,0,0,drop,70,70,0,1,0,1,0
65407,30654,51221,0,0,deny,72,72,0,1,0,1,0
65408,6057,51221,0,0,deny,78,78,0,1,0,1,0
65409,53813,11392,0,0,deny,62,62,0,1,0,1,0
65410,50325,445,0,0,drop,66,66,0,1,0,1,0
65411,61023,26467,0,0,deny,62,62,0,1,0,1,0
65412,56827,63710,0,0,deny,62,62,0,1,0,1,0
65413,24504,37965,0,0,deny,62,62,0,1,0,1,0
65414,52934,26467,0,0,deny,66,66,0,1,0,1,0
65415,49487,60043,0,0,deny,62,62,0,1,0,1,0
65416,50315,445,0,0,drop,66,66,0,1,0,1,0
65417,54909,445,0,0,drop,70,70,0,1,0,1,0
65418,49826,445,0,0,drop,70,70,0,1,0,1,0
65419,5661,37965,0,0,deny,66,66,0,1,0,1,0
65420,44147,64147,0,0,deny,62,62,0,1,0,1,0
65421,57107,64147,0,0,deny,66,66,0,1,0,1,0
65422,11136,15503,0,0,deny,145,145,0,1,0,1,0
65423,40489,1433,0,0,deny,60,60,0,1,0,1,0
65424,53912,26467,0,0,deny,66,66,0,1,0,1,0
65425,9381,35440,0,0,deny,62,62,0,1,0,1,0
65426,50313,445,0,0,drop,66,66,0,1,0,1,0
65427,52328,44847,0,0,deny,66,66,0,1,0,1,0
65428,9265,37965,0,0,deny,66,66,0,1,0,1,0
65429,53358,23,0,0,deny,60,60,0,1,0,1,0
65430,62914,11392,0,0,deny,62,62,0,1,0,1,0
65431,50306,445,0,0,drop,66,66,0,1,0,1,0
65432,49821,445,0,0,drop,70,70,0,1,0,1,0
65433,50303,445,0,0,drop,66,66,0,1,0,1,0
65434,13223,1310,0,0,deny,62,62,0,1,0,1,0
65435,24021,6881,0,0,deny,146,146,0,1,0,1,0
65436,52600,22,0,0,deny,60,60,0,1,0,1,0
65437,51320,37965,0,0,deny,62,62,0,1,0,1,0
65438,49812,445,0,0,drop,70,70,0,1,0,1,0
65439,49810,445,0,0,drop,70,70,0,1,0,1,0
65440,1027,23684,0,0,deny,159,159,0,1,0,1,0
65441,49809,445,0,0,drop,70,70,0,1,0,1,0
65442,49808,445,0,0,drop,70,70,0,1,0,1,0
65443,49804,445,0,0,drop,70,70,0,1,0,1,0
65444,64572,37965,0,0,deny,66,66,0,1,0,1,0
65445,54894,445,0,0,drop,70,70,0,1,0,1,0
65446,54891,445,0,0,drop,70,70,0,1,0,1,0
65447,54892,445,0,0,drop,70,70,0,1,0,1,0
65448,50285,445,0,0,drop,66,66,0,1,0,1,0
65449,50289,445,0,0,drop,66,66,0,1,0,1,0
65450,50290,445,0,0,drop,66,66,0,1,0,1,0
65451,50286,445,0,0,drop,66,66,0,1,0,1,0
65452,50284,445,0,0,drop,66,66,0,1,0,1,0
65453,50288,445,0,0,drop,66,66,0,1,0,1,0
65454,50287,445,0,0,drop,66,66,0,1,0,1,0
65455,50282,445,0,0,drop,66,66,0,1,0,1,0
65456,62739,21416,0,0,deny,145,145,0,1,0,1,0
65457,49502,44847,0,0,deny,66,66,0,1,0,1,0
65458,49798,445,0,0,drop,70,70,0,1,0,1,0
65459,2609,35993,0,0,deny,146,146,0,1,0,1,0
65460,14438,51505,0,0,deny,62,62,0,1,0,1,0
65461,54889,445,0,0,drop,70,70,0,1,0,1,0
65462,54880,445,0,0,drop,70,70,0,1,0,1,0
65463,54875,445,0,0,drop,70,70,0,1,0,1,0
65464,49791,445,0,0,drop,70,70,0,1,0,1,0
65465,40078,44847,0,0,deny,62,62,0,1,0,1,0
65466,49788,445,0,0,drop,70,70,0,1,0,1,0
65467,51098,60043,0,0,deny,62,62,0,1,0,1,0
65468,5938,35070,0,0,allow,60,60,0,1,90,1,0
65469,14092,80,14092,80,allow,3182,2082,1100,18,86,10,8
65470,51689,4765,24946,4765,allow,66,66,0,1,5,1,0
65471,22345,80,22345,80,allow,490,264,226,8,30,5,3
65472,64677,53,12416,53,allow,172,88,84,2,31,1,1
65473,50366,80,53987,80,allow,318,192,126,6,28,4,2
65474,50358,80,31825,80,allow,318,192,126,6,28,4,2
65475,50369,80,41191,80,allow,318,192,126,6,28,4,2
65476,53506,50144,41476,50144,allow,492,306,186,8,15,5,3
65477,55216,53,59483,53,allow,711,87,624,2,30,1,1
65478,58956,53,19380,53,allow,213,89,124,2,30,1,1
65479,55850,443,8932,443,allow,2883,642,2241,13,135,6,7
65480,64385,443,4632,443,allow,3677,1168,2509,17,120,8,9
65481,56456,443,10392,443,allow,3528,1162,2366,10,120,5,5
65482,51000,443,31109,443,allow,41713,34380,7333,67,333,38,29
65483,51709,40705,43195,40705,allow,70,70,0,2,8,2,0
65484,5394,23,5394,23,allow,124,60,64,2,5,1,1
65485,50370,80,12726,80,allow,318,192,126,6,28,4,2
65486,50359,80,41698,80,allow,318,192,126,6,28,4,2
65487,41340,80,50400,80,allow,2426,1540,886,14,23,8,6
65488,61308,443,22375,443,allow,44341,5858,38483,102,195,42,60
65489,50367,80,15574,80,allow,318,192,126,6,28,4,2
65490,30023,3389,30023,3389,allow,4145,1976,2169,22,19,13,9
65491,55015,443,8354,443,allow,1786,172,1614,7,120,3,4
65492,55726,27015,16348,27015,allow,1173,924,249,6,30,3,3
65493,56457,443,49133,443,allow,3654,1144,2510,10,120,5,5
65494,59021,443,44226,443,allow,4596,1442,3154,24,154,11,13
65495,53518,29500,52778,29500,allow,320,140,180,6,7,3,3
65496,51688,47961,35098,47961,allow,66,66,0,1,5,1,0
65497,57031,53,9800,53,allow,170,87,83,2,31,1,1
65498,60375,32277,60465,32277,allow,70,70,0,1,5,1,0
65499,57904,443,64826,443,allow,7912,3215,4697,23,20,12,11
65500,50343,80,49722,80,allow,22233,10123,12110,37,28,16,21
65501,50360,80,16489,80,allow,318,192,126,6,28,4,2
65502,50438,3389,50438,3389,allow,3429,1474,1955,16,16,8,8
65503,50361,80,40866,80,allow,318,192,126,6,28,4,2
65504,50368,80,46672,80,allow,318,192,126,6,28,4,2
65505,49681,53,1706,53,allow,170,87,83,2,30,1,1
65506,35608,443,62915,443,allow,5776,1880,3896,19,272,11,8
65507,57137,53,7336,53,allow,711,87,624,2,30,1,1
65508,5938,22455,0,0,allow,60,60,0,1,90,1,0
65509,36226,60038,0,0,allow,66,66,0,1,91,1,0
65510,49559,53,6355,53,allow,164,84,80,2,31,1,1
65511,57292,53,56725,53,allow,170,87,83,2,31,1,1
65512,58574,443,3429,443,allow,3447,788,2659,13,135,6,7
65513,56985,53,45052,53,allow,711,87,624,2,31,1,1
65514,50269,445,0,0,drop,66,66,0,1,0,1,0
65515,50270,445,0,0,drop,66,66,0,1,0,1,0
65516,50268,445,0,0,drop,66,66,0,1,0,1,0
65517,56103,21247,0,0,deny,66,66,0,1,0,1,0
65518,54874,445,0,0,drop,70,70,0,1,0,1,0
65519,54013,37965,0,0,deny,66,66,0,1,0,1,0
65520,49784,445,0,0,drop,70,70,0,1,0,1,0
65521,49783,445,0,0,drop,70,70,0,1,0,1,0
65522,42995,26467,0,0,deny,62,62,0,1,0,1,0
65523,53314,64097,0,0,deny,66,66,0,1,0,1,0
65524,55142,26467,0,0,deny,66,66,0,1,0,1,0
65525,53848,36237,0,0,deny,62,62,0,1,0,1,0
65526,65323,53,33275,53,allow,356,118,238,2,30,1,1
65527,51710,43069,65147,43069,allow,70,70,0,2,8,2,0
65528,63691,80,13237,80,allow,314,192,122,6,15,4,2
65529,50964,80,13485,80,allow,4680740,67312,4613428,4675,77,985,3690
65530,54871,445,0,0,drop,70,70,0,1,0,1,0
65531,54870,445,0,0,drop,70,70,0,1,0,1,0
65532,54867,445,0,0,drop,70,70,0,1,0,1,0